id,label,timeset,state,totalMig,totalNonMig,population
1001,Autauga County,,AL,5936,53711,59647
1003,Baldwin County,,AL,10318,167596,177914
1005,Barbour County,,AL,1669,26144,27813
1007,Bibb County,,AL,1369,21216,22585
1009,Blount County,,AL,3241,54044,57285
1011,Bullock County,,AL,543,8545,9088
1013,Butler County,,AL,1148,22112,23260
1015,Calhoun County,,AL,6564,123877,130441
1017,Chambers County,,AL,2174,39123,41297
1019,Cherokee County,,AL,1429,24670,26099
1021,Chilton County,,AL,2170,42336,44506
1023,Choctaw County,,AL,710,14944,15654
1025,Clarke County,,AL,1404,29643,31047
1027,Clay County,,AL,769,15551,16320
1029,Cleburne County,,AL,876,14461,15337
1031,Coffee County,,AL,5042,45883,50925
1033,Colbert County,,AL,3324,59337,62661
1035,Conecuh County,,AL,812,13834,14646
1037,Coosa County,,AL,1029,11597,12626
1039,Covington County,,AL,1937,37736,39673
1041,Crenshaw County,,AL,963,14541,15504
1043,Cullman County,,AL,3626,82756,86382
1045,Dale County,,AL,7580,47217,54797
1047,Dallas County,,AL,2324,46715,49039
1049,DeKalb County,,AL,3375,69465,72840
1051,Elmore County,,AL,6654,78919,85573
1053,Escambia County,,AL,1927,37282,39209
1055,Etowah County,,AL,5042,108424,113466
1057,Fayette County,,AL,1071,17739,18810
1059,Franklin County,,AL,1875,31560,33435
1061,Geneva County,,AL,1932,25205,27137
1063,Greene County,,AL,526,9498,10024
1065,Hale County,,AL,993,18258,19251
1067,Henry County,,AL,1258,17578,18836
1069,Houston County,,AL,6625,101033,107658
1071,Jackson County,,AL,2657,56375,59032
1073,Jefferson County,,AL,39192,703435,742627
1075,Lamar County,,AL,773,15660,16433
1077,Lauderdale County,,AL,4613,93967,98580
1079,Lawrence County,,AL,1867,36744,38611
1081,Lee County,,AL,10498,117708,128206
1083,Limestone County,,AL,4191,76860,81051
1085,Lowndes County,,AL,1169,14244,15413
1087,Macon County,,AL,1735,21398,23133
1089,Madison County,,AL,18043,344660,362703
1091,Marengo County,,AL,1239,22893,24132
1093,Marion County,,AL,1585,28735,30320
1095,Marshall County,,AL,5174,92348,97522
1097,Mobile County,,AL,17348,416617,433965
1099,Monroe County,,AL,1279,25058,26337
1101,Montgomery County,,AL,19333,241870,261203
1103,Morgan County,,AL,6944,126225,133169
1105,Perry County,,AL,643,11106,11749
1107,Pickens County,,AL,1152,20887,22039
1109,Pike County,,AL,2155,27775,29930
1111,Randolph County,,AL,1227,22603,23830
1113,Russell County,,AL,5950,50785,56735
1115,St. Clair County,,AL,4963,77040,82003
1117,Shelby County,,AL,15216,188828,204044
1119,Sumter County,,AL,844,13555,14399
1121,Talladega County,,AL,4766,83934,88700
1123,Tallapoosa County,,AL,2488,43338,45826
1125,Tuscaloosa County,,AL,9922,178362,188284
1127,Walker County,,AL,3130,67921,71051
1129,Washington County,,AL,1014,18007,19021
1131,Wilcox County,,AL,732,12974,13706
1133,Winston County,,AL,1538,24844,26382
2013,Aleutians East Borough,,AK,280,1603,1883
2016,Aleutians West Census Area,,AK,769,4171,4940
2020,Anchorage Municipality,,AK,29333,293869,323202
2050,Bethel Census Area,,AK,1081,16686,17767
2060,Bristol Bay Borough,,AK,175,1154,1329
2068,Denali Borough,,AK,336,2169,2505
2070,Dillingham Census Area,,AK,386,4648,5034
2090,Fairbanks North Star Borough,,AK,11505,94975,106480
2100,Haines Borough,,AK,197,2501,2698
2105,Hoonah-Angoon Census Area,,AK,0,0,0
2110,Juneau City and Borough,,AK,3005,34087,37092
2122,Kenai Peninsula Borough,,AK,3534,55141,58675
2130,Ketchikan Gateway Borough,,AK,1415,14503,15918
2150,Kodiak Island Borough,,AK,2021,14578,16599
2164,Lake and Peninsula Borough,,AK,147,1451,1598
2170,Matanuska-Susitna Borough,,AK,6073,78356,84429
2180,Nome Census Area,,AK,595,8798,9393
2185,North Slope Borough,,AK,606,6583,7189
2188,Northwest Arctic Borough,,AK,441,6495,6936
2195,Petersburg Census Area,,AK,0,0,0
2220,Sitka City and Borough,,AK,1117,9812,10929
2240,Southeast Fairbanks Census Area,,AK,785,7474,8259
2261,Valdez-Cordova Census Area,,AK,1242,10415,11657
2270,Wade Hampton Census Area,,AK,394,6938,7332
2282,Yakutat City and Borough,,AK,41,556,597
2290,Yukon-Koyukuk Census Area,,AK,502,5705,6207
4001,Apache County,,AZ,6883,61861,68744
4003,Cochise County,,AZ,13315,121905,135220
4005,Coconino County,,AZ,13141,123676,136817
4007,Gila County,,AZ,3419,50877,54296
4009,Graham County,,AZ,1559,26694,28253
4011,Greenlee County,,AZ,704,7445,8149
4012,La Paz County,,AZ,1382,14610,15992
4013,Maricopa County,,AZ,186247,3724138,3910385
4015,Mohave County,,AZ,14091,179470,193561
4017,Navajo County,,AZ,7680,95290,102970
4019,Pima County,,AZ,46948,950436,997384
4021,Pinal County,,AZ,19902,227489,247391
4023,Santa Cruz County,,AZ,2668,49932,52600
4025,Yavapai County,,AZ,14140,203883,218023
4027,Yuma County,,AZ,11836,194618,206454
5001,Arkansas County,,AR,1255,20999,22254
5003,Ashley County,,AR,1234,23041,24275
5005,Baxter County,,AR,2685,41567,44252
5007,Benton County,,AR,15246,204985,220231
5009,Boone County,,AR,2436,36712,39148
5011,Bradley County,,AR,778,11388,12166
5013,Calhoun County,,AR,389,5324,5713
5015,Carroll County,,AR,1902,26222,28124
5017,Chicot County,,AR,930,11469,12399
5019,Clark County,,AR,1776,20854,22630
5021,Clay County,,AR,1220,16726,17946
5023,Cleburne County,,AR,1677,25003,26680
5025,Cleveland County,,AR,757,9723,10480
5027,Columbia County,,AR,1600,24020,25620
5029,Conway County,,AR,1293,21008,22301
5031,Craighead County,,AR,6058,87218,93276
5033,Crawford County,,AR,4601,59858,64459
5035,Crittenden County,,AR,3475,52587,56062
5037,Cross County,,AR,1513,18930,20443
5039,Dallas County,,AR,637,8356,8993
5041,Desha County,,AR,1164,14178,15342
5043,Drew County,,AR,1486,17826,19312
5045,Faulkner County,,AR,7728,100554,108282
5047,Franklin County,,AR,1162,17774,18936
5049,Fulton County,,AR,807,10674,11481
5051,Garland County,,AR,5868,94838,100706
5053,Grant County,,AR,1379,18487,19866
5055,Greene County,,AR,2403,41139,43542
5057,Hempstead County,,AR,1489,22450,23939
5059,Hot Spring County,,AR,2219,30795,33014
5061,Howard County,,AR,953,14333,15286
5063,Independence County,,AR,2277,36785,39062
5065,Izard County,,AR,972,12080,13052
5067,Jackson County,,AR,1079,15864,16943
5069,Jefferson County,,AR,5571,79515,85086
5071,Johnson County,,AR,1364,23922,25286
5073,Lafayette County,,AR,543,7047,7590
5075,Lawrence County,,AR,1032,16400,17432
5077,Lee County,,AR,704,8152,8856
5079,Lincoln County,,AR,814,11059,11873
5081,Little River County,,AR,788,13336,14124
5083,Logan County,,AR,1487,22571,24058
5085,Lonoke County,,AR,5961,65140,71101
5087,Madison County,,AR,1013,15116,16129
5089,Marion County,,AR,1311,15448,16759
5091,Miller County,,AR,4127,40613,44740
5093,Mississippi County,,AR,2897,47842,50739
5095,Monroe County,,AR,732,8727,9459
5097,Montgomery County,,AR,516,8349,8865
5099,Nevada County,,AR,750,9436,10186
5101,Newton County,,AR,596,7929,8525
5103,Ouachita County,,AR,1727,27002,28729
5105,Perry County,,AR,783,10220,11003
5107,Phillips County,,AR,1452,22030,23482
5109,Pike County,,AR,697,11072,11769
5111,Poinsett County,,AR,1727,24189,25916
5113,Polk County,,AR,1240,19632,20872
5115,Pope County,,AR,4149,57604,61753
5117,Prairie County,,AR,592,8303,8895
5119,Pulaski County,,AR,28378,395967,424345
5121,Randolph County,,AR,1102,17751,18853
5123,St. Francis County,,AR,1933,24650,26583
5125,Saline County,,AR,6322,96440,102762
5127,Scott County,,AR,757,10929,11686
5129,Searcy County,,AR,408,7279,7687
5131,Sebastian County,,AR,9536,124638,134174
5133,Sevier County,,AR,995,15462,16457
5135,Sharp County,,AR,1469,16938,18407
5137,Stone County,,AR,619,11081,11700
5139,Union County,,AR,2480,46396,48876
5141,Van Buren County,,AR,1112,15660,16772
5143,Washington County,,AR,16437,182401,198838
5145,White County,,AR,4789,71272,76061
5147,Woodruff County,,AR,643,7674,8317
5149,Yell County,,AR,1581,20356,21937
6001,Alameda County,,CA,106613,1530774,1637387
6003,Alpine County,,CA,143,1026,1169
6005,Amador County,,CA,2168,37211,39379
6007,Butte County,,CA,12546,201515,214061
6009,Calaveras County,,CA,3108,45057,48165
6011,Colusa County,,CA,1509,24152,25661
6013,Contra Costa County,,CA,63118,1086259,1149377
6015,Del Norte County,,CA,1539,22285,23824
6017,El Dorado County,,CA,13061,185924,198985
6019,Fresno County,,CA,33585,873252,906837
6021,Glenn County,,CA,1766,28872,30638
6023,Humboldt County,,CA,7777,123908,131685
6025,Imperial County,,CA,8100,188203,196303
6027,Inyo County,,CA,1473,19248,20721
6029,Kern County,,CA,34176,751481,785657
6031,Kings County,,CA,10760,127845,138605
6033,Lake County,,CA,3624,56290,59914
6035,Lassen County,,CA,1864,25095,26959
6037,Los Angeles County,,CA,443189,9985591,10428780
6039,Madera County,,CA,7742,128074,135816
6041,Marin County,,CA,15362,239282,254644
6043,Mariposa County,,CA,1356,17582,18938
6045,Mendocino County,,CA,4677,87318,91995
6047,Merced County,,CA,14616,240416,255032
6049,Modoc County,,CA,726,8380,9106
6051,Mono County,,CA,1635,11964,13599
6053,Monterey County,,CA,30916,422769,453685
6055,Napa County,,CA,8375,141957,150332
6057,Nevada County,,CA,6695,102175,108870
6059,Orange County,,CA,184976,3162417,3347393
6061,Placer County,,CA,24740,344132,368872
6063,Plumas County,,CA,1631,21333,22964
6065,Riverside County,,CA,123122,2008846,2131968
6067,Sacramento County,,CA,80891,1443942,1524833
6069,San Benito County,,CA,4465,59212,63677
6071,San Bernardino County,,CA,146950,1992847,2139797
6073,San Diego County,,CA,183738,3203256,3386994
6075,San Francisco County,,CA,69066,793545,862611
6077,San Joaquin County,,CA,39613,678962,718575
6079,San Luis Obispo County,,CA,15135,256251,271386
6081,San Mateo County,,CA,54468,755878,810346
6083,Santa Barbara County,,CA,25790,410161,435951
6085,Santa Clara County,,CA,100702,1892570,1993272
6087,Santa Cruz County,,CA,15946,263680,279626
6089,Shasta County,,CA,9008,175084,184092
6091,Sierra County,,CA,307,3180,3487
6093,Siskiyou County,,CA,2635,43836,46471
6095,Solano County,,CA,32861,436382,469243
6097,Sonoma County,,CA,23618,502904,526522
6099,Stanislaus County,,CA,29175,523042,552217
6101,Sutter County,,CA,6905,92911,99816
6103,Tehama County,,CA,3655,58365,62020
6105,Trinity County,,CA,745,11139,11884
6107,Tulare County,,CA,16564,407640,424204
6109,Tuolumne County,,CA,3275,55678,58953
6111,Ventura County,,CA,47575,879294,926869
6113,Yolo County,,CA,15443,172561,188004
6115,Yuba County,,CA,8006,64429,72435
8001,Adams County,,CO,44124,429676,473800
8003,Alamosa County,,CO,1547,14158,15705
8005,Arapahoe County,,CO,61198,561693,622891
8007,Archuleta County,,CO,922,11356,12278
8009,Baca County,,CO,299,4063,4362
8011,Bent County,,CO,467,4211,4678
8013,Boulder County,,CO,27132,288457,315589
8014,Broomfield County,,CO,7251,49853,57104
8015,Chaffee County,,CO,1483,16531,18014
8017,Cheyenne County,,CO,201,2076,2277
8019,Clear Creek County,,CO,1022,8926,9948
8021,Conejos County,,CO,522,7965,8487
8023,Costilla County,,CO,246,3019,3265
8025,Crowley County,,CO,292,2865,3157
8027,Custer County,,CO,403,3741,4144
8029,Delta County,,CO,2007,29493,31500
8031,Denver County,,CO,73734,538677,612411
8033,Dolores County,,CO,187,1978,2165
8035,Douglas County,,CO,25626,275426,301052
8037,Eagle County,,CO,5453,45179,50632
8039,Elbert County,,CO,2216,22206,24422
8041,El Paso County,,CO,56726,615403,672129
8043,Fremont County,,CO,2768,40115,42883
8045,Garfield County,,CO,4559,49237,53796
8047,Gilpin County,,CO,693,4861,5554
8049,Grand County,,CO,1523,13240,14763
8051,Gunnison County,,CO,1661,12892,14553
8053,Hinsdale County,,CO,105,734,839
8055,Huerfano County,,CO,534,6207,6741
8057,Jackson County,,CO,170,1461,1631
8059,Jefferson County,,CO,50484,571081,621565
8061,Kiowa County,,CO,145,1535,1680
8063,Kit Carson County,,CO,544,8187,8731
8065,Lake County,,CO,737,6454,7191
8067,La Plata County,,CO,4160,46384,50544
8069,Larimer County,,CO,22873,294442,317315
8071,Las Animas County,,CO,1123,14720,15843
8073,Lincoln County,,CO,452,4866,5318
8075,Logan County,,CO,1407,20194,21601
8077,Mesa County,,CO,8158,141464,149622
8079,Mineral County,,CO,66,869,935
8081,Moffat County,,CO,1287,13932,15219
8083,Montezuma County,,CO,1974,24269,26243
8085,Montrose County,,CO,2521,39845,42366
8087,Morgan County,,CO,1972,29349,31321
8089,Otero County,,CO,1499,19514,21013
8091,Ouray County,,CO,405,3880,4285
8093,Park County,,CO,1607,14292,15899
8095,Phillips County,,CO,345,4749,5094
8097,Pitkin County,,CO,1766,13569,15335
8099,Prowers County,,CO,1162,12890,14052
8101,Pueblo County,,CO,7372,157198,164570
8103,Rio Blanco County,,CO,665,6171,6836
8105,Rio Grande County,,CO,1269,14759,16028
8107,Routt County,,CO,2134,20795,22929
8109,Saguache County,,CO,365,3179,3544
8111,San Juan County,,CO,91,582,673
8113,San Miguel County,,CO,763,6005,6768
8115,Sedgwick County,,CO,200,2475,2675
8117,Summit County,,CO,3825,25922,29747
8119,Teller County,,CO,2670,23661,26331
8121,Washington County,,CO,405,4667,5072
8123,Weld County,,CO,17418,238341,255759
8125,Yuma County,,CO,879,9876,10755
9001,Fairfield County,,CT,49103,961811,1010914
9003,Hartford County,,CT,44305,1022508,1066813
9005,Litchfield County,,CT,11199,222837,234036
9007,Middlesex County,,CT,11444,189627,201071
9009,New Haven County,,CT,44555,949122,993677
9011,New London County,,CT,19653,311704,331357
9013,Tolland County,,CT,10854,159334,170188
9015,Windham County,,CT,7537,131421,138958
10001,Kent County,,DE,10800,165761,176561
10003,New Castle County,,DE,28967,597504,626471
10005,Sussex County,,DE,8786,198267,207053
11001,District of Columbia,,DC,62808,541640,604448
12001,Alachua County,,FL,21613,216460,238073
12003,Baker County,,FL,1613,24872,26485
12005,Bay County,,FL,15463,174370,189833
12007,Bradford County,,FL,1743,23429,25172
12009,Brevard County,,FL,32740,586454,619194
12011,Broward County,,FL,148342,1806268,1954610
12013,Calhoun County,,FL,842,11285,12127
12015,Charlotte County,,FL,13091,156404,169495
12017,Citrus County,,FL,8637,140158,148795
12019,Clay County,,FL,19618,196702,216320
12021,Collier County,,FL,26625,318355,344980
12023,Columbia County,,FL,4748,59693,64441
12027,DeSoto County,,FL,2219,27012,29231
12029,Dixie County,,FL,978,12026,13004
12031,Duval County,,FL,68060,918696,986756
12033,Escambia County,,FL,30544,303575,334119
12035,Flagler County,,FL,6788,89872,96660
12037,Franklin County,,FL,757,9468,10225
12039,Gadsden County,,FL,2991,47702,50693
12041,Gilchrist County,,FL,1154,14159,15313
12043,Glades County,,FL,963,8230,9193
12045,Gulf County,,FL,1047,12438,13485
12047,Hamilton County,,FL,1026,11458,12484
12049,Hardee County,,FL,1653,22930,24583
12051,Hendry County,,FL,3391,35150,38541
12053,Hernando County,,FL,11737,166718,178455
12055,Highlands County,,FL,6136,90655,96791
12057,Hillsborough County,,FL,94070,1218312,1312382
12059,Holmes County,,FL,1252,16851,18103
12061,Indian River County,,FL,9281,138982,148263
12063,Jackson County,,FL,2774,45189,47963
12065,Jefferson County,,FL,1154,13772,14926
12067,Lafayette County,,FL,415,4769,5184
12069,Lake County,,FL,24791,293503,318294
12071,Lee County,,FL,41249,598580,639829
12073,Leon County,,FL,23526,244500,268026
12075,Levy County,,FL,3160,36902,40062
12077,Liberty County,,FL,459,6045,6504
12079,Madison County,,FL,1129,17522,18651
12081,Manatee County,,FL,25654,320407,346061
12083,Marion County,,FL,19960,326142,346102
12085,Martin County,,FL,12061,142239,154300
12086,Miami-Dade County,,FL,133990,2499871,2633861
12087,Monroe County,,FL,9812,73300,83112
12089,Nassau County,,FL,5651,74870,80521
12091,Okaloosa County,,FL,24570,199579,224149
12093,Okeechobee County,,FL,2883,35127,38010
12095,Orange County,,FL,117313,1120226,1237539
12097,Osceola County,,FL,31059,249059,280118
12099,Palm Beach County,,FL,89704,1311167,1400871
12101,Pasco County,,FL,36061,441723,477784
12103,Pinellas County,,FL,64810,962204,1027014
12105,Polk County,,FL,37146,584606,621752
12107,Putnam County,,FL,4726,71429,76155
12109,St. Johns County,,FL,14308,175049,189357
12111,St. Lucie County,,FL,21525,264641,286166
12113,Santa Rosa County,,FL,15880,143779,159659
12115,Sarasota County,,FL,28855,388416,417271
12117,Seminole County,,FL,50216,428650,478866
12119,Sumter County,,FL,4460,72560,77020
12121,Suwannee County,,FL,2694,38509,41203
12123,Taylor County,,FL,1026,19869,20895
12125,Union County,,FL,1048,10309,11357
12127,Volusia County,,FL,34978,508964,543942
12129,Wakulla County,,FL,1989,26289,28278
12131,Walton County,,FL,4697,45549,50246
12133,Washington County,,FL,1688,21241,22929
13001,Appling County,,GA,911,17697,18608
13003,Atkinson County,,GA,499,7018,7517
13005,Bacon County,,GA,576,9831,10407
13007,Baker County,,GA,327,3277,3604
13009,Baldwin County,,GA,2721,41865,44586
13011,Banks County,,GA,1551,16760,18311
13013,Barrow County,,GA,5623,62303,67926
13015,Bartow County,,GA,7155,99285,106440
13017,Ben Hill County,,GA,1217,18006,19223
13019,Berrien County,,GA,1420,16251,17671
13021,Bibb County,,GA,11259,158897,170156
13023,Bleckley County,,GA,635,10372,11007
13025,Brantley County,,GA,1127,15784,16911
13027,Brooks County,,GA,1480,15269,16749
13029,Bryan County,,GA,4385,29376,33761
13031,Bulloch County,,GA,4538,50794,55332
13033,Burke County,,GA,1515,24160,25675
13035,Butts County,,GA,1998,21456,23454
13037,Calhoun County,,GA,354,5415,5769
13039,Camden County,,GA,6619,47809,54428
13043,Candler County,,GA,732,9311,10043
13045,Carroll County,,GA,7812,104789,112601
13047,Catoosa County,,GA,5169,61018,66187
13049,Charlton County,,GA,791,9113,9904
13051,Chatham County,,GA,21776,240084,261860
13053,Chattahoochee County,,GA,4726,7118,11844
13055,Chattooga County,,GA,1317,26264,27581
13057,Cherokee County,,GA,16703,201515,218218
13059,Clarke County,,GA,11512,88206,99718
13061,Clay County,,GA,199,3007,3206
13063,Clayton County,,GA,36827,257870,294697
13065,Clinch County,,GA,349,6554,6903
13067,Cobb County,,GA,74031,702662,776693
13069,Coffee County,,GA,2117,38264,40381
13071,Colquitt County,,GA,2090,41439,43529
13073,Columbia County,,GA,10593,119780,130373
13075,Cook County,,GA,1123,16051,17174
13077,Coweta County,,GA,9151,119977,129128
13079,Crawford County,,GA,1057,12599,13656
13081,Crisp County,,GA,1451,21848,23299
13083,Dade County,,GA,1169,15434,16603
13085,Dawson County,,GA,1919,19477,21396
13087,Decatur County,,GA,1675,28154,29829
13089,DeKalb County,,GA,89355,649915,739270
13091,Dodge County,,GA,1031,18565,19596
13093,Dooly County,,GA,866,11567,12433
13095,Dougherty County,,GA,7658,93405,101063
13097,Douglas County,,GA,14992,119191,134183
13099,Early County,,GA,727,11996,12723
13101,Echols County,,GA,266,2834,3100
13103,Effingham County,,GA,3840,49944,53784
13105,Elbert County,,GA,1128,22000,23128
13107,Emanuel County,,GA,1343,22678,24021
13109,Evans County,,GA,743,10743,11486
13111,Fannin County,,GA,1223,21905,23128
13113,Fayette County,,GA,10599,112441,123040
13115,Floyd County,,GA,5144,94480,99624
13117,Forsyth County,,GA,11410,148887,160297
13119,Franklin County,,GA,1800,22628,24428
13121,Fulton County,,GA,103230,779816,883046
13123,Gilmer County,,GA,1868,26312,28180
13125,Glascock County,,GA,161,2730,2891
13127,Glynn County,,GA,5640,74686,80326
13129,Gordon County,,GA,3393,56566,59959
13131,Grady County,,GA,1516,23625,25141
13133,Greene County,,GA,1025,15551,16576
13135,Gwinnett County,,GA,72838,774490,847328
13137,Habersham County,,GA,2388,40455,42843
13139,Hall County,,GA,11108,175257,186365
13141,Hancock County,,GA,569,8935,9504
13143,Haralson County,,GA,2119,27355,29474
13145,Harris County,,GA,2538,30237,32775
13147,Hart County,,GA,1402,24850,26252
13149,Heard County,,GA,932,10385,11317
13151,Henry County,,GA,19230,192146,211376
13153,Houston County,,GA,12335,142377,154712
13155,Irwin County,,GA,807,9137,9944
13157,Jackson County,,GA,4670,55626,60296
13159,Jasper County,,GA,1189,13733,14922
13161,Jeff Davis County,,GA,949,13629,14578
13163,Jefferson County,,GA,992,19394,20386
13165,Jenkins County,,GA,544,8314,8858
13167,Johnson County,,GA,464,8212,8676
13169,Jones County,,GA,2152,28829,30981
13171,Lamar County,,GA,1368,15961,17329
13173,Lanier County,,GA,843,7035,7878
13175,Laurens County,,GA,2224,51558,53782
13177,Lee County,,GA,3218,28967,32185
13179,Liberty County,,GA,15355,54952,70307
13181,Lincoln County,,GA,533,8487,9020
13183,Long County,,GA,1701,8016,9717
13185,Lowndes County,,GA,9356,95263,104619
13187,Lumpkin County,,GA,2421,24041,26462
13189,McDuffie County,,GA,1488,23903,25391
13191,McIntosh County,,GA,801,10826,11627
13193,Macon County,,GA,829,12071,12900
13195,Madison County,,GA,1960,27870,29830
13197,Marion County,,GA,537,6797,7334
13199,Meriwether County,,GA,1897,22916,24813
13201,Miller County,,GA,347,5399,5746
13205,Mitchell County,,GA,1527,22447,23974
13207,Monroe County,,GA,1778,24964,26742
13209,Montgomery County,,GA,703,7928,8631
13211,Morgan County,,GA,1242,18166,19408
13213,Murray County,,GA,3307,41386,44693
13215,Muscogee County,,GA,20108,193181,213289
13217,Newton County,,GA,8743,92093,100836
13219,Oconee County,,GA,2591,31630,34221
13221,Oglethorpe County,,GA,1012,13642,14654
13223,Paulding County,,GA,11233,126498,137731
13225,Peach County,,GA,2279,25091,27370
13227,Pickens County,,GA,1929,29453,31382
13229,Pierce County,,GA,1278,17408,18686
13231,Pike County,,GA,1268,17572,18840
13233,Polk County,,GA,2301,40852,43153
13235,Pulaski County,,GA,604,9495,10099
13237,Putnam County,,GA,1558,20554,22112
13239,Quitman County,,GA,234,2296,2530
13241,Rabun County,,GA,1086,16010,17096
13243,Randolph County,,GA,419,7686,8105
13245,Richmond County,,GA,21261,197221,218482
13247,Rockdale County,,GA,10552,78205,88757
13249,Schley County,,GA,411,4681,5092
13251,Screven County,,GA,853,14900,15753
13253,Seminole County,,GA,712,9049,9761
13255,Spalding County,,GA,5007,62420,67427
13257,Stephens County,,GA,1747,26681,28428
13259,Stewart County,,GA,329,4713,5042
13261,Sumter County,,GA,2130,31198,33328
13263,Talbot County,,GA,493,7082,7575
13265,Taliaferro County,,GA,130,1753,1883
13267,Tattnall County,,GA,1343,18397,19740
13269,Taylor County,,GA,491,8990,9481
13271,Telfair County,,GA,697,10782,11479
13273,Terrell County,,GA,696,10582,11278
13275,Thomas County,,GA,2800,45525,48325
13277,Tift County,,GA,3121,40514,43635
13279,Toombs County,,GA,1742,26260,28002
13281,Towns County,,GA,637,9915,10552
13283,Treutlen County,,GA,340,6206,6546
13285,Troup County,,GA,3751,66695,70446
13287,Turner County,,GA,605,9628,10233
13289,Twiggs County,,GA,823,9882,10705
13291,Union County,,GA,1094,19873,20967
13293,Upson County,,GA,1369,28210,29579
13295,Walker County,,GA,4290,64876,69166
13297,Walton County,,GA,5561,78177,83738
13299,Ware County,,GA,2437,34093,36530
13301,Warren County,,GA,451,6422,6873
13303,Washington County,,GA,858,21724,22582
13305,Wayne County,,GA,1608,26934,28542
13307,Webster County,,GA,152,2443,2595
13309,Wheeler County,,GA,371,4565,4936
13311,White County,,GA,1923,23936,25859
13313,Whitfield County,,GA,6647,109910,116557
13315,Wilcox County,,GA,462,6991,7453
13317,Wilkes County,,GA,552,10897,11449
13319,Wilkinson County,,GA,608,10976,11584
13321,Worth County,,GA,1659,22546,24205
15001,Hawaii County,,HI,7734,175765,183499
15003,Honolulu County,,HI,68768,1032989,1101757
15005,Kalawao County,,HI,-2,-2,-4
15007,Kauai County,,HI,3208,69328,72536
15009,Maui County,,HI,8059,155238,163297
16001,Ada County,,ID,26457,387046,413503
16003,Adams County,,ID,351,3917,4268
16005,Bannock County,,ID,6626,81027,87653
16007,Bear Lake County,,ID,469,6675,7144
16009,Benewah County,,ID,685,9597,10282
16011,Bingham County,,ID,3503,46896,50399
16013,Blaine County,,ID,1896,23688,25584
16015,Boise County,,ID,658,6741,7399
16017,Bonner County,,ID,2758,40114,42872
16019,Bonneville County,,ID,7441,103807,111248
16021,Boundary County,,ID,735,10940,11675
16023,Butte County,,ID,215,2952,3167
16025,Camas County,,ID,95,965,1060
16027,Canyon County,,ID,13393,174400,187793
16029,Caribou County,,ID,519,7648,8167
16031,Cassia County,,ID,1857,22184,24041
16033,Clark County,,ID,97,979,1076
16035,Clearwater County,,ID,721,8594,9315
16037,Custer County,,ID,361,4347,4708
16039,Elmore County,,ID,4320,26810,31130
16041,Franklin County,,ID,898,13578,14476
16043,Fremont County,,ID,1168,13633,14801
16045,Gem County,,ID,1477,16994,18471
16047,Gooding County,,ID,1380,14969,16349
16049,Idaho County,,ID,993,14511,15504
16051,Jefferson County,,ID,2244,24744,26988
16053,Jerome County,,ID,2146,20280,22426
16055,Kootenai County,,ID,8348,139363,147711
16057,Latah County,,ID,4244,33217,37461
16059,Lemhi County,,ID,626,7846,8472
16061,Lewis County,,ID,385,4179,4564
16063,Lincoln County,,ID,441,4853,5294
16065,Madison County,,ID,4947,25438,30385
16067,Minidoka County,,ID,1821,21103,22924
16069,Nez Perce County,,ID,3145,40503,43648
16071,Oneida County,,ID,298,4404,4702
16073,Owyhee County,,ID,1253,10732,11985
16075,Payette County,,ID,1905,22513,24418
16077,Power County,,ID,709,8098,8807
16079,Shoshone County,,ID,1016,12443,13459
16081,Teton County,,ID,863,8263,9126
16083,Twin Falls County,,ID,5588,75748,81336
16085,Valley County,,ID,1205,9658,10863
16087,Washington County,,ID,891,9746,10637
17001,Adams County,,IL,3058,79736,82794
17003,Alexander County,,IL,614,7706,8320
17005,Bond County,,IL,1166,18386,19552
17007,Boone County,,IL,4734,63042,67776
17009,Brown County,,IL,373,5756,6129
17011,Bureau County,,IL,2281,42898,45179
17013,Calhoun County,,IL,218,6017,6235
17015,Carroll County,,IL,1063,19723,20786
17017,Cass County,,IL,1029,15544,16573
17019,Champaign County,,IL,14420,190264,204684
17021,Christian County,,IL,1884,40526,42410
17023,Clark County,,IL,1051,19787,20838
17025,Clay County,,IL,846,16453,17299
17027,Clinton County,,IL,2120,43871,45991
17029,Coles County,,IL,3529,50926,54455
17031,Cook County,,IL,252842,5766519,6019361
17033,Crawford County,,IL,899,22745,23644
17035,Cumberland County,,IL,830,12666,13496
17037,DeKalb County,,IL,8463,103765,112228
17039,De Witt County,,IL,1257,19413,20670
17041,Douglas County,,IL,1508,25105,26613
17043,DuPage County,,IL,81155,1074995,1156150
17045,Edgar County,,IL,1079,21583,22662
17047,Edwards County,,IL,323,8066,8389
17049,Effingham County,,IL,2139,42831,44970
17051,Fayette County,,IL,1099,24382,25481
17053,Ford County,,IL,1140,16613,17753
17055,Franklin County,,IL,2212,43036,45248
17057,Fulton County,,IL,1811,41893,43704
17059,Gallatin County,,IL,433,6492,6925
17061,Greene County,,IL,813,16118,16931
17063,Grundy County,,IL,4241,57161,61402
17065,Hamilton County,,IL,451,9407,9858
17067,Hancock County,,IL,1315,23489,24804
17069,Hardin County,,IL,248,4370,4618
17071,Henderson County,,IL,497,8772,9269
17073,Henry County,,IL,3316,61305,64621
17075,Iroquois County,,IL,1980,36864,38844
17077,Jackson County,,IL,5922,51470,57392
17079,Jasper County,,IL,540,12486,13026
17081,Jefferson County,,IL,2240,42386,44626
17083,Jersey County,,IL,1394,26242,27636
17085,Jo Daviess County,,IL,1364,27853,29217
17087,Johnson County,,IL,810,12549,13359
17089,Kane County,,IL,36649,542556,579205
17091,Kankakee County,,IL,5796,124903,130699
17093,Kendall County,,IL,8101,110474,118575
17095,Knox County,,IL,3117,57716,60833
17097,Lake County,,IL,47302,788507,835809
17099,LaSalle County,,IL,6660,137164,143824
17101,Lawrence County,,IL,876,16601,17477
17103,Lee County,,IL,2347,41125,43472
17105,Livingston County,,IL,2297,44723,47020
17107,Logan County,,IL,1935,32178,34113
17109,McDonough County,,IL,2250,29649,31899
17111,McHenry County,,IL,19798,368853,388651
17113,McLean County,,IL,10905,177662,188567
17115,Macon County,,IL,5882,126956,132838
17117,Macoupin County,,IL,3033,55834,58867
17119,Madison County,,IL,14777,310562,325339
17121,Marion County,,IL,2282,45867,48149
17123,Marshall County,,IL,1037,15844,16881
17125,Mason County,,IL,1061,17393,18454
17127,Massac County,,IL,937,17405,18342
17129,Menard County,,IL,966,15076,16042
17131,Mercer County,,IL,1232,21099,22331
17133,Monroe County,,IL,1883,40027,41910
17135,Montgomery County,,IL,1693,33684,35377
17137,Morgan County,,IL,2065,39172,41237
17139,Moultrie County,,IL,992,17247,18239
17141,Ogle County,,IL,3967,64690,68657
17143,Peoria County,,IL,13025,212075,225100
17145,Perry County,,IL,1261,23209,24470
17147,Piatt County,,IL,1305,19835,21140
17149,Pike County,,IL,749,18486,19235
17151,Pope County,,IL,191,4269,4460
17153,Pulaski County,,IL,509,6809,7318
17155,Putnam County,,IL,514,7338,7852
17157,Randolph County,,IL,1683,36041,37724
17159,Richland County,,IL,944,18860,19804
17161,Rock Island County,,IL,9354,173480,182834
17163,St. Clair County,,IL,17858,296515,314373
17165,Saline County,,IL,1129,26921,28050
17167,Sangamon County,,IL,10511,233223,243734
17169,Schuyler County,,IL,549,8428,8977
17171,Scott County,,IL,356,6401,6757
17173,Shelby County,,IL,1463,25798,27261
17175,Stark County,,IL,390,7401,7791
17177,Stephenson County,,IL,2833,57084,59917
17179,Tazewell County,,IL,8198,160021,168219
17181,Union County,,IL,900,20202,21102
17183,Vermilion County,,IL,4164,91863,96027
17185,Wabash County,,IL,696,14265,14961
17187,Warren County,,IL,1117,19607,20724
17189,Washington County,,IL,1089,18279,19368
17191,Wayne County,,IL,701,19198,19899
17193,White County,,IL,823,17270,18093
17195,Whiteside County,,IL,3335,72058,75393
17197,Will County,,IL,46088,764507,810595
17199,Williamson County,,IL,4203,69614,73817
17201,Winnebago County,,IL,14887,341987,356874
17203,Woodford County,,IL,2537,44659,47196
18001,Adams County,,IN,1766,41351,43117
18003,Allen County,,IN,17888,412236,430124
18005,Bartholomew County,,IN,5087,88262,93349
18007,Benton County,,IN,878,10413,11291
18009,Blackford County,,IN,912,16027,16939
18011,Boone County,,IN,4235,61664,65899
18013,Brown County,,IN,1327,17994,19321
18015,Carroll County,,IN,1748,23754,25502
18017,Cass County,,IN,2650,45957,48607
18019,Clark County,,IN,8104,119556,127660
18021,Clay County,,IN,1763,31408,33171
18023,Clinton County,,IN,2277,39561,41838
18025,Crawford County,,IN,811,12005,12816
18027,Daviess County,,IN,1299,34293,35592
18029,Dearborn County,,IN,3461,58813,62274
18031,Decatur County,,IN,1801,31378,33179
18033,DeKalb County,,IN,3133,50159,53292
18035,Delaware County,,IN,7255,117927,125182
18037,Dubois County,,IN,2249,52873,55122
18039,Elkhart County,,IN,11700,229655,241355
18041,Fayette County,,IN,1550,27349,28899
18043,Floyd County,,IN,6764,82818,89582
18045,Fountain County,,IN,1418,21237,22655
18047,Franklin County,,IN,1493,28686,30179
18049,Fulton County,,IN,1590,24529,26119
18051,Gibson County,,IN,2133,39478,41611
18053,Grant County,,IN,4080,75784,79864
18055,Greene County,,IN,2342,37244,39586
18057,Hamilton County,,IN,20963,281006,301969
18059,Hancock County,,IN,5502,79000,84502
18061,Harrison County,,IN,2485,44818,47303
18063,Hendricks County,,IN,11355,152207,163562
18065,Henry County,,IN,3084,56361,59445
18067,Howard County,,IN,5329,101146,106475
18069,Huntington County,,IN,2494,45869,48363
18071,Jackson County,,IN,2757,50396,53153
18073,Jasper County,,IN,2260,37899,40159
18075,Jay County,,IN,1258,25659,26917
18077,Jefferson County,,IN,1944,36639,38583
18079,Jennings County,,IN,2049,32176,34225
18081,Johnson County,,IN,12244,151591,163835
18083,Knox County,,IN,2125,40816,42941
18085,Kosciusko County,,IN,5052,93647,98699
18087,LaGrange County,,IN,2628,44187,46815
18089,Lake County,,IN,28077,551781,579858
18091,LaPorte County,,IN,5468,123855,129323
18093,Lawrence County,,IN,2181,53062,55243
18095,Madison County,,IN,7358,146506,153864
18097,Marion County,,IN,66497,987283,1053780
18099,Marshall County,,IN,3385,55149,58534
18101,Martin County,,IN,678,12190,12868
18103,Miami County,,IN,2947,39781,42728
18105,Monroe County,,IN,10648,112984,123632
18107,Montgomery County,,IN,2446,43867,46313
18109,Morgan County,,IN,5693,80754,86447
18111,Newton County,,IN,1227,16455,17682
18113,Noble County,,IN,3510,53727,57237
18115,Ohio County,,IN,638,6955,7593
18117,Orange County,,IN,1113,21635,22748
18119,Owen County,,IN,1760,23276,25036
18121,Parke County,,IN,1073,16716,17789
18123,Perry County,,IN,927,20819,21746
18125,Pike County,,IN,819,14665,15484
18127,Porter County,,IN,11486,183800,195286
18129,Posey County,,IN,1780,31270,33050
18131,Pulaski County,,IN,1040,15635,16675
18133,Putnam County,,IN,2441,39236,41677
18135,Randolph County,,IN,1900,30741,32641
18137,Ripley County,,IN,2037,32228,34265
18139,Rush County,,IN,1295,20751,22046
18141,St. Joseph County,,IN,16061,300824,316885
18143,Scott County,,IN,1699,25774,27473
18145,Shelby County,,IN,3176,51636,54812
18147,Spencer County,,IN,1571,25034,26605
18149,Starke County,,IN,1851,26153,28004
18151,Steuben County,,IN,2739,38333,41072
18153,Sullivan County,,IN,1247,22716,23963
18155,Switzerland County,,IN,748,9987,10735
18157,Tippecanoe County,,IN,12934,157485,170419
18159,Tipton County,,IN,1191,19674,20865
18161,Union County,,IN,624,8494,9118
18163,Vanderburgh County,,IN,11072,196070,207142
18165,Vermillion County,,IN,1196,19289,20485
18167,Vigo County,,IN,6886,110429,117315
18169,Wabash County,,IN,2192,39792,41984
18171,Warren County,,IN,695,10135,10830
18173,Warrick County,,IN,4674,66769,71443
18175,Washington County,,IN,1721,31559,33280
18177,Wayne County,,IN,4035,79836,83871
18179,Wells County,,IN,1760,32124,33884
18181,White County,,IN,2068,29774,31842
18183,Whitley County,,IN,2293,40411,42704
19001,Adair County,,IA,595,9138,9733
19003,Adams County,,IA,267,4977,5244
19005,Allamakee County,,IA,825,16989,17814
19007,Appanoose County,,IA,840,14363,15203
19009,Audubon County,,IA,381,7476,7857
19011,Benton County,,IA,1957,30753,32710
19013,Black Hawk County,,IA,7994,137616,145610
19015,Boone County,,IA,1876,30695,32571
19017,Bremer County,,IA,1611,27426,29037
19019,Buchanan County,,IA,1285,24589,25874
19021,Buena Vista County,,IA,1753,22733,24486
19023,Butler County,,IA,1029,18108,19137
19025,Calhoun County,,IA,670,12017,12687
19027,Carroll County,,IA,1192,25808,27000
19029,Cass County,,IA,883,16118,17001
19031,Cedar County,,IA,1332,21979,23311
19033,Cerro Gordo County,,IA,2898,51205,54103
19035,Cherokee County,,IA,722,14547,15269
19037,Chickasaw County,,IA,743,15227,15970
19039,Clarke County,,IA,793,10269,11062
19041,Clay County,,IA,1158,20487,21645
19043,Clayton County,,IA,1181,21984,23165
19045,Clinton County,,IA,2800,58077,60877
19047,Crawford County,,IA,1044,19537,20581
19049,Dallas County,,IA,5798,63777,69575
19051,Davis County,,IA,546,9639,10185
19053,Decatur County,,IA,608,8131,8739
19055,Delaware County,,IA,977,21843,22820
19057,Des Moines County,,IA,2376,47087,49463
19059,Dickinson County,,IA,1441,19870,21311
19061,Dubuque County,,IA,4547,108707,113254
19063,Emmet County,,IA,733,11679,12412
19065,Fayette County,,IA,1404,23152,24556
19067,Floyd County,,IA,1108,18998,20106
19069,Franklin County,,IA,653,12157,12810
19071,Fremont County,,IA,637,8638,9275
19073,Greene County,,IA,662,11345,12007
19075,Grundy County,,IA,886,15039,15925
19077,Guthrie County,,IA,857,13146,14003
19079,Hamilton County,,IA,1220,18815,20035
19081,Hancock County,,IA,871,14005,14876
19083,Hardin County,,IA,1148,20036,21184
19085,Harrison County,,IA,1049,17479,18528
19087,Henry County,,IA,1390,22399,23789
19089,Howard County,,IA,662,11875,12537
19091,Humboldt County,,IA,642,11979,12621
19093,Ida County,,IA,474,8645,9119
19095,Iowa County,,IA,1145,19970,21115
19097,Jackson County,,IA,1185,23977,25162
19099,Jasper County,,IA,2619,42217,44836
19101,Jefferson County,,IA,1160,16425,17585
19103,Johnson County,,IA,11877,123036,134913
19105,Jones County,,IA,1185,22667,23852
19107,Keokuk County,,IA,752,12274,13026
19109,Kossuth County,,IA,799,19798,20597
19111,Lee County,,IA,2177,40497,42674
19113,Linn County,,IA,10879,237399,248278
19115,Louisa County,,IA,913,13392,14305
19117,Lucas County,,IA,616,9925,10541
19119,Lyon County,,IA,682,13964,14646
19121,Madison County,,IA,1134,17485,18619
19123,Mahaska County,,IA,1550,24767,26317
19125,Marion County,,IA,2137,38373,40510
19127,Marshall County,,IA,2379,45657,48036
19129,Mills County,,IA,1206,16522,17728
19131,Mitchell County,,IA,548,12745,13293
19133,Monona County,,IA,596,10817,11413
19135,Monroe County,,IA,562,8774,9336
19137,Montgomery County,,IA,822,12655,13477
19139,Muscatine County,,IA,2715,50609,53324
19141,O'Brien County,,IA,1082,17215,18297
19143,Osceola County,,IA,476,7941,8417
19145,Page County,,IA,1135,17401,18536
19147,Palo Alto County,,IA,668,11012,11680
19149,Plymouth County,,IA,1662,30295,31957
19151,Pocahontas County,,IA,509,9027,9536
19153,Polk County,,IA,24849,468519,493368
19155,Pottawattamie County,,IA,5991,101339,107330
19157,Poweshiek County,,IA,1355,20970,22325
19159,Ringgold County,,IA,300,5549,5849
19161,Sac County,,IA,686,12690,13376
19163,Scott County,,IA,10600,184727,195327
19165,Shelby County,,IA,772,14725,15497
19167,Sioux County,,IA,1639,37745,39384
19169,Story County,,IA,8592,78722,87314
19171,Tama County,,IA,1274,21410,22684
19173,Taylor County,,IA,521,7192,7713
19175,Union County,,IA,839,13838,14677
19177,Van Buren County,,IA,460,8618,9078
19179,Wapello County,,IA,2569,39055,41624
19181,Warren County,,IA,3319,51021,54340
19183,Washington County,,IA,1432,25290,26722
19185,Wayne County,,IA,467,7314,7781
19187,Webster County,,IA,2281,41952,44233
19189,Winnebago County,,IA,807,13197,14004
19191,Winneshiek County,,IA,1058,23032,24090
19193,Woodbury County,,IA,6830,112983,119813
19195,Worth County,,IA,546,9031,9577
19197,Wright County,,IA,936,15255,16191
20001,Allen County,,KS,955,14886,15841
20003,Anderson County,,KS,556,9305,9861
20005,Atchison County,,KS,975,18067,19042
20007,Barber County,,KS,389,5632,6021
20009,Barton County,,KS,1850,30552,32402
20011,Bourbon County,,KS,1073,16154,17227
20013,Brown County,,KS,758,11762,12520
20015,Butler County,,KS,4948,67231,72179
20017,Chase County,,KS,260,3116,3376
20019,Chautauqua County,,KS,352,3921,4273
20021,Cherokee County,,KS,1547,22476,24023
20023,Cheyenne County,,KS,188,3248,3436
20025,Clark County,,KS,212,2332,2544
20027,Clay County,,KS,737,9807,10544
20029,Cloud County,,KS,756,10445,11201
20031,Coffey County,,KS,717,10073,10790
20033,Comanche County,,KS,88,2016,2104
20035,Cowley County,,KS,2328,37725,40053
20037,Crawford County,,KS,2918,38139,41057
20039,Decatur County,,KS,269,3519,3788
20041,Dickinson County,,KS,1929,22018,23947
20043,Doniphan County,,KS,587,8589,9176
20045,Douglas County,,KS,10334,98762,109096
20047,Edwards County,,KS,268,3496,3764
20049,Elk County,,KS,242,3080,3322
20051,Ellis County,,KS,2246,29641,31887
20053,Ellsworth County,,KS,417,6747,7164
20055,Finney County,,KS,3867,41509,45376
20057,Ford County,,KS,2648,35242,37890
20059,Franklin County,,KS,1991,28286,30277
20061,Geary County,,KS,10371,31186,41557
20063,Gove County,,KS,239,3422,3661
20065,Graham County,,KS,227,3050,3277
20067,Grant County,,KS,618,8851,9469
20069,Gray County,,KS,629,6867,7496
20071,Greeley County,,KS,106,1542,1648
20073,Greenwood County,,KS,513,7152,7665
20075,Hamilton County,,KS,191,2705,2896
20077,Harper County,,KS,494,6746,7240
20079,Harvey County,,KS,2511,37761,40272
20081,Haskell County,,KS,451,4725,5176
20083,Hodgeman County,,KS,168,2300,2468
20085,Jackson County,,KS,1144,15611,16755
20087,Jefferson County,,KS,1515,21315,22830
20089,Jewell County,,KS,244,3905,4149
20091,Johnson County,,KS,40436,590855,631291
20093,Kearny County,,KS,466,4619,5085
20095,Kingman County,,KS,683,9202,9885
20097,Kiowa County,,KS,308,3271,3579
20099,Labette County,,KS,1471,24374,25845
20101,Lane County,,KS,135,2031,2166
20103,Leavenworth County,,KS,8948,73039,81987
20105,Lincoln County,,KS,233,3985,4218
20107,Linn County,,KS,864,10372,11236
20109,Logan County,,KS,217,3265,3482
20111,Lyon County,,KS,2952,37668,40620
20113,McPherson County,,KS,2032,34147,36179
20115,Marion County,,KS,941,14023,14964
20117,Marshall County,,KS,658,12803,13461
20119,Meade County,,KS,433,5101,5534
20121,Miami County,,KS,2327,34090,36417
20123,Mitchell County,,KS,401,7175,7576
20125,Montgomery County,,KS,2548,37148,39696
20127,Morris County,,KS,483,6622,7105
20129,Morton County,,KS,432,3716,4148
20131,Nemaha County,,KS,664,12592,13256
20133,Neosho County,,KS,1123,17937,19060
20135,Ness County,,KS,177,3730,3907
20137,Norton County,,KS,446,5944,6390
20139,Osage County,,KS,1336,18936,20272
20141,Osborne County,,KS,356,4773,5129
20143,Ottawa County,,KS,557,7230,7787
20145,Pawnee County,,KS,540,7034,7574
20147,Phillips County,,KS,397,6704,7101
20149,Pottawatomie County,,KS,1728,22423,24151
20151,Pratt County,,KS,833,10391,11224
20153,Rawlins County,,KS,156,3009,3165
20155,Reno County,,KS,3858,69894,73752
20157,Republic County,,KS,270,6163,6433
20159,Rice County,,KS,875,10912,11787
20161,Riley County,,KS,10436,48320,58756
20163,Rooks County,,KS,366,5936,6302
20165,Rush County,,KS,278,3768,4046
20167,Russell County,,KS,511,7635,8146
20169,Saline County,,KS,4102,63294,67396
20171,Scott County,,KS,483,5635,6118
20173,Sedgwick County,,KS,24541,528739,553280
20175,Seward County,,KS,2501,25139,27640
20177,Shawnee County,,KS,9859,196329,206188
20179,Sheridan County,,KS,168,3227,3395
20181,Sherman County,,KS,470,6314,6784
20183,Smith County,,KS,304,4917,5221
20185,Stafford County,,KS,380,5009,5389
20187,Stanton County,,KS,249,2435,2684
20189,Stevens County,,KS,549,6170,6719
20191,Sumner County,,KS,2136,26908,29044
20193,Thomas County,,KS,693,8321,9014
20195,Trego County,,KS,232,3667,3899
20197,Wabaunsee County,,KS,631,7860,8491
20199,Wallace County,,KS,126,1815,1941
20201,Washington County,,KS,371,7325,7696
20203,Wichita County,,KS,251,2751,3002
20205,Wilson County,,KS,764,10727,11491
20207,Woodson County,,KS,294,3519,3813
20209,Wyandotte County,,KS,13351,153680,167031
21001,Adair County,,KY,843,16753,17596
21003,Allen County,,KY,998,19581,20579
21005,Anderson County,,KY,1561,24176,25737
21007,Ballard County,,KY,481,9162,9643
21009,Barren County,,KY,2161,43825,45986
21011,Bath County,,KY,808,11464,12272
21013,Bell County,,KY,1472,24845,26317
21015,Boone County,,KY,11487,124601,136088
21017,Bourbon County,,KY,1590,21335,22925
21019,Boyd County,,KY,3003,50461,53464
21021,Boyle County,,KY,2184,28530,30714
21023,Bracken County,,KY,670,10257,10927
21025,Breathitt County,,KY,479,12778,13257
21027,Breckinridge County,,KY,1087,19873,20960
21029,Bullitt County,,KY,5406,81699,87105
21031,Butler County,,KY,660,13253,13913
21033,Caldwell County,,KY,712,13590,14302
21035,Calloway County,,KY,2413,34080,36493
21037,Campbell County,,KY,7190,96147,103337
21039,Carlisle County,,KY,377,5703,6080
21041,Carroll County,,KY,1009,12706,13715
21043,Carter County,,KY,1277,28600,29877
21045,Casey County,,KY,732,15198,15930
21047,Christian County,,KY,10460,68887,79347
21049,Clark County,,KY,2497,37636,40133
21051,Clay County,,KY,780,17576,18356
21053,Clinton County,,KY,356,9499,9855
21055,Crittenden County,,KY,538,9200,9738
21057,Cumberland County,,KY,339,6859,7198
21059,Daviess County,,KY,4307,107041,111348
21061,Edmonson County,,KY,995,13560,14555
21063,Elliott County,,KY,335,5916,6251
21065,Estill County,,KY,719,14907,15626
21067,Fayette County,,KY,21716,280330,302046
21069,Fleming County,,KY,734,15460,16194
21071,Floyd County,,KY,1674,37350,39024
21073,Franklin County,,KY,3488,55226,58714
21075,Fulton County,,KY,627,6399,7026
21077,Gallatin County,,KY,734,6015,6749
21079,Garrard County,,KY,1464,16727,18191
21081,Grant County,,KY,2423,27275,29698
21083,Graves County,,KY,1899,38816,40715
21085,Grayson County,,KY,1077,26838,27915
21087,Green County,,KY,627,11925,12552
21089,Greenup County,,KY,2144,39388,41532
21091,Hancock County,,KY,582,9776,10358
21093,Hardin County,,KY,11348,107043,118391
21095,Harlan County,,KY,941,27603,28544
21097,Harrison County,,KY,1091,19934,21025
21099,Hart County,,KY,937,18428,19365
21101,Henderson County,,KY,2506,50894,53400
21103,Henry County,,KY,1322,16742,18064
21105,Hickman County,,KY,276,5030,5306
21107,Hopkins County,,KY,2320,50773,53093
21109,Jackson County,,KY,588,12610,13198
21111,Jefferson County,,KY,35630,793782,829412
21113,Jessamine County,,KY,4360,44858,49218
21115,Johnson County,,KY,1219,21934,23153
21117,Kenton County,,KY,14399,172443,186842
21119,Knott County,,KY,767,14494,15261
21121,Knox County,,KY,1524,29065,30589
21123,Larue County,,KY,1063,14927,15990
21125,Laurel County,,KY,3061,56800,59861
21127,Lawrence County,,KY,837,14564,15401
21129,Lee County,,KY,301,6192,6493
21131,Leslie County,,KY,422,10845,11267
21133,Letcher County,,KY,871,23110,23981
21135,Lewis County,,KY,636,13631,14267
21137,Lincoln County,,KY,1718,25649,27367
21139,Livingston County,,KY,749,10115,10864
21141,Logan County,,KY,1495,28438,29933
21143,Lyon County,,KY,634,7600,8234
21145,McCracken County,,KY,4435,71139,75574
21147,McCreary County,,KY,590,14394,14984
21149,McLean County,,KY,576,10585,11161
21151,Madison County,,KY,5960,76476,82436
21153,Magoffin County,,KY,492,11449,11941
21155,Marion County,,KY,847,19476,20323
21157,Marshall County,,KY,1895,34252,36147
21159,Martin County,,KY,495,9812,10307
21161,Mason County,,KY,1254,18477,19731
21163,Meade County,,KY,3333,29332,32665
21165,Menifee County,,KY,479,5847,6326
21167,Mercer County,,KY,1424,24014,25438
21169,Metcalfe County,,KY,669,10409,11078
21171,Monroe County,,KY,526,11674,12200
21173,Montgomery County,,KY,1815,26611,28426
21175,Morgan County,,KY,554,11935,12489
21177,Muhlenberg County,,KY,1193,33242,34435
21179,Nelson County,,KY,2349,48665,51014
21181,Nicholas County,,KY,466,7693,8159
21183,Ohio County,,KY,1195,24716,25911
21185,Oldham County,,KY,4372,58954,63326
21187,Owen County,,KY,781,10582,11363
21189,Owsley County,,KY,191,3760,3951
21191,Pendleton County,,KY,1177,15062,16239
21193,Perry County,,KY,1261,28795,30056
21195,Pike County,,KY,2332,58613,60945
21197,Powell County,,KY,932,13104,14036
21199,Pulaski County,,KY,2657,61806,64463
21201,Robertson County,,KY,144,2014,2158
21203,Rockcastle County,,KY,861,16232,17093
21205,Rowan County,,KY,1733,19721,21454
21207,Russell County,,KY,629,17211,17840
21209,Scott County,,KY,3722,45143,48865
21211,Shelby County,,KY,2926,41112,44038
21213,Simpson County,,KY,1269,18307,19576
21215,Spencer County,,KY,1213,16973,18186
21217,Taylor County,,KY,1389,24302,25691
21219,Todd County,,KY,835,12611,13446
21221,Trigg County,,KY,941,14485,15426
21223,Trimble County,,KY,706,9468,10174
21225,Union County,,KY,920,16173,17093
21227,Warren County,,KY,7032,105855,112887
21229,Washington County,,KY,632,12277,12909
21231,Wayne County,,KY,661,19547,20208
21233,Webster County,,KY,904,14839,15743
21235,Whitley County,,KY,2097,34904,37001
21237,Wolfe County,,KY,400,6711,7111
21239,Woodford County,,KY,1944,26947,28891
22001,Acadia Parish,,LA,3287,62305,65592
22003,Allen Parish,,LA,1436,22299,23735
22005,Ascension Parish,,LA,7083,101114,108197
22007,Assumption Parish,,LA,1560,26286,27846
22009,Avoyelles Parish,,LA,1985,42408,44393
22011,Beauregard Parish,,LA,2900,32627,35527
22013,Bienville Parish,,LA,944,14697,15641
22015,Bossier Parish,,LA,13021,113035,126056
22017,Caddo Parish,,LA,17537,264539,282076
22019,Calcasieu Parish,,LA,10003,189653,199656
22021,Caldwell Parish,,LA,599,9791,10390
22023,Cameron Parish,,LA,999,6745,7744
22025,Catahoula Parish,,LA,561,10056,10617
22027,Claiborne Parish,,LA,890,15282,16172
22029,Concordia Parish,,LA,1350,19308,20658
22031,De Soto Parish,,LA,1904,28432,30336
22033,East Baton Rouge Parish,,LA,33893,425706,459599
22035,East Carroll Parish,,LA,437,7334,7771
22037,East Feliciana Parish,,LA,1522,20037,21559
22039,Evangeline Parish,,LA,1755,33944,35699
22041,Franklin Parish,,LA,1160,20633,21793
22043,Grant Parish,,LA,1668,19349,21017
22045,Iberia Parish,,LA,4171,80297,84468
22047,Iberville Parish,,LA,2269,32759,35028
22049,Jackson Parish,,LA,1232,16148,17380
22051,Jefferson Parish,,LA,40493,354497,394990
22053,Jefferson Davis Parish,,LA,2156,32259,34415
22055,Lafayette Parish,,LA,15520,212546,228066
22057,Lafourche Parish,,LA,5255,97370,102625
22059,La Salle Parish,,LA,656,13785,14441
22061,Lincoln Parish,,LA,3500,37715,41215
22063,Livingston Parish,,LA,8299,115606,123905
22065,Madison Parish,,LA,750,11752,12502
22067,Morehouse Parish,,LA,2014,30711,32725
22069,Natchitoches Parish,,LA,2616,36981,39597
22071,Orleans Parish,,LA,33056,137142,170198
22073,Ouachita Parish,,LA,9720,155379,165099
22075,Plaquemines Parish,,LA,3771,17879,21650
22077,Pointe Coupee Parish,,LA,1342,23485,24827
22079,Rapides Parish,,LA,7762,139024,146786
22081,Red River Parish,,LA,614,9349,9963
22083,Richland Parish,,LA,1484,20677,22161
22085,Sabine Parish,,LA,1211,23305,24516
22087,St. Bernard Parish,,LA,2410,9305,11715
22089,St. Charles Parish,,LA,4965,52160,57125
22091,St. Helena Parish,,LA,1118,13282,14400
22093,St. James Parish,,LA,1396,25222,26618
22095,St. John the Baptist Parish,,LA,4844,47721,52565
22097,St. Landry Parish,,LA,4826,88732,93558
22099,St. Martin Parish,,LA,3279,55373,58652
22101,St. Mary Parish,,LA,3634,58601,62235
22103,St. Tammany Parish,,LA,17023,180161,197184
22105,Tangipahoa Parish,,LA,7088,105105,112193
22107,Tensas Parish,,LA,432,5334,5766
22109,Terrebonne Parish,,LA,6369,117933,124302
22111,Union Parish,,LA,1560,22823,24383
22113,Vermilion Parish,,LA,3156,59276,62432
22115,Vernon Parish,,LA,8860,49408,58268
22117,Washington Parish,,LA,1981,39932,41913
22119,Webster Parish,,LA,2478,41617,44095
22121,West Baton Rouge Parish,,LA,2067,24773,26840
22123,West Carroll Parish,,LA,864,11717,12581
22125,West Feliciana Parish,,LA,933,10729,11662
22127,Winn Parish,,LA,890,14128,15018
23001,Androscoggin County,,ME,7230,116793,124023
23003,Aroostook County,,ME,2789,80361,83150
23005,Cumberland County,,ME,20239,313871,334110
23007,Franklin County,,ME,1990,31236,33226
23009,Hancock County,,ME,3043,59954,62997
23011,Kennebec County,,ME,6961,136306,143267
23013,Knox County,,ME,2329,44208,46537
23015,Lincoln County,,ME,2268,40386,42654
23017,Oxford County,,ME,3035,61356,64391
23019,Penobscot County,,ME,7864,161613,169477
23021,Piscataquis County,,ME,1171,18318,19489
23023,Sagadahoc County,,ME,3744,41070,44814
23025,Somerset County,,ME,3196,53830,57026
23027,Waldo County,,ME,2451,41673,44124
23029,Washington County,,ME,1539,35500,37039
23031,York County,,ME,12352,228506,240858
24001,Allegany County,,MD,2817,74707,77524
24003,Anne Arundel County,,MD,47257,584338,631595
24005,Baltimore County,,MD,66348,894470,960818
24009,Calvert County,,MD,6376,101719,108095
24011,Caroline County,,MD,2504,35265,37769
24013,Carroll County,,MD,10424,200239,210663
24015,Cecil County,,MD,7008,109072,116080
24017,Charles County,,MD,14861,161428,176289
24019,Dorchester County,,MD,1849,35517,37366
24021,Frederick County,,MD,18402,262983,281385
24023,Garrett County,,MD,1338,33311,34649
24025,Harford County,,MD,18567,286423,304990
24027,Howard County,,MD,28628,302899,331527
24029,Kent County,,MD,1139,20965,22104
24031,Montgomery County,,MD,81857,1037803,1119660
24033,Prince George's County,,MD,84487,925795,1010282
24035,Queen Anne's County,,MD,3114,51047,54161
24037,St. Mary's County,,MD,8494,112731,121225
24039,Somerset County,,MD,1469,21583,23052
24041,Talbot County,,MD,2809,40836,43645
24043,Washington County,,MD,9207,162636,171843
24045,Wicomico County,,MD,6611,99639,106250
24047,Worcester County,,MD,4320,57779,62099
24510,Baltimore city,,MD,50575,571113,621688
25001,Barnstable County,,MA,12978,263473,276451
25003,Berkshire County,,MA,5331,149546,154877
25005,Bristol County,,MA,25465,620100,645565
25007,Dukes County,,MA,997,18786,19783
25009,Essex County,,MA,38852,828798,867650
25011,Franklin County,,MA,4732,81647,86379
25013,Hampden County,,MA,19627,515653,535280
25015,Hampshire County,,MA,11806,159347,171153
25017,Middlesex County,,MA,106974,1636014,1742988
25019,Nantucket County,,MA,855,11786,12641
25021,Norfolk County,,MA,51939,737731,789670
25023,Plymouth County,,MA,26594,566107,592701
25025,Suffolk County,,MA,74825,657433,732258
25027,Worcester County,,MA,37688,906296,943984
26001,Alcona County,,MI,696,12542,13238
26003,Alger County,,MI,490,10288,10778
26005,Allegan County,,MI,8201,131809,140010
26007,Alpena County,,MI,1444,35279,36723
26009,Antrim County,,MI,1790,26954,28744
26011,Arenac County,,MI,1094,18964,20058
26013,Baraga County,,MI,494,8769,9263
26015,Barry County,,MI,4004,70920,74924
26017,Bay County,,MI,5270,132692,137962
26019,Benzie County,,MI,1551,20630,22181
26021,Berrien County,,MI,9277,176471,185748
26023,Branch County,,MI,2857,49772,52629
26025,Calhoun County,,MI,8264,152547,160811
26027,Cass County,,MI,3660,57834,61494
26029,Charlevoix County,,MI,1863,30976,32839
26031,Cheboygan County,,MI,1867,31026,32893
26033,Chippewa County,,MI,2060,38693,40753
26035,Clare County,,MI,2141,32726,34867
26037,Clinton County,,MI,5870,85637,91507
26039,Crawford County,,MI,1028,14886,15914
26041,Delta County,,MI,1907,45138,47045
26043,Dickinson County,,MI,1451,32195,33646
26045,Eaton County,,MI,10105,126221,136326
26047,Emmet County,,MI,2663,37902,40565
26049,Genesee County,,MI,22505,497120,519625
26051,Gladwin County,,MI,1724,29002,30726
26053,Gogebic County,,MI,790,16577,17367
26055,Grand Traverse County,,MI,6037,99651,105688
26057,Gratiot County,,MI,2368,43920,46288
26059,Hillsdale County,,MI,3092,52803,55895
26061,Houghton County,,MI,2246,35572,37818
26063,Huron County,,MI,1684,42867,44551
26065,Ingham County,,MI,24200,280867,305067
26067,Ionia County,,MI,4163,68902,73065
26069,Iosco County,,MI,2043,29736,31779
26071,Iron County,,MI,602,13513,14115
26073,Isabella County,,MI,5093,59533,64626
26075,Jackson County,,MI,7809,178076,185885
26077,Kalamazoo County,,MI,17087,263681,280768
26079,Kalkaska County,,MI,1355,18759,20114
26081,Kent County,,MI,33873,689284,723157
26083,Keweenaw County,,MI,159,2259,2418
26085,Lake County,,MI,914,10796,11710
26087,Lapeer County,,MI,5976,108072,114048
26089,Leelanau County,,MI,1490,25373,26863
26091,Lenawee County,,MI,5478,116825,122303
26093,Livingston County,,MI,11797,214676,226473
26095,Luce County,,MI,322,6456,6778
26097,Mackinac County,,MI,1046,13380,14426
26099,Macomb County,,MI,44968,1008904,1053872
26101,Manistee County,,MI,1612,27879,29491
26103,Marquette County,,MI,3666,70765,74431
26105,Mason County,,MI,1895,33398,35293
26107,Mecosta County,,MI,3409,40065,43474
26109,Menominee County,,MI,1383,28015,29398
26111,Midland County,,MI,5636,98197,103833
26113,Missaukee County,,MI,1136,16445,17581
26115,Monroe County,,MI,8894,183810,192704
26117,Montcalm County,,MI,4614,69157,73771
26119,Montmorency County,,MI,699,11054,11753
26121,Muskegon County,,MI,7893,191656,199549
26123,Newaygo County,,MI,3310,54598,57908
26125,Oakland County,,MI,84030,1387629,1471659
26127,Oceana County,,MI,2005,30397,32402
26129,Ogemaw County,,MI,1402,23875,25277
26131,Ontonagon County,,MI,366,7898,8264
26133,Osceola County,,MI,1943,25608,27551
26135,Oscoda County,,MI,590,9351,9941
26137,Otsego County,,MI,2093,28642,30735
26139,Ottawa County,,MI,17103,297992,315095
26141,Presque Isle County,,MI,775,16569,17344
26143,Roscommon County,,MI,1801,27434,29235
26145,Saginaw County,,MI,11310,232253,243563
26147,St. Clair County,,MI,8913,199914,208827
26149,St. Joseph County,,MI,3774,71676,75450
26151,Sanilac County,,MI,2815,51933,54748
26153,Schoolcraft County,,MI,451,9181,9632
26155,Shiawassee County,,MI,4896,85640,90536
26157,Tuscola County,,MI,3553,68306,71859
26159,Van Buren County,,MI,5644,85995,91639
26161,Washtenaw County,,MI,29909,348278,378187
26163,Wayne County,,MI,100065,2020345,2120410
26165,Wexford County,,MI,2488,36751,39239
27001,Aitkin County,,MN,841,15189,16030
27003,Anoka County,,MN,25827,382204,408031
27005,Becker County,,MN,2036,37106,39142
27007,Beltrami County,,MN,2769,43421,46190
27009,Benton County,,MN,4375,42371,46746
27011,Big Stone County,,MN,277,6176,6453
27013,Blue Earth County,,MN,5660,62522,68182
27015,Brown County,,MN,1766,31992,33758
27017,Carlton County,,MN,1901,37880,39781
27019,Carver County,,MN,7078,100174,107252
27021,Cass County,,MN,2218,32168,34386
27023,Chippewa County,,MN,1074,15094,16168
27025,Chisago County,,MN,4138,61914,66052
27027,Clay County,,MN,4394,57743,62137
27029,Clearwater County,,MN,541,9276,9817
27031,Cook County,,MN,363,6323,6686
27033,Cottonwood County,,MN,675,14441,15116
27035,Crow Wing County,,MN,3702,69959,73661
27037,Dakota County,,MN,33238,464404,497642
27039,Dodge County,,MN,1401,22821,24222
27041,Douglas County,,MN,2212,42842,45054
27043,Faribault County,,MN,1047,18364,19411
27045,Fillmore County,,MN,1282,25414,26696
27047,Freeborn County,,MN,1795,37513,39308
27049,Goodhue County,,MN,2915,55022,57937
27051,Grant County,,MN,483,7407,7890
27053,Hennepin County,,MN,89427,1263460,1352887
27055,Houston County,,MN,1248,24286,25534
27057,Hubbard County,,MN,1279,21817,23096
27059,Isanti County,,MN,2809,42125,44934
27061,Itasca County,,MN,2009,50813,52822
27063,Jackson County,,MN,705,12723,13428
27065,Kanabec County,,MN,1207,18498,19705
27067,Kandiyohi County,,MN,2736,49146,51882
27069,Kittson County,,MN,277,5576,5853
27071,Koochiching County,,MN,650,15210,15860
27073,Lac qui Parle County,,MN,415,8999,9414
27075,Lake County,,MN,625,12426,13051
27077,Lake of the Woods County,,MN,327,4909,5236
27079,Le Sueur County,,MN,1844,31521,33365
27081,Lincoln County,,MN,379,6644,7023
27083,Lyon County,,MN,2256,29337,31593
27085,McLeod County,,MN,2787,45331,48118
27087,Mahnomen County,,MN,375,4952,5327
27089,Marshall County,,MN,712,11833,12545
27091,Martin County,,MN,1187,25874,27061
27093,Meeker County,,MN,1657,27488,29145
27095,Mille Lacs County,,MN,1968,29095,31063
27097,Morrison County,,MN,1900,39526,41426
27099,Mower County,,MN,2399,44780,47179
27101,Murray County,,MN,603,10598,11201
27103,Nicollet County,,MN,3415,34683,38098
27105,Nobles County,,MN,1380,24310,25690
27107,Norman County,,MN,482,8050,8532
27109,Olmsted County,,MN,9876,169750,179626
27111,Otter Tail County,,MN,3280,65761,69041
27113,Pennington County,,MN,1122,15780,16902
27115,Pine County,,MN,1770,29675,31445
27117,Pipestone County,,MN,706,11265,11971
27119,Polk County,,MN,2338,35304,37642
27121,Pope County,,MN,772,13251,14023
27123,Ramsey County,,MN,48822,533260,582082
27125,Red Lake County,,MN,244,4861,5105
27127,Redwood County,,MN,1070,19122,20192
27129,Renville County,,MN,1218,20056,21274
27131,Rice County,,MN,4219,66935,71154
27133,Rock County,,MN,609,11089,11698
27135,Roseau County,,MN,1011,19949,20960
27137,St. Louis County,,MN,9610,215967,225577
27139,Scott County,,MN,10050,143290,153340
27141,Sherburne County,,MN,7419,95435,102854
27143,Sibley County,,MN,997,18662,19659
27145,Stearns County,,MN,10381,161262,171643
27147,Steele County,,MN,2516,44915,47431
27149,Stevens County,,MN,691,10206,10897
27151,Swift County,,MN,640,11823,12463
27153,Todd County,,MN,1459,25951,27410
27155,Traverse County,,MN,262,4231,4493
27157,Wabasha County,,MN,1411,25078,26489
27159,Wadena County,,MN,1039,15580,16619
27161,Waseca County,,MN,1251,22933,24184
27163,Washington County,,MN,18166,268751,286917
27165,Watonwan County,,MN,827,12595,13422
27167,Wilkin County,,MN,604,8282,8886
27169,Winona County,,MN,3008,52503,55511
27171,Wright County,,MN,8620,136172,144792
27173,Yellow Medicine County,,MN,842,12609,13451
28001,Adams County,,MS,2023,31265,33288
28003,Alcorn County,,MS,1873,35361,37234
28005,Amite County,,MS,952,12819,13771
28007,Attala County,,MS,994,18371,19365
28009,Benton County,,MS,694,8414,9108
28011,Bolivar County,,MS,2226,35979,38205
28013,Calhoun County,,MS,714,15846,16560
28015,Carroll County,,MS,783,10712,11495
28017,Chickasaw County,,MS,1249,19772,21021
28019,Choctaw County,,MS,534,7295,7829
28021,Claiborne County,,MS,687,9886,10573
28023,Clarke County,,MS,1429,20447,21876
28025,Clay County,,MS,1283,21138,22421
28027,Coahoma County,,MS,1921,28311,30232
28029,Copiah County,,MS,1645,30948,32593
28031,Covington County,,MS,1429,20357,21786
28033,DeSoto County,,MS,12572,158492,171064
28035,Forrest County,,MS,7247,65199,72446
28037,Franklin County,,MS,584,8999,9583
28039,George County,,MS,1076,20905,21981
28041,Greene County,,MS,523,11520,12043
28043,Grenada County,,MS,1521,23623,25144
28045,Hancock County,,MS,3329,29297,32626
28047,Harrison County,,MS,17328,151956,169284
28049,Hinds County,,MS,19218,257880,277098
28051,Holmes County,,MS,1436,20902,22338
28053,Humphreys County,,MS,709,9887,10596
28055,Issaquena County,,MS,99,863,962
28057,Itawamba County,,MS,1743,25304,27047
28059,Jackson County,,MS,10155,122353,132508
28061,Jasper County,,MS,1260,19460,20720
28063,Jefferson County,,MS,403,8157,8560
28065,Jefferson Davis County,,MS,844,12256,13100
28067,Jones County,,MS,3410,63840,67250
28069,Kemper County,,MS,508,8785,9293
28071,Lafayette County,,MS,3390,35977,39367
28073,Lamar County,,MS,4699,44275,48974
28075,Lauderdale County,,MS,4870,76633,81503
28077,Lawrence County,,MS,927,14349,15276
28079,Leake County,,MS,1249,21956,23205
28081,Lee County,,MS,5556,85681,91237
28083,Leflore County,,MS,2073,32750,34823
28085,Lincoln County,,MS,2067,35362,37429
28087,Lowndes County,,MS,5047,60980,66027
28089,Madison County,,MS,8630,89937,98567
28091,Marion County,,MS,1400,26794,28194
28093,Marshall County,,MS,2562,37442,40004
28095,Monroe County,,MS,2084,40040,42124
28097,Montgomery County,,MS,795,12367,13162
28099,Neshoba County,,MS,1554,30510,32064
28101,Newton County,,MS,1187,23577,24764
28103,Noxubee County,,MS,641,13062,13703
28105,Oktibbeha County,,MS,3704,37251,40955
28107,Panola County,,MS,1865,37022,38887
28109,Pearl River County,,MS,3724,47916,51640
28111,Perry County,,MS,715,12471,13186
28113,Pike County,,MS,2841,40451,43292
28115,Pontotoc County,,MS,2017,30178,32195
28117,Prentiss County,,MS,1376,25017,26393
28119,Quitman County,,MS,706,8264,8970
28121,Rankin County,,MS,10897,135898,146795
28123,Scott County,,MS,1746,29448,31194
28125,Sharkey County,,MS,495,5761,6256
28127,Simpson County,,MS,1902,26543,28445
28129,Smith County,,MS,878,14532,15410
28131,Stone County,,MS,1189,14489,15678
28133,Sunflower County,,MS,1615,27576,29191
28135,Tallahatchie County,,MS,957,14012,14969
28137,Tate County,,MS,2210,28391,30601
28139,Tippah County,,MS,1074,23040,24114
28141,Tishomingo County,,MS,1086,19098,20184
28143,Tunica County,,MS,1549,12677,14226
28145,Union County,,MS,1728,28103,29831
28147,Walthall County,,MS,1014,14746,15760
28149,Warren County,,MS,3434,55569,59003
28151,Washington County,,MS,3749,57020,60769
28153,Wayne County,,MS,900,21481,22381
28155,Webster County,,MS,669,11698,12367
28157,Wilkinson County,,MS,560,9389,9949
28159,Winston County,,MS,998,21093,22091
28161,Yalobusha County,,MS,869,13573,14442
28163,Yazoo County,,MS,1472,25826,27298
29001,Adair County,,MO,2147,21490,23637
29003,Andrew County,,MO,1692,19386,21078
29005,Atchison County,,MO,342,6667,7009
29007,Audrain County,,MO,1810,27058,28868
29009,Barry County,,MO,2897,35985,38882
29011,Barton County,,MO,1078,14137,15215
29013,Bates County,,MO,1195,18216,19411
29015,Benton County,,MO,1341,18222,19563
29017,Bollinger County,,MO,768,12716,13484
29019,Boone County,,MO,12398,151283,163681
29021,Buchanan County,,MO,5497,91350,96847
29023,Butler County,,MO,2873,42677,45550
29025,Caldwell County,,MO,791,9872,10663
29027,Callaway County,,MO,3261,44646,47907
29029,Camden County,,MO,3647,40329,43976
29031,Cape Girardeau County,,MO,5031,78161,83192
29033,Carroll County,,MO,588,10910,11498
29035,Carter County,,MO,478,6291,6769
29037,Cass County,,MO,7180,105740,112920
29039,Cedar County,,MO,1025,13370,14395
29041,Chariton County,,MO,508,9027,9535
29043,Christian County,,MO,7063,73953,81016
29045,Clark County,,MO,354,8203,8557
29047,Clay County,,MO,19081,238266,257347
29049,Clinton County,,MO,1801,22668,24469
29051,Cole County,,MO,5725,82874,88599
29053,Cooper County,,MO,1264,17918,19182
29055,Crawford County,,MO,1644,25270,26914
29057,Dade County,,MO,611,8459,9070
29059,Dallas County,,MO,1298,16395,17693
29061,Daviess County,,MO,747,9309,10056
29063,DeKalb County,,MO,916,10198,11114
29065,Dent County,,MO,1006,14593,15599
29067,Douglas County,,MO,819,12825,13644
29069,Dunklin County,,MO,2106,30960,33066
29071,Franklin County,,MO,5653,118882,124535
29073,Gasconade County,,MO,1170,17896,19066
29075,Gentry County,,MO,482,7343,7825
29077,Greene County,,MO,20637,275078,295715
29079,Grundy County,,MO,669,10866,11535
29081,Harrison County,,MO,527,9519,10046
29083,Henry County,,MO,1702,24082,25784
29085,Hickory County,,MO,682,8793,9475
29087,Holt County,,MO,356,5805,6161
29089,Howard County,,MO,746,10609,11355
29091,Howell County,,MO,2395,40332,42727
29093,Iron County,,MO,780,10538,11318
29095,Jackson County,,MO,44111,710332,754443
29097,Jasper County,,MO,7663,115904,123567
29099,Jefferson County,,MO,14012,251002,265014
29101,Johnson County,,MO,5971,49862,55833
29103,Knox County,,MO,292,4553,4845
29105,Laclede County,,MO,2373,37876,40249
29107,Lafayette County,,MO,2577,36926,39503
29109,Lawrence County,,MO,2815,39522,42337
29111,Lewis County,,MO,695,10892,11587
29113,Lincoln County,,MO,3212,55884,59096
29115,Linn County,,MO,835,14913,15748
29117,Livingston County,,MO,956,15401,16357
29119,McDonald County,,MO,1963,19837,21800
29121,Macon County,,MO,1172,18345,19517
29123,Madison County,,MO,747,12452,13199
29125,Maries County,,MO,544,9024,9568
29127,Marion County,,MO,2000,31933,33933
29129,Mercer County,,MO,298,3954,4252
29131,Miller County,,MO,2107,24557,26664
29133,Mississippi County,,MO,816,12949,13765
29135,Moniteau County,,MO,1080,16424,17504
29137,Monroe County,,MO,640,10391,11031
29139,Montgomery County,,MO,892,13706,14598
29141,Morgan County,,MO,1638,20922,22560
29143,New Madrid County,,MO,1373,18824,20197
29145,Newton County,,MO,4677,58812,63489
29147,Nodaway County,,MO,1588,21271,22859
29149,Oregon County,,MO,751,9546,10297
29151,Osage County,,MO,813,15556,16369
29153,Ozark County,,MO,671,9258,9929
29155,Pemiscot County,,MO,1259,18116,19375
29157,Perry County,,MO,1027,21246,22273
29159,Pettis County,,MO,3031,44138,47169
29161,Phelps County,,MO,3958,43153,47111
29163,Pike County,,MO,1067,18494,19561
29165,Platte County,,MO,11213,90969,102182
29167,Polk County,,MO,2485,30235,32720
29169,Pulaski County,,MO,6904,39998,46902
29171,Putnam County,,MO,470,5773,6243
29173,Ralls County,,MO,712,11622,12334
29175,Randolph County,,MO,1795,25661,27456
29177,Ray County,,MO,2034,26989,29023
29179,Reynolds County,,MO,465,6511,6976
29181,Ripley County,,MO,878,13486,14364
29183,St. Charles County,,MO,23300,403698,426998
29185,St. Clair County,,MO,672,8708,9380
29186,Ste. Genevieve County,,MO,1297,21647,22944
29187,St. Francois County,,MO,3546,62226,65772
29189,St. Louis County,,MO,75667,1159624,1235291
29195,Saline County,,MO,1463,24014,25477
29197,Schuyler County,,MO,293,4230,4523
29199,Scotland County,,MO,233,5470,5703
29201,Scott County,,MO,2852,43076,45928
29203,Shannon County,,MO,484,8008,8492
29205,Shelby County,,MO,466,7495,7961
29207,Stoddard County,,MO,1928,32043,33971
29209,Stone County,,MO,3088,31249,34337
29211,Sullivan County,,MO,556,7546,8102
29213,Taney County,,MO,4151,44799,48950
29215,Texas County,,MO,1725,23780,25505
29217,Vernon County,,MO,1560,21122,22682
29219,Warren County,,MO,2405,33723,36128
29221,Washington County,,MO,1347,22429,23776
29223,Wayne County,,MO,923,11896,12819
29225,Webster County,,MO,2947,36871,39818
29227,Worth County,,MO,125,2469,2594
29229,Wright County,,MO,1351,18341,19692
29510,St. Louis city,,MO,36719,298557,335276
30001,Beaverhead County,,MT,807,8790,9597
30003,Big Horn County,,MT,805,12314,13119
30005,Blaine County,,MT,487,6895,7382
30007,Broadwater County,,MT,388,4811,5199
30009,Carbon County,,MT,850,10019,10869
30011,Carter County,,MT,96,1375,1471
30013,Cascade County,,MT,7455,88912,96367
30015,Chouteau County,,MT,344,5246,5590
30017,Custer County,,MT,867,12320,13187
30019,Daniels County,,MT,140,2196,2336
30021,Dawson County,,MT,569,9987,10556
30023,Deer Lodge County,,MT,596,9576,10172
30025,Fallon County,,MT,212,3301,3513
30027,Fergus County,,MT,883,12787,13670
30029,Flathead County,,MT,5528,94404,99932
30031,Gallatin County,,MT,7938,86492,94430
30033,Garfield County,,MT,76,1381,1457
30035,Glacier County,,MT,785,13873,14658
30037,Golden Valley County,,MT,97,1095,1192
30039,Granite County,,MT,256,2858,3114
30041,Hill County,,MT,1295,18124,19419
30043,Jefferson County,,MT,1012,11530,12542
30045,Judith Basin County,,MT,246,2100,2346
30047,Lake County,,MT,2064,26692,28756
30049,Lewis and Clark County,,MT,4388,67565,71953
30051,Liberty County,,MT,106,2170,2276
30053,Lincoln County,,MT,1299,18769,20068
30055,McCone County,,MT,124,1993,2117
30057,Madison County,,MT,570,7233,7803
30059,Meagher County,,MT,195,2224,2419
30061,Mineral County,,MT,471,4116,4587
30063,Missoula County,,MT,9077,107040,116117
30065,Musselshell County,,MT,399,4399,4798
30067,Park County,,MT,1410,16997,18407
30069,Petroleum County,,MT,-2,-2,-4
30071,Phillips County,,MT,295,4699,4994
30073,Pondera County,,MT,485,6657,7142
30075,Powder River County,,MT,118,1602,1720
30077,Powell County,,MT,573,5804,6377
30079,Prairie County,,MT,92,1261,1353
30081,Ravalli County,,MT,3022,40663,43685
30083,Richland County,,MT,740,11169,11909
30085,Roosevelt County,,MT,738,10428,11166
30087,Rosebud County,,MT,829,10091,10920
30089,Sanders County,,MT,831,10800,11631
30091,Sheridan County,,MT,202,4319,4521
30093,Silver Bow County,,MT,2265,35201,37466
30095,Stillwater County,,MT,859,9475,10334
30097,Sweet Grass County,,MT,321,3841,4162
30099,Teton County,,MT,445,7352,7797
30101,Toole County,,MT,385,5300,5685
30103,Treasure County,,MT,-2,-2,-4
30105,Valley County,,MT,532,8313,8845
30107,Wheatland County,,MT,152,2122,2274
30109,Wibaux County,,MT,92,1007,1099
30111,Yellowstone County,,MT,8859,156882,165741
31001,Adams County,,NE,1966,34852,36818
31003,Antelope County,,NE,432,8046,8478
31005,Arthur County,,NE,46,534,580
31007,Banner County,,NE,76,673,749
31009,Blaine County,,NE,64,472,536
31011,Boone County,,NE,321,6834,7155
31013,Box Butte County,,NE,941,13702,14643
31015,Boyd County,,NE,107,2559,2666
31017,Brown County,,NE,273,3662,3935
31019,Buffalo County,,NE,3500,48431,51931
31021,Burt County,,NE,523,8221,8744
31023,Butler County,,NE,689,11057,11746
31025,Cass County,,NE,2190,29411,31601
31027,Cedar County,,NE,644,11148,11792
31029,Chase County,,NE,324,4490,4814
31031,Cherry County,,NE,496,6398,6894
31033,Cheyenne County,,NE,802,11535,12337
31035,Clay County,,NE,527,7744,8271
31037,Colfax County,,NE,736,11447,12183
31039,Cuming County,,NE,707,11222,11929
31041,Custer County,,NE,689,12906,13595
31043,Dakota County,,NE,2061,23143,25204
31045,Dawes County,,NE,878,8415,9293
31047,Dawson County,,NE,2118,28310,30428
31049,Deuel County,,NE,176,2133,2309
31051,Dixon County,,NE,409,7195,7604
31053,Dodge County,,NE,2742,41876,44618
31055,Douglas County,,NE,34306,556146,590452
31057,Dundy County,,NE,153,2202,2355
31059,Fillmore County,,NE,451,7628,8079
31061,Franklin County,,NE,296,3847,4143
31063,Frontier County,,NE,269,2863,3132
31065,Furnas County,,NE,419,5896,6315
31067,Gage County,,NE,1507,26607,28114
31069,Garden County,,NE,197,2171,2368
31071,Garfield County,,NE,120,1643,1763
31073,Gosper County,,NE,205,2400,2605
31075,Grant County,,NE,106,905,1011
31077,Greeley County,,NE,194,3013,3207
31079,Hall County,,NE,3984,62913,66897
31081,Hamilton County,,NE,685,11442,12127
31083,Harlan County,,NE,202,3761,3963
31085,Hayes County,,NE,61,1028,1089
31087,Hitchcock County,,NE,240,3451,3691
31089,Holt County,,NE,571,12273,12844
31091,Hooker County,,NE,108,1023,1131
31093,Howard County,,NE,505,7349,7854
31095,Jefferson County,,NE,575,9011,9586
31097,Johnson County,,NE,458,4762,5220
31099,Kearney County,,NE,597,7627,8224
31101,Keith County,,NE,653,9337,9990
31103,Keya Paha County,,NE,78,1039,1117
31105,Kimball County,,NE,386,4144,4530
31107,Knox County,,NE,499,10195,10694
31109,Lancaster County,,NE,16961,304409,321370
31111,Lincoln County,,NE,2713,41351,44064
31113,Logan County,,NE,83,934,1017
31115,Loup County,,NE,48,689,737
31117,McPherson County,,NE,33,584,617
31119,Madison County,,NE,4281,40385,44666
31121,Merrick County,,NE,709,8817,9526
31123,Morrill County,,NE,430,5545,5975
31125,Nance County,,NE,288,3563,3851
31127,Nemaha County,,NE,585,7808,8393
31129,Nuckolls County,,NE,294,5502,5796
31131,Otoe County,,NE,1315,18774,20089
31133,Pawnee County,,NE,151,2725,2876
31135,Perkins County,,NE,240,3496,3736
31137,Phelps County,,NE,846,10881,11727
31139,Pierce County,,NE,560,8749,9309
31141,Platte County,,NE,2150,37766,39916
31143,Polk County,,NE,392,6537,6929
31145,Red Willow County,,NE,828,12540,13368
31147,Richardson County,,NE,612,10014,10626
31149,Rock County,,NE,106,1654,1760
31151,Saline County,,NE,1126,15750,16876
31153,Sarpy County,,NE,18546,167150,185696
31155,Saunders County,,NE,1464,23965,25429
31157,Scotts Bluff County,,NE,2312,39482,41794
31159,Seward County,,NE,1418,18357,19775
31161,Sheridan County,,NE,465,6279,6744
31163,Sherman County,,NE,256,3476,3732
31165,Sioux County,,NE,94,1282,1376
31167,Stanton County,,NE,572,7411,7983
31169,Thayer County,,NE,352,6189,6541
31171,Thomas County,,NE,91,736,827
31173,Thurston County,,NE,431,7475,7906
31175,Valley County,,NE,307,4838,5145
31177,Washington County,,NE,1594,23108,24702
31179,Wayne County,,NE,757,9413,10170
31181,Webster County,,NE,228,4325,4553
31183,Wheeler County,,NE,45,841,886
31185,York County,,NE,1199,16135,17334
32001,Churchill County,,NV,2882,25970,28852
32003,Clark County,,NV,104361,1899271,2003632
32005,Douglas County,,NV,4871,52087,56958
32007,Elko County,,NV,4217,50537,54754
32009,Esmeralda County,,NV,115,734,849
32011,Eureka County,,NV,133,1450,1583
32013,Humboldt County,,NV,1465,17758,19223
32015,Lander County,,NV,556,5908,6464
32017,Lincoln County,,NV,280,4216,4496
32019,Lyon County,,NV,5642,51753,57395
32021,Mineral County,,NV,438,4848,5286
32023,Nye County,,NV,3960,41292,45252
32027,Pershing County,,NV,480,5004,5484
32029,Storey County,,NV,610,4507,5117
32031,Washoe County,,NV,26341,432954,459295
32033,White Pine County,,NV,870,9198,10068
32510,Carson City,,NV,6150,58135,64285
33001,Belknap County,,NH,4824,71849,76673
33003,Carroll County,,NH,3380,55031,58411
33005,Cheshire County,,NH,5304,86967,92271
33007,Coos County,,NH,2150,38830,40980
33009,Grafton County,,NH,7860,93267,101127
33011,Hillsborough County,,NH,27907,470690,498597
33013,Merrimack County,,NH,11394,166596,177990
33015,Rockingham County,,NH,22697,354230,376927
33017,Strafford County,,NH,9284,132635,141919
33019,Sullivan County,,NH,2979,48774,51753
34001,Atlantic County,,NJ,14367,329070,343437
34003,Bergen County,,NJ,55793,1020253,1076046
34005,Burlington County,,NJ,32481,530591,563072
34007,Camden County,,NJ,31636,589879,621515
34009,Cape May County,,NJ,6323,112393,118716
34011,Cumberland County,,NJ,6611,166535,173146
34013,Essex County,,NJ,55609,815847,871456
34015,Gloucester County,,NJ,15540,332341,347881
34017,Hudson County,,NJ,62784,643743,706527
34019,Hunterdon County,,NJ,8053,148858,156911
34021,Mercer County,,NJ,24393,394479,418872
34023,Middlesex County,,NJ,65463,911214,976677
34025,Monmouth County,,NJ,34621,721318,755939
34027,Morris County,,NJ,34488,569749,604237
34029,Ocean County,,NJ,26365,647611,673976
34031,Passaic County,,NJ,34797,569187,603984
34033,Salem County,,NJ,3855,77836,81691
34035,Somerset County,,NJ,26938,367257,394195
34037,Sussex County,,NJ,9664,178029,187693
34039,Union County,,NJ,41900,598604,640504
34041,Warren County,,NJ,7940,128988,136928
35001,Bernalillo County,,NM,40830,653335,694165
35003,Catron County,,NM,283,2900,3183
35005,Chaves County,,NM,3426,59397,62823
35006,Cibola County,,NM,1568,23422,24990
35007,Colfax County,,NM,1169,13755,14924
35009,Curry County,,NM,5847,46570,52417
35011,De Baca County,,NM,183,2015,2198
35013,Dona Ana County,,NM,12638,194037,206675
35015,Eddy County,,NM,3176,52605,55781
35017,Grant County,,NM,1915,29900,31815
35019,Guadalupe County,,NM,333,4302,4635
35021,Harding County,,NM,58,677,735
35023,Hidalgo County,,NM,380,4908,5288
35025,Lea County,,NM,3280,59468,62748
35027,Lincoln County,,NM,1920,19359,21279
35028,Los Alamos County,,NM,2111,22348,24459
35029,Luna County,,NM,1845,25727,27572
35031,McKinley County,,NM,8422,84738,93160
35033,Mora County,,NM,306,4843,5149
35035,Otero County,,NM,6597,59386,65983
35037,Quay County,,NM,697,8729,9426
35039,Rio Arriba County,,NM,2447,40308,42755
35041,Roosevelt County,,NM,1824,17370,19194
35043,Sandoval County,,NM,11279,118932,130211
35045,San Juan County,,NM,10767,139623,150390
35047,San Miguel County,,NM,1750,26161,27911
35049,Santa Fe County,,NM,9711,139773,149484
35051,Sierra County,,NM,838,10410,11248
35053,Socorro County,,NM,1366,16729,18095
35055,Taos County,,NM,1931,31957,33888
35057,Torrance County,,NM,1364,13878,15242
35059,Union County,,NM,308,4085,4393
35061,Valencia County,,NM,4700,70254,74954
36001,Albany County,,NY,22643,333792,356435
36003,Allegany County,,NY,2698,48701,51399
36005,Bronx County,,NY,93933,1294390,1388323
36007,Broome County,,NY,9667,219987,229654
36009,Cattaraugus County,,NY,4528,88811,93339
36011,Cayuga County,,NY,3931,86693,90624
36013,Chautauqua County,,NY,5201,145698,150899
36015,Chemung County,,NY,4442,96902,101344
36017,Chenango County,,NY,2941,58755,61696
36019,Clinton County,,NY,3400,89926,93326
36021,Columbia County,,NY,3735,69398,73133
36023,Cortland County,,NY,2770,50577,53347
36025,Delaware County,,NY,2733,47701,50434
36027,Dutchess County,,NY,16791,323163,339954
36029,Erie County,,NY,32960,1042796,1075756
36031,Essex County,,NY,2292,41387,43679
36033,Franklin County,,NY,2122,50373,52495
36035,Fulton County,,NY,2750,62344,65094
36037,Genesee County,,NY,3433,70027,73460
36039,Greene County,,NY,2718,51034,53752
36041,Hamilton County,,NY,362,5729,6091
36043,Herkimer County,,NY,3180,71594,74774
36045,Jefferson County,,NY,12667,120173,132840
36047,Kings County,,NY,151536,2348860,2500396
36049,Lewis County,,NY,1455,27976,29431
36051,Livingston County,,NY,3937,69818,73755
36053,Madison County,,NY,4516,74564,79080
36055,Monroe County,,NY,31892,846095,877987
36057,Montgomery County,,NY,3432,58370,61802
36059,Nassau County,,NY,74459,1558849,1633308
36061,New York County,,NY,163906,1506262,1670168
36063,Niagara County,,NY,9987,251050,261037
36065,Oneida County,,NY,9906,259038,268944
36067,Onondaga County,,NY,22963,521471,544434
36069,Ontario County,,NY,6699,121488,128187
36071,Orange County,,NY,24113,409797,433910
36073,Orleans County,,NY,2503,46729,49232
36075,Oswego County,,NY,6723,135198,141921
36077,Otsego County,,NY,3548,66208,69756
36079,Putnam County,,NY,6834,112766,119600
36081,Queens County,,NY,146821,2291201,2438022
36083,Rensselaer County,,NY,11391,177649,189040
36085,Richmond County,,NY,22509,501996,524505
36087,Rockland County,,NY,15883,333897,349780
36089,St. Lawrence County,,NY,4696,112688,117384
36091,Saratoga County,,NY,15784,251871,267655
36093,Schenectady County,,NY,10371,174923,185294
36095,Schoharie County,,NY,1624,31659,33283
36097,Schuyler County,,NY,1339,20900,22239
36099,Seneca County,,NY,2072,37412,39484
36101,Steuben County,,NY,5349,108918,114267
36103,Suffolk County,,NY,69452,1760457,1829909
36105,Sullivan County,,NY,4781,80847,85628
36107,Tioga County,,NY,3357,60361,63718
36109,Tompkins County,,NY,8155,88812,96967
36111,Ulster County,,NY,9845,196145,205990
36113,Warren County,,NY,4654,76472,81126
36115,Washington County,,NY,3987,67523,71510
36117,Wayne County,,NY,5901,111723,117624
36119,Westchester County,,NY,53942,1011222,1065164
36121,Wyoming County,,NY,2522,46224,48746
36123,Yates County,,NY,1355,28211,29566
37001,Alamance County,,NC,7449,153746,161195
37003,Alexander County,,NC,2150,39593,41743
37005,Alleghany County,,NC,529,11349,11878
37007,Anson County,,NC,1309,25561,26870
37009,Ashe County,,NC,1055,26663,27718
37011,Avery County,,NC,1011,16265,17276
37013,Beaufort County,,NC,2667,49403,52070
37015,Bertie County,,NC,1202,21492,22694
37017,Bladen County,,NC,1887,31601,33488
37019,Brunswick County,,NC,6141,93239,99380
37021,Buncombe County,,NC,15175,236695,251870
37023,Burke County,,NC,5134,95247,100381
37025,Cabarrus County,,NC,12217,174823,187040
37027,Caldwell County,,NC,4131,88768,92899
37029,Camden County,,NC,943,10053,10996
37031,Carteret County,,NC,4892,67148,72040
37033,Caswell County,,NC,1562,24280,25842
37035,Catawba County,,NC,9703,171016,180719
37037,Chatham County,,NC,4991,62830,67821
37039,Cherokee County,,NC,1453,25690,27143
37041,Chowan County,,NC,927,15759,16686
37043,Clay County,,NC,722,9522,10244
37045,Cleveland County,,NC,5234,104767,110001
37047,Columbus County,,NC,2292,53996,56288
37049,Craven County,,NC,12731,104000,116731
37051,Cumberland County,,NC,48307,306705,355012
37053,Currituck County,,NC,1990,23438,25428
37055,Dare County,,NC,2951,35624,38575
37057,Davidson County,,NC,9107,177332,186439
37059,Davie County,,NC,2534,43615,46149
37061,Duplin County,,NC,2887,50870,53757
37063,Durham County,,NC,24577,251036,275613
37065,Edgecombe County,,NC,4715,58699,63414
37067,Forsyth County,,NC,21212,361988,383200
37069,Franklin County,,NC,4046,53949,57995
37071,Gaston County,,NC,10898,214068,224966
37073,Gates County,,NC,653,11769,12422
37075,Graham County,,NC,445,8354,8799
37077,Granville County,,NC,3518,54379,57897
37079,Greene County,,NC,1373,18097,19470
37081,Guilford County,,NC,29939,491056,520995
37083,Halifax County,,NC,3044,58268,61312
37085,Harnett County,,NC,9963,99001,108964
37087,Haywood County,,NC,3031,60441,63472
37089,Henderson County,,NC,6512,107229,113741
37091,Hertford County,,NC,1396,21482,22878
37093,Hoke County,,NC,5657,37560,43217
37095,Hyde County,,NC,300,4757,5057
37097,Iredell County,,NC,10450,163074,173524
37099,Jackson County,,NC,2377,30693,33070
37101,Johnston County,,NC,9998,157293,167291
37103,Jones County,,NC,707,9874,10581
37105,Lee County,,NC,3901,57229,61130
37107,Lenoir County,,NC,3518,63290,66808
37109,Lincoln County,,NC,5522,78735,84257
37111,McDowell County,,NC,2048,45285,47333
37113,Macon County,,NC,1943,33968,35911
37115,Madison County,,NC,1146,19619,20765
37117,Martin County,,NC,1464,26372,27836
37119,Mecklenburg County,,NC,70251,880547,950798
37121,Mitchell County,,NC,746,16589,17335
37123,Montgomery County,,NC,1563,27405,28968
37125,Moore County,,NC,5053,89036,94089
37127,Nash County,,NC,7480,102226,109706
37129,New Hanover County,,NC,16821,180910,197731
37131,Northampton County,,NC,1324,21494,22818
37133,Onslow County,,NC,33485,155350,188835
37135,Orange County,,NC,13331,114886,128217
37137,Pamlico County,,NC,801,13057,13858
37139,Pasquotank County,,NC,3242,39837,43079
37141,Pender County,,NC,3716,45459,49175
37143,Perquimans County,,NC,791,12532,13323
37145,Person County,,NC,2059,41151,43210
37147,Pitt County,,NC,10171,145060,155231
37149,Polk County,,NC,1288,20295,21583
37151,Randolph County,,NC,7594,152049,159643
37153,Richmond County,,NC,2257,47453,49710
37155,Robeson County,,NC,5351,122786,128137
37157,Rockingham County,,NC,4753,102923,107676
37159,Rowan County,,NC,7619,146486,154105
37161,Rutherford County,,NC,2904,65434,68338
37163,Sampson County,,NC,3323,63513,66836
37165,Scotland County,,NC,2328,37393,39721
37167,Stanly County,,NC,2827,64621,67448
37169,Stokes County,,NC,2880,50653,53533
37171,Surry County,,NC,3562,77720,81282
37173,Swain County,,NC,938,18418,19356
37175,Transylvania County,,NC,1695,30947,32642
37177,Tyrrell County,,NC,295,3965,4260
37179,Union County,,NC,11246,188214,199460
37181,Vance County,,NC,2890,46422,49312
37183,Wake County,,NC,55338,861714,917052
37185,Warren County,,NC,1162,16914,18076
37187,Washington County,,NC,839,14113,14952
37189,Watauga County,,NC,3534,36959,40493
37191,Wayne County,,NC,8336,120064,128400
37193,Wilkes County,,NC,2856,72551,75407
37195,Wilson County,,NC,4117,82993,87110
37197,Yadkin County,,NC,2263,41847,44110
37199,Yancey County,,NC,821,17797,18618
38001,Adams County,,ND,141,2745,2886
38003,Barnes County,,ND,705,12671,13376
38005,Benson County,,ND,396,6977,7373
38007,Billings County,,ND,73,942,1015
38009,Bottineau County,,ND,481,7722,8203
38011,Bowman County,,ND,186,3730,3916
38013,Burke County,,ND,163,2495,2658
38015,Burleigh County,,ND,5245,89819,95064
38017,Cass County,,ND,11132,155924,167056
38019,Cavalier County,,ND,304,5244,5548
38021,Dickey County,,ND,391,6178,6569
38023,Divide County,,ND,115,2501,2616
38025,Dunn County,,ND,215,3856,4071
38027,Eddy County,,ND,204,2760,2964
38029,Emmons County,,ND,239,4340,4579
38031,Foster County,,ND,318,4157,4475
38033,Golden Valley County,,ND,120,1906,2026
38035,Grand Forks County,,ND,7858,68540,76398
38037,Grant County,,ND,193,2923,3116
38039,Griggs County,,ND,200,2989,3189
38041,Hettinger County,,ND,173,2965,3138
38043,Kidder County,,ND,195,2993,3188
38045,LaMoure County,,ND,235,5152,5387
38047,Logan County,,ND,109,2313,2422
38049,McHenry County,,ND,479,6401,6880
38051,McIntosh County,,ND,257,3503,3760
38053,McKenzie County,,ND,349,5667,6016
38055,McLean County,,ND,631,10534,11165
38057,Mercer County,,ND,613,10306,10919
38059,Morton County,,ND,2343,30413,32756
38061,Mountrail County,,ND,496,7919,8415
38063,Nelson County,,ND,223,3916,4139
38065,Oliver County,,ND,140,2326,2466
38067,Pembina County,,ND,671,9658,10329
38069,Pierce County,,ND,287,5052,5339
38071,Ramsey County,,ND,899,13172,14071
38073,Ransom County,,ND,386,6735,7121
38075,Renville County,,ND,284,2946,3230
38077,Richland County,,ND,1442,19163,20605
38079,Rolette County,,ND,663,14004,14667
38081,Sargent County,,ND,299,5202,5501
38083,Sheridan County,,ND,84,1707,1791
38085,Sioux County,,ND,306,3658,3964
38087,Slope County,,ND,61,824,885
38089,Stark County,,ND,1503,26473,27976
38091,Steele County,,ND,174,2422,2596
38093,Stutsman County,,ND,1519,23581,25100
38095,Towner County,,ND,226,2912,3138
38097,Traill County,,ND,670,9187,9857
38099,Walsh County,,ND,872,13328,14200
38101,Ward County,,ND,6419,66764,73183
38103,Wells County,,ND,314,5304,5618
38105,Williams County,,ND,1268,23686,24954
39001,Adams County,,OH,1518,30338,31856
39003,Allen County,,OH,5635,122630,128265
39005,Ashland County,,OH,2951,60097,63048
39007,Ashtabula County,,OH,4970,116958,121928
39009,Athens County,,OH,4178,51661,55839
39011,Auglaize County,,OH,2992,58088,61080
39013,Belmont County,,OH,3055,76682,79737
39015,Brown County,,OH,3236,49287,52523
39017,Butler County,,OH,24355,395926,420281
39019,Carroll County,,OH,2264,32591,34855
39021,Champaign County,,OH,2683,46489,49172
39023,Clark County,,OH,7650,159782,167432
39025,Clermont County,,OH,14139,221476,235615
39027,Clinton County,,OH,3599,48431,52030
39029,Columbiana County,,OH,5226,121947,127173
39031,Coshocton County,,OH,1827,42187,44014
39033,Crawford County,,OH,3006,54967,57973
39035,Cuyahoga County,,OH,65088,1460018,1525106
39037,Darke County,,OH,2830,64887,67717
39039,Defiance County,,OH,2781,48132,50913
39041,Delaware County,,OH,13146,180010,193156
39043,Erie County,,OH,5076,92449,97525
39045,Fairfield County,,OH,10614,159028,169642
39047,Fayette County,,OH,2029,32337,34366
39049,Franklin County,,OH,76652,1254013,1330665
39051,Fulton County,,OH,3020,53470,56490
39053,Gallia County,,OH,1512,31957,33469
39055,Geauga County,,OH,5673,109095,114768
39057,Greene County,,OH,16478,170197,186675
39059,Guernsey County,,OH,2139,46238,48377
39061,Hamilton County,,OH,50686,900032,950718
39063,Hancock County,,OH,5194,86699,91893
39065,Hardin County,,OH,1987,33942,35929
39067,Harrison County,,OH,985,17439,18424
39069,Henry County,,OH,2224,36415,38639
39071,Highland County,,OH,3176,48129,51305
39073,Hocking County,,OH,1787,31323,33110
39075,Holmes County,,OH,1869,41722,43591
39077,Huron County,,OH,4192,74256,78448
39079,Jackson County,,OH,1760,35565,37325
39081,Jefferson County,,OH,3333,79012,82345
39083,Knox County,,OH,3172,64798,67970
39085,Lake County,,OH,12213,279629,291842
39087,Lawrence County,,OH,3122,66573,69695
39089,Licking County,,OH,9704,188293,197997
39091,Logan County,,OH,2848,55619,58467
39093,Lorain County,,OH,14883,346484,361367
39095,Lucas County,,OH,23442,485628,509070
39097,Madison County,,OH,3077,44435,47512
39099,Mahoning County,,OH,12606,272966,285572
39101,Marion County,,OH,3380,70612,73992
39103,Medina County,,OH,11622,202706,214328
39105,Meigs County,,OH,1139,23978,25117
39107,Mercer County,,OH,1992,52643,54635
39109,Miami County,,OH,7098,122465,129563
39111,Monroe County,,OH,759,17343,18102
39113,Montgomery County,,OH,34785,612435,647220
39115,Morgan County,,OH,825,15361,16186
39117,Morrow County,,OH,2409,36544,38953
39119,Muskingum County,,OH,4111,99881,103992
39121,Noble County,,OH,750,13449,14199
39123,Ottawa County,,OH,2912,50705,53617
39125,Paulding County,,OH,1169,23898,25067
39127,Perry County,,OH,2152,38421,40573
39129,Pickaway County,,OH,3693,57105,60798
39131,Pike County,,OH,1602,29926,31528
39133,Portage County,,OH,11507,170783,182290
39135,Preble County,,OH,2960,49687,52647
39137,Putnam County,,OH,1738,44760,46498
39139,Richland County,,OH,6700,146037,152737
39141,Ross County,,OH,3759,81453,85212
39143,Sandusky County,,OH,3751,74668,78419
39145,Scioto County,,OH,2875,76533,79408
39147,Seneca County,,OH,3445,67492,70937
39149,Shelby County,,OH,3009,60789,63798
39151,Stark County,,OH,16390,445992,462382
39153,Summit County,,OH,30771,621264,652035
39155,Trumbull County,,OH,10621,253905,264526
39157,Tuscarawas County,,OH,4397,113929,118326
39159,Union County,,OH,3608,54053,57661
39161,Van Wert County,,OH,1540,36596,38136
39163,Vinton County,,OH,925,13814,14739
39165,Warren County,,OH,17195,227405,244600
39167,Washington County,,OH,3339,70648,73987
39169,Wayne County,,OH,6580,135726,142306
39171,Williams County,,OH,2281,46800,49081
39173,Wood County,,OH,10641,135227,145868
39175,Wyandot County,,OH,1578,27607,29185
40001,Adair County,,OK,1412,22209,23621
40003,Alfalfa County,,OK,383,5176,5559
40005,Atoka County,,OK,800,13651,14451
40007,Beaver County,,OK,457,5600,6057
40009,Beckham County,,OK,1685,19830,21515
40011,Blaine County,,OK,829,10190,11019
40013,Bryan County,,OK,2549,33622,36171
40015,Caddo County,,OK,2048,27977,30025
40017,Canadian County,,OK,8710,107808,116518
40019,Carter County,,OK,3137,47918,51055
40021,Cherokee County,,OK,3240,39371,42611
40023,Choctaw County,,OK,993,13856,14849
40025,Cimarron County,,OK,257,2906,3163
40027,Cleveland County,,OK,23461,232664,256125
40029,Coal County,,OK,397,4838,5235
40031,Comanche County,,OK,13268,107489,120757
40033,Cotton County,,OK,540,6101,6641
40035,Craig County,,OK,981,13890,14871
40037,Creek County,,OK,5719,69231,74950
40039,Custer County,,OK,2201,24603,26804
40041,Delaware County,,OK,2804,34002,36806
40043,Dewey County,,OK,380,4981,5361
40045,Ellis County,,OK,275,3880,4155
40047,Garfield County,,OK,4750,61830,66580
40049,Garvin County,,OK,1911,27050,28961
40051,Grady County,,OK,3826,47594,51420
40053,Grant County,,OK,389,4676,5065
40055,Greer County,,OK,403,4799,5202
40057,Harmon County,,OK,296,2792,3088
40059,Harper County,,OK,275,3798,4073
40061,Haskell County,,OK,732,11856,12588
40063,Hughes County,,OK,886,11531,12417
40065,Jackson County,,OK,3752,27267,31019
40067,Jefferson County,,OK,521,5558,6079
40069,Johnston County,,OK,818,9810,10628
40071,Kay County,,OK,3258,48610,51868
40073,Kingfisher County,,OK,967,16177,17144
40075,Kiowa County,,OK,766,9206,9972
40077,Latimer County,,OK,884,11276,12160
40079,Le Flore County,,OK,2803,44832,47635
40081,Lincoln County,,OK,2458,32163,34621
40083,Logan County,,OK,3277,35908,39185
40085,Love County,,OK,799,8971,9770
40087,McClain County,,OK,3097,32580,35677
40089,McCurtain County,,OK,1709,31015,32724
40091,McIntosh County,,OK,1338,17363,18701
40093,Major County,,OK,568,8125,8693
40095,Marshall County,,OK,1036,13477,14513
40097,Mayes County,,OK,2692,40147,42839
40099,Murray County,,OK,1021,12104,13125
40101,Muskogee County,,OK,4505,70047,74552
40103,Noble County,,OK,977,12229,13206
40105,Nowata County,,OK,773,10725,11498
40107,Okfuskee County,,OK,781,10187,10968
40109,Oklahoma County,,OK,49755,686628,736383
40111,Okmulgee County,,OK,2868,38025,40893
40113,Osage County,,OK,4076,41402,45478
40115,Ottawa County,,OK,2759,33368,36127
40117,Pawnee County,,OK,1407,16048,17455
40119,Payne County,,OK,6494,59688,66182
40121,Pittsburg County,,OK,2577,43325,45902
40123,Pontotoc County,,OK,2531,34737,37268
40125,Pottawatomie County,,OK,4986,66296,71282
40127,Pushmataha County,,OK,690,10342,11032
40129,Roger Mills County,,OK,247,3715,3962
40131,Rogers County,,OK,6499,86012,92511
40133,Seminole County,,OK,1891,22449,24340
40135,Sequoyah County,,OK,2440,39858,42298
40137,Stephens County,,OK,2688,44063,46751
40139,Texas County,,OK,1803,20128,21931
40141,Tillman County,,OK,739,7647,8386
40143,Tulsa County,,OK,41785,604410,646195
40145,Wagoner County,,OK,6334,65325,71659
40147,Washington County,,OK,3612,52711,56323
40149,Washita County,,OK,1028,11282,12310
40151,Woods County,,OK,741,8256,8997
40153,Woodward County,,OK,1251,20178,21429
41001,Baker County,,OR,1231,15974,17205
41003,Benton County,,OR,8211,78024,86235
41005,Clackamas County,,OR,29520,374085,403605
41007,Clatsop County,,OR,2928,35280,38208
41009,Columbia County,,OR,3580,51128,54708
41011,Coos County,,OR,4169,61633,65802
41013,Crook County,,OR,1776,20976,22752
41015,Curry County,,OR,1986,22401,24387
41017,Deschutes County,,OR,11773,152949,164722
41019,Douglas County,,OR,6041,107983,114024
41021,Gilliam County,,OR,184,1873,2057
41023,Grant County,,OR,652,7272,7924
41025,Harney County,,OR,623,7096,7719
41027,Hood River County,,OR,1712,23105,24817
41029,Jackson County,,OR,10927,204744,215671
41031,Jefferson County,,OR,1669,21118,22787
41033,Josephine County,,OR,4897,80634,85531
41035,Klamath County,,OR,4169,66257,70426
41037,Lake County,,OR,632,7371,8003
41039,Lane County,,OR,19796,344771,364567
41041,Lincoln County,,OR,3876,43207,47083
41043,Linn County,,OR,7733,114814,122547
41045,Malheur County,,OR,2101,27220,29321
41047,Marion County,,OR,19955,312037,331992
41049,Morrow County,,OR,1103,11494,12597
41051,Multnomah County,,OR,54895,699033,753928
41053,Polk County,,OR,6407,70231,76638
41055,Sherman County,,OR,137,1800,1937
41057,Tillamook County,,OR,1827,25898,27725
41059,Umatilla County,,OR,5133,74701,79834
41061,Union County,,OR,1894,26401,28295
41063,Wallowa County,,OR,450,7656,8106
41065,Wasco County,,OR,1799,23968,25767
41067,Washington County,,OR,43621,536381,580002
41069,Wheeler County,,OR,122,1215,1337
41071,Yamhill County,,OR,6329,93638,99967
42001,Adams County,,PA,6153,119251,125404
42003,Allegheny County,,PA,52932,1406694,1459626
42005,Armstrong County,,PA,3314,79799,83113
42007,Beaver County,,PA,7769,206739,214508
42009,Bedford County,,PA,1971,59857,61828
42011,Berks County,,PA,18021,481329,499350
42013,Blair County,,PA,4378,147780,152158
42015,Bradford County,,PA,2769,72994,75763
42017,Bucks County,,PA,36806,761026,797832
42019,Butler County,,PA,9533,216943,226476
42021,Cambria County,,PA,5589,167018,172607
42023,Cameron County,,PA,272,6410,6682
42025,Carbon County,,PA,3409,73431,76840
42027,Centre County,,PA,8989,134428,143417
42029,Chester County,,PA,29370,565393,594763
42031,Clarion County,,PA,2153,44761,46914
42033,Clearfield County,,PA,3589,91760,95349
42035,Clinton County,,PA,1809,41452,43261
42037,Columbia County,,PA,3080,71057,74137
42039,Crawford County,,PA,4182,99402,103584
42041,Cumberland County,,PA,15807,271420,287227
42043,Dauphin County,,PA,16763,314604,331367
42045,Delaware County,,PA,32095,632701,664796
42047,Elk County,,PA,1202,41890,43092
42049,Erie County,,PA,10866,314185,325051
42051,Fayette County,,PA,4833,154873,159706
42053,Forest County,,PA,392,5542,5934
42055,Franklin County,,PA,6861,179654,186515
42057,Fulton County,,PA,717,18036,18753
42059,Greene County,,PA,1662,39709,41371
42061,Huntingdon County,,PA,1758,49271,51029
42063,Indiana County,,PA,4151,93166,97317
42065,Jefferson County,,PA,2442,53917,56359
42067,Juniata County,,PA,1042,28141,29183
42069,Lackawanna County,,PA,8306,239250,247556
42071,Lancaster County,,PA,19564,624727,644291
42073,Lawrence County,,PA,3604,105346,108950
42075,Lebanon County,,PA,6280,160405,166685
42077,Lehigh County,,PA,22768,397293,420061
42079,Luzerne County,,PA,11786,363316,375102
42081,Lycoming County,,PA,5365,134258,139623
42083,McKean County,,PA,2008,48840,50848
42085,Mercer County,,PA,5451,134822,140273
42087,Mifflin County,,PA,1632,54294,55926
42089,Monroe County,,PA,11974,176025,187999
42091,Montgomery County,,PA,51398,922278,973676
42093,Montour County,,PA,1454,20851,22305
42095,Northampton County,,PA,18194,341983,360177
42097,Northumberland County,,PA,4427,106199,110626
42099,Perry County,,PA,2607,56005,58612
42101,Philadelphia County,,PA,80711,1424978,1505689
42103,Pike County,,PA,4280,60263,64543
42105,Potter County,,PA,1322,20187,21509
42107,Schuylkill County,,PA,5307,170509,175816
42109,Snyder County,,PA,1939,42095,44034
42111,Somerset County,,PA,2863,90243,93106
42113,Sullivan County,,PA,388,7057,7445
42115,Susquehanna County,,PA,2385,49958,52343
42117,Tioga County,,PA,1932,45563,47495
42119,Union County,,PA,2503,41770,44273
42121,Venango County,,PA,2523,64498,67021
42123,Warren County,,PA,1852,48252,50104
42125,Washington County,,PA,9645,243570,253215
42127,Wayne County,,PA,3205,54788,57993
42129,Westmoreland County,,PA,15609,442351,457960
42131,Wyoming County,,PA,1680,33358,35038
42133,York County,,PA,20135,514402,534537
44001,Bristol County,,RI,3477,54841,58318
44003,Kent County,,RI,12820,198807,211627
44005,Newport County,,RI,8353,91882,100235
44007,Providence County,,RI,34580,679267,713847
44009,Washington County,,RI,8253,143154,151407
45001,Abbeville County,,SC,1584,26382,27966
45003,Aiken County,,SC,8768,161824,170592
45005,Allendale County,,SC,599,9772,10371
45007,Anderson County,,SC,9047,192237,201284
45009,Bamberg County,,SC,1041,15256,16297
45011,Barnwell County,,SC,1146,23693,24839
45013,Beaufort County,,SC,14713,148273,162986
45015,Berkeley County,,SC,18330,163466,181796
45017,Calhoun County,,SC,1059,15296,16355
45019,Charleston County,,SC,32114,324100,356214
45021,Cherokee County,,SC,2505,57587,60092
45023,Chester County,,SC,2044,36340,38384
45025,Chesterfield County,,SC,2079,46466,48545
45027,Clarendon County,,SC,1937,33084,35021
45029,Colleton County,,SC,2229,40702,42931
45031,Darlington County,,SC,4243,73788,78031
45033,Dillon County,,SC,1664,33303,34967
45035,Dorchester County,,SC,12879,125304,138183
45037,Edgefield County,,SC,1772,24938,26710
45039,Fairfield County,,SC,1421,24804,26225
45041,Florence County,,SC,7726,138440,146166
45043,Georgetown County,,SC,3731,64756,68487
45045,Greenville County,,SC,24863,444862,469725
45047,Greenwood County,,SC,3659,71318,74977
45049,Hampton County,,SC,1054,21067,22121
45051,Horry County,,SC,15355,252783,268138
45053,Jasper County,,SC,1658,19278,20936
45055,Kershaw County,,SC,3358,62983,66341
45057,Lancaster County,,SC,3164,69434,72598
45059,Laurens County,,SC,3848,67528,71376
45061,Lee County,,SC,1292,19214,20506
45063,Lexington County,,SC,17431,262006,279437
45065,McCormick County,,SC,589,9925,10514
45067,Marion County,,SC,2048,35434,37482
45069,Marlboro County,,SC,1508,29792,31300
45071,Newberry County,,SC,1790,38853,40643
45073,Oconee County,,SC,3760,76285,80045
45075,Orangeburg County,,SC,5045,93095,98140
45077,Pickens County,,SC,8061,112697,120758
45079,Richland County,,SC,30060,347787,377847
45081,Saluda County,,SC,1135,19468,20603
45083,Spartanburg County,,SC,12642,289560,302202
45085,Sumter County,,SC,8895,111819,120714
45087,Union County,,SC,1259,31056,32315
45089,Williamsburg County,,SC,1668,35796,37464
45091,York County,,SC,11836,218931,230767
46003,Aurora County,,SD,223,3269,3492
46005,Beadle County,,SD,889,17967,18856
46007,Bennett County,,SD,224,3055,3279
46009,Bon Homme County,,SD,415,6984,7399
46011,Brookings County,,SD,2776,28642,31418
46013,Brown County,,SD,2185,41634,43819
46015,Brule County,,SD,361,5096,5457
46017,Buffalo County,,SD,163,1916,2079
46019,Butte County,,SD,951,9848,10799
46021,Campbell County,,SD,131,1769,1900
46023,Charles Mix County,,SD,513,9525,10038
46025,Clark County,,SD,242,3917,4159
46027,Clay County,,SD,1554,11555,13109
46029,Codington County,,SD,2029,31370,33399
46031,Corson County,,SD,282,3525,3807
46033,Custer County,,SD,775,7784,8559
46035,Davison County,,SD,1935,21886,23821
46037,Day County,,SD,425,6688,7113
46039,Deuel County,,SD,386,5511,5897
46041,Dewey County,,SD,505,6453,6958
46043,Douglas County,,SD,209,3622,3831
46045,Edmunds County,,SD,239,4451,4690
46047,Fall River County,,SD,706,7374,8080
46049,Faulk County,,SD,127,2578,2705
46051,Grant County,,SD,520,9355,9875
46053,Gregory County,,SD,285,4882,5167
46055,Haakon County,,SD,144,2346,2490
46057,Hamlin County,,SD,389,6151,6540
46059,Hand County,,SD,229,4045,4274
46061,Hanson County,,SD,173,3270,3443
46063,Harding County,,SD,63,1565,1628
46065,Hughes County,,SD,1496,19729,21225
46067,Hutchinson County,,SD,451,8672,9123
46069,Hyde County,,SD,147,1720,1867
46071,Jackson County,,SD,232,2839,3071
46073,Jerauld County,,SD,206,2629,2835
46075,Jones County,,SD,90,1223,1313
46077,Kingsbury County,,SD,342,6297,6639
46079,Lake County,,SD,843,11988,12831
46081,Lawrence County,,SD,2400,24255,26655
46083,Lincoln County,,SD,3755,39471,43226
46085,Lyman County,,SD,257,4158,4415
46087,McCook County,,SD,497,6622,7119
46089,McPherson County,,SD,168,2686,2854
46091,Marshall County,,SD,316,4797,5113
46093,Meade County,,SD,4612,29314,33926
46095,Mellette County,,SD,146,1912,2058
46097,Miner County,,SD,206,2715,2921
46099,Minnehaha County,,SD,13712,199619,213331
46101,Moody County,,SD,511,7742,8253
46103,Pennington County,,SD,9008,105311,114319
46105,Perkins County,,SD,184,3480,3664
46107,Potter County,,SD,219,2990,3209
46109,Roberts County,,SD,629,11339,11968
46111,Sanborn County,,SD,193,2866,3059
46113,Shannon County,,SD,784,11605,12389
46115,Spink County,,SD,471,7320,7791
46117,Stanley County,,SD,359,3533,3892
46119,Sully County,,SD,121,1929,2050
46121,Todd County,,SD,506,8428,8934
46123,Tripp County,,SD,424,6975,7399
46125,Turner County,,SD,603,9780,10383
46127,Union County,,SD,1427,16244,17671
46129,Walworth County,,SD,498,6424,6922
46135,Yankton County,,SD,1549,24149,25698
46137,Ziebach County,,SD,108,1227,1335
47001,Anderson County,,TN,5389,78116,83505
47003,Bedford County,,TN,2809,47439,50248
47005,Benton County,,TN,963,16834,17797
47007,Bledsoe County,,TN,710,10850,11560
47009,Blount County,,TN,7197,130043,137240
47011,Bradley County,,TN,5799,99280,105079
47013,Campbell County,,TN,1761,37919,39680
47015,Cannon County,,TN,943,14086,15029
47017,Carroll County,,TN,2014,31747,33761
47019,Carter County,,TN,3463,56263,59726
47021,Cheatham County,,TN,3130,42163,45293
47023,Chester County,,TN,1228,15808,17036
47025,Claiborne County,,TN,1660,32621,34281
47027,Clay County,,TN,461,7752,8213
47029,Cocke County,,TN,1704,36271,37975
47031,Coffee County,,TN,3447,55964,59411
47033,Crockett County,,TN,1074,15493,16567
47035,Cumberland County,,TN,2698,58545,61243
47037,Davidson County,,TN,54811,617630,672441
47039,Decatur County,,TN,642,11518,12160
47041,DeKalb County,,TN,1266,18476,19742
47043,Dickson County,,TN,2941,51372,54313
47045,Dyer County,,TN,2493,41982,44475
47047,Fayette County,,TN,2887,40532,43419
47049,Fentress County,,TN,736,17170,17906
47051,Franklin County,,TN,2317,43546,45863
47053,Gibson County,,TN,2885,52720,55605
47055,Giles County,,TN,1983,31957,33940
47057,Grainger County,,TN,1464,21655,23119
47059,Greene County,,TN,2883,72673,75556
47061,Grundy County,,TN,725,13975,14700
47063,Hamblen County,,TN,3997,63083,67080
47065,Hamilton County,,TN,18165,345832,363997
47067,Hancock County,,TN,228,4773,5001
47069,Hardeman County,,TN,1419,27159,28578
47071,Hardin County,,TN,1370,26452,27822
47073,Hawkins County,,TN,3740,59551,63291
47075,Haywood County,,TN,1223,21864,23087
47077,Henderson County,,TN,1510,29589,31099
47079,Henry County,,TN,1961,33546,35507
47081,Hickman County,,TN,1663,23321,24984
47083,Houston County,,TN,391,8223,8614
47085,Humphreys County,,TN,1140,19968,21108
47087,Jackson County,,TN,841,11878,12719
47089,Jefferson County,,TN,4121,50110,54231
47091,Johnson County,,TN,681,16134,16815
47093,Knox County,,TN,25543,428039,453582
47095,Lake County,,TN,334,5212,5546
47097,Lauderdale County,,TN,1461,25552,27013
47099,Lawrence County,,TN,1759,42812,44571
47101,Lewis County,,TN,665,11828,12493
47103,Lincoln County,,TN,1628,35579,37207
47105,Loudon County,,TN,3431,50185,53616
47107,McMinn County,,TN,3134,53468,56602
47109,McNairy County,,TN,1462,26454,27916
47111,Macon County,,TN,1265,22414,23679
47113,Madison County,,TN,7133,101648,108781
47115,Marion County,,TN,1517,30896,32413
47117,Marshall County,,TN,1932,32529,34461
47119,Maury County,,TN,5132,83857,88989
47121,Meigs County,,TN,973,11579,12552
47123,Monroe County,,TN,2461,44159,46620
47125,Montgomery County,,TN,17650,158895,176545
47127,Moore County,,TN,429,6615,7044
47129,Morgan County,,TN,1016,20004,21020
47131,Obion County,,TN,1939,35535,37474
47133,Overton County,,TN,1038,22253,23291
47135,Perry County,,TN,439,7554,7993
47137,Pickett County,,TN,273,5034,5307
47139,Polk County,,TN,1365,16360,17725
47141,Putnam County,,TN,4840,68139,72979
47143,Rhea County,,TN,1785,30926,32711
47145,Roane County,,TN,3365,57466,60831
47147,Robertson County,,TN,4624,70316,74940
47149,Rutherford County,,TN,18360,251941,270301
47151,Scott County,,TN,657,22038,22695
47153,Sequatchie County,,TN,825,13333,14158
47155,Sevier County,,TN,6651,87433,94084
47157,Shelby County,,TN,53182,1015045,1068227
47159,Smith County,,TN,1132,20154,21286
47161,Stewart County,,TN,970,13714,14684
47163,Sullivan County,,TN,8630,168351,176981
47165,Sumner County,,TN,11350,162604,173954
47167,Tipton County,,TN,3889,59461,63350
47169,Trousdale County,,TN,563,7987,8550
47171,Unicoi County,,TN,1002,18384,19386
47173,Union County,,TN,1273,18610,19883
47175,Van Buren County,,TN,351,5333,5684
47177,Warren County,,TN,1774,42430,44204
47179,Washington County,,TN,8522,119624,128146
47181,Wayne County,,TN,747,15485,16232
47183,Weakley County,,TN,2126,32482,34608
47185,White County,,TN,1452,26141,27593
47187,Williamson County,,TN,13980,175096,189076
47189,Wilson County,,TN,8111,115938,124049
48001,Anderson County,,TX,3200,44155,47355
48003,Andrews County,,TX,963,14658,15621
48005,Angelina County,,TX,4996,85491,90487
48007,Aransas County,,TX,2234,20800,23034
48009,Archer County,,TX,905,8835,9740
48011,Armstrong County,,TX,346,2159,2505
48013,Atascosa County,,TX,3479,44392,47871
48015,Austin County,,TX,2066,27975,30041
48017,Bailey County,,TX,677,6767,7444
48019,Bandera County,,TX,1515,17685,19200
48021,Bastrop County,,TX,5612,64436,70048
48023,Baylor County,,TX,327,3725,4052
48025,Bee County,,TX,1926,24415,26341
48027,Bell County,,TX,37549,273284,310833
48029,Bexar County,,TX,85772,1653722,1739494
48031,Blanco County,,TX,771,9125,9896
48033,Borden County,,TX,-2,-2,-4
48035,Bosque County,,TX,1533,17164,18697
48037,Bowie County,,TX,6563,91531,98094
48039,Brazoria County,,TX,20727,292631,313358
48041,Brazos County,,TX,15141,136906,152047
48043,Brewster County,,TX,1098,8386,9484
48045,Briscoe County,,TX,154,1675,1829
48047,Brooks County,,TX,570,7915,8485
48049,Brown County,,TX,2593,36618,39211
48051,Burleson County,,TX,1340,17100,18440
48053,Burnet County,,TX,3386,39916,43302
48055,Caldwell County,,TX,3207,33762,36969
48057,Calhoun County,,TX,1532,21403,22935
48059,Callahan County,,TX,1400,13259,14659
48061,Cameron County,,TX,15889,386132,402021
48063,Camp County,,TX,1048,12414,13462
48065,Carson County,,TX,570,6259,6829
48067,Cass County,,TX,2116,31272,33388
48069,Castro County,,TX,767,7535,8302
48071,Chambers County,,TX,3188,33907,37095
48073,Cherokee County,,TX,3242,49608,52850
48075,Childress County,,TX,523,5868,6391
48077,Clay County,,TX,1139,10939,12078
48079,Cochran County,,TX,351,3366,3717
48081,Coke County,,TX,382,3305,3687
48083,Coleman County,,TX,641,8050,8691
48085,Collin County,,TX,64748,696281,761029
48087,Collingsworth County,,TX,220,2932,3152
48089,Colorado County,,TX,1246,21346,22592
48091,Comal County,,TX,8573,102190,110763
48093,Comanche County,,TX,1003,13125,14128
48095,Concho County,,TX,251,2490,2741
48097,Cooke County,,TX,3002,39308,42310
48099,Coryell County,,TX,11726,58119,69845
48101,Cottle County,,TX,150,1567,1717
48103,Crane County,,TX,338,4325,4663
48105,Crockett County,,TX,285,3909,4194
48107,Crosby County,,TX,732,6333,7065
48109,Culberson County,,TX,301,2659,2960
48111,Dallam County,,TX,683,6584,7267
48113,Dallas County,,TX,175963,2308145,2484108
48115,Dawson County,,TX,953,12858,13811
48117,Deaf Smith County,,TX,1357,19948,21305
48119,Delta County,,TX,610,4813,5423
48121,Denton County,,TX,59993,587194,647187
48123,DeWitt County,,TX,1327,18802,20129
48125,Dickens County,,TX,157,1991,2148
48127,Dimmit County,,TX,777,9873,10650
48129,Donley County,,TX,299,3302,3601
48131,Duval County,,TX,891,11882,12773
48133,Eastland County,,TX,1393,17444,18837
48135,Ector County,,TX,7390,138202,145592
48137,Edwards County,,TX,148,2006,2154
48139,Ellis County,,TX,10484,142527,153011
48141,El Paso County,,TX,43386,814567,857953
48143,Erath County,,TX,2981,30711,33692
48145,Falls County,,TX,1319,14873,16192
48147,Fannin County,,TX,2299,30343,32642
48149,Fayette County,,TX,1413,23990,25403
48151,Fisher County,,TX,304,3793,4097
48153,Floyd County,,TX,713,7237,7950
48155,Foard County,,TX,133,1309,1442
48157,Fort Bend County,,TX,40809,501775,542584
48159,Franklin County,,TX,985,9901,10886
48161,Freestone County,,TX,1519,17407,18926
48163,Frio County,,TX,876,13987,14863
48165,Gaines County,,TX,979,16006,16985
48167,Galveston County,,TX,21431,288424,309855
48169,Garza County,,TX,472,4397,4869
48171,Gillespie County,,TX,1503,23970,25473
48173,Glasscock County,,TX,110,1313,1423
48175,Goliad County,,TX,610,7259,7869
48177,Gonzales County,,TX,1301,19195,20496
48179,Gray County,,TX,1695,21424,23119
48181,Grayson County,,TX,7351,119509,126860
48183,Gregg County,,TX,10436,124930,135366
48185,Grimes County,,TX,2025,23231,25256
48187,Guadalupe County,,TX,10250,117425,127675
48189,Hale County,,TX,3103,36443,39546
48191,Hall County,,TX,385,3208,3593
48193,Hamilton County,,TX,640,8295,8935
48195,Hansford County,,TX,425,5565,5990
48197,Hardeman County,,TX,437,4149,4586
48199,Hardin County,,TX,4322,53193,57515
48201,Harris County,,TX,220970,3879253,4100223
48203,Harrison County,,TX,5242,64488,69730
48205,Hartley County,,TX,437,3733,4170
48207,Haskell County,,TX,557,5379,5936
48209,Hays County,,TX,13447,116274,129721
48211,Hemphill County,,TX,390,3519,3909
48213,Henderson County,,TX,6543,71525,78068
48215,Hidalgo County,,TX,22523,687280,709803
48217,Hill County,,TX,2841,33249,36090
48219,Hockley County,,TX,2289,24015,26304
48221,Hood County,,TX,4105,46403,50508
48223,Hopkins County,,TX,2317,34256,36573
48225,Houston County,,TX,1208,19725,20933
48227,Howard County,,TX,1948,29287,31235
48229,Hudspeth County,,TX,331,3442,3773
48231,Hunt County,,TX,7090,80076,87166
48233,Hutchinson County,,TX,1918,24210,26128
48235,Irion County,,TX,287,1969,2256
48237,Jack County,,TX,861,7438,8299
48239,Jackson County,,TX,1021,14865,15886
48241,Jasper County,,TX,2488,34213,36701
48243,Jeff Davis County,,TX,244,2124,2368
48245,Jefferson County,,TX,14806,243018,257824
48247,Jim Hogg County,,TX,311,5196,5507
48249,Jim Wells County,,TX,2759,42611,45370
48251,Johnson County,,TX,11616,145993,157609
48253,Jones County,,TX,1516,15233,16749
48255,Karnes County,,TX,797,12371,13168
48257,Kaufman County,,TX,8262,95939,104201
48259,Kendall County,,TX,2624,31641,34265
48261,Kenedy County,,TX,-2,-2,-4
48263,Kent County,,TX,65,717,782
48265,Kerr County,,TX,3380,47296,50676
48267,Kimble County,,TX,371,4431,4802
48269,King County,,TX,45,237,282
48271,Kinney County,,TX,251,3142,3393
48273,Kleberg County,,TX,3162,29419,32581
48275,Knox County,,TX,403,3699,4102
48277,Lamar County,,TX,2974,50691,53665
48279,Lamb County,,TX,1195,14564,15759
48281,Lampasas County,,TX,1885,19134,21019
48283,La Salle County,,TX,395,5634,6029
48285,Lavaca County,,TX,1238,21264,22502
48287,Lee County,,TX,1176,16318,17494
48289,Leon County,,TX,1290,16604,17894
48291,Liberty County,,TX,6306,67883,74189
48293,Limestone County,,TX,1619,21238,22857
48295,Lipscomb County,,TX,322,3094,3416
48297,Live Oak County,,TX,763,8886,9649
48299,Llano County,,TX,1355,15303,16658
48301,Loving County,,TX,-2,-2,-4
48303,Lubbock County,,TX,18666,250579,269245
48305,Lynn County,,TX,734,6352,7086
48307,McCulloch County,,TX,773,8056,8829
48309,McLennan County,,TX,13186,223157,236343
48311,McMullen County,,TX,50,810,860
48313,Madison County,,TX,837,10771,11608
48315,Marion County,,TX,902,9025,9927
48317,Martin County,,TX,412,4330,4742
48319,Mason County,,TX,238,3693,3931
48321,Matagorda County,,TX,2556,37271,39827
48323,Maverick County,,TX,2886,60519,63405
48325,Medina County,,TX,3266,42037,45303
48327,Menard County,,TX,203,2054,2257
48329,Midland County,,TX,9063,131428,140491
48331,Milam County,,TX,1828,24658,26486
48333,Mills County,,TX,333,4547,4880
48335,Mitchell County,,TX,546,6726,7272
48337,Montague County,,TX,1504,19380,20884
48339,Montgomery County,,TX,31026,383250,414276
48341,Moore County,,TX,2136,21463,23599
48343,Morris County,,TX,1080,14363,15443
48345,Motley County,,TX,103,1138,1241
48347,Nacogdoches County,,TX,4505,55120,59625
48349,Navarro County,,TX,3561,47095,50656
48351,Newton County,,TX,949,10232,11181
48353,Nolan County,,TX,1317,15185,16502
48355,Nueces County,,TX,23358,331403,354761
48357,Ochiltree County,,TX,660,10085,10745
48359,Oldham County,,TX,299,1968,2267
48361,Orange County,,TX,5282,86971,92253
48363,Palo Pinto County,,TX,2274,26676,28950
48365,Panola County,,TX,1620,24379,25999
48367,Parker County,,TX,9170,104362,113532
48369,Parmer County,,TX,912,10772,11684
48371,Pecos County,,TX,1037,13593,14630
48373,Polk County,,TX,5200,52576,57776
48375,Potter County,,TX,13040,111644,124684
48377,Presidio County,,TX,1004,10338,11342
48379,Rains County,,TX,859,8852,9711
48381,Randall County,,TX,11757,115806,127563
48383,Reagan County,,TX,233,3575,3808
48385,Real County,,TX,277,2969,3246
48387,Red River County,,TX,909,13389,14298
48389,Reeves County,,TX,793,11198,11991
48391,Refugio County,,TX,583,8154,8737
48393,Roberts County,,TX,94,796,890
48395,Robertson County,,TX,1416,16384,17800
48397,Rockwall County,,TX,6484,67070,73554
48399,Runnels County,,TX,957,10872,11829
48401,Rusk County,,TX,3514,43976,47490
48403,Sabine County,,TX,888,10029,10917
48405,San Augustine County,,TX,593,8348,8941
48407,San Jacinto County,,TX,2272,21766,24038
48409,San Patricio County,,TX,7896,71962,79858
48411,San Saba County,,TX,374,5378,5752
48413,Schleicher County,,TX,263,3114,3377
48415,Scurry County,,TX,1082,16096,17178
48417,Shackelford County,,TX,282,3332,3614
48419,Shelby County,,TX,1232,24292,25524
48421,Sherman County,,TX,216,2594,2810
48423,Smith County,,TX,13094,200702,213796
48425,Somervell County,,TX,792,7545,8337
48427,Starr County,,TX,2718,63600,66318
48429,Stephens County,,TX,631,8546,9177
48431,Sterling County,,TX,93,1129,1222
48433,Stonewall County,,TX,74,1489,1563
48435,Sutton County,,TX,486,4955,5441
48437,Swisher County,,TX,665,7687,8352
48439,Tarrant County,,TX,112456,1753005,1865461
48441,Taylor County,,TX,12466,130049,142515
48443,Terrell County,,TX,108,867,975
48445,Terry County,,TX,998,11781,12779
48447,Throckmorton County,,TX,181,1591,1772
48449,Titus County,,TX,2120,31149,33269
48451,Tom Green County,,TX,10126,107976,118102
48453,Travis County,,TX,78720,869379,948099
48455,Trinity County,,TX,1397,12923,14320
48457,Tyler County,,TX,1384,17498,18882
48459,Upshur County,,TX,3159,34973,38132
48461,Upton County,,TX,323,3254,3577
48463,Uvalde County,,TX,2013,28255,30268
48465,Val Verde County,,TX,4250,51442,55692
48467,Van Zandt County,,TX,3703,48295,51998
48469,Victoria County,,TX,5414,91023,96437
48471,Walker County,,TX,4721,43890,48611
48473,Waller County,,TX,3241,32946,36187
48475,Ward County,,TX,936,10770,11706
48477,Washington County,,TX,2008,32614,34622
48479,Webb County,,TX,7559,249288,256847
48481,Wharton County,,TX,2625,44693,47318
48483,Wheeler County,,TX,418,5293,5711
48485,Wichita County,,TX,13010,125406,138416
48487,Wilbarger County,,TX,1075,13913,14988
48489,Willacy County,,TX,1292,19846,21138
48491,Williamson County,,TX,35285,357003,392288
48493,Wilson County,,TX,2905,39836,42741
48495,Winkler County,,TX,598,6953,7551
48497,Wise County,,TX,4805,55181,59986
48499,Wood County,,TX,3157,38933,42090
48501,Yoakum County,,TX,656,8276,8932
48503,Young County,,TX,1413,18178,19591
48505,Zapata County,,TX,490,12775,13265
48507,Zavala County,,TX,771,11194,11965
49001,Beaver County,,UT,598,6671,7269
49003,Box Elder County,,UT,3457,53072,56529
49005,Cache County,,UT,9541,106175,115716
49007,Carbon County,,UT,1530,21242,22772
49009,Daggett County,,UT,144,875,1019
49011,Davis County,,UT,27006,308196,335202
49013,Duchesne County,,UT,994,16990,17984
49015,Emery County,,UT,811,11444,12255
49017,Garfield County,,UT,373,4704,5077
49019,Grand County,,UT,900,8970,9870
49021,Iron County,,UT,4181,38862,43043
49023,Juab County,,UT,639,9518,10157
49025,Kane County,,UT,636,6235,6871
49027,Millard County,,UT,908,12900,13808
49029,Morgan County,,UT,728,9487,10215
49031,Piute County,,UT,78,1379,1457
49033,Rich County,,UT,186,2071,2257
49035,Salt Lake County,,UT,59969,1070186,1130155
49037,San Juan County,,UT,1126,9251,10377
49039,Sanpete County,,UT,1651,23007,24658
49041,Sevier County,,UT,1280,20763,22043
49043,Summit County,,UT,3631,36186,39817
49045,Tooele County,,UT,4891,55883,60774
49047,Uintah County,,UT,1939,28490,30429
49049,Utah County,,UT,32389,450548,482937
49051,Wasatch County,,UT,2085,20633,22718
49053,Washington County,,UT,9952,122464,132416
49055,Wayne County,,UT,254,2557,2811
49057,Weber County,,UT,16848,234157,251005
50001,Addison County,,VT,2268,42045,44313
50003,Bennington County,,VT,2299,42221,44520
50005,Caledonia County,,VT,1892,35351,37243
50007,Chittenden County,,VT,11188,175844,187032
50009,Essex County,,VT,502,7267,7769
50011,Franklin County,,VT,2727,55032,57759
50013,Grand Isle County,,VT,801,8553,9354
50015,Lamoille County,,VT,2008,28338,30346
50017,Orange County,,VT,2417,33351,35768
50019,Orleans County,,VT,1352,31807,33159
50021,Rutland County,,VT,3353,74122,77475
50023,Washington County,,VT,4207,70319,74526
50025,Windham County,,VT,3083,51440,54523
50027,Windsor County,,VT,4749,67745,72494
51001,Accomack County,,VA,1855,36979,38834
51003,Albemarle County,,VA,10478,93906,104384
51005,Alleghany County,,VA,896,18557,19453
51007,Amelia County,,VA,900,13625,14525
51009,Amherst County,,VA,1913,34303,36216
51011,Appomattox County,,VA,851,16061,16912
51013,Arlington County,,VA,40294,199990,240284
51015,Augusta County,,VA,4366,81589,85955
51017,Bath County,,VA,362,5678,6040
51019,Bedford County,,VA,5056,74504,79560
51021,Bland County,,VA,367,6689,7056
51023,Botetourt County,,VA,2569,37648,40217
51025,Brunswick County,,VA,1102,17040,18142
51027,Buchanan County,,VA,1045,22539,23584
51029,Buckingham County,,VA,881,13437,14318
51031,Campbell County,,VA,3987,58610,62597
51033,Caroline County,,VA,2719,30498,33217
51035,Carroll County,,VA,1355,30791,32146
51036,Charles City County,,VA,457,8052,8509
51037,Charlotte County,,VA,802,13510,14312
51041,Chesterfield County,,VA,25604,343324,368928
51043,Clarke County,,VA,1191,14646,15837
51045,Craig County,,VA,239,5515,5754
51047,Culpeper County,,VA,3741,47591,51332
51049,Cumberland County,,VA,706,9811,10517
51051,Dickenson County,,VA,639,14625,15264
51053,Dinwiddie County,,VA,2115,29092,31207
51057,Essex County,,VA,736,11829,12565
51059,Fairfax County,,VA,116710,1132378,1249088
51061,Fauquier County,,VA,5630,69497,75127
51063,Floyd County,,VA,808,15951,16759
51065,Fluvanna County,,VA,2080,25898,27978
51067,Franklin County,,VA,2670,57596,60266
51069,Frederick County,,VA,6600,83239,89839
51071,Giles County,,VA,1015,19234,20249
51073,Gloucester County,,VA,2683,41536,44219
51075,Goochland County,,VA,1497,21118,22615
51077,Grayson County,,VA,702,16547,17249
51079,Greene County,,VA,1561,19589,21150
51081,Greensville County,,VA,561,8852,9413
51083,Halifax County,,VA,1495,38716,40211
51085,Hanover County,,VA,7409,112293,119702
51087,Henrico County,,VA,29230,322975,352205
51089,Henry County,,VA,2842,61336,64178
51091,Highland County,,VA,128,2731,2859
51093,Isle of Wight County,,VA,2997,38573,41570
51095,James City County,,VA,6125,68052,74177
51097,King and Queen County,,VA,572,6847,7419
51099,King George County,,VA,2764,23616,26380
51101,King William County,,VA,1085,18005,19090
51103,Lancaster County,,VA,604,13415,14019
51105,Lee County,,VA,857,21402,22259
51107,Loudoun County,,VA,29427,305739,335166
51109,Louisa County,,VA,2143,33072,35215
51111,Lunenburg County,,VA,726,11755,12481
51113,Madison County,,VA,810,13778,14588
51115,Mathews County,,VA,556,9795,10351
51117,Mecklenburg County,,VA,1689,33320,35009
51119,Middlesex County,,VA,801,11284,12085
51121,Montgomery County,,VA,7616,73227,80843
51125,Nelson County,,VA,1070,16491,17561
51127,New Kent County,,VA,1335,18749,20084
51131,Northampton County,,VA,747,13737,14484
51133,Northumberland County,,VA,772,13398,14170
51135,Nottoway County,,VA,939,15085,16024
51137,Orange County,,VA,2769,35288,38057
51139,Page County,,VA,1133,27092,28225
51141,Patrick County,,VA,891,19203,20094
51143,Pittsylvania County,,VA,3630,70399,74029
51145,Powhatan County,,VA,1868,28414,30282
51147,Prince Edward County,,VA,1304,17679,18983
51149,Prince George County,,VA,4960,32374,37334
51153,Prince William County,,VA,48969,403232,452201
51155,Pulaski County,,VA,1930,36480,38410
51157,Rappahannock County,,VA,582,8061,8643
51159,Richmond County,,VA,547,8254,8801
51161,Roanoke County,,VA,8535,104463,112998
51163,Rockbridge County,,VA,1309,23296,24605
51165,Rockingham County,,VA,4543,85674,90217
51167,Russell County,,VA,995,26623,27618
51169,Scott County,,VA,1005,23395,24400
51171,Shenandoah County,,VA,2700,46544,49244
51173,Smyth County,,VA,1435,35037,36472
51175,Southampton County,,VA,1170,18287,19457
51177,Spotsylvania County,,VA,13280,129742,143022
51179,Stafford County,,VA,16613,128279,144892
51181,Surry County,,VA,521,7362,7883
51183,Sussex County,,VA,836,10932,11768
51185,Tazewell County,,VA,2159,43709,45868
51187,Warren County,,VA,3122,40541,43663
51191,Washington County,,VA,2870,55154,58024
51193,Westmoreland County,,VA,1298,18120,19418
51195,Wise County,,VA,1716,38689,40405
51197,Wythe County,,VA,1592,31512,33104
51199,York County,,VA,10082,70174,80256
51510,Alexandria city,,VA,30364,132255,162619
51515,Bedford city,,VA,553,6755,7308
51520,Bristol city,,VA,1840,16291,18131
51530,Buena Vista city,,VA,655,6712,7367
51540,Charlottesville city,,VA,6173,34282,40455
51550,Chesapeake city,,VA,27001,233550,260551
51570,Colonial Heights city,,VA,2561,19801,22362
51580,Covington city,,VA,368,7078,7446
51590,Danville city,,VA,3250,45891,49141
51595,Emporia city,,VA,495,6235,6730
51600,Fairfax city,,VA,4423,24840,29263
51610,Falls Church city,,VA,1792,11247,13039
51620,Franklin city,,VA,818,9182,10000
51630,Fredericksburg city,,VA,4891,18187,23078
51640,Galax city,,VA,558,7647,8205
51650,Hampton city,,VA,21136,140112,161248
51660,Harrisonburg city,,VA,4473,31553,36026
51670,Hopewell city,,VA,2802,23512,26314
51678,Lexington city,,VA,683,5483,6166
51680,Lynchburg city,,VA,6175,64783,70958
51683,Manassas city,,VA,7559,38795,46354
51685,Manassas Park city,,VA,2973,13062,16035
51690,Martinsville city,,VA,1383,14687,16070
51700,Newport News city,,VA,29433,183446,212879
51710,Norfolk city,,VA,37063,213099,250162
51720,Norton city,,VA,426,4025,4451
51730,Petersburg city,,VA,4186,32543,36729
51735,Poquoson city,,VA,1157,13948,15105
51740,Portsmouth city,,VA,13891,100752,114643
51750,Radford city,,VA,1673,10165,11838
51760,Richmond city,,VA,23050,174858,197908
51770,Roanoke city,,VA,9932,97084,107016
51775,Salem city,,VA,2700,26151,28851
51790,Staunton city,,VA,2127,24857,26984
51800,Suffolk city,,VA,8856,85070,93926
51810,Virginia Beach city,,VA,59166,472305,531471
51820,Waynesboro city,,VA,2255,23024,25279
51830,Williamsburg city,,VA,1651,8746,10397
51840,Winchester city,,VA,4327,25647,29974
53001,Adams County,,WA,1225,18362,19587
53003,Asotin County,,WA,2048,21221,23269
53005,Benton County,,WA,12908,171419,184327
53007,Chelan County,,WA,5993,74478,80471
53009,Clallam County,,WA,3886,74480,78366
53011,Clark County,,WA,24917,437715,462632
53013,Columbia County,,WA,333,3973,4306
53015,Cowlitz County,,WA,5628,105462,111090
53017,Douglas County,,WA,3688,35098,38786
53019,Ferry County,,WA,650,6225,6875
53021,Franklin County,,WA,5882,68355,74237
53023,Garfield County,,WA,211,2236,2447
53025,Grant County,,WA,4997,84857,89854
53027,Grays Harbor County,,WA,4152,69960,74112
53029,Island County,,WA,10418,82887,93305
53031,Jefferson County,,WA,2159,30935,33094
53033,King County,,WA,126325,2005135,2131460
53035,Kitsap County,,WA,23912,262515,286427
53037,Kittitas County,,WA,3227,33493,36720
53039,Klickitat County,,WA,1498,19790,21288
53041,Lewis County,,WA,4796,75971,80767
53043,Lincoln County,,WA,888,11015,11903
53045,Mason County,,WA,4250,58270,62520
53047,Okanogan County,,WA,2317,40204,42521
53049,Pacific County,,WA,1512,21143,22655
53051,Pend Oreille County,,WA,1019,12488,13507
53053,Pierce County,,WA,66655,819093,885748
53055,San Juan County,,WA,1019,15770,16789
53057,Skagit County,,WA,7717,121204,128921
53059,Skamania County,,WA,702,10348,11050
53061,Snohomish County,,WA,48719,735712,784431
53063,Spokane County,,WA,24691,481612,506303
53065,Stevens County,,WA,3055,42952,46007
53067,Thurston County,,WA,19544,255931,275475
53069,Wahkiakum County,,WA,257,4057,4314
53071,Walla Walla County,,WA,4095,56825,60920
53073,Whatcom County,,WA,11471,197116,208587
53075,Whitman County,,WA,4819,33502,38321
53077,Yakima County,,WA,10549,247162,257711
54001,Barbour County,,WV,789,16010,16799
54003,Berkeley County,,WV,6553,108663,115216
54005,Boone County,,WV,1040,24872,25912
54007,Braxton County,,WV,594,13097,13691
54009,Brooke County,,WV,1283,27511,28794
54011,Cabell County,,WV,5923,94151,100074
54013,Calhoun County,,WV,345,7141,7486
54015,Clay County,,WV,502,9299,9801
54017,Doddridge County,,WV,257,5182,5439
54019,Fayette County,,WV,2262,44255,46517
54021,Gilmer County,,WV,414,5983,6397
54023,Grant County,,WV,611,13348,13959
54025,Greenbrier County,,WV,1556,36228,37784
54027,Hampshire County,,WV,1153,24790,25943
54029,Hancock County,,WV,1903,36653,38556
54031,Hardy County,,WV,762,15135,15897
54033,Harrison County,,WV,3342,76035,79377
54035,Jackson County,,WV,1266,30891,32157
54037,Jefferson County,,WV,4051,54958,59009
54039,Kanawha County,,WV,9423,212772,222195
54041,Lewis County,,WV,863,19088,19951
54043,Lincoln County,,WV,1193,21144,22337
54045,Logan County,,WV,1279,35857,37136
54047,McDowell County,,WV,972,17614,18586
54049,Marion County,,WV,2651,61098,63749
54051,Marshall County,,WV,1467,36600,38067
54053,Mason County,,WV,1053,26557,27610
54055,Mercer County,,WV,2707,61778,64485
54057,Mineral County,,WV,1330,31342,32672
54059,Mingo County,,WV,974,24971,25945
54061,Monongalia County,,WV,6163,79072,85235
54063,Monroe County,,WV,501,13040,13541
54065,Morgan County,,WV,957,18348,19305
54067,Nicholas County,,WV,1184,26982,28166
54069,Ohio County,,WV,2636,50473,53109
54071,Pendleton County,,WV,590,8833,9423
54073,Pleasants County,,WV,421,8292,8713
54075,Pocahontas County,,WV,472,9187,9659
54077,Preston County,,WV,1341,33662,35003
54079,Putnam County,,WV,3923,60935,64858
54081,Raleigh County,,WV,3382,78419,81801
54083,Randolph County,,WV,1318,30787,32105
54085,Ritchie County,,WV,612,11988,12600
54087,Roane County,,WV,877,15097,15974
54089,Summers County,,WV,594,11393,11987
54091,Taylor County,,WV,920,17238,18158
54093,Tucker County,,WV,366,7779,8145
54095,Tyler County,,WV,595,9597,10192
54097,Upshur County,,WV,1150,23919,25069
54099,Wayne County,,WV,2100,41025,43125
54101,Webster County,,WV,358,8818,9176
54103,Wetzel County,,WV,941,18806,19747
54105,Wirt County,,WV,358,5587,5945
54107,Wood County,,WV,4054,96530,100584
54109,Wyoming County,,WV,897,22120,23017
55001,Adams County,,WI,1575,21868,23443
55003,Ashland County,,WI,1062,18460,19522
55005,Barron County,,WI,3166,55148,58314
55007,Bayfield County,,WI,939,17586,18525
55009,Brown County,,WI,13229,295897,309126
55011,Buffalo County,,WI,954,16846,17800
55013,Burnett County,,WI,938,18362,19300
55015,Calumet County,,WI,3889,54398,58287
55017,Chippewa County,,WI,3939,70968,74907
55019,Clark County,,WI,2095,39850,41945
55021,Columbia County,,WI,4701,69410,74111
55023,Crawford County,,WI,1164,19357,20521
55025,Dane County,,WI,31024,554988,586012
55027,Dodge County,,WI,6572,103062,109634
55029,Door County,,WI,1771,34826,36597
55031,Douglas County,,WI,2539,48939,51478
55033,Dunn County,,WI,3178,43993,47171
55035,Eau Claire County,,WI,7220,105153,112373
55037,Florence County,,WI,400,5461,5861
55039,Fond du Lac County,,WI,5488,123388,128876
55041,Forest County,,WI,527,10552,11079
55043,Grant County,,WI,2874,57396,60270
55045,Green County,,WI,2444,44406,46850
55047,Green Lake County,,WI,1505,23354,24859
55049,Iowa County,,WI,1816,28367,30183
55051,Iron County,,WI,358,7161,7519
55053,Jackson County,,WI,1206,22373,23579
55055,Jefferson County,,WI,6194,94510,100704
55057,Juneau County,,WI,1993,29304,31297
55059,Kenosha County,,WI,11295,186047,197342
55061,Kewaunee County,,WI,1267,25399,26666
55063,La Crosse County,,WI,6890,123054,129944
55065,Lafayette County,,WI,1146,20292,21438
55067,Langlade County,,WI,1042,24109,25151
55069,Lincoln County,,WI,1652,36046,37698
55071,Manitowoc County,,WI,3876,101899,105775
55073,Marathon County,,WI,6770,160626,167396
55075,Marinette County,,WI,2865,49929,52794
55077,Marquette County,,WI,1397,18195,19592
55078,Menominee County,,WI,388,4427,4815
55079,Milwaukee County,,WI,52131,1032275,1084406
55081,Monroe County,,WI,3032,50588,53620
55083,Oconto County,,WI,2545,45236,47781
55085,Oneida County,,WI,2726,46139,48865
55087,Outagamie County,,WI,13162,216387,229549
55089,Ozaukee County,,WI,6313,104529,110842
55091,Pepin County,,WI,520,8500,9020
55093,Pierce County,,WI,2917,44820,47737
55095,Polk County,,WI,2804,52435,55239
55097,Portage County,,WI,4024,77354,81378
55099,Price County,,WI,1047,18001,19048
55101,Racine County,,WI,11527,231908,243435
55103,Richland County,,WI,1261,20079,21340
55105,Rock County,,WI,8477,189210,197687
55107,Rusk County,,WI,960,17134,18094
55109,St. Croix County,,WI,5616,95616,101232
55111,Sauk County,,WI,4307,74020,78327
55113,Sawyer County,,WI,1095,19784,20879
55115,Shawano County,,WI,2592,48247,50839
55117,Sheboygan County,,WI,5692,144407,150099
55119,Taylor County,,WI,1145,23010,24155
55121,Trempealeau County,,WI,1921,35488,37409
55123,Vernon County,,WI,1825,33169,34994
55125,Vilas County,,WI,1583,25471,27054
55127,Walworth County,,WI,7192,113829,121021
55129,Washburn County,,WI,1218,18941,20159
55131,Washington County,,WI,8612,160608,169220
55133,Waukesha County,,WI,26156,475896,502052
55135,Waupaca County,,WI,2962,60880,63842
55137,Waushara County,,WI,1619,26670,28289
55139,Winnebago County,,WI,11787,188711,200498
55141,Wood County,,WI,4609,91545,96154
56001,Albany County,,WY,4591,29364,33955
56003,Big Horn County,,WY,795,11769,12564
56005,Campbell County,,WY,3358,44797,48155
56007,Carbon County,,WY,1490,16241,17731
56009,Converse County,,WY,1257,14431,15688
56011,Crook County,,WY,523,7056,7579
56013,Fremont County,,WY,2438,40601,43039
56015,Goshen County,,WY,859,12533,13392
56017,Hot Springs County,,WY,369,5034,5403
56019,Johnson County,,WY,655,8117,8772
56021,Laramie County,,WY,8346,98153,106499
56023,Lincoln County,,WY,1550,17990,19540
56025,Natrona County,,WY,4963,78810,83773
56027,Niobrara County,,WY,212,2494,2706
56029,Park County,,WY,2199,31045,33244
56031,Platte County,,WY,778,9573,10351
56033,Sheridan County,,WY,2311,30578,32889
56035,Sublette County,,WY,751,7837,8588
56037,Sweetwater County,,WY,3611,45838,49449
56039,Teton County,,WY,2547,21924,24471
56041,Uinta County,,WY,1791,22496,24287
56043,Washakie County,,WY,612,9236,9848
56045,Weston County,,WY,499,7400,7899
2198,Prince Of Wales Oute,,AK,489,4704,5193
2230,Skagway Hoonah Ango,,AK,318,3351,3669
2275,Wrangell Peters,,AK,2262,4721,6983
