Id,Label,timeset,state,totalmig,totalnonmig,population,indegree,outdegree,Degree,weighted indegree,weighted outdegree,Weighted Degree,Eccentricity,closnesscentrality,harmonicclosnesscentrality,betweenesscentrality,Authority,Hub,modularity_class,pageranks,componentnumber,strongcompnum,clustering,eigencentrality
1001,Autauga County,,AL,5956,52323,58279,20,13,33,4165,3278,7443,6,0.338411,0.358522,1246.190874,0.006101,0.005025,0,0.000326,0,20,0.506494,0.047455
1003,Baldwin County,,AL,10504,162590,173094,62,39,101,9443,5167,14610,6,0.362843,0.389267,12429.340859,0.020495,0.013548,0,0.000911,0,20,0.364237,0.151802
1005,Barbour County,,AL,1782,26165,27947,9,9,18,622,994,1616,7,0.281241,0.294388,5984.008385,0.000431,0.000431,0,0.000281,0,20,0.388889,0.00401
1007,Bibb County,,AL,1460,21080,22540,4,4,8,951,992,1943,7,0.286389,0.298749,0,0.000487,0.000576,0,0.000124,0,20,1,0.004734
1009,Blount County,,AL,3265,53243,56508,7,10,17,2824,2357,5181,7,0.288233,0.301991,4.248992,0.00047,0.001052,0,0.000182,0,20,0.755556,0.004906
1011,Bullock County,,AL,557,8278,8835,3,3,6,179,263,442,7,0.279458,0.291192,1.142857,0.00025,0.000243,0,0.000108,0,20,0.666667,0.002097
1013,Butler County,,AL,1148,21852,23000,4,6,10,313,515,828,7,0.2797,0.292023,4.678828,0.000253,0.000455,0,0.000125,0,20,0.5,0.00225
1015,Calhoun County,,AL,6614,122392,129006,26,23,49,3617,3724,7341,6,0.312836,0.331695,10399.606724,0.005239,0.003818,0,0.00052,0,20,0.389247,0.038176
1017,Chambers County,,AL,2419,38883,41302,4,7,11,1191,1609,2800,6,0.305769,0.320848,100.144048,0.000116,0.001147,0,0.000132,0,20,0.52381,0.001207
1019,Cherokee County,,AL,1355,24385,25740,7,5,12,863,794,1657,7,0.240238,0.249498,65.908431,0.00016,0.000093,0,0.000213,0,20,0.380952,0.00309
1021,Chilton County,,AL,2330,41659,43989,8,9,17,1444,1547,2991,7,0.290564,0.304264,13.199982,0.000789,0.000897,0,0.000207,0,20,0.694444,0.007472
1023,Choctaw County,,AL,643,15051,15694,1,2,3,61,172,233,7,0.264377,0.274878,6.617125,0.000006,0.000101,0,0.000072,0,20,0.5,0.000127
1025,Clarke County,,AL,1287,29692,30979,5,7,12,575,628,1203,7,0.286615,0.299774,22.983749,0.000246,0.000643,0,0.000153,0,20,0.571429,0.002269
1027,Clay County,,AL,921,15327,16248,4,5,9,386,542,928,7,0.238485,0.246955,5.221127,0.000047,0.000057,0,0.000135,0,20,0.5,0.000853
1029,Cleburne County,,AL,900,14181,15081,5,4,9,625,501,1126,7,0.240934,0.250186,6.70577,0.000095,0.00011,0,0.00016,0,20,0.5,0.001417
1031,Coffee County,,AL,5250,44785,50035,15,17,32,2604,2519,5123,6,0.320026,0.338677,1179.753172,0.003959,0.003661,0,0.000262,0,20,0.430952,0.028455
1033,Colbert County,,AL,3258,58550,61808,8,8,16,2072,2097,4169,7,0.288319,0.30175,1380.844548,0.000294,0.000759,0,0.00023,0,20,0.541667,0.003902
1035,Conecuh County,,AL,749,14247,14996,5,4,9,521,406,927,7,0.279485,0.291364,0.667832,0.000374,0.000263,0,0.000148,0,20,0.85,0.00367
1037,Coosa County,,AL,1068,11588,12656,5,5,10,727,796,1523,7,0.290245,0.303234,246.365043,0.00027,0.000619,0,0.000151,0,20,0.733333,0.002542
1039,Covington County,,AL,1972,37075,39047,12,11,23,1134,1029,2163,6,0.29385,0.30866,234.562783,0.001014,0.000973,0,0.000277,0,20,0.423077,0.009458
1041,Crenshaw County,,AL,896,14202,15098,6,6,12,586,531,1117,7,0.280212,0.292464,5.48615,0.000299,0.0003,0,0.000166,0,20,0.533333,0.002848
1043,Cullman County,,AL,3775,81930,85705,11,13,24,2101,2324,4425,7,0.288547,0.302878,38.717372,0.00078,0.001147,0,0.000254,0,20,0.587912,0.008414
1045,Dale County,,AL,7738,47409,55147,22,24,46,3421,4300,7721,6,0.33704,0.359404,5959.163255,0.005433,0.007711,0,0.00035,0,20,0.508046,0.040759
1047,Dallas County,,AL,2440,44887,47327,10,12,22,886,1406,2292,7,0.293258,0.308079,159.385913,0.001355,0.001466,0,0.000229,0,20,0.489011,0.009927
1049,DeKalb County,,AL,3539,68392,71931,11,9,20,2075,2113,4188,7,0.289985,0.304138,435.630109,0.000832,0.000976,0,0.000292,0,20,0.463636,0.008579
1051,Elmore County,,AL,6619,75724,82343,21,14,35,5547,4236,9783,6,0.297242,0.313133,354.775261,0.00253,0.001654,0,0.000407,0,20,0.454762,0.020434
1053,Escambia County,,AL,2107,36676,38783,10,9,19,1236,1197,2433,7,0.296576,0.311447,77.714229,0.001899,0.001598,0,0.000216,0,20,0.688889,0.015129
1055,Etowah County,,AL,5089,107597,112686,13,14,27,3081,3149,6230,7,0.292492,0.307604,420.766639,0.00108,0.001388,0,0.000315,0,20,0.566667,0.011245
1057,Fayette County,,AL,1056,17899,18955,4,4,8,447,633,1080,7,0.258437,0.268478,21.14956,0.000068,0.000072,0,0.000134,0,20,0.75,0.000949
1059,Franklin County,,AL,1744,30906,32650,10,8,18,1059,1037,2096,7,0.279432,0.291891,3370.005085,0.002037,0.000391,0,0.000248,0,20,0.354545,0.015456
1061,Geneva County,,AL,1871,25127,26998,6,6,12,1210,1224,2434,7,0.274347,0.28675,8.112304,0.000142,0.000382,0,0.000163,0,20,0.571429,0.001971
1063,Greene County,,AL,762,9494,10256,1,2,3,103,421,524,7,0.258185,0.267762,0,0.000055,0.000066,0,0.000073,0,20,1,0.000564
1065,Hale County,,AL,1093,17445,18538,3,3,6,650,704,1354,7,0.258208,0.267934,0.326923,0.000064,0.000069,0,0.000118,0,20,0.833333,0.000809
1067,Henry County,,AL,1305,17198,18503,3,3,6,867,822,1689,7,0.253882,0.263678,0,0.00009,0.000102,0,0.000109,0,20,1,0.00105
1069,Houston County,,AL,6811,99456,106267,29,23,52,4554,3900,8454,6,0.312601,0.331896,13575.757784,0.007269,0.003477,0,0.000536,0,20,0.387311,0.051016
1071,Jackson County,,AL,2576,56678,59254,8,6,14,1512,1479,2991,7,0.282634,0.29529,126.119861,0.000796,0.000578,0,0.000223,0,20,0.607143,0.007912
1073,Jefferson County,,AL,38103,699686,737789,127,103,230,27152,30405,57557,6,0.400551,0.435596,86700.623029,0.045118,0.041364,0,0.001848,0,20,0.329038,0.338741
1075,Lamar County,,AL,972,15825,16797,5,6,11,404,639,1043,7,0.266313,0.277618,54.953835,0.000045,0.000103,0,0.000172,0,20,0.466667,0.000763
1077,Lauderdale County,,AL,4599,93169,97768,15,15,30,2589,2737,5326,6,0.305287,0.320785,3842.81533,0.001309,0.002102,0,0.000382,0,20,0.362745,0.014099
1079,Lawrence County,,AL,1987,36373,38360,5,6,11,1064,1409,2473,7,0.279163,0.291175,4.201176,0.000287,0.000405,0,0.000159,0,20,0.766667,0.003492
1081,Lee County,,AL,10353,115071,125424,35,36,71,7483,6441,13924,6,0.353456,0.379124,9341.318935,0.00817,0.010077,0,0.000605,0,20,0.357143,0.060284
1083,Limestone County,,AL,4044,74529,78573,10,9,19,3457,2511,5968,7,0.288347,0.301951,83.354363,0.001285,0.000759,0,0.000243,0,20,0.472727,0.01248
1085,Lowndes County,,AL,1133,13737,14870,3,5,8,579,915,1494,7,0.279485,0.291478,1.344444,0.000256,0.000315,0,0.000098,0,20,0.7,0.002136
1087,Macon County,,AL,1510,21545,23055,4,6,10,638,907,1545,7,0.290361,0.303577,3.137673,0.000338,0.000677,0,0.000123,0,20,0.733333,0.002861
1089,Madison County,,AL,17885,337272,355157,113,74,187,14565,11172,25737,6,0.386249,0.418064,43925.195952,0.044085,0.031432,0,0.00156,0,20,0.360317,0.327056
1091,Marengo County,,AL,1284,22791,24075,8,9,17,536,695,1231,7,0.290709,0.304494,3380.461072,0.000392,0.000825,0,0.000232,0,20,0.333333,0.003956
1093,Marion County,,AL,1549,29041,30590,8,9,17,884,871,1755,7,0.286954,0.300255,1056.758276,0.000393,0.00045,0,0.000228,0,20,0.366667,0.004107
1095,Marshall County,,AL,5239,90405,95644,12,13,25,3468,3657,7125,7,0.288948,0.303623,51.752739,0.000868,0.001087,0,0.000291,0,20,0.604762,0.009657
1097,Mobile County,,AL,17082,410069,427151,74,68,142,11623,9911,21534,6,0.387535,0.418895,30326.640633,0.030102,0.028939,0,0.000981,0,20,0.405877,0.213907
1099,Monroe County,,AL,1280,24838,26118,7,7,14,523,653,1176,7,0.292051,0.305599,40.845083,0.000594,0.000998,0,0.000186,0,20,0.625,0.00548
1101,Montgomery County,,AL,18260,239249,257509,92,84,176,13881,13063,26944,6,0.387587,0.420785,67957.324559,0.030417,0.031046,0,0.001358,0,20,0.327632,0.222754
1103,Morgan County,,AL,6690,125601,132291,18,17,35,4182,3989,8171,6,0.30638,0.322388,881.028404,0.003695,0.002268,0,0.000359,0,20,0.445238,0.025084
1105,Perry County,,AL,663,10731,11394,4,5,9,235,348,583,7,0.286446,0.298978,149.091635,0.000387,0.000427,0,0.000137,0,20,0.75,0.003581
1107,Pickens County,,AL,1051,20701,21752,3,3,6,544,628,1172,7,0.266045,0.276673,18.872389,0.000095,0.000094,0,0.000112,0,20,0.833333,0.000962
1109,Pike County,,AL,2020,27741,29761,8,7,15,837,966,1803,7,0.291437,0.304906,49.358148,0.000442,0.000721,0,0.000204,0,20,0.555556,0.00402
1111,Randolph County,,AL,1296,22489,23785,8,7,15,672,693,1365,7,0.261903,0.273088,109.278704,0.000252,0.000201,0,0.000219,0,20,0.428571,0.003303
1113,Russell County,,AL,5619,50150,55769,12,9,21,4117,3751,7868,6,0.309344,0.325968,410.913128,0.00353,0.002184,0,0.000198,0,20,0.471429,0.018367
1115,St. Clair County,,AL,4761,73650,78411,15,9,24,5851,3158,9009,7,0.288662,0.302432,26.480287,0.001223,0.001022,0,0.000313,0,20,0.642857,0.012402
1117,Shelby County,,AL,14902,182832,197734,57,43,100,15752,10496,26248,6,0.362662,0.389399,10241.092557,0.020288,0.013496,0,0.000855,0,20,0.411162,0.149556
1119,Sumter County,,AL,845,13544,14389,3,4,7,190,376,566,7,0.287266,0.299912,13.604927,0.000862,0.000454,0,0.000089,0,20,0.55,0.001826
1121,Talladega County,,AL,4821,83297,88118,11,12,23,2860,3146,6006,7,0.292286,0.307002,774.497415,0.000859,0.001216,0,0.000269,0,20,0.538462,0.008183
1123,Tallapoosa County,,AL,2454,43123,45577,10,10,20,1430,1549,2979,7,0.290564,0.304436,666.948734,0.000787,0.000839,0,0.000236,0,20,0.511111,0.007309
1125,Tuscaloosa County,,AL,9516,174115,183631,46,33,79,7224,5431,12655,6,0.347836,0.372497,29520.261426,0.008068,0.007031,0,0.000867,0,20,0.259309,0.054777
1127,Walker County,,AL,3351,67847,71198,9,12,21,1838,2181,4019,7,0.28849,0.302678,339.093767,0.000749,0.001126,0,0.000222,0,20,0.590909,0.007864
1129,Washington County,,AL,1024,18024,19048,4,4,8,466,647,1113,7,0.280131,0.291882,38.686796,0.000336,0.000398,0,0.000126,0,20,0.416667,0.003272
1131,Wilcox County,,AL,720,12701,13421,5,6,11,274,369,643,7,0.286502,0.299459,39.153642,0.000585,0.00049,0,0.000136,0,20,0.642857,0.005013
1133,Winston County,,AL,1384,24331,25715,6,8,14,859,908,1767,7,0.286841,0.29994,18.042815,0.000363,0.000482,0,0.000164,0,20,0.660714,0.003714
2013,Aleutians East Borough,,AK,346,1604,1950,0,2,2,0,87,87,6,0.313213,0.327717,0,0,0.001167,6,0.00005,0,21,1,0
2016,Aleutians West Census Area,,AK,896,4135,5031,3,3,6,160,248,408,6,0.313814,0.328832,0.402371,0.001782,0.001347,6,0.000085,0,20,0.833333,0.01432
2020,Anchorage Municipality,,AK,28310,293149,321459,141,128,269,18170,18282,36452,6,0.39727,0.435624,88358.482644,0.042263,0.043369,6,0.002096,0,20,0.261713,0.323447
2050,Bethel Census Area,,AK,1143,16884,18027,2,5,7,296,681,977,7,0.285322,0.298468,0.25,0.00034,0.0005,6,0.000081,0,20,0.8,0.002772
2060,Bristol Bay Borough,,AK,200,1227,1427,0,0,0,0,0,0,0,0,0,0,0,0,1,0.00005,1,22,0,0
2068,Denali Borough,,AK,328,2149,2477,1,2,3,63,107,170,7,0.285238,0.297953,0,0.00014,0.000438,6,0.000063,0,20,1,0.000975
2070,Dillingham Census Area,,AK,414,4652,5066,1,1,2,83,137,220,7,0.284346,0.296956,0,0.000337,0.000328,6,0.000064,0,20,0,0.002665
2090,Fairbanks North Star Borough,,AK,12669,95627,108296,46,47,93,4428,5224,9652,6,0.364388,0.392302,12337.96235,0.014215,0.01802,6,0.000704,0,20,0.369209,0.111363
2100,Haines Borough,,AK,240,2551,2791,0,1,1,0,41,41,7,0.251447,0.259184,0,0,0.00001,6,0.00005,0,23,0,0
2105,Hoonah-Angoon Census Area,,AK,0,0,0,0,0,0,0,0,0,0,0,0,0,0,0,2,0.00005,2,24,0,0
2110,Juneau City and Borough,,AK,3014,34628,37642,10,14,24,729,1200,1929,6,0.335795,0.355183,13716.924858,0.001274,0.003456,6,0.000343,0,20,0.342857,0.011012
2122,Kenai Peninsula Borough,,AK,4156,54066,58222,10,9,19,1647,1623,3270,6,0.336845,0.356014,486.710244,0.002409,0.003945,6,0.000215,0,20,0.560606,0.020569
2130,Ketchikan Gateway Borough,,AK,1383,14698,16081,5,4,9,274,303,577,6,0.313341,0.328173,4353.139172,0.001094,0.001177,6,0.000211,0,20,0.5,0.009186
2150,Kodiak Island Borough,,AK,1870,14712,16582,3,7,10,211,632,843,6,0.31957,0.335911,12.365506,0.002102,0.002129,6,0.000081,0,20,0.583333,0.015631
2164,Lake and Peninsula Borough,,AK,149,1493,1642,0,1,1,0,54,54,7,0.284388,0.297026,0,0,0.000328,6,0.00005,0,25,0,0
2170,Matanuska-Susitna Borough,,AK,5292,75260,80552,17,9,26,5447,2241,7688,6,0.335601,0.354324,741.691626,0.00522,0.003283,6,0.000299,0,20,0.496732,0.042579
2180,Nome Census Area,,AK,688,8947,9635,1,1,2,85,253,338,7,0.284346,0.296956,0,0.000337,0.000328,6,0.000064,0,20,0,0.002665
2185,North Slope Borough,,AK,663,6723,7386,1,2,3,61,307,368,7,0.285238,0.297953,0,0.000337,0.000438,6,0.000064,0,20,1,0.002665
2188,Northwest Arctic Borough,,AK,481,6305,6786,1,1,2,116,150,266,7,0.284346,0.296956,0,0.000337,0.000328,6,0.000064,0,20,0,0.002665
2195,Petersburg Census Area,,AK,0,0,0,0,0,0,0,0,0,0,0,0,0,0,0,3,0.00005,3,26,0,0
2220,Sitka City and Borough,,AK,1046,9842,10888,3,2,5,178,169,347,7,0.284457,0.2973,0,0.000366,0.000338,6,0.0001,0,20,0.833333,0.002934
2240,Southeast Fairbanks Census Area,,AK,734,7321,8055,2,3,5,257,330,587,7,0.285266,0.298125,0,0.000476,0.000479,6,0.000077,0,20,1,0.003639
2261,Valdez-Cordova Census Area,,AK,1247,10657,11904,4,4,8,328,485,813,7,0.285294,0.298297,0,0.000532,0.000497,6,0.000125,0,20,1,0.004321
2270,Wade Hampton Census Area,,AK,486,7001,7487,2,4,6,149,327,476,7,0.285294,0.298297,0,0.00034,0.000481,6,0.000078,0,20,0.833333,0.002772
2282,Yakutat City and Borough,,AK,65,557,622,0,0,0,0,0,0,0,0,0,0,0,0,4,0.00005,4,27,0,0
2290,Yukon-Koyukuk Census Area,,AK,701,5883,6584,2,2,4,181,364,545,7,0.285238,0.297953,0,0.000476,0.000438,6,0.000077,0,20,1,0.003639
4001,Apache County,,AZ,6634,57881,64515,14,13,27,5805,5401,11206,6,0.33456,0.353963,155.401608,0.005064,0.00412,6,0.000252,0,20,0.654412,0.043761
4003,Cochise County,,AZ,13504,119277,132781,48,44,92,7241,7404,14645,6,0.361087,0.388373,1074.205567,0.021831,0.018679,6,0.000589,0,20,0.537281,0.167714
4005,Coconino County,,AZ,13216,121558,134774,30,34,64,8051,8964,17015,6,0.352471,0.376924,1895.724976,0.013107,0.014078,6,0.000429,0,20,0.607287,0.102134
4007,Gila County,,AZ,4016,49830,53846,15,8,23,3333,2592,5925,6,0.332192,0.350235,5.881899,0.007248,0.002602,6,0.000243,0,20,0.841667,0.05716
4009,Graham County,,AZ,1807,25844,27651,8,7,15,1362,1062,2424,6,0.332306,0.350235,44.421267,0.001985,0.002125,6,0.000194,0,20,0.763889,0.019236
4011,Greenlee County,,AZ,637,7189,7826,4,4,8,357,368,725,6,0.331964,0.349433,0.85119,0.000708,0.001991,6,0.000123,0,20,0.75,0.007227
4012,La Paz County,,AZ,1529,14375,15904,5,6,11,574,704,1278,6,0.333524,0.351684,0,0.003503,0.002797,6,0.000096,0,20,1,0.026062
4013,Maricopa County,,AZ,179566,3576737,3756303,639,552,1191,224956,157238,382194,5,0.496333,0.562423,897388.348179,0.137811,0.128978,6,0.00816,0,20,0.079973,1
4015,Mohave County,,AZ,13823,171786,185609,51,38,89,13844,7716,21560,6,0.353928,0.3802,363.883986,0.020617,0.016478,6,0.000587,0,20,0.609322,0.155045
4017,Navajo County,,AZ,7606,92559,100165,20,19,39,7046,5490,12536,6,0.343525,0.364708,251.688058,0.007839,0.006702,6,0.000321,0,20,0.626482,0.062937
4019,Pima County,,AZ,47177,923799,970976,254,171,425,45018,33078,78096,5,0.425439,0.464908,48238.195773,0.09329,0.070726,6,0.002807,0,20,0.277491,0.656318
4021,Pinal County,,AZ,18296,192513,210809,85,26,111,39842,12719,52561,6,0.34913,0.372612,619.228339,0.037085,0.012023,6,0.000885,0,20,0.518809,0.263261
4023,Santa Cruz County,,AZ,2429,48353,50782,9,5,14,1748,1694,3442,6,0.337587,0.356094,0,0.006362,0.003232,6,0.000134,0,20,0.977778,0.047389
4025,Yavapai County,,AZ,13918,192748,206666,55,37,92,16026,7825,23851,6,0.35307,0.378969,933.432599,0.023533,0.015488,6,0.00064,0,20,0.555288,0.17644
4027,Yuma County,,AZ,11083,188616,199699,47,31,78,8748,5992,14740,6,0.352514,0.377612,165.773093,0.02109,0.015678,6,0.000518,0,20,0.650204,0.159944
5001,Arkansas County,,AR,1322,21288,22610,5,6,11,428,650,1078,7,0.28393,0.296874,5.073072,0.000327,0.00037,5,0.000154,0,20,0.633333,0.002893
5003,Ashley County,,AR,1278,23272,24550,5,7,12,322,498,820,7,0.285827,0.299629,135.975952,0.000308,0.000392,5,0.00014,0,20,0.357143,0.002671
5005,Baxter County,,AR,2661,40376,43037,14,11,25,1217,984,2201,7,0.292963,0.307558,17372.461689,0.003203,0.000853,5,0.000367,0,20,0.333333,0.026015
5007,Benton County,,AR,14748,195193,209941,68,38,106,13729,8410,22139,6,0.371173,0.397978,24199.862196,0.024219,0.012986,5,0.001116,0,20,0.369914,0.179162
5009,Boone County,,AR,2522,36290,38812,9,12,21,1204,1412,2616,7,0.292668,0.307157,11305.340967,0.000399,0.00091,5,0.000364,0,20,0.325758,0.005365
5011,Bradley County,,AR,782,11429,12211,2,3,5,171,267,438,7,0.283875,0.296415,95.715036,0.000004,0.000269,5,0.000087,0,20,0.333333,0.000211
5013,Calhoun County,,AR,363,5310,5673,3,2,5,188,139,327,7,0.241694,0.248913,1.313585,0.000022,0.000012,5,0.000098,0,20,0.666667,0.000376
5015,Carroll County,,AR,1943,26073,28016,7,8,15,683,825,1508,7,0.281677,0.293875,219.509825,0.001283,0.000599,5,0.000225,0,20,0.597222,0.010949
5017,Chicot County,,AR,899,11602,12501,5,5,10,310,367,677,7,0.284096,0.29696,8.286206,0.000331,0.000303,5,0.000124,0,20,0.566667,0.002758
5019,Clark County,,AR,1806,20774,22580,9,7,16,656,815,1471,7,0.284847,0.298454,314.532029,0.000357,0.000531,5,0.00024,0,20,0.344444,0.003861
5021,Clay County,,AR,1232,16798,18030,5,6,11,545,778,1323,7,0.244066,0.253009,119.936583,0.000029,0.000027,5,0.000186,0,20,0.5,0.000729
5023,Cleburne County,,AR,1761,24796,26557,7,6,13,912,825,1737,7,0.283958,0.296931,94.231304,0.000927,0.000363,5,0.00022,0,20,0.690476,0.00797
5025,Cleveland County,,AR,687,8911,9598,3,4,7,309,358,667,7,0.254928,0.264154,251.697596,0.000036,0.000027,5,0.000102,0,20,0.25,0.000435
5027,Columbia County,,AR,1508,24025,25533,4,7,11,410,546,956,6,0.31772,0.333603,546.677758,0.000022,0.001089,5,0.000122,0,20,0.404762,0.000554
5029,Conway County,,AR,1365,20897,22262,5,5,10,820,840,1660,7,0.283958,0.296816,3.594877,0.000328,0.000346,5,0.000185,0,20,0.7,0.003205
5031,Craighead County,,AR,6187,86159,92346,27,25,52,4413,3801,8214,6,0.311697,0.329387,17662.038483,0.001976,0.001614,5,0.000649,0,20,0.221505,0.013177
5033,Crawford County,,AR,4464,58261,62725,12,11,23,3571,3036,6607,6,0.297851,0.312423,1118.746459,0.002397,0.001041,5,0.000302,0,20,0.456044,0.014757
5035,Crittenden County,,AR,3587,52320,55907,10,12,22,2028,2024,4052,6,0.338884,0.358975,1967.757518,0.002317,0.002764,130,0.000217,0,20,0.423077,0.010494
5037,Cross County,,AR,1715,19171,20886,5,7,12,600,900,1500,6,0.309706,0.324158,322.453083,0.000629,0.000926,5,0.000146,0,20,0.619048,0.005284
5039,Dallas County,,AR,633,8454,9087,2,6,8,128,343,471,7,0.284013,0.297045,103.715918,0.000009,0.000274,5,0.000091,0,20,0.366667,0.000208
5041,Desha County,,AR,1072,14333,15405,6,6,12,452,572,1024,7,0.283958,0.296931,267.668341,0.001093,0.000349,5,0.000138,0,20,0.571429,0.00368
5043,Drew County,,AR,1588,17838,19426,7,10,17,595,781,1376,7,0.285154,0.299285,3097.812274,0.000328,0.000508,5,0.000183,0,20,0.444444,0.002945
5045,Faulkner County,,AR,7344,97866,105210,35,23,58,6234,4457,10691,6,0.333524,0.355069,9019.269445,0.006983,0.004155,5,0.000735,0,20,0.275526,0.051303
5047,Franklin County,,AR,1255,17564,18819,6,5,11,771,718,1489,7,0.271531,0.282647,8.483814,0.000196,0.00023,5,0.000192,0,20,0.933333,0.002498
5049,Fulton County,,AR,909,10461,11370,5,5,10,359,454,813,8,0.226918,0.234392,468.090533,0.000011,0.000026,5,0.0002,0,20,0.35,0.000705
5051,Garland County,,AR,5809,93074,98883,31,23,54,3729,2874,6603,6,0.343728,0.366844,18922.602411,0.010651,0.006156,5,0.000606,0,20,0.387395,0.076442
5053,Grant County,,AR,1459,17974,19433,7,5,12,1005,838,1843,7,0.283958,0.296816,107.686502,0.000376,0.000411,5,0.0002,0,20,0.547619,0.003794
5055,Greene County,,AR,2111,40051,42162,8,9,17,1510,1178,2688,6,0.310102,0.32492,4538.595568,0.000308,0.000908,5,0.00025,0,20,0.458333,0.003098
5057,Hempstead County,,AR,1633,22562,24195,6,8,14,612,886,1498,7,0.285126,0.299084,8438.562892,0.000351,0.000479,136,0.000159,0,20,0.357143,0.003143
5059,Hot Spring County,,AR,2134,30619,32753,6,5,11,1374,1206,2580,7,0.283902,0.296702,1.020916,0.000377,0.00039,5,0.000195,0,20,0.833333,0.003743
5061,Howard County,,AR,1127,14556,15683,3,7,10,319,551,870,7,0.284319,0.297733,374.745848,0.000005,0.000339,136,0.000124,0,20,0.47619,0.000312
5063,Independence County,,AR,2296,36456,38752,9,10,19,1123,1266,2389,7,0.285154,0.299314,2162.316342,0.000347,0.000503,5,0.000329,0,20,0.433333,0.003674
5065,Izard County,,AR,988,11888,12876,4,5,9,316,436,752,8,0.226848,0.234231,61.297988,0.000011,0.000028,5,0.000174,0,20,0.4,0.000629
5067,Jackson County,,AR,1108,15903,17011,6,5,11,453,574,1027,7,0.28418,0.297189,1084.134659,0.000311,0.0003,5,0.000221,0,20,0.566667,0.00292
5069,Jefferson County,,AR,5353,81587,86940,16,22,38,2304,3195,5499,6,0.34171,0.363843,10829.08821,0.003057,0.004107,5,0.000358,0,20,0.356667,0.019684
5071,Johnson County,,AR,1486,23379,24865,5,7,12,604,765,1369,7,0.273548,0.285038,11.673211,0.000187,0.00044,5,0.00018,0,20,0.857143,0.002287
5073,Lafayette County,,AR,530,7262,7792,2,5,7,126,287,413,7,0.250905,0.26029,7.023101,0.000012,0.000086,136,0.000082,0,20,0.45,0.000213
5075,Lawrence County,,AR,1247,16447,17694,5,5,10,523,710,1233,7,0.237823,0.245695,8.402571,0.000022,0.00002,5,0.0002,0,20,0.5,0.000664
5077,Lee County,,AR,666,8461,9127,1,5,6,98,354,452,7,0.284987,0.298397,1.715587,0.000008,0.000437,5,0.000069,0,20,0.65,0.000155
5079,Lincoln County,,AR,790,11174,11964,3,4,7,296,446,742,7,0.283875,0.29653,0,0.000039,0.000301,5,0.000099,0,20,1,0.000497
5081,Little River County,,AR,841,13269,14110,4,3,7,372,442,814,7,0.25056,0.25926,31.235454,0.000066,0.000069,136,0.000147,0,20,0.666667,0.000907
5083,Logan County,,AR,1545,22530,24075,7,7,14,761,929,1690,7,0.271633,0.283105,32.514103,0.000074,0.000255,5,0.000237,0,20,0.625,0.001536
5085,Lonoke County,,AR,5944,62961,68905,19,13,32,4973,3573,8546,7,0.287464,0.302019,516.685014,0.002836,0.000856,5,0.000413,0,20,0.385714,0.019292
5087,Madison County,,AR,1060,14847,15907,3,3,6,814,710,1524,7,0.273239,0.283949,0,0.00023,0.000339,5,0.000119,0,20,1,0.00286
5089,Marion County,,AR,1338,15063,16401,2,2,4,471,465,936,8,0.226741,0.233544,0,0.000014,0.000028,5,0.000104,0,20,1,0.000443
5091,Miller County,,AR,4265,40048,44313,13,8,21,2972,2739,5711,6,0.319429,0.33571,6179.130499,0.002018,0.001466,136,0.00028,0,20,0.291209,0.011178
5093,Mississippi County,,AR,2963,48098,51061,8,10,18,919,1262,2181,6,0.310665,0.325922,2675.061557,0.000915,0.001116,5,0.000214,0,20,0.5,0.007632
5095,Monroe County,,AR,793,9035,9828,3,5,8,204,352,556,7,0.284152,0.297131,3.169481,0.000294,0.000313,5,0.000106,0,20,0.7,0.002428
5097,Montgomery County,,AR,571,8101,8672,2,2,4,215,186,401,7,0.255959,0.265164,1.208333,0.000048,0.000083,5,0.000097,0,20,0.5,0.0008
5099,Nevada County,,AR,811,9330,10141,1,4,5,211,385,596,7,0.250797,0.259918,0,0.000004,0.000074,136,0.000067,0,20,0.583333,0.000118
5101,Newton County,,AR,630,7877,8507,1,1,2,227,328,555,8,0.226424,0.232765,0,0.000007,0.000003,5,0.000076,0,20,0,0.00014
5103,Ouachita County,,AR,1922,27211,29133,6,8,14,544,838,1382,6,0.31772,0.333717,5003.310469,0.000309,0.001142,5,0.00018,0,20,0.428571,0.002736
5105,Perry County,,AR,907,9964,10871,4,4,8,513,529,1042,7,0.283819,0.296415,13.50276,0.000321,0.000358,5,0.000146,0,20,0.65,0.002915
5107,Phillips County,,AR,1543,22737,24280,4,6,10,201,548,749,6,0.309739,0.324101,65.417339,0.000881,0.001065,130,0.000106,0,20,0.5,0.006966
5109,Pike County,,AR,777,10886,11663,3,4,7,274,331,605,7,0.256139,0.265766,544.970673,0.000055,0.000086,5,0.000117,0,20,0.333333,0.000924
5111,Poinsett County,,AR,1757,24308,26065,6,5,11,969,900,1869,7,0.25446,0.263839,37.031222,0.000644,0.000048,5,0.00016,0,20,0.766667,0.005403
5113,Polk County,,AR,1261,19497,20758,4,5,9,213,315,528,7,0.271912,0.28342,353.140722,0.000052,0.00022,5,0.00017,0,20,0.309524,0.001023
5115,Pope County,,AR,3959,56572,60531,16,13,29,2238,2077,4315,7,0.287266,0.301647,1990.592983,0.002721,0.000863,5,0.000411,0,20,0.444853,0.023939
5117,Prairie County,,AR,598,8396,8994,4,4,8,313,366,679,7,0.283792,0.296358,0.783333,0.000304,0.000306,5,0.000139,0,20,0.833333,0.002729
5119,Pulaski County,,AR,28966,394555,423521,113,103,216,20115,20665,40780,6,0.396026,0.432079,169451.149906,0.034266,0.036544,5,0.001889,0,20,0.268627,0.258221
5121,Randolph County,,AR,1133,17876,19009,4,4,8,433,497,930,7,0.237726,0.245392,1.707371,0.00002,0.000018,5,0.000156,0,20,0.833333,0.00055
5123,St. Francis County,,AR,2014,25062,27076,8,8,16,822,1140,1962,6,0.309772,0.324387,3101.066841,0.00095,0.000973,5,0.000177,0,20,0.513889,0.007735
5125,Saline County,,AR,6446,98014,104460,20,13,33,6001,3996,9997,7,0.287322,0.301762,693.594075,0.004567,0.000892,5,0.000462,0,20,0.47381,0.034102
5127,Scott County,,AR,773,10567,11340,2,2,4,266,298,564,7,0.26195,0.271335,0,0.00006,0.000069,5,0.000095,0,20,1,0.000812
5129,Searcy County,,AR,499,7216,7715,2,2,4,99,158,257,8,0.22653,0.233195,4.629279,0.00001,0.000006,5,0.00011,0,20,0,0.000255
5131,Sebastian County,,AR,9564,122351,131915,29,24,53,6538,6448,12986,6,0.354792,0.379003,14207.421648,0.008831,0.006659,5,0.000594,0,20,0.376114,0.062691
5133,Sevier County,,AR,1038,15260,16298,5,5,10,317,405,722,7,0.244599,0.252831,77.892154,0.00002,0.00002,136,0.00019,0,20,0.3,0.000606
5135,Sharp County,,AR,1352,16737,18089,5,5,10,696,614,1310,7,0.237998,0.246068,81.080096,0.000017,0.000018,5,0.000198,0,20,0.4,0.000652
5137,Stone County,,AR,662,10906,11568,3,2,5,146,162,308,7,0.283819,0.296186,527.535477,0.000036,0.000269,5,0.000135,0,20,0.666667,0.000751
5139,Union County,,AR,2395,46609,49004,9,12,21,809,1042,1851,6,0.318555,0.335464,6133.466349,0.001198,0.001372,5,0.000222,0,20,0.314103,0.009779
5141,Van Buren County,,AR,1208,15465,16673,5,5,10,520,561,1081,7,0.28393,0.29673,2132.278201,0.000321,0.00033,5,0.000202,0,20,0.5,0.003046
5143,Washington County,,AR,15568,177018,192586,64,50,114,11671,10215,21886,6,0.372123,0.400825,40971.569033,0.018203,0.01603,5,0.001176,0,20,0.278873,0.133689
5145,White County,,AR,4712,70501,75213,16,14,30,2866,2458,5324,6,0.310665,0.326535,2897.040495,0.002065,0.001434,5,0.000407,0,20,0.424837,0.011404
5147,Woodruff County,,AR,541,7902,8443,3,2,5,164,208,372,7,0.237087,0.24392,0.533333,0.000302,0.000018,5,0.000108,0,20,0.583333,0.002487
5149,Yell County,,AR,1566,20101,21667,4,6,10,786,1011,1797,7,0.271709,0.283162,41.257736,0.000325,0.000288,5,0.000149,0,20,0.690476,0.003085
6001,Alameda County,,CA,118374,1511488,1629862,170,194,364,86155,108356,194511,5,0.420035,0.46331,13398.126585,0.076216,0.077619,6,0.001563,0,20,0.360641,0.528218
6003,Alpine County,,CA,129,988,1117,0,1,1,0,43,43,7,0.255777,0.263908,0,0,0.000078,6,0.00005,0,28,0,0
6005,Amador County,,CA,2431,36782,39213,13,9,22,2113,1188,3301,6,0.329148,0.34736,2.654073,0.005956,0.003258,6,0.000137,0,20,0.955128,0.040168
6007,Butte County,,CA,11977,199826,211803,45,57,102,9883,8808,18691,6,0.348461,0.375504,1100.375947,0.014623,0.018567,6,0.000413,0,20,0.643797,0.102756
6009,Calaveras County,,CA,3513,44312,47825,13,11,24,3535,1707,5242,6,0.340192,0.359633,12.163025,0.004932,0.004859,6,0.00014,0,20,0.917582,0.033232
6011,Colusa County,,CA,1515,22993,24508,8,7,15,1003,883,1886,6,0.29782,0.311707,3.977158,0.002298,0.00113,6,0.000115,0,20,0.819444,0.015315
6013,Contra Costa County,,CA,71868,1076273,1148141,115,149,264,57539,63074,120613,5,0.398849,0.43953,5648.373996,0.054448,0.061197,6,0.001026,0,20,0.412726,0.38182
6015,Del Norte County,,CA,1716,22133,23849,8,7,15,660,636,1296,6,0.296787,0.310682,11.709985,0.003272,0.001137,6,0.000123,0,20,0.755556,0.023577
6017,El Dorado County,,CA,14372,182777,197149,41,58,99,12906,10665,23571,6,0.349718,0.377211,127.483293,0.016221,0.020439,6,0.000364,0,20,0.65765,0.115276
6019,Fresno County,,CA,34617,858077,892694,74,97,171,26717,27223,53940,6,0.378709,0.413414,2828.800112,0.030025,0.037545,6,0.000738,0,20,0.505769,0.227171
6021,Glenn County,,CA,1699,28391,30090,6,5,11,950,956,1906,6,0.296485,0.310034,1.876038,0.001491,0.000821,6,0.000109,0,20,0.8,0.011087
6023,Humboldt County,,CA,7657,124242,131899,41,52,93,4212,4961,9173,6,0.346759,0.372784,2412.208776,0.015062,0.01699,6,0.000394,0,20,0.652189,0.107872
6025,Imperial County,,CA,7904,181742,189646,21,22,43,7490,5860,13350,6,0.343201,0.364593,2.341266,0.010926,0.010392,6,0.000206,0,20,0.896923,0.076001
6027,Inyo County,,CA,1455,19145,20600,8,7,15,753,536,1289,6,0.338136,0.356884,8.851317,0.004743,0.004165,6,0.000119,0,20,0.811111,0.032972
6029,Kern County,,CA,34243,726064,760307,78,121,199,34164,24594,58758,6,0.382191,0.420115,3148.010459,0.032965,0.042958,6,0.000757,0,20,0.40161,0.242601
6031,Kings County,,CA,10762,124163,134925,38,35,73,7340,6527,13867,6,0.350307,0.37425,250.359355,0.015998,0.015249,6,0.000357,0,20,0.611296,0.112596
6033,Lake County,,CA,4029,55602,59631,19,19,38,3370,2138,5508,6,0.342434,0.363414,0.937766,0.008225,0.007481,6,0.000173,0,20,0.933333,0.056275
6035,Lassen County,,CA,2205,24835,27040,12,9,21,870,883,1753,6,0.298829,0.313603,102.994449,0.004761,0.001479,6,0.000152,0,20,0.730769,0.032885
6037,Los Angeles County,,CA,454153,9942878,10397031,451,563,1014,244883,432411,677294,5,0.499914,0.566014,476042.993023,0.129281,0.134046,6,0.00503,0,20,0.104421,0.919839
6039,Madera County,,CA,8004,124200,132204,28,24,52,8026,5533,13559,6,0.343728,0.36551,268.671774,0.012535,0.010505,6,0.000243,0,20,0.875862,0.08534
6041,Marin County,,CA,17449,240352,257801,43,52,95,12218,13564,25782,6,0.356968,0.384691,142.220485,0.021992,0.023114,6,0.000366,0,20,0.69774,0.151062
6043,Mariposa County,,CA,1416,17357,18773,9,5,14,880,538,1418,7,0.275646,0.288514,0.214286,0.003231,0.000662,6,0.000109,0,20,0.958333,0.021202
6045,Mendocino County,,CA,5005,87819,92824,19,25,44,2357,2731,5088,6,0.344664,0.366856,2.742276,0.00799,0.010219,6,0.000175,0,20,0.873153,0.055335
6047,Merced County,,CA,15662,234261,249923,31,48,79,12735,12263,24998,6,0.358772,0.38642,607.724302,0.013103,0.02054,6,0.000271,0,20,0.741633,0.090642
6049,Modoc County,,CA,714,8286,9000,3,2,5,125,130,255,7,0.257613,0.267452,0.257576,0.000681,0.000227,6,0.000081,0,20,0.75,0.005117
6051,Mono County,,CA,1643,11949,13592,6,9,15,574,781,1355,6,0.338293,0.357342,0.506622,0.004268,0.005364,6,0.000099,0,20,0.888889,0.02946
6053,Monterey County,,CA,35236,414314,449550,79,120,199,15542,27752,43294,6,0.38209,0.419714,2431.468167,0.035049,0.046642,6,0.000757,0,20,0.430769,0.259489
6055,Napa County,,CA,9567,139320,148887,29,34,63,6926,6913,13839,6,0.345196,0.368545,14.779898,0.013485,0.013787,6,0.000251,0,20,0.881935,0.093765
6057,Nevada County,,CA,7476,102352,109828,32,34,66,5736,4957,10693,6,0.345729,0.36925,675.562383,0.013991,0.013331,6,0.000277,0,20,0.792173,0.098611
6059,Orange County,,CA,199847,3139416,3339263,247,329,576,132699,185949,318648,5,0.453412,0.506329,54394.22239,0.099984,0.108992,6,0.002436,0,20,0.216519,0.697434
6061,Placer County,,CA,27044,334599,361643,60,77,137,30043,22255,52298,6,0.357143,0.38854,872.668899,0.022306,0.028362,6,0.000569,0,20,0.529138,0.165726
6063,Plumas County,,CA,1785,21731,23516,7,6,13,548,683,1231,6,0.297242,0.31118,0.420635,0.002193,0.001232,6,0.000109,0,20,0.888889,0.015871
6065,Riverside County,,CA,125103,1907296,2032399,200,252,452,178008,109662,287670,5,0.436544,0.484129,36549.39718,0.08033,0.082038,6,0.002046,0,20,0.238895,0.574833
6067,Sacramento County,,CA,90908,1414984,1505892,160,191,351,75332,80016,155348,5,0.421068,0.46327,34882.113327,0.064704,0.069386,6,0.001679,0,20,0.313602,0.474766
6069,San Benito County,,CA,5493,58683,64176,9,23,32,3108,3928,7036,6,0.343363,0.364937,0,0.004516,0.009639,6,0.000107,0,20,0.980237,0.030711
6071,San Bernardino County,,CA,146452,1942014,2088466,191,285,476,140207,128929,269136,5,0.441176,0.492188,41909.634503,0.077005,0.089868,6,0.002001,0,20,0.214349,0.555045
6073,San Diego County,,CA,209191,3168657,3377848,433,515,948,141494,183223,324717,5,0.488829,0.553356,355020.37332,0.126436,0.130932,6,0.004824,0,20,0.122065,0.895635
6075,San Francisco County,,CA,74372,783859,858231,150,122,272,61279,67376,128655,5,0.400551,0.437761,4850.629978,0.072081,0.057008,6,0.001304,0,20,0.476336,0.488487
6077,San Joaquin County,,CA,41825,661961,703786,58,100,158,35632,34976,70608,6,0.368821,0.404221,1726.389167,0.023197,0.035655,6,0.000545,0,20,0.458333,0.164484
6079,San Luis Obispo County,,CA,16025,253237,269262,42,59,101,12347,11624,23971,6,0.353284,0.381821,62.321572,0.017025,0.02165,6,0.00036,0,20,0.703279,0.12164
6081,San Mateo County,,CA,61160,753044,814204,95,110,205,44927,55707,100634,5,0.388518,0.424737,1863.050755,0.049139,0.050827,6,0.00082,0,20,0.532194,0.341845
6083,Santa Barbara County,,CA,28978,406895,435873,71,105,176,15495,22713,38208,5,0.378808,0.414233,2265.231215,0.032042,0.042606,6,0.000706,0,20,0.493324,0.238282
6085,Santa Clara County,,CA,110554,1863011,1973565,202,209,411,81556,99534,181090,5,0.419188,0.464582,22047.503462,0.086149,0.082076,6,0.001914,0,20,0.32318,0.5964
6087,Santa Cruz County,,CA,17680,262607,280287,45,58,103,10673,14040,24713,6,0.350476,0.378127,178.266771,0.018834,0.021111,6,0.00038,0,20,0.665387,0.134237
6089,Shasta County,,CA,9666,174021,183687,51,50,101,7841,6322,14163,6,0.346676,0.37244,5436.622657,0.016126,0.016851,6,0.000528,0,20,0.588313,0.115816
6091,Sierra County,,CA,314,3033,3347,2,1,3,146,49,195,7,0.270522,0.283111,0,0.000387,0.000281,6,0.000068,0,20,1,0.003149
6093,Siskiyou County,,CA,2950,43443,46393,21,12,33,1611,1269,2880,6,0.338411,0.357973,9.503164,0.007916,0.005312,6,0.000209,0,20,0.867754,0.054218
6095,Solano County,,CA,36427,432126,468553,73,103,176,25678,28590,54268,6,0.381189,0.416919,3762.32653,0.030055,0.040692,6,0.000677,0,20,0.459951,0.213924
6097,Sonoma County,,CA,26879,501331,528210,59,94,153,16488,21386,37874,5,0.37592,0.409599,2608.940382,0.027443,0.034531,6,0.000548,0,20,0.507273,0.203518
6099,Stanislaus County,,CA,30740,511952,542692,53,90,143,26798,24527,51325,6,0.366915,0.400601,1684.995473,0.021382,0.031379,6,0.000496,0,20,0.505495,0.156497
6101,Sutter County,,CA,7412,89142,96554,22,22,44,6967,4950,11917,6,0.340231,0.361409,113.180578,0.009381,0.008937,6,0.000203,0,20,0.851852,0.063508
6103,Tehama County,,CA,3829,56957,60786,20,12,32,2949,1838,4787,6,0.338451,0.358156,160.664411,0.008066,0.004142,6,0.000198,0,20,0.835145,0.054409
6105,Trinity County,,CA,776,11066,11842,3,2,5,299,280,579,7,0.257773,0.267767,0,0.000531,0.000242,6,0.000071,0,20,1,0.003594
6107,Tulare County,,CA,17104,395833,412937,40,53,93,14082,12431,26513,6,0.359748,0.387984,644.8992,0.015673,0.021846,6,0.000356,0,20,0.673019,0.110208
6109,Tuolumne County,,CA,3606,55077,58683,19,17,36,2470,1727,4197,6,0.342837,0.363505,215.581573,0.008213,0.007936,6,0.000185,0,20,0.876623,0.055227
6111,Ventura County,,CA,53384,864707,918091,101,150,251,35705,43015,78720,5,0.402601,0.443013,3610.410618,0.049817,0.061399,6,0.000931,0,20,0.411902,0.356435
6113,Yolo County,,CA,17621,176295,193916,44,50,94,14092,13692,27784,6,0.356924,0.384387,459.718128,0.016142,0.018865,6,0.000371,0,20,0.689226,0.113017
6115,Yuba County,,CA,8580,60760,69340,25,23,48,8732,5606,14338,6,0.347131,0.369708,182.98217,0.009186,0.01159,6,0.000242,0,20,0.788306,0.063927
8001,Adams County,,CO,43956,413261,457217,77,66,143,41530,35828,77358,5,0.38194,0.41197,12617.822232,0.029653,0.028217,8,0.0011,0,20,0.443081,0.227846
8003,Alamosa County,,CO,1553,14269,15822,4,5,9,516,439,955,6,0.334252,0.352119,9438.619155,0.00065,0.001873,8,0.000156,0,20,0.333333,0.005582
8005,Arapahoe County,,CO,65124,552282,617406,145,134,279,55296,55336,110632,5,0.417384,0.453717,27211.282893,0.065655,0.05901,8,0.001662,0,20,0.408118,0.470137
8007,Archuleta County,,CO,1035,10874,11909,2,3,5,186,163,349,6,0.331964,0.349318,0,0.000424,0.001228,8,0.000082,0,20,1,0.003491
8009,Baca County,,CO,279,4206,4485,0,1,1,0,44,44,7,0.236791,0.242449,0,0,0,8,0.00005,0,30,0,0
8011,Bent County,,CO,401,4518,4919,1,2,3,68,91,159,7,0.237191,0.243162,1,0.000006,0.000001,8,0.000087,0,29,0,0.000089
8013,Boulder County,,CO,28171,287181,315352,112,79,191,19078,20834,39912,5,0.38345,0.415309,8341.469123,0.055092,0.038112,8,0.001244,0,20,0.522658,0.393044
8014,Broomfield County,,CO,7615,47529,55144,14,12,26,6774,5539,12313,6,0.339755,0.359536,2.073182,0.007885,0.005604,8,0.000214,0,20,0.916667,0.062872
8015,Chaffee County,,CO,1603,16508,18111,8,5,13,571,441,1012,6,0.312668,0.326145,5.487413,0.002494,0.001746,8,0.000162,0,20,0.708333,0.021448
8017,Cheyenne County,,CO,188,2135,2323,0,0,0,0,0,0,0,0,0,0,0,0,7,0.00005,5,31,0,0
8019,Clear Creek County,,CO,1165,8965,10130,4,4,8,406,578,984,6,0.301336,0.313677,0,0.001348,0.001634,8,0.000093,0,20,1,0.010703
8021,Conejos County,,CO,551,7977,8528,2,2,4,119,212,331,7,0.256772,0.265448,0,0.000023,0.000094,8,0.00009,0,20,0.666667,0.000218
8023,Costilla County,,CO,257,2937,3194,0,1,1,0,52,52,7,0.250581,0.257885,0,0,0.000005,8,0.00005,0,32,0,0
8025,Crowley County,,CO,301,2923,3224,2,2,4,162,134,296,7,0.256659,0.265218,0,0.000078,0.00009,8,0.000105,0,20,1,0.000899
8027,Custer County,,CO,394,3768,4162,1,2,3,65,104,169,6,0.30997,0.322595,0,0.000026,0.00074,8,0.000073,0,20,1,0.000308
8029,Delta County,,CO,2198,28786,30984,12,6,18,1258,936,2194,6,0.332876,0.350951,14.646934,0.00351,0.001892,8,0.000248,0,20,0.833333,0.029957
8031,Denver County,,CO,75319,525577,600896,151,131,282,62730,66337,129067,5,0.422229,0.457371,30957.96342,0.068036,0.060332,8,0.001737,0,20,0.423612,0.482626
8033,Dolores County,,CO,185,1878,2063,1,1,2,81,43,124,7,0.249421,0.256662,0,0.00001,0.000012,6,0.0001,0,20,0,0.000209
8035,Douglas County,,CO,26886,262731,289617,106,77,183,31236,20106,51342,5,0.393616,0.424593,6920.767195,0.049027,0.038049,8,0.001271,0,20,0.513511,0.369927
8037,Eagle County,,CO,5039,44215,49254,20,22,42,2324,2388,4712,6,0.350054,0.3724,2609.173629,0.008901,0.009743,8,0.000301,0,20,0.668478,0.070554
8039,Elbert County,,CO,2251,22232,24483,6,7,13,1671,1312,2983,6,0.313206,0.327062,0,0.002451,0.003017,8,0.000123,0,20,1,0.020462
8041,El Paso County,,CO,52418,607410,659828,281,234,515,42160,35966,78126,5,0.449005,0.491655,145367.592252,0.092034,0.082564,8,0.003341,0,20,0.217627,0.663266
8043,Fremont County,,CO,2951,39570,42521,11,9,20,1460,1257,2717,6,0.334829,0.353379,3077.228795,0.003377,0.003379,8,0.000243,0,20,0.685897,0.028547
8045,Garfield County,,CO,4346,47709,52055,20,16,36,2723,2168,4891,6,0.335331,0.354868,853.635007,0.007761,0.004981,8,0.000346,0,20,0.670996,0.063696
8047,Gilpin County,,CO,647,4918,5565,3,2,5,334,238,572,6,0.289437,0.301512,0,0.001133,0.000794,8,0.000086,0,20,1,0.009733
8049,Grand County,,CO,1479,13094,14573,8,5,13,638,330,968,6,0.301773,0.314479,0,0.002387,0.001943,8,0.000151,0,20,0.986111,0.020868
8051,Gunnison County,,CO,1575,13025,14600,5,8,13,270,448,718,6,0.312937,0.326919,1.803571,0.001578,0.002289,8,0.000148,0,20,0.847222,0.01339
8053,Hinsdale County,,CO,90,732,822,0,0,0,0,0,0,0,0,0,0,0,0,9,0.00005,6,33,0,0
8055,Huerfano County,,CO,593,6205,6798,1,1,2,78,155,233,7,0.256636,0.265047,0,0.000069,0.000089,8,0.000074,0,20,0,0.000799
8057,Jackson County,,CO,151,1535,1686,0,0,0,0,0,0,0,0,0,0,0,0,10,0.00005,7,34,0,0
8059,Jefferson County,,CO,54531,569872,624403,112,118,230,42899,45598,88497,5,0.403159,0.438723,30812.350557,0.047205,0.047618,8,0.001521,0,20,0.393702,0.355324
8061,Kiowa County,,CO,130,1583,1713,0,0,0,0,0,0,0,0,0,0,0,0,11,0.00005,8,35,0,0
8063,Kit Carson County,,CO,652,8110,8762,0,0,0,0,0,0,0,0,0,0,0,0,12,0.00005,9,36,0,0
8065,Lake County,,CO,787,6370,7157,2,4,6,139,248,387,6,0.310168,0.323167,0.285714,0.000128,0.000835,8,0.000072,0,20,0.666667,0.000985
8067,La Plata County,,CO,4250,45798,50048,22,16,38,1988,1698,3686,6,0.337548,0.357961,429.372821,0.008902,0.007044,8,0.000384,0,20,0.728333,0.073618
8069,Larimer County,,CO,23156,289590,312746,91,67,158,15996,14854,30850,6,0.37592,0.40701,17967.074616,0.037237,0.029512,8,0.00123,0,20,0.44803,0.283091
8071,Las Animas County,,CO,1077,14579,15656,5,4,9,343,295,638,6,0.310466,0.323511,251.891461,0.001558,0.001034,8,0.000119,0,20,0.619048,0.012876
8073,Lincoln County,,CO,571,4887,5458,1,2,3,45,132,177,6,0.310301,0.322995,0,0.000641,0.000843,8,0.000062,0,20,1,0.005322
8075,Logan County,,CO,1442,20145,21587,9,6,15,606,467,1073,6,0.280347,0.292365,10009.867712,0.001187,0.00066,8,0.000318,0,20,0.377778,0.010063
8077,Mesa County,,CO,8103,136873,144976,49,32,81,6843,4048,10891,6,0.35128,0.375991,11875.403726,0.014386,0.011519,8,0.000866,0,20,0.405882,0.115805
8079,Mineral County,,CO,65,870,935,0,0,0,0,0,0,0,0,0,0,0,0,13,0.00005,10,37,0,0
8081,Moffat County,,CO,1231,13789,15020,3,2,5,328,282,610,7,0.26003,0.269525,1.574616,0.000118,0.000126,8,0.000116,0,20,0.5,0.001314
8083,Montezuma County,,CO,1968,24040,26008,10,5,15,900,657,1557,6,0.332268,0.350006,5917.687777,0.001544,0.00134,6,0.00029,0,20,0.488889,0.014424
8085,Montrose County,,CO,2777,38474,41251,17,8,25,1755,1096,2851,6,0.334906,0.353322,8855.455569,0.006954,0.00259,8,0.000388,0,20,0.595588,0.055029
8087,Morgan County,,CO,2163,29070,31233,7,8,15,772,1059,1831,6,0.301961,0.315023,1805.345987,0.001502,0.002061,8,0.000175,0,20,0.597222,0.013036
8089,Otero County,,CO,1365,19742,21107,4,5,9,398,628,1026,6,0.310731,0.323969,1925.887166,0.000078,0.001163,8,0.000181,0,20,0.452381,0.001164
8091,Ouray County,,CO,438,3877,4315,0,1,1,0,108,108,7,0.250948,0.258411,0,0,0.000054,8,0.00005,0,38,0,0
8093,Park County,,CO,1815,14200,16015,8,8,16,1036,892,1928,6,0.313038,0.327033,5.016666,0.002512,0.002779,8,0.000158,0,20,0.839286,0.021061
8095,Phillips County,,CO,339,4810,5149,1,1,2,43,54,97,7,0.218978,0.224519,0,0.000005,0.000009,8,0.000095,0,20,0,0.000171
8097,Pitkin County,,CO,1946,13521,15467,4,6,10,508,904,1412,6,0.33456,0.352468,3.291708,0.000878,0.0022,8,0.000105,0,20,0.966667,0.008109
8099,Prowers County,,CO,1114,13342,14456,2,3,5,85,214,299,6,0.31015,0.323003,4134.810294,0,0.000803,8,0.00013,0,29,0.166667,0.00017
8101,Pueblo County,,CO,7600,155475,163075,31,22,53,5056,4058,9114,6,0.345196,0.367027,17743.634369,0.011477,0.008929,8,0.00062,0,20,0.445161,0.091056
8103,Rio Blanco County,,CO,607,6030,6637,2,3,5,141,228,369,7,0.260077,0.269755,1.492513,0.000098,0.000173,8,0.000093,0,20,0.416667,0.001247
8105,Rio Grande County,,CO,1406,15123,16529,1,5,6,141,433,574,6,0.310566,0.323797,1.15758,0.000015,0.001039,8,0.000077,0,20,0.6,0.000131
8107,Routt County,,CO,2236,20676,22912,7,9,16,608,743,1351,6,0.333066,0.351523,760.465285,0.001874,0.003532,8,0.000172,0,20,0.8,0.016176
8109,Saguache County,,CO,315,3218,3533,0,0,0,0,0,0,0,0,0,0,0,0,14,0.00005,11,39,0,0
8111,San Juan County,,CO,83,604,687,0,0,0,0,0,0,0,0,0,0,0,0,15,0.00005,12,40,0,0
8113,San Miguel County,,CO,892,6059,6951,1,1,2,63,137,200,7,0.250905,0.258328,0,0.00002,0.000054,8,0.000091,0,20,0,0.000516
8115,Sedgwick County,,CO,210,2569,2779,0,0,0,0,0,0,0,0,0,0,0,0,16,0.00005,13,41,0,0
8117,Summit County,,CO,3914,25303,29217,13,18,31,1410,1687,3097,6,0.344012,0.364937,1013.164641,0.004137,0.006744,8,0.000221,0,20,0.665789,0.034717
8119,Teller County,,CO,2739,23476,26215,6,5,11,1347,1413,2760,6,0.310268,0.323454,28.004757,0.002397,0.001229,8,0.000141,0,20,0.809524,0.020516
8121,Washington County,,CO,363,4742,5105,2,1,3,100,55,155,7,0.218978,0.224519,0,0.000021,0.000009,8,0.000114,0,20,1,0.000359
8123,Weld County,,CO,17761,229827,247588,42,36,78,17451,11876,29327,6,0.361581,0.387342,7900.821934,0.016638,0.014506,8,0.000691,0,20,0.467262,0.131771
8125,Yuma County,,CO,771,9880,10651,1,5,6,58,224,282,6,0.311064,0.324485,0,0.000113,0.001374,8,0.000067,0,20,0.75,0.001113
9001,Fairfield County,,CT,53549,963892,1017441,119,190,309,34004,45822,79826,5,0.413176,0.456936,8470.851922,0.062007,0.083726,17,0.000927,0,20,0.41617,0.408639
9003,Hartford County,,CT,44228,1011966,1056194,125,163,288,32980,36117,69097,5,0.401545,0.443637,8099.699141,0.063827,0.073824,17,0.001018,0,20,0.463711,0.427573
9005,Litchfield County,,CT,11184,222250,233434,18,32,50,8710,7104,15814,6,0.350941,0.374215,25.886043,0.00945,0.016403,17,0.000143,0,20,0.725462,0.053354
9007,Middlesex County,,CT,12161,188529,200690,22,29,51,9730,8305,18035,6,0.353413,0.377257,57.559908,0.01209,0.015862,17,0.000175,0,20,0.808378,0.07424
9009,New Haven County,,CT,45527,944370,989897,116,168,284,34264,37556,71820,5,0.405745,0.447829,5260.143394,0.05863,0.07464,17,0.000886,0,20,0.434575,0.381303
9011,New London County,,CT,20593,311354,331947,65,84,149,12495,13487,25982,6,0.375339,0.408064,1147.683847,0.031244,0.041241,17,0.000508,0,20,0.553997,0.201778
9013,Tolland County,,CT,11080,158366,169446,16,22,38,8738,7594,16332,6,0.350645,0.373139,74.78628,0.007279,0.011737,17,0.000139,0,20,0.853261,0.042671
9015,Windham County,,CT,7435,130287,137722,9,16,25,5223,4649,9872,6,0.30941,0.326953,1.172057,0.003164,0.005406,17,0.000094,0,20,0.829167,0.016743
10001,Kent County,,DE,10506,161302,171808,45,30,75,9372,3507,12879,6,0.35367,0.378018,1413.086077,0.019345,0.014081,43,0.000385,0,20,0.509416,0.117858
10003,New Castle County,,DE,30119,593716,623835,112,114,226,21805,21571,43376,6,0.389558,0.426466,6248.216423,0.058398,0.058666,43,0.000908,0,20,0.565371,0.381947
10005,Sussex County,,DE,8796,192985,201781,49,27,76,6783,4534,11317,6,0.340431,0.363047,2474.17871,0.01789,0.01169,43,0.000418,0,20,0.553571,0.109205
11001,District of Columbia,,DC,62990,538386,601376,172,140,312,47964,53776,101740,5,0.411249,0.450046,13162.173382,0.082321,0.067267,43,0.001571,0,20,0.441275,0.555121
12001,Alachua County,,FL,21003,212344,233347,90,80,170,15776,14880,30656,6,0.385277,0.417675,10835.277738,0.041861,0.041969,17,0.00119,0,20,0.547952,0.317976
12003,Baker County,,FL,1636,24177,25813,7,7,14,1395,1064,2459,6,0.304936,0.319599,6.21993,0.001049,0.001359,17,0.000183,0,20,0.595238,0.01049
12005,Bay County,,FL,15106,172372,187478,77,65,142,7792,7303,15095,6,0.374614,0.405367,18936.54771,0.030462,0.030717,17,0.001043,0,20,0.434424,0.233514
12007,Bradford County,,FL,1875,22789,24664,6,8,14,1241,1178,2419,6,0.305319,0.320286,3.178692,0.001329,0.00212,17,0.000154,0,20,0.75,0.01205
12009,Brevard County,,FL,34261,575728,609989,203,158,361,29470,21317,50787,6,0.409571,0.45059,21752.392842,0.08772,0.070552,17,0.00189,0,20,0.322606,0.597061
12011,Broward County,,FL,141574,1812515,1954089,274,320,594,108541,127895,236436,5,0.4532,0.505011,68383.506483,0.107783,0.110285,17,0.002661,0,20,0.214913,0.750624
12013,Calhoun County,,FL,884,11048,11932,5,5,10,506,455,961,7,0.284624,0.297346,16.055144,0.000606,0.000541,17,0.000173,0,20,0.65,0.00456
12015,Charlotte County,,FL,14232,151584,165816,72,37,109,11149,7388,18537,6,0.357055,0.382852,366.0115,0.036321,0.019113,17,0.000586,0,20,0.597994,0.233873
12017,Citrus County,,FL,8939,134634,143573,56,21,77,8956,3908,12864,6,0.335524,0.356128,58.311479,0.027589,0.01269,17,0.000573,0,20,0.711039,0.188895
12019,Clay County,,FL,19383,187888,207271,93,53,146,20210,13196,33406,6,0.367796,0.39646,2633.233388,0.046987,0.02826,17,0.000982,0,20,0.595185,0.340425
12021,Collier County,,FL,26630,309151,335781,137,86,223,20727,18195,38922,5,0.39765,0.430046,2962.647138,0.065115,0.045233,17,0.001078,0,20,0.440534,0.414114
12023,Columbia County,,FL,4449,58091,62540,26,17,43,4156,2420,6576,6,0.320449,0.339101,979.706423,0.010178,0.006993,17,0.000457,0,20,0.649471,0.086332
12027,DeSoto County,,FL,2154,26357,28511,8,8,16,1061,996,2057,6,0.310301,0.326168,3.578957,0.002799,0.00372,17,0.000154,0,20,0.892857,0.025878
12029,Dixie County,,FL,921,11757,12678,7,3,10,501,342,843,7,0.278203,0.289642,3.857532,0.002278,0.000422,17,0.000212,0,20,0.619048,0.01912
12031,Duval County,,FL,70589,904017,974606,290,240,530,61017,55919,116936,5,0.438187,0.484559,129214.290006,0.10423,0.091378,17,0.003347,0,20,0.245991,0.744589
12033,Escambia County,,FL,31436,299667,331103,105,124,229,17012,20452,37464,6,0.403942,0.441512,12174.643588,0.04729,0.05487,0,0.001175,0,20,0.410723,0.349131
12035,Flagler County,,FL,6742,81673,88415,58,17,75,9950,3271,13221,6,0.333945,0.354198,24.069908,0.030444,0.010276,17,0.000478,0,20,0.729398,0.193455
12037,Franklin County,,FL,730,9405,10135,3,2,5,182,166,348,7,0.279969,0.291578,1.49579,0.000587,0.000278,17,0.000099,0,20,0.666667,0.004058
12039,Gadsden County,,FL,3222,47496,50718,8,7,15,2118,2151,4269,6,0.30564,0.320773,759.958299,0.003563,0.001137,17,0.00017,0,20,0.433333,0.027076
12041,Gilchrist County,,FL,1306,13624,14930,11,5,16,981,732,1713,7,0.278389,0.290272,6.371845,0.004864,0.000554,17,0.000266,0,20,0.745455,0.037909
12043,Glades County,,FL,945,8302,9247,6,6,12,516,434,950,6,0.31378,0.329645,2.013117,0.003081,0.00247,17,0.000101,0,20,0.880952,0.02216
12045,Gulf County,,FL,1053,12174,13227,3,4,7,452,467,919,7,0.284569,0.297117,0.333333,0.000588,0.000501,17,0.000106,0,20,0.75,0.004065
12047,Hamilton County,,FL,892,11418,12310,4,3,7,410,351,761,7,0.25869,0.269629,5.345249,0.000903,0.000276,17,0.000134,0,20,0.75,0.008395
12049,Hardee County,,FL,1630,22184,23814,5,5,10,698,820,1518,6,0.309443,0.324565,0,0.001683,0.002145,17,0.000115,0,20,1,0.015249
12051,Hendry County,,FL,3412,34907,38319,7,11,18,2106,1851,3957,6,0.31852,0.336105,6.73629,0.004171,0.00628,17,0.000118,0,20,0.827273,0.031613
12053,Hernando County,,FL,11929,158030,169959,74,26,100,14799,6379,21178,6,0.346883,0.370069,76.414012,0.037415,0.015947,17,0.000622,0,20,0.669369,0.241159
12055,Highlands County,,FL,6457,87810,94267,27,23,50,4522,2681,7203,6,0.321796,0.341466,79.9825,0.010369,0.011987,17,0.000345,0,20,0.725806,0.086632
12057,Hillsborough County,,FL,90624,1192411,1283035,340,285,625,92024,75387,167411,5,0.446387,0.495945,94113.853763,0.117181,0.105304,17,0.00355,0,20,0.204111,0.819762
12059,Holmes County,,FL,1358,16612,17970,8,6,14,918,832,1750,7,0.273291,0.285324,104.922333,0.001106,0.000409,17,0.000199,0,20,0.589286,0.010433
12061,Indian River County,,FL,9405,134188,143593,44,32,76,7875,4245,12120,6,0.355008,0.380292,196.875102,0.024344,0.018144,17,0.000398,0,20,0.719427,0.165398
12063,Jackson County,,FL,2948,44382,47330,13,12,25,1479,1500,2979,6,0.310201,0.326564,1233.168908,0.005343,0.0021,17,0.000257,0,20,0.474265,0.039876
12065,Jefferson County,,FL,1106,13646,14752,1,3,4,587,541,1128,7,0.280077,0.291922,0,0.000345,0.000282,17,0.000063,0,20,0.666667,0.002042
12067,Lafayette County,,FL,345,4873,5218,1,1,2,114,82,196,7,0.237881,0.244962,0,0.000027,0.000074,17,0.000083,0,20,0,0.000689
12069,Lake County,,FL,24529,279077,303606,121,52,173,28655,15508,44163,6,0.369994,0.398648,872.181974,0.060325,0.029512,17,0.001101,0,20,0.550258,0.404451
12071,Lee County,,FL,39166,567408,606574,264,171,435,54322,25316,79638,5,0.414412,0.455979,30379.893863,0.09363,0.070312,17,0.002418,0,20,0.23063,0.622215
12073,Leon County,,FL,23527,241145,264672,84,92,176,15705,17294,32999,6,0.388726,0.422503,55029.080394,0.032947,0.044466,17,0.001366,0,20,0.446954,0.253505
12075,Levy County,,FL,3120,36028,39148,16,8,24,2516,1781,4297,6,0.315618,0.331397,189.477285,0.007615,0.003629,17,0.000319,0,20,0.8125,0.063383
12077,Liberty County,,FL,471,5939,6410,4,2,6,272,205,477,7,0.279969,0.291578,0.333333,0.000374,0.00026,17,0.000131,0,20,0.833333,0.00285
12079,Madison County,,FL,997,17481,18478,5,4,9,373,387,760,7,0.282936,0.295702,20.099249,0.001259,0.000462,17,0.000159,0,20,0.55,0.009257
12081,Manatee County,,FL,25652,312724,338376,130,79,209,22499,15804,38303,6,0.389767,0.422331,3470.791696,0.063424,0.04164,17,0.001149,0,20,0.496835,0.424772
12083,Marion County,,FL,20239,311678,331917,129,64,193,24571,10954,35525,6,0.373604,0.404267,2766.8791,0.058867,0.032968,17,0.001242,0,20,0.484382,0.391457
12085,Martin County,,FL,13711,140318,154029,40,38,78,8645,8298,16943,6,0.358684,0.384874,134.533463,0.02279,0.022019,17,0.00034,0,20,0.739035,0.146867
12086,Miami-Dade County,,FL,125454,2478067,2603521,221,255,476,75683,113059,188742,5,0.436282,0.484845,31168.687499,0.097792,0.099515,17,0.002101,0,20,0.29142,0.678563
12087,Monroe County,,FL,10846,74678,85524,27,40,67,3263,5951,9214,6,0.35128,0.377428,36.725172,0.017096,0.022169,17,0.00029,0,20,0.765495,0.12526
12089,Nassau County,,FL,5647,72563,78210,20,13,33,4658,3018,7676,6,0.317616,0.335212,341.532701,0.01041,0.004241,17,0.000293,0,20,0.650198,0.081369
12091,Okaloosa County,,FL,25626,199419,225045,105,114,219,12911,15312,28223,5,0.400661,0.436844,20132.521271,0.041922,0.048041,0,0.001259,0,20,0.358738,0.307627
12093,Okeechobee County,,FL,2794,34177,36971,9,13,22,1612,1111,2723,6,0.317201,0.334473,5.401986,0.003391,0.006273,17,0.000135,0,20,0.87619,0.025082
12095,Orange County,,FL,112177,1091737,1203914,297,274,571,104646,97715,202361,5,0.447761,0.495619,73014.19956,0.109724,0.104897,17,0.003098,0,20,0.237953,0.770202
12097,Osceola County,,FL,30033,232647,262680,98,65,163,32748,22228,54976,6,0.377726,0.408505,585.097376,0.051127,0.035231,17,0.000769,0,20,0.586432,0.326832
12099,Palm Beach County,,FL,90967,1303632,1394599,242,290,532,77050,77400,154450,5,0.442048,0.493265,47845.32515,0.098977,0.104343,17,0.002247,0,20,0.233729,0.6836
12101,Pasco County,,FL,36600,419974,456574,186,91,277,48477,24879,73356,6,0.391392,0.425498,5984.274439,0.082608,0.046019,17,0.00161,0,20,0.380822,0.542962
12103,Pinellas County,,FL,68653,963180,1031833,276,246,522,53093,54618,107711,5,0.4372,0.484175,54708.074578,0.105307,0.096632,17,0.002705,0,20,0.243271,0.723111
12105,Polk County,,FL,36030,560100,596130,196,122,318,43302,23026,66328,6,0.40011,0.437715,23182.086744,0.082646,0.054247,17,0.001824,0,20,0.329345,0.551722
12107,Putnam County,,FL,4926,69939,74865,19,14,33,3427,2810,6237,6,0.31852,0.33579,35.303218,0.008845,0.007092,17,0.000293,0,20,0.862573,0.074128
12109,St. Johns County,,FL,15571,167634,183205,77,41,118,16180,10065,26245,6,0.364845,0.3913,426.871938,0.040661,0.025596,17,0.000791,0,20,0.672013,0.292111
12111,St. Lucie County,,FL,20864,247836,268700,90,64,154,27634,12814,40448,6,0.368168,0.398167,881.881348,0.047168,0.033038,17,0.000698,0,20,0.563734,0.30466
12113,Santa Rosa County,,FL,16866,139700,156566,64,51,115,10839,9507,20346,6,0.367563,0.396804,2890.206421,0.030585,0.024657,0,0.000727,0,20,0.509968,0.220956
12115,Sarasota County,,FL,31803,382768,414571,166,114,280,27483,21401,48884,5,0.401656,0.437623,7208.392659,0.074117,0.05591,17,0.001398,0,20,0.392314,0.488029
12117,Seminole County,,FL,51246,423117,474363,155,129,284,44482,42161,86643,5,0.411424,0.448162,4109.87486,0.07676,0.065799,17,0.001416,0,20,0.458838,0.518369
12119,Sumter County,,FL,4583,62457,67040,58,11,69,7678,2517,10195,6,0.318276,0.335074,7.419945,0.030339,0.006693,17,0.000563,0,20,0.737145,0.214367
12121,Suwannee County,,FL,3074,37214,40288,23,12,35,2424,1624,4048,6,0.312098,0.328975,6357.200157,0.0095,0.003448,17,0.000462,0,20,0.637681,0.079703
12123,Taylor County,,FL,1017,19710,20727,4,3,7,257,238,495,7,0.280077,0.291922,11.417897,0.001193,0.000283,17,0.00014,0,20,0.5,0.009411
12125,Union County,,FL,1003,10279,11282,5,5,10,645,624,1269,6,0.304968,0.319427,1.009935,0.001116,0.001231,17,0.000136,0,20,0.85,0.009494
12127,Volusia County,,FL,35598,497084,532682,175,137,312,34650,23938,58588,6,0.406198,0.444674,17704.780794,0.076588,0.061895,17,0.001629,0,20,0.360641,0.5153
12129,Wakulla County,,FL,2093,25116,27209,7,1,8,1724,951,2675,7,0.279942,0.291406,0,0.002838,0.000256,17,0.000167,0,20,0.47619,0.019918
12131,Walton County,,FL,4627,43687,48314,20,12,32,3410,2258,5668,6,0.312332,0.329834,634.63656,0.008774,0.003186,0,0.000311,0,20,0.65368,0.061319
12133,Washington County,,FL,1694,20784,22478,5,4,9,1318,933,2251,7,0.272753,0.284207,0.856584,0.000655,0.000355,17,0.000142,0,20,0.8,0.0055
13001,Appling County,,GA,1086,17687,18773,3,7,10,218,463,681,7,0.278203,0.290965,1200.224745,0.000011,0.000428,0,0.00016,0,20,0.285714,0.000358
13003,Atkinson County,,GA,515,7881,8396,1,1,2,187,207,394,7,0.234602,0.241197,0,0.000007,0.000001,0,0.00009,0,20,0,0.000115
13005,Bacon County,,GA,581,9787,10368,3,3,6,207,237,444,7,0.235171,0.242446,10.740917,0.000019,0.000009,0,0.000149,0,20,0.5,0.000379
13007,Baker County,,GA,257,3170,3427,2,0,2,101,0,101,0,0,0,0,0.000069,0,0,0.00009,0,3,1,0.000756
13009,Baldwin County,,GA,2878,41341,44219,11,13,24,1316,1559,2875,6,0.311297,0.327881,7704.071388,0.002196,0.003701,0,0.000317,0,20,0.43956,0.01916
13011,Banks County,,GA,1719,16256,17975,8,8,16,1389,1244,2633,6,0.29966,0.314376,52.367068,0.000762,0.001012,0,0.000272,0,20,0.652778,0.007818
13013,Barrow County,,GA,5178,58487,63665,19,13,32,6222,3496,9718,6,0.309443,0.325412,99.236638,0.005754,0.003972,0,0.000378,0,20,0.631579,0.047835
13015,Bartow County,,GA,7226,95393,102619,24,17,41,5586,4285,9871,6,0.309805,0.326501,1125.051375,0.007184,0.00426,0,0.000504,0,20,0.450142,0.063572
13017,Ben Hill County,,GA,995,17874,18869,4,3,7,433,351,784,7,0.235095,0.242411,112.04271,0.000015,0.000006,0,0.000199,0,20,0.416667,0.000444
13019,Berrien County,,GA,1527,16421,17948,4,4,8,602,829,1431,7,0.258322,0.26917,5.366667,0.000123,0.00013,0,0.000171,0,20,0.666667,0.00142
13021,Bibb County,,GA,11312,158858,170170,41,36,77,6761,7568,14329,6,0.352599,0.37732,20528.334664,0.013662,0.010767,0,0.000744,0,20,0.355102,0.098592
13023,Bleckley County,,GA,700,11820,12520,4,4,8,347,311,658,7,0.267095,0.27795,7.249634,0.000172,0.000198,0,0.000167,0,20,0.666667,0.001869
13025,Brantley County,,GA,1168,15639,16807,6,6,12,884,732,1616,6,0.305319,0.319931,281.843436,0.000848,0.000977,17,0.000201,0,20,0.733333,0.007606
13027,Brooks County,,GA,1426,14822,16248,3,3,6,794,829,1623,7,0.258322,0.268999,0,0.000123,0.000132,0,0.000117,0,20,1,0.00133
13029,Bryan County,,GA,3537,28692,32229,5,5,10,2095,1728,3823,6,0.30964,0.323711,84.317286,0.001121,0.001126,0,0.000141,0,20,0.733333,0.009611
13031,Bulloch County,,GA,4391,50092,54483,18,20,38,2435,2226,4661,6,0.314323,0.333024,14179.929025,0.00334,0.005042,0,0.000473,0,20,0.369048,0.029303
13033,Burke County,,GA,1652,24365,26017,4,6,10,694,1099,1793,7,0.274502,0.286865,283.781757,0.000349,0.000505,99,0.000111,0,20,0.309524,0.003154
13035,Butts County,,GA,2285,21318,23603,13,10,23,1970,1506,3476,6,0.306542,0.321369,229.809313,0.001978,0.002277,0,0.000317,0,20,0.589744,0.020026
13037,Calhoun County,,GA,421,5391,5812,2,2,4,89,162,251,7,0.253993,0.263492,48.093002,0.000068,0.000083,0,0.000113,0,20,0.5,0.000756
13039,Camden County,,GA,8049,46241,54290,24,27,51,3389,4398,7787,6,0.341629,0.364147,713.539624,0.010087,0.010064,17,0.000329,0,20,0.520161,0.073117
13043,Candler County,,GA,710,9323,10033,4,3,7,426,271,697,7,0.239388,0.247545,109.18187,0.000343,0.00003,0,0.000143,0,20,0.666667,0.003169
13045,Carroll County,,GA,7806,101809,109615,28,22,50,6647,5095,11742,6,0.31324,0.331959,4344.367084,0.007879,0.005715,0,0.000544,0,20,0.486207,0.060292
13047,Catoosa County,,GA,5186,59561,64747,10,9,19,4531,3754,8285,6,0.304361,0.319066,913.946385,0.001214,0.001084,130,0.000273,0,20,0.462121,0.011655
13049,Charlton County,,GA,811,9091,9902,4,4,8,428,402,830,6,0.304968,0.319187,0.601121,0.000831,0.000976,17,0.000114,0,20,0.833333,0.007407
13051,Chatham County,,GA,19832,237454,257286,104,88,192,12479,12649,25128,6,0.384057,0.417589,62030.720572,0.044698,0.03865,0,0.001414,0,20,0.417322,0.327317
13053,Chattahoochee County,,GA,3733,7021,10754,9,15,24,1057,1929,2986,6,0.334637,0.354089,180.771684,0.003126,0.005442,0,0.000149,0,20,0.708333,0.023292
13055,Chattooga County,,GA,1347,25288,26635,5,6,11,706,765,1471,7,0.275386,0.287071,65.021814,0.000057,0.000331,130,0.000172,0,20,0.571429,0.001033
13057,Cherokee County,,GA,15870,188541,204411,73,40,113,19007,10803,29810,6,0.365303,0.39106,4068.812562,0.034961,0.018592,0,0.001002,0,20,0.517563,0.263807
13059,Clarke County,,GA,11319,86410,97729,38,39,77,5997,6904,12901,6,0.361895,0.387211,19397.155718,0.009453,0.014969,0,0.000745,0,20,0.370323,0.069653
13061,Clay County,,GA,217,3000,3217,0,0,0,0,0,0,0,0,0,0,0,0,18,0.00005,14,42,0,0
13063,Clayton County,,GA,37253,249900,287153,98,69,167,31419,31165,62584,6,0.381389,0.412778,15783.486643,0.044415,0.029196,0,0.001203,0,20,0.428411,0.310935
13065,Clinch County,,GA,387,6576,6963,0,2,2,0,117,117,7,0.258296,0.26882,0,0,0.000131,0,0.00005,0,43,1,0
13067,Cobb County,,GA,74963,698850,773813,255,217,472,69282,65034,134316,5,0.435238,0.478734,102571.393208,0.09655,0.086407,0,0.003088,0,20,0.276309,0.688085
13069,Coffee County,,GA,2164,37484,39648,9,9,18,780,829,1609,6,0.306477,0.321821,15950.743314,0.000132,0.000946,0,0.000422,0,20,0.218182,0.001945
13071,Colquitt County,,GA,2027,40568,42595,9,8,17,929,840,1769,7,0.260356,0.272418,312.236921,0.000659,0.000217,0,0.000253,0,20,0.402778,0.003564
13073,Columbia County,,GA,10690,115738,126428,42,32,74,8856,5810,14666,6,0.343241,0.367921,8576.663425,0.018213,0.01387,99,0.000558,0,20,0.529469,0.136871
13075,Cook County,,GA,1281,15821,17102,4,4,8,639,690,1329,7,0.258345,0.269228,0.952381,0.000123,0.000134,0,0.000157,0,20,0.833333,0.00145
13077,Coweta County,,GA,8496,114718,123214,39,24,63,8250,4868,13118,6,0.327813,0.349164,3659.244786,0.017791,0.007737,0,0.000575,0,20,0.545958,0.132616
13079,Crawford County,,GA,1120,12723,13843,4,3,7,709,637,1346,7,0.268326,0.279422,0.333333,0.000249,0.000293,0,0.000143,0,20,0.833333,0.002565
13081,Crisp County,,GA,1422,21836,23258,7,8,15,614,589,1203,7,0.268252,0.280362,6952.497314,0.000243,0.00028,0,0.000253,0,20,0.303571,0.002654
13083,Dade County,,GA,1185,15244,16429,6,6,12,710,735,1445,7,0.275021,0.286498,9.158346,0.000226,0.000245,130,0.000201,0,20,0.633333,0.002519
13085,Dawson County,,GA,1824,18573,20397,8,7,15,1722,1169,2891,6,0.305833,0.320899,1.195423,0.002957,0.002243,0,0.000194,0,20,0.861111,0.026852
13087,Decatur County,,GA,1688,27702,29390,7,7,14,762,679,1441,7,0.280374,0.292982,7344.767669,0.000434,0.000291,17,0.000227,0,20,0.410714,0.003414
13089,DeKalb County,,GA,88848,640575,729423,220,189,409,74689,80306,154995,5,0.429584,0.471031,69841.323745,0.087168,0.077752,0,0.002618,0,20,0.305972,0.618626
13091,Dodge County,,GA,992,18596,19588,4,5,9,417,465,882,7,0.268624,0.280224,6838.812335,0.00017,0.000303,0,0.000177,0,20,0.5,0.001861
13093,Dooly County,,GA,1043,12788,13831,4,4,8,401,551,952,7,0.267316,0.278283,5.427574,0.000176,0.000194,0,0.000145,0,20,0.75,0.001834
13095,Dougherty County,,GA,8506,93114,101620,30,32,62,4249,5425,9674,6,0.339914,0.363923,40232.485094,0.010581,0.008734,0,0.000624,0,20,0.340081,0.072113
13097,Douglas County,,GA,13102,113305,126407,48,23,71,14068,9340,23408,6,0.338608,0.360309,1074.906107,0.024526,0.009051,0,0.000594,0,20,0.580694,0.167356
13099,Early County,,GA,674,12081,12755,5,4,9,272,271,543,7,0.238681,0.247302,1704.153419,0.000096,0.000057,17,0.000215,0,20,0.25,0.001434
13101,Echols County,,GA,245,2822,3067,1,1,2,89,122,211,7,0.258139,0.268369,0,0.000113,0.000123,0,0.000067,0,20,0,0.001072
13103,Effingham County,,GA,3858,48021,51879,9,6,15,3338,1996,5334,7,0.282305,0.295587,73.732867,0.002281,0.000925,0,0.000212,0,20,0.527778,0.019051
13105,Elbert County,,GA,1091,21881,22972,5,4,9,449,424,873,7,0.265996,0.275845,0,0.000772,0.000095,0,0.000166,0,20,0.95,0.006531
13107,Emanuel County,,GA,1192,22518,23710,8,7,15,558,487,1045,7,0.23998,0.249206,142.621754,0.00006,0.000045,0,0.000273,0,20,0.166667,0.001163
13109,Evans County,,GA,784,10482,11266,3,3,6,312,357,669,7,0.277619,0.289448,0,0.000343,0.000376,0,0.00011,0,20,1,0.003062
13111,Fannin County,,GA,1149,21401,22550,8,5,13,650,375,1025,7,0.235933,0.243559,6121.611862,0.002158,0.000129,0,0.000369,0,20,0.430556,0.019779
13113,Fayette County,,GA,10981,111563,122544,39,27,66,7829,6886,14715,6,0.334137,0.356667,1226.635997,0.022776,0.011307,0,0.000485,0,20,0.632747,0.163574
13115,Floyd County,,GA,5027,95720,100747,17,19,36,2660,2794,5454,6,0.31153,0.329422,3653.893684,0.004751,0.004369,0,0.000359,0,20,0.411255,0.035578
13117,Forsyth County,,GA,11869,140709,152578,65,36,101,14520,7472,21992,6,0.355833,0.380378,2769.990751,0.033186,0.016537,0,0.000857,0,20,0.54433,0.253908
13119,Franklin County,,GA,1823,22231,24054,10,8,18,1191,1114,2305,7,0.266191,0.276762,12.04078,0.001007,0.000151,0,0.000288,0,20,0.581818,0.010274
13121,Fulton County,,GA,100399,746299,846698,266,226,492,102967,91016,193983,5,0.435759,0.480836,97990.926845,0.1011,0.089109,0,0.003115,0,20,0.269712,0.717025
13123,Gilmer County,,GA,1670,25556,27226,11,6,17,1092,724,1816,6,0.303631,0.31752,2914.893867,0.003589,0.001125,0,0.000295,0,20,0.554545,0.030593
13125,Glascock County,,GA,191,2718,2909,2,0,2,91,0,91,0,0,0,0,0.000007,0,99,0.000095,0,4,0.5,0.000232
13127,Glynn County,,GA,5329,73014,78343,24,15,39,2878,2249,5127,6,0.318416,0.336575,2743.039362,0.008716,0.00533,17,0.000442,0,20,0.483696,0.064022
13129,Gordon County,,GA,3371,54289,57660,12,11,23,2445,2096,4541,6,0.304457,0.319439,1366.121201,0.001998,0.001415,0,0.000307,0,20,0.467949,0.01739
13131,Grady County,,GA,1504,23191,24695,5,6,11,866,739,1605,7,0.28135,0.294219,93.25778,0.000366,0.000374,0,0.000158,0,20,0.666667,0.002691
13133,Greene County,,GA,1156,15447,16603,6,4,10,383,400,783,7,0.265948,0.275799,6.684145,0.00206,0.00013,0,0.000169,0,20,0.761905,0.017073
13135,Gwinnett County,,GA,71092,745224,816316,252,213,465,76545,61063,137608,5,0.427313,0.472331,102870.549394,0.096895,0.082451,0,0.002986,0,20,0.271594,0.682297
13137,Habersham County,,GA,2499,38994,41493,11,7,18,1803,1426,3229,6,0.29966,0.314261,2531.323489,0.002133,0.000948,0,0.000387,0,20,0.545455,0.019114
13139,Hall County,,GA,11323,167994,179317,42,25,67,9570,7117,16687,6,0.343525,0.366586,2337.248338,0.017637,0.008216,0,0.0007,0,20,0.488384,0.134046
13141,Hancock County,,GA,586,9179,9765,1,1,2,162,238,400,7,0.237415,0.244361,0,0.000029,0.000017,0,0.000071,0,20,0,0.00024
13143,Haralson County,,GA,2163,26866,29029,6,7,13,1585,1469,3054,6,0.303663,0.317663,379.359985,0.000837,0.001237,0,0.000194,0,20,0.738095,0.008942
13145,Harris County,,GA,2524,29357,31881,7,6,13,2214,1566,3780,7,0.277301,0.289866,15.740799,0.000437,0.000368,0,0.000177,0,20,0.547619,0.003503
13147,Hart County,,GA,1390,24714,26104,8,7,15,913,712,1625,6,0.299784,0.314462,130.73585,0.000847,0.000937,0,0.000239,0,20,0.589286,0.00782
13149,Heard County,,GA,950,10351,11301,5,3,8,622,608,1230,7,0.247302,0.256471,0,0.001496,0.000233,0,0.000136,0,20,1,0.013103
13151,Henry County,,GA,18613,182067,200680,87,52,139,21866,13279,35145,6,0.369102,0.397617,13923.422107,0.038783,0.01952,0,0.001113,0,20,0.446521,0.269648
13153,Houston County,,GA,13073,138959,152032,68,56,124,7753,6868,14621,6,0.363886,0.392486,69413.811727,0.023812,0.020332,0,0.001085,0,20,0.337658,0.175431
13155,Irwin County,,GA,765,9047,9812,3,3,6,388,432,820,7,0.235095,0.242411,4.275982,0.000015,0.000006,0,0.000173,0,20,0.833333,0.00036
13157,Jackson County,,GA,4594,51684,56278,17,17,34,5576,3219,8795,6,0.309509,0.325985,597.546806,0.003883,0.003603,0,0.000418,0,20,0.488304,0.033235
13159,Jasper County,,GA,1088,13255,14343,8,6,14,981,572,1553,7,0.269919,0.2811,11.483918,0.001523,0.000579,0,0.000208,0,20,0.736111,0.014937
13161,Jeff Davis County,,GA,865,13688,14553,3,3,6,365,300,665,7,0.235266,0.242646,122.052608,0.000011,0.000001,0,0.000158,0,20,0.166667,0.000298
13163,Jefferson County,,GA,1045,19377,20422,4,7,11,295,559,854,7,0.274192,0.286378,1721.110061,0.00035,0.00039,99,0.000125,0,20,0.309524,0.003172
13165,Jenkins County,,GA,426,8287,8713,1,3,4,91,177,268,7,0.239605,0.247883,2.814736,0.000039,0.000029,0,0.00007,0,20,0.5,0.000325
13167,Johnson County,,GA,491,8298,8789,3,3,6,275,296,571,7,0.23464,0.241675,5.009524,0.000012,0.000013,0,0.000139,0,20,0.5,0.00041
13169,Jones County,,GA,2461,28602,31063,7,8,15,1667,1528,3195,7,0.283239,0.296819,111.017059,0.000287,0.000691,0,0.000211,0,20,0.388889,0.003265
13171,Lamar County,,GA,1447,15637,17084,9,7,16,1073,923,1996,7,0.276721,0.288787,32.979369,0.001224,0.000714,0,0.000248,0,20,0.763889,0.012267
13173,Lanier County,,GA,809,6887,7696,2,2,4,468,388,856,7,0.258162,0.26854,0,0.000114,0.000124,0,0.000103,0,20,1,0.001173
13175,Laurens County,,GA,2321,50554,52875,11,10,21,815,765,1580,6,0.306026,0.321105,10130.361735,0.001379,0.001361,0,0.000314,0,20,0.328571,0.012932
13177,Lee County,,GA,3011,28152,31163,8,5,13,2500,1492,3992,6,0.304139,0.31815,758.651168,0.000646,0.000838,0,0.000248,0,20,0.388889,0.004684
13179,Liberty County,,GA,9068,58823,67891,36,32,68,3931,3996,7927,6,0.345196,0.370401,5222.731071,0.015863,0.013478,0,0.000553,0,20,0.566463,0.119762
13181,Lincoln County,,GA,509,8561,9070,3,4,7,226,224,450,7,0.273702,0.285198,81.021803,0.000346,0.000386,99,0.000101,0,20,0.583333,0.003045
13183,Long County,,GA,1552,7929,9481,4,3,7,876,837,1713,7,0.278256,0.290272,1.748846,0.000419,0.000479,0,0.000127,0,20,0.833333,0.003917
13185,Lowndes County,,GA,9454,93911,103365,45,45,90,4729,4589,9318,6,0.34792,0.375344,51233.921015,0.015856,0.01453,0,0.00089,0,20,0.367794,0.126993
13187,Lumpkin County,,GA,2251,23115,25366,9,7,16,1691,1095,2786,6,0.305801,0.320842,15.895154,0.00237,0.001987,0,0.000258,0,20,0.763889,0.022481
13189,McDuffie County,,GA,1442,23630,25072,6,5,11,903,745,1648,7,0.274063,0.286,1522.031277,0.000354,0.000501,99,0.000176,0,20,0.339286,0.00337
13191,McIntosh County,,GA,787,10585,11372,3,3,6,485,406,891,7,0.278176,0.290129,0,0.000446,0.000538,17,0.000104,0,20,1,0.004199
13193,Macon County,,GA,857,10725,11582,4,5,9,329,491,820,7,0.267242,0.278254,510.915233,0.000177,0.000194,0,0.000159,0,20,0.45,0.00183
13195,Madison County,,GA,2174,27586,29760,11,10,21,1735,1565,3300,6,0.299722,0.314719,167.87479,0.000883,0.000955,0,0.000329,0,20,0.572727,0.008321
13197,Marion County,,GA,551,6829,7380,1,1,2,142,169,311,7,0.276353,0.287615,0,0.000255,0.00023,0,0.000061,0,20,0,0.001752
13199,Meriwether County,,GA,1905,23287,25192,11,10,21,1368,1303,2671,6,0.305672,0.320962,236.585777,0.001545,0.00175,0,0.000265,0,20,0.581818,0.015555
13201,Miller County,,GA,413,5262,5675,3,3,6,230,237,467,8,0.219639,0.226055,3.561187,0.000003,0.000004,17,0.000159,0,20,0.666667,0.000316
13205,Mitchell County,,GA,1404,22307,23711,6,7,13,749,767,1516,7,0.253949,0.264219,37.859295,0.000084,0.0001,0,0.000193,0,20,0.410714,0.001248
13207,Monroe County,,GA,1833,24527,26360,9,8,17,1334,943,2277,6,0.305319,0.320292,96.426246,0.001372,0.001437,0,0.000229,0,20,0.708333,0.013556
13209,Montgomery County,,GA,681,7835,8516,2,2,4,302,324,626,8,0.217586,0.223567,1926.027454,0.000003,0.000003,0,0.00014,0,20,0.5,0.00021
13211,Morgan County,,GA,1178,17995,19173,10,7,17,1014,584,1598,6,0.300931,0.314645,165.6004,0.001495,0.00095,0,0.000273,0,20,0.677778,0.013887
13213,Murray County,,GA,3245,40296,43541,8,6,14,2456,2236,4692,7,0.242743,0.251637,118.38173,0.001156,0.000142,0,0.000236,0,20,0.482143,0.009744
13215,Muscogee County,,GA,19744,193274,213018,78,78,156,11921,13361,25282,6,0.38184,0.414353,31470.744313,0.029661,0.032848,0,0.001029,0,20,0.425836,0.213232
13217,Newton County,,GA,8647,87880,96527,29,18,47,9773,5951,15724,6,0.316236,0.334507,855.299624,0.012846,0.005269,0,0.000427,0,20,0.539315,0.082811
13219,Oconee County,,GA,2695,31107,33802,14,10,24,2141,1537,3678,6,0.307644,0.322978,395.807622,0.002906,0.002424,0,0.000344,0,20,0.648352,0.025509
13221,Oglethorpe County,,GA,1120,13312,14432,5,4,9,898,615,1513,7,0.265923,0.275771,0,0.00081,0.000133,0,0.000157,0,20,1,0.006843
13223,Paulding County,,GA,10502,117227,127729,46,17,63,14606,7050,21656,6,0.314935,0.332686,2040.294187,0.021603,0.005448,0,0.000634,0,20,0.557823,0.154882
13225,Peach County,,GA,2500,24695,27195,5,4,9,1561,1529,3090,7,0.268401,0.279709,11.727642,0.000247,0.000294,0,0.000171,0,20,0.5,0.002643
13227,Pickens County,,GA,2095,28124,30219,11,8,19,1944,1215,3159,6,0.307351,0.322205,5523.781003,0.002949,0.002329,0,0.000316,0,20,0.636364,0.027141
13229,Pierce County,,GA,1266,17092,18358,5,4,9,837,677,1514,7,0.242157,0.250389,5.879202,0.000743,0.000091,0,0.000193,0,20,0.733333,0.006503
13231,Pike County,,GA,1283,16814,18097,8,5,13,1453,726,2179,7,0.269719,0.280556,1.742296,0.000588,0.000363,0,0.000222,0,20,0.767857,0.008005
13233,Polk County,,GA,2182,39903,42085,8,8,16,1518,1345,2863,6,0.304012,0.318408,9.717495,0.001595,0.001133,0,0.000213,0,20,0.688889,0.015401
13235,Pulaski County,,GA,648,9358,10006,2,2,4,202,247,449,7,0.26685,0.277275,0,0.000159,0.000186,0,0.000102,0,20,1,0.001574
13237,Putnam County,,GA,1521,20151,21672,12,7,19,868,669,1537,7,0.261456,0.272103,165.182117,0.002951,0.000264,0,0.00028,0,20,0.565934,0.026406
13239,Quitman County,,GA,207,2067,2274,1,1,2,98,92,190,8,0.219523,0.225497,0,0.000003,0.000003,0,0.000077,0,20,0,0.00013
13241,Rabun County,,GA,1036,15949,16985,5,2,7,266,197,463,7,0.231614,0.238436,11.613589,0.001567,0.000063,0,0.000249,0,20,0.5,0.014213
13243,Randolph County,,GA,411,7502,7913,1,1,2,54,76,130,7,0.253705,0.262902,0,0.000068,0.000082,0,0.000067,0,20,0,0.000652
13245,Richmond County,,GA,21207,198015,219222,70,67,137,11485,13940,25425,6,0.375629,0.406707,35833.778635,0.031038,0.03066,99,0.00087,0,20,0.473485,0.223973
13247,Rockdale County,,GA,10362,75656,86018,27,19,46,8246,7453,15699,6,0.309706,0.326558,471.141548,0.014461,0.004679,0,0.000348,0,20,0.549206,0.097327
13249,Schley County,,GA,420,4460,4880,2,1,3,294,178,472,7,0.236451,0.243141,0,0.000017,0.000006,0,0.000102,0,20,1,0.000249
13251,Screven County,,GA,969,15009,15978,4,3,7,357,492,849,7,0.277619,0.289448,6.719265,0.00035,0.00039,0,0.00013,0,20,0.5,0.003285
13253,Seminole County,,GA,676,9085,9761,3,4,7,313,377,690,7,0.238818,0.247652,105.030648,0.000003,0.000061,17,0.000169,0,20,0.5,0.000316
13255,Spalding County,,GA,5174,61656,66830,18,16,34,4179,3595,7774,6,0.310831,0.327537,489.917108,0.004377,0.004224,0,0.000381,0,20,0.542105,0.034809
13257,Stephens County,,GA,1802,26152,27954,5,7,12,720,800,1520,6,0.299629,0.314204,49.825689,0.000719,0.000956,0,0.000193,0,20,0.738095,0.007072
13259,Stewart County,,GA,411,4699,5110,1,2,3,55,138,193,7,0.276406,0.287844,2970,0.000255,0.00023,0,0.000061,0,20,0,0.001752
13261,Sumter County,,GA,2148,31539,33687,7,10,17,671,884,1555,6,0.30964,0.325412,6085.990007,0.00075,0.001933,0,0.000292,0,20,0.4,0.006632
13263,Talbot County,,GA,541,7168,7709,3,3,6,276,299,575,7,0.276458,0.288073,0,0.000271,0.000246,0,0.000109,0,20,1,0.002088
13265,Taliaferro County,,GA,114,1769,1883,0,0,0,0,0,0,0,0,0,0,0,0,19,0.00005,15,44,0,0
13267,Tattnall County,,GA,1451,18598,20049,6,7,13,590,672,1262,7,0.278309,0.290874,177.762088,0.00045,0.000507,0,0.000216,0,20,0.5,0.004289
13269,Taylor County,,GA,571,8875,9446,1,3,4,44,156,200,7,0.266997,0.277733,5.375301,0.000158,0.00019,0,0.000067,0,20,0.333333,0.001469
13271,Telfair County,,GA,826,10876,11702,3,3,6,285,302,587,8,0.21213,0.218337,1104.347084,0.000002,0.000001,0,0.00017,0,20,0,0.000285
13273,Terrell County,,GA,795,10707,11502,2,2,4,317,438,755,7,0.253727,0.263074,0,0.000074,0.000087,0,0.000109,0,20,1,0.000784
13275,Thomas County,,GA,3050,44606,47656,9,9,18,1303,1432,2735,6,0.304012,0.319198,654.768681,0.000536,0.00115,0,0.000247,0,20,0.411111,0.004429
13277,Tift County,,GA,2644,40401,43045,10,12,22,1381,1193,2574,6,0.306994,0.322995,14065.384853,0.000606,0.001028,0,0.000379,0,20,0.25,0.006796
13279,Toombs County,,GA,1834,26004,27838,7,5,12,758,612,1370,7,0.277884,0.290164,10911.593401,0.000347,0.000377,0,0.000267,0,20,0.261905,0.003439
13281,Towns County,,GA,731,9682,10413,2,2,4,190,201,391,9,0.160738,0.16351,0,0.000001,0.000041,17,0.000246,0,20,1,0.000505
13283,Treutlen County,,GA,320,6204,6524,2,0,2,116,0,116,0,0,0,0,0.000011,0,0,0.00011,0,8,1,0.000303
13285,Troup County,,GA,3925,65641,69566,17,14,31,2359,2098,4457,6,0.311097,0.327789,2043.197471,0.004306,0.003786,0,0.000342,0,20,0.547794,0.03301
13287,Turner County,,GA,618,9747,10365,3,2,5,190,222,412,7,0.235456,0.242766,4.901407,0.000011,0.000007,0,0.00013,0,20,0.666667,0.000371
13289,Twiggs County,,GA,879,10161,11040,3,4,7,460,572,1032,7,0.268425,0.279766,1.116667,0.000247,0.000304,0,0.000107,0,20,0.833333,0.002452
13291,Union County,,GA,1193,18818,20011,12,4,16,729,318,1047,8,0.191498,0.196097,7565.306102,0.005298,0.000052,17,0.000475,0,20,0.515152,0.04283
13293,Upson County,,GA,1530,27992,29522,7,7,14,688,624,1312,7,0.277407,0.289881,42.115691,0.000434,0.000812,0,0.000213,0,20,0.535714,0.00566
13295,Walker County,,GA,4553,64170,68723,9,11,20,3567,3309,6876,7,0.275516,0.287987,159.450016,0.000311,0.000387,130,0.000263,0,20,0.445455,0.003784
13297,Walton County,,GA,5617,75863,81480,18,17,35,6456,3712,10168,6,0.309607,0.326157,196.197013,0.004989,0.004093,0,0.000376,0,20,0.571053,0.042486
13299,Ware County,,GA,2516,34134,36650,11,7,18,1189,1209,2398,6,0.30638,0.321449,4854.61119,0.001002,0.001013,0,0.000329,0,20,0.354545,0.009642
13301,Warren County,,GA,552,6630,7182,2,2,4,212,317,529,7,0.273137,0.284259,0,0.000242,0.000244,99,0.000091,0,20,1,0.001935
13303,Washington County,,GA,968,21523,22491,4,4,8,267,281,548,7,0.260987,0.270889,470.182473,0.00027,0.000134,0,0.000137,0,20,0.366667,0.002263
13305,Wayne County,,GA,1524,26598,28122,8,9,17,747,645,1392,6,0.306026,0.321392,3554.321485,0.00117,0.00137,17,0.000241,0,20,0.472222,0.010592
13307,Webster County,,GA,180,2441,2621,1,0,1,45,0,45,0,0,0,0,0.000002,0,0,0.000076,0,16,0,0.000098
13309,Wheeler County,,GA,374,4779,5153,2,3,5,135,211,346,8,0.217749,0.224008,23.795202,0,0.000003,0,0.000158,0,20,0.333333,0.000181
13311,White County,,GA,2058,23176,25234,9,6,15,1426,1061,2487,6,0.299598,0.314032,8.328162,0.002185,0.00096,0,0.000258,0,20,0.75,0.020062
13313,Whitfield County,,GA,6824,106278,113102,13,15,28,3647,4267,7914,6,0.316924,0.334679,2046.933682,0.00493,0.004416,0,0.000261,0,20,0.494737,0.03537
13315,Wilcox County,,GA,442,7015,7457,1,2,3,94,135,229,8,0.211806,0.217885,8.320586,0.000002,0.000002,0,0.000077,0,20,0,0.000116
13317,Wilkes County,,GA,591,10995,11586,2,3,5,83,164,247,7,0.266045,0.275788,14.430405,0.000119,0.000079,99,0.000088,0,20,0.166667,0.000761
13319,Wilkinson County,,GA,752,11230,11982,2,3,5,247,354,601,7,0.260799,0.270385,0,0.000112,0.000125,0,0.000089,0,20,1,0.001103
13321,Worth County,,GA,1619,22571,24190,6,7,13,968,1052,2020,7,0.254126,0.264592,117.865795,0.000087,0.0001,0,0.000213,0,20,0.5,0.001281
15001,Hawaii County,,HI,7342,169757,177099,43,22,65,7000,3541,10541,6,0.345934,0.36819,18.905322,0.020126,0.013095,6,0.00046,0,20,0.828753,0.153024
15003,Honolulu County,,HI,68471,1017444,1085915,263,259,522,45842,51491,97333,5,0.444886,0.491609,61092.625206,0.097774,0.09247,6,0.002701,0,20,0.24962,0.69397
15005,Kalawao County,,HI,-2,-2,-4,0,0,0,0,0,0,0,0,0,0,0,0,20,0.00005,16,45,0,0
15007,Kauai County,,HI,3286,68368,71654,8,7,15,633,1411,2044,6,0.339042,0.358047,0,0.006492,0.005501,6,0.000121,0,20,0.988889,0.048548
15009,Maui County,,HI,7945,152734,160679,32,26,58,4399,4314,8713,6,0.348253,0.371569,6.767953,0.016679,0.014146,6,0.000349,0,20,0.911765,0.125435
16001,Ada County,,ID,26032,372684,398716,131,87,218,29692,19294,48986,6,0.372552,0.40571,68129.117329,0.036773,0.026743,6,0.001947,0,20,0.305471,0.289955
16003,Adams County,,ID,391,3880,4271,2,2,4,109,113,222,7,0.271481,0.283096,0,0.000211,0.000288,6,0.000109,0,20,1,0.002522
16005,Bannock County,,ID,6589,79766,86355,27,27,54,3651,3833,7484,6,0.33853,0.360493,21020.418409,0.007007,0.005579,6,0.000618,0,20,0.385918,0.056294
16007,Bear Lake County,,ID,493,6669,7162,1,1,2,55,63,118,7,0.252934,0.261404,0,0.000043,0.000054,6,0.00007,0,20,0,0.000545
16009,Benewah County,,ID,707,9374,10081,3,2,5,338,333,671,7,0.270899,0.283185,0,0.000327,0.000356,6,0.000106,0,20,1,0.003251
16011,Bingham County,,ID,3705,46236,49941,13,12,25,1917,2512,4429,6,0.322939,0.340842,1777.74305,0.003288,0.002532,6,0.000293,0,20,0.775641,0.02896
16013,Blaine County,,ID,1925,22830,24755,9,6,15,603,588,1191,6,0.309542,0.324731,4341.852277,0.003367,0.001347,6,0.0002,0,20,0.472727,0.026387
16015,Boise County,,ID,780,6503,7283,2,3,5,521,508,1029,7,0.271785,0.283623,0,0.000291,0.000441,6,0.000093,0,20,1,0.003719
16017,Bonner County,,ID,3040,38897,41937,15,10,25,1531,1454,2985,6,0.335215,0.354089,1625.538134,0.007087,0.003547,6,0.000278,0,20,0.709524,0.055618
16019,Bonneville County,,ID,7394,100213,107607,32,23,55,5932,4623,10555,6,0.345606,0.367887,6330.160136,0.010096,0.007463,6,0.00053,0,20,0.475045,0.080951
16021,Boundary County,,ID,794,10643,11437,2,3,5,287,299,586,7,0.270924,0.283357,0,0.000114,0.000411,6,0.000094,0,20,1,0.001622
16023,Butte County,,ID,204,2950,3154,0,0,0,0,0,0,0,0,0,0,0,0,21,0.00005,17,46,0,0
16025,Camas County,,ID,122,952,1074,1,0,1,60,0,60,0,0,0,0,0.00001,0,6,0.000079,0,7,0,0.000291
16027,Canyon County,,ID,13804,164437,178241,73,38,111,16124,9920,26044,6,0.34738,0.371856,14170.717771,0.019756,0.010786,6,0.001052,0,20,0.403765,0.152638
16029,Caribou County,,ID,658,7642,8300,1,1,2,99,165,264,7,0.252934,0.261404,0,0.000043,0.000054,6,0.00007,0,20,0,0.000545
16031,Cassia County,,ID,2066,21666,23732,4,8,12,849,1321,2170,6,0.300341,0.314822,93.635309,0.000585,0.001348,6,0.000124,0,20,0.75,0.005212
16033,Clark County,,ID,95,991,1086,0,0,0,0,0,0,0,0,0,0,0,0,22,0.00005,18,47,0,0
16035,Clearwater County,,ID,637,8589,9226,2,1,3,179,178,357,7,0.23699,0.243736,0,0.000016,0.00001,6,0.000098,0,20,1,0.000326
16037,Custer County,,ID,422,4241,4663,0,0,0,0,0,0,0,0,0,0,0,0,23,0.00005,19,48,0,0
16039,Elmore County,,ID,4846,26649,31495,12,14,26,1238,1616,2854,6,0.342232,0.363184,780.820872,0.004939,0.005416,6,0.000222,0,20,0.639706,0.039053
16041,Franklin County,,ID,1012,13365,14377,4,2,6,348,369,717,7,0.262328,0.272217,0,0.000759,0.000119,6,0.000105,0,20,1,0.00615
16043,Fremont County,,ID,1146,13324,14470,4,5,9,504,611,1115,7,0.271886,0.28423,0,0.000149,0.000475,6,0.000133,0,20,1,0.001949
16045,Gem County,,ID,1462,16802,18264,4,3,7,737,890,1627,7,0.271785,0.283623,0.333333,0.000298,0.000441,6,0.000151,0,20,0.833333,0.003957
16047,Gooding County,,ID,1480,14533,16013,3,5,8,517,853,1370,7,0.271683,0.283898,49.260118,0.000038,0.000382,6,0.000122,0,20,0.85,0.000855
16049,Idaho County,,ID,1110,14385,15495,5,6,11,331,536,867,7,0.271709,0.28407,1110.675498,0.000391,0.00033,6,0.000177,0,20,0.517857,0.00511
16051,Jefferson County,,ID,2191,23984,26175,10,7,17,1674,1471,3145,6,0.297637,0.311867,304.456742,0.002292,0.000993,6,0.000216,0,20,0.866667,0.019748
16053,Jerome County,,ID,2162,19468,21630,6,7,13,1236,1339,2575,7,0.271988,0.284539,160.58064,0.000258,0.000535,6,0.000176,0,20,0.553571,0.003471
16055,Kootenai County,,ID,8980,134153,143133,56,35,91,8428,5721,14149,6,0.347048,0.371294,8626.427979,0.016511,0.011199,6,0.000815,0,20,0.47303,0.127502
16057,Latah County,,ID,4109,33161,37270,14,14,28,1688,1876,3564,6,0.335369,0.355017,436.889731,0.003211,0.003836,6,0.000297,0,20,0.610294,0.028281
16059,Lemhi County,,ID,605,7838,8443,1,1,2,58,48,106,7,0.271455,0.282924,0,0.000208,0.000285,6,0.000069,0,20,0,0.002405
16061,Lewis County,,ID,332,4132,4464,2,2,4,137,143,280,7,0.237009,0.243908,0,0.000016,0.000013,6,0.000098,0,20,1,0.000326
16063,Lincoln County,,ID,518,4716,5234,4,4,8,271,269,540,7,0.252538,0.261255,1.098839,0.00005,0.000097,6,0.000141,0,20,0.833333,0.001143
16065,Madison County,,ID,4583,24598,29181,16,16,32,2027,2784,4811,6,0.337587,0.35803,2054.89439,0.005013,0.005114,6,0.000325,0,20,0.628947,0.042152
16067,Minidoka County,,ID,1848,21089,22937,4,5,9,803,1095,1898,7,0.271937,0.284345,4.457677,0.000131,0.000415,6,0.000129,0,20,0.8,0.002199
16069,Nez Perce County,,ID,3159,40122,43281,10,12,22,1848,2005,3853,6,0.310566,0.326627,10803.230194,0.001343,0.001696,6,0.000317,0,20,0.469697,0.012725
16071,Oneida County,,ID,311,4397,4708,1,2,3,59,112,171,7,0.252977,0.261633,0.748918,0.000018,0.00008,6,0.000072,0,20,0.5,0.000301
16073,Owyhee County,,ID,1248,10641,11889,3,3,6,770,845,1615,7,0.2726,0.284642,0,0.000333,0.000477,6,0.000106,0,20,1,0.004113
16075,Payette County,,ID,2115,21920,24035,5,5,10,1411,1193,2604,7,0.271937,0.284167,1.78125,0.000302,0.000446,6,0.000191,0,20,0.8,0.004089
16077,Power County,,ID,592,8148,8740,2,2,4,258,278,536,7,0.252955,0.261576,0,0.000063,0.00008,6,0.00009,0,20,1,0.000867
16079,Shoshone County,,ID,935,12297,13232,2,2,4,461,428,889,7,0.270899,0.283185,0,0.000314,0.000356,6,0.000084,0,20,1,0.003056
16081,Teton County,,ID,845,7820,8665,2,3,5,312,260,572,7,0.257294,0.266393,1.001625,0.000067,0.000136,8,0.000083,0,20,0.5,0.000969
16083,Twin Falls County,,ID,5443,73013,78456,30,20,50,4272,3105,7377,6,0.3363,0.357113,10140.873405,0.00882,0.004217,6,0.000486,0,20,0.473118,0.068203
16085,Valley County,,ID,1053,9166,10219,3,3,6,629,435,1064,7,0.271785,0.283623,1.752157,0.000293,0.00044,6,0.000139,0,20,0.666667,0.003825
16087,Washington County,,ID,909,9794,10703,4,4,8,380,497,877,7,0.271912,0.283995,0,0.000299,0.000444,6,0.000149,0,20,1,0.003971
17001,Adams County,,IL,3066,79095,82161,10,13,23,1054,1164,2218,6,0.331511,0.350155,13592.068752,0.00165,0.002085,37,0.000336,0,20,0.302198,0.01242
17003,Alexander County,,IL,698,7850,8548,3,3,6,192,290,482,7,0.236336,0.243585,427.52014,0.000014,0.000011,37,0.000126,0,20,0.833333,0.000398
17005,Bond County,,IL,1186,18112,19298,5,6,11,665,662,1327,6,0.305865,0.319473,164.094692,0.000298,0.000864,37,0.00014,0,20,0.6,0.002573
17007,Boone County,,IL,4847,59716,64563,10,12,22,5513,3568,9081,6,0.341109,0.360779,1.923796,0.00321,0.003828,166,0.000131,0,20,0.848485,0.020396
17009,Brown County,,IL,394,5770,6164,3,1,4,149,51,200,7,0.248995,0.256474,11.98475,0.000018,0.000013,37,0.000116,0,20,0.333333,0.000382
17011,Bureau County,,IL,2369,42442,44811,9,10,19,1463,1270,2733,6,0.328442,0.345756,1712.164729,0.002294,0.001928,166,0.000159,0,20,0.618182,0.015408
17013,Calhoun County,,IL,281,6012,6293,2,2,4,143,123,266,7,0.269569,0.2798,0,0.00011,0.000093,37,0.000096,0,20,1,0.000915
17015,Carroll County,,IL,1022,19627,20649,7,6,13,509,511,1020,7,0.256523,0.265843,6.912916,0.001931,0.000102,166,0.000132,0,20,0.611111,0.013026
17017,Cass County,,IL,994,15514,16508,3,3,6,287,458,745,7,0.264425,0.27464,154.937085,0.000088,0.000063,166,0.000115,0,20,0.333333,0.000768
17019,Champaign County,,IL,14920,188317,203237,52,60,112,7398,8572,15970,5,0.383905,0.413425,26820.564884,0.017975,0.026064,166,0.000707,0,20,0.435404,0.129318
17021,Christian County,,IL,1996,40533,42529,5,4,9,935,898,1833,7,0.265341,0.275751,16.833241,0.000113,0.00009,166,0.000144,0,20,0.55,0.001184
17023,Clark County,,IL,1098,19447,20545,5,5,10,492,540,1032,7,0.257545,0.26716,2988.984312,0.000045,0.000043,166,0.00017,0,20,0.3,0.000828
17025,Clay County,,IL,1005,16346,17351,5,6,11,381,508,889,7,0.250021,0.259039,3109.271154,0.000023,0.000016,166,0.000213,0,20,0.261905,0.000521
17027,Clinton County,,IL,1952,42804,44756,7,7,14,1468,1123,2591,6,0.305962,0.319691,171.516377,0.000914,0.000871,37,0.000169,0,20,0.690476,0.007047
17029,Coles County,,IL,3713,50663,54376,14,15,29,1911,1839,3750,6,0.329857,0.348293,15662.127578,0.001654,0.001662,166,0.000316,0,20,0.358333,0.012035
17031,Cook County,,IL,280949,5732996,6013945,421,479,900,165957,261826,427783,5,0.487437,0.548041,615132.095927,0.118118,0.121875,166,0.004961,0,20,0.119137,0.833173
17033,Crawford County,,IL,916,22894,23810,3,4,7,247,242,489,7,0.231154,0.238356,96.081483,0,0.000005,130,0.00014,0,20,0.166667,0.00028
17035,Cumberland County,,IL,816,12581,13397,4,4,8,494,448,942,7,0.249379,0.257716,8.217322,0.000029,0.000014,166,0.000131,0,20,0.666667,0.000506
17037,DeKalb County,,IL,8533,99938,108471,15,17,32,7891,5667,13558,6,0.342918,0.363562,72.672104,0.003474,0.005046,166,0.000202,0,20,0.673203,0.022381
17039,De Witt County,,IL,1191,19329,20520,5,5,10,796,597,1393,6,0.281159,0.292239,4.333478,0.000345,0.00029,166,0.000132,0,20,0.8,0.002623
17041,Douglas County,,IL,1489,25266,26755,5,5,10,747,827,1574,6,0.277857,0.289003,34.690772,0.000245,0.000157,166,0.000139,0,20,0.566667,0.001775
17043,DuPage County,,IL,90185,1065279,1155464,158,198,356,67278,80422,147700,5,0.428319,0.470601,36939.134619,0.068019,0.077972,166,0.001653,0,20,0.327255,0.476571
17045,Edgar County,,IL,1176,21551,22727,6,6,12,532,542,1074,6,0.278923,0.29063,227.321452,0.000071,0.000202,166,0.000183,0,20,0.375,0.001081
17047,Edwards County,,IL,443,8024,8467,3,2,5,143,157,300,8,0.210503,0.21558,136.006451,0.000001,0,166,0.000176,0,20,0.166667,0.00028
17049,Effingham County,,IL,2271,42960,45231,7,13,20,865,1016,1881,6,0.331246,0.349811,10170.412477,0.000022,0.001909,166,0.000209,0,20,0.371795,0.000814
17051,Fayette County,,IL,1145,24363,25508,6,8,14,554,646,1200,7,0.27032,0.281868,1016.730082,0.000135,0.000094,166,0.000163,0,20,0.375,0.001321
17053,Ford County,,IL,1229,16496,17725,4,5,9,668,708,1376,6,0.28032,0.291489,1.420908,0.000325,0.000302,166,0.000106,0,20,0.75,0.00243
17055,Franklin County,,IL,2173,43150,45323,9,7,16,1173,1089,2262,7,0.261033,0.271278,3272.862599,0.001199,0.000061,37,0.000281,0,20,0.418182,0.009345
17057,Fulton County,,IL,2026,41610,43636,6,6,12,1043,1087,2130,6,0.277196,0.288305,247.040563,0.000179,0.000259,166,0.000154,0,20,0.547619,0.001676
17059,Gallatin County,,IL,352,6560,6912,2,2,4,125,181,306,8,0.210977,0.216262,4.545455,0.000001,0.000001,37,0.000116,0,20,0.5,0.000198
17061,Greene County,,IL,914,16258,17172,4,6,10,369,543,912,7,0.270824,0.282297,184.375127,0.000125,0.000171,37,0.000146,0,20,0.566667,0.001276
17063,Grundy County,,IL,4126,54358,58484,8,8,16,5339,2582,7921,6,0.328109,0.345011,1.713998,0.002326,0.002041,166,0.000126,0,20,0.839286,0.015393
17065,Hamilton County,,IL,434,9294,9728,4,3,7,197,187,384,7,0.248782,0.256531,16.140544,0.000011,0.00002,37,0.000173,0,20,0.333333,0.000544
17067,Hancock County,,IL,1437,23321,24758,4,5,9,546,658,1204,7,0.25097,0.259899,62.121051,0.000044,0.000033,24,0.000133,0,20,0.35,0.000642
17069,Hardin County,,IL,269,4512,4781,1,1,2,54,103,157,8,0.210778,0.215712,0,0,0,37,0.000096,0,20,0,0.000105
17071,Henderson County,,IL,560,8810,9370,3,2,5,219,188,407,7,0.24876,0.256307,6.480736,0.000012,0.000012,24,0.000123,0,20,0.333333,0.000376
17073,Henry County,,IL,3638,61470,65108,9,12,21,1932,2225,4157,6,0.341269,0.361008,1189.215228,0.001221,0.002395,166,0.000198,0,20,0.5,0.009532
17075,Iroquois County,,IL,2095,36542,38637,7,6,13,1246,1172,2418,6,0.328257,0.345011,218.798412,0.001568,0.001395,166,0.000135,0,20,0.547619,0.010869
17077,Jackson County,,IL,5987,51671,57658,16,20,36,2338,2941,5279,6,0.350349,0.373288,12739.476394,0.003667,0.005585,37,0.000321,0,20,0.430736,0.025184
17079,Jasper County,,IL,604,12436,13040,2,3,5,170,236,406,7,0.249251,0.257275,94.573761,0.000015,0,166,0.000094,0,20,0,0.000195
17081,Jefferson County,,IL,2318,41991,44309,10,11,21,981,1016,1997,6,0.329895,0.347577,12038.998731,0.001266,0.001254,37,0.000302,0,20,0.427273,0.009976
17083,Jersey County,,IL,1455,25992,27447,6,5,11,1049,933,1982,6,0.303694,0.316913,357.580236,0.000934,0.000687,37,0.000175,0,20,0.533333,0.007214
17085,Jo Daviess County,,IL,1374,27620,28994,6,4,10,771,676,1447,7,0.258391,0.267598,144.675267,0.00161,0.000053,166,0.000143,0,20,0.428571,0.011431
17087,Johnson County,,IL,770,12281,13051,4,4,8,342,406,748,7,0.250086,0.258346,201.401604,0.000015,0.000027,37,0.000217,0,20,0.4,0.000532
17089,Kane County,,IL,39682,523265,562947,63,87,150,35288,31952,67240,5,0.402156,0.434158,6549.858356,0.026503,0.040343,166,0.000714,0,20,0.475384,0.191947
17091,Kankakee County,,IL,6152,122516,128668,11,16,27,4658,3171,7829,6,0.346181,0.367405,376.715961,0.002828,0.005108,166,0.000174,0,20,0.566176,0.018395
17093,Kendall County,,IL,7632,97657,105289,10,10,20,15257,5167,20424,6,0.340829,0.360149,12.451421,0.00314,0.003656,166,0.000143,0,20,0.854545,0.01996
17095,Knox County,,IL,3254,58219,61473,11,12,23,1389,1432,2821,6,0.341349,0.361123,3101.75117,0.002244,0.002362,166,0.000234,0,20,0.537879,0.018046
17097,Lake County,,IL,50101,775564,825665,119,165,284,39752,39808,79560,5,0.421312,0.460664,12882.772882,0.058624,0.071833,166,0.001155,0,20,0.387678,0.406787
17099,LaSalle County,,IL,6607,136434,143041,19,20,39,4927,4027,8954,6,0.341629,0.36244,4796.099298,0.004276,0.004093,166,0.000303,0,20,0.5,0.030555
17101,Lawrence County,,IL,1040,16392,17432,3,4,7,297,466,763,7,0.231007,0.238121,2508.042883,0.000005,0.000005,130,0.000161,0,20,0.083333,0.000322
17103,Lee County,,IL,2447,40959,43406,11,9,20,1763,1457,3220,6,0.328146,0.345183,449.723777,0.002476,0.00188,166,0.000172,0,20,0.763636,0.016751
17105,Livingston County,,IL,2528,44978,47506,8,11,19,1208,1490,2698,6,0.32848,0.345928,174.630791,0.002089,0.001668,166,0.000143,0,20,0.666667,0.014603
17107,Logan County,,IL,2006,32139,34145,7,8,15,799,1029,1828,6,0.328517,0.345641,191.030474,0.00036,0.001241,166,0.000169,0,20,0.714286,0.00309
17109,McDonough County,,IL,2436,29577,32013,9,11,20,784,972,1756,6,0.328814,0.346386,8090.306996,0.00113,0.00164,166,0.000222,0,20,0.372727,0.008697
17111,McHenry County,,IL,20983,358201,379184,31,44,75,21341,15004,36345,6,0.369242,0.39689,618.433644,0.013944,0.022496,166,0.000335,0,20,0.624422,0.095894
17113,McLean County,,IL,11057,174837,185894,50,38,88,7206,5817,13023,6,0.370465,0.396735,12279.725688,0.014415,0.012786,166,0.000702,0,20,0.34271,0.10402
17115,Macon County,,IL,6207,127168,133375,20,20,40,2561,3002,5563,6,0.334868,0.355126,5933.505857,0.00434,0.004037,166,0.000357,0,20,0.45671,0.030551
17117,Macoupin County,,IL,3283,55661,58944,9,8,17,2004,2119,4123,6,0.306187,0.320246,688.518258,0.00193,0.000927,37,0.000215,0,20,0.555556,0.014357
17119,Madison County,,IL,15074,308609,323683,45,43,88,10076,9809,19885,6,0.368962,0.396644,33440.375408,0.011085,0.013485,37,0.000787,0,20,0.300125,0.082086
17121,Marion County,,IL,2250,46108,48358,9,11,20,958,1056,2014,6,0.307254,0.321718,4948.821126,0.000324,0.00092,37,0.000236,0,20,0.431818,0.003119
17123,Marshall County,,IL,1067,16046,17113,6,4,10,574,517,1091,6,0.270145,0.280487,31.116124,0.001134,0.000162,166,0.000146,0,20,0.7,0.008471
17125,Mason County,,IL,1247,17798,19045,5,6,11,524,798,1322,6,0.271076,0.281993,22.404397,0.000237,0.000179,166,0.000136,0,20,0.6,0.001825
17127,Massac County,,IL,980,17376,18356,4,3,7,322,377,699,7,0.240655,0.248181,6062.281894,0.000015,0.000023,130,0.000256,0,20,0,0.000557
17129,Menard County,,IL,1038,14958,15996,2,1,3,637,532,1169,7,0.264233,0.273953,0,0.000081,0.000054,166,0.000085,0,20,1,0.00063
17131,Mercer County,,IL,1217,21203,22420,6,6,12,758,782,1540,7,0.268153,0.278085,32.5438,0.000166,0.000153,166,0.000155,0,20,0.666667,0.001771
17133,Monroe County,,IL,2044,39106,41150,6,7,13,1890,1347,3237,6,0.305608,0.319284,32.741804,0.001136,0.001299,37,0.000143,0,20,0.833333,0.008476
17135,Montgomery County,,IL,1625,33795,35420,6,6,12,959,840,1799,7,0.270924,0.282469,33.928372,0.000199,0.00016,37,0.000172,0,20,0.5,0.001817
17137,Morgan County,,IL,2355,39231,41586,7,8,15,1083,1098,2181,6,0.328962,0.346231,7154.905795,0.001035,0.001075,166,0.000257,0,20,0.392857,0.007908
17139,Moultrie County,,IL,1166,17370,18536,5,5,10,582,647,1229,6,0.278709,0.289782,56.212195,0.000249,0.000188,166,0.000138,0,20,0.7,0.001869
17141,Ogle County,,IL,3848,63816,67664,13,11,24,3265,2329,5594,6,0.32822,0.345527,472.050092,0.003213,0.001998,166,0.000185,0,20,0.692308,0.020669
17143,Peoria County,,IL,13636,210512,224148,41,40,81,7879,8954,16833,5,0.369665,0.396334,16220.222506,0.011225,0.013979,166,0.000609,0,20,0.380408,0.077931
17145,Perry County,,IL,1191,23140,24331,6,5,11,679,636,1315,7,0.260729,0.270516,13.468229,0.000252,0.00006,37,0.000174,0,20,0.6,0.002365
17147,Piatt County,,IL,1339,19756,21095,5,5,10,943,810,1753,6,0.281159,0.292239,10.846473,0.000336,0.00029,166,0.000137,0,20,0.7,0.002609
17149,Pike County,,IL,1039,18509,19548,4,5,9,261,381,642,7,0.271025,0.282515,70.961039,0.000111,0.000161,37,0.000134,0,20,0.333333,0.001014
17151,Pope County,,IL,235,4302,4537,1,1,2,40,66,106,8,0.193987,0.19786,0,0,0,130,0.000123,0,20,0,0.000095
17153,Pulaski County,,IL,501,6874,7375,2,4,6,143,203,346,7,0.236701,0.244237,16.699291,0.000001,0.000012,37,0.000112,0,20,0.5,0.000195
17155,Putnam County,,IL,557,7395,7952,2,3,5,253,347,600,7,0.254771,0.263231,0.25,0.000047,0.00006,166,0.000077,0,20,0.666667,0.000555
17157,Randolph County,,IL,1753,36046,37799,7,7,14,891,979,1870,6,0.305769,0.319485,231.322878,0.00035,0.000898,37,0.000189,0,20,0.5,0.003011
17159,Richland County,,IL,1095,18723,19818,4,3,7,309,175,484,8,0.200995,0.206278,63.179687,0,0,166,0.000216,0,20,0.15,0.00037
17161,Rock Island County,,IL,9381,172879,182260,19,24,43,4890,5667,10557,6,0.349928,0.372394,6075.695013,0.005558,0.005944,166,0.000332,0,20,0.437192,0.041132
17163,St. Clair County,,IL,18267,294428,312695,69,65,134,11910,11543,23453,6,0.386352,0.416438,31241.04325,0.0238,0.023733,37,0.000915,0,20,0.329959,0.170274
17165,Saline County,,IL,1271,26563,27834,7,6,13,536,457,993,7,0.267046,0.277446,9077.413966,0.000059,0.000052,37,0.00032,0,20,0.236111,0.001059
17167,Sangamon County,,IL,10387,232706,243093,35,36,71,6103,5751,11854,6,0.359082,0.385246,27850.856775,0.00701,0.010227,166,0.00067,0,20,0.332172,0.051456
17169,Schuyler County,,IL,603,8364,8967,2,4,6,164,252,416,7,0.247828,0.255677,11.108045,0.000013,0.000011,166,0.0001,0,20,0.166667,0.00026
17171,Scott County,,IL,434,6384,6818,2,1,3,200,190,390,7,0.247554,0.254601,0,0.00001,0.000008,166,0.000098,0,20,1,0.000256
17173,Shelby County,,IL,1512,25780,27292,7,8,15,861,915,1776,7,0.265753,0.277,97.904078,0.000062,0.000105,166,0.000196,0,20,0.428571,0.001053
17175,Stark County,,IL,438,7237,7675,2,2,4,214,180,394,6,0.270019,0.279971,0,0.000127,0.000097,166,0.000077,0,20,1,0.000898
17177,Stephenson County,,IL,2861,57082,59943,8,9,17,1297,1400,2697,6,0.341309,0.360693,2444.957297,0.002273,0.003064,166,0.000166,0,20,0.522222,0.015459
17179,Tazewell County,,IL,8717,158142,166859,21,18,39,6595,5672,12267,6,0.348545,0.370172,3104.139353,0.004177,0.004881,166,0.000359,0,20,0.441667,0.030759
17181,Union County,,IL,1012,19933,20945,6,7,13,429,517,946,7,0.262564,0.273134,2896.271121,0.000072,0.000066,37,0.000217,0,20,0.357143,0.001008
17183,Vermilion County,,IL,4082,91842,95924,13,17,30,1717,2011,3728,6,0.343444,0.364433,3231.202371,0.002474,0.003383,166,0.000273,0,20,0.426316,0.018082
17185,Wabash County,,IL,774,14519,15293,3,3,6,225,272,497,7,0.265996,0.275488,3185.405139,0,0.000035,130,0.000188,0,20,0.166667,0.000291
17187,Warren County,,IL,1296,19443,20739,5,5,10,482,545,1027,7,0.259729,0.269196,131.029952,0.000078,0.000071,166,0.00017,0,20,0.45,0.001029
17189,Washington County,,IL,1092,18321,19413,5,7,12,598,664,1262,7,0.281404,0.293148,60.029428,0.000208,0.000295,37,0.000154,0,20,0.642857,0.002003
17191,Wayne County,,IL,874,19088,19962,4,3,7,260,256,516,7,0.248569,0.256353,1353.008605,0.00001,0.00001,166,0.000185,0,20,0.2,0.000461
17193,White County,,IL,952,17205,18157,3,6,9,191,353,544,7,0.266581,0.276856,5603.490988,0.000074,0.000035,37,0.000142,0,20,0.190476,0.000573
17195,Whiteside County,,IL,3315,72032,75347,12,13,25,1746,1641,3387,6,0.328517,0.346214,487.14691,0.00217,0.002008,166,0.000196,0,20,0.557692,0.014994
17197,Will County,,IL,46492,735764,782256,88,105,193,61935,37567,99502,5,0.404111,0.43803,14221.387148,0.03804,0.044981,166,0.00097,0,20,0.405638,0.271617
17199,Williamson County,,IL,4234,68875,73109,13,13,26,2459,2010,4469,6,0.332647,0.351415,13479.999932,0.002245,0.001848,37,0.000342,0,20,0.341667,0.016703
17201,Winnebago County,,IL,15083,335479,350562,40,45,85,11756,9131,20887,6,0.371695,0.399296,2473.870363,0.01426,0.018677,166,0.000472,0,20,0.436688,0.101813
17203,Woodford County,,IL,2606,44049,46655,7,6,13,1965,1574,3539,6,0.32822,0.344954,126.97955,0.001237,0.00119,166,0.00016,0,20,0.809524,0.009506
18001,Adams County,,IN,1787,41326,43113,4,6,10,585,920,1505,6,0.298921,0.312812,69.197136,0.000253,0.000727,166,0.000117,0,20,0.5,0.001703
18003,Allen County,,IN,17817,408590,426407,67,73,140,10550,10821,21371,6,0.383652,0.415384,39662.242422,0.021922,0.03041,166,0.000822,0,20,0.386975,0.156519
18005,Bartholomew County,,IN,5149,85451,90600,13,14,27,2796,2908,5704,6,0.332344,0.351334,563.901835,0.00257,0.002551,166,0.000259,0,20,0.459559,0.01835
18007,Benton County,,IN,985,10401,11386,2,4,6,452,573,1025,7,0.273548,0.284442,0.25,0.000157,0.00013,166,0.000079,0,20,0.833333,0.001004
18009,Blackford County,,IN,1015,15958,16973,4,4,8,444,548,992,7,0.258989,0.26846,1.921522,0.000061,0.000034,166,0.000115,0,20,0.583333,0.000646
18011,Boone County,,IN,3890,60116,64006,10,7,17,3330,2179,5509,6,0.299106,0.312818,4.835568,0.001147,0.00104,166,0.000209,0,20,0.711111,0.009408
18013,Brown County,,IN,1532,17994,19526,5,5,10,897,960,1857,6,0.29837,0.311638,0.166667,0.000682,0.000706,166,0.000126,0,20,0.95,0.0057
18015,Carroll County,,IN,1778,23805,25583,6,6,12,1127,1209,2336,6,0.298615,0.312239,6.229611,0.00073,0.000684,166,0.000142,0,20,0.833333,0.005622
18017,Cass County,,IN,2854,45922,48776,10,12,22,1173,1675,2848,6,0.299845,0.314737,452.55448,0.001941,0.001193,166,0.000191,0,20,0.50641,0.014671
18019,Clark County,,IN,7867,116057,123924,16,10,26,6996,5282,12278,6,0.304553,0.319845,648.951111,0.002617,0.001136,130,0.000385,0,20,0.3625,0.020606
18021,Clay County,,IN,2012,31219,33231,7,10,17,1134,1280,2414,6,0.298737,0.312801,338.204912,0.000572,0.000741,166,0.000186,0,20,0.581818,0.005082
18023,Clinton County,,IN,2166,38883,41049,8,7,15,1119,1237,2356,6,0.299106,0.312818,4.255294,0.000997,0.001,166,0.000178,0,20,0.680556,0.007888
18025,Crawford County,,IN,864,11923,12787,5,7,12,483,589,1072,7,0.290361,0.304242,3151.965182,0.000449,0.000505,130,0.00017,0,20,0.380952,0.004044
18027,Daviess County,,IN,1568,34147,35715,7,9,16,594,796,1390,6,0.299475,0.313637,1185.930736,0.000092,0.000676,130,0.000229,0,20,0.513889,0.001093
18029,Dearborn County,,IN,3561,58217,61778,10,11,21,2942,2289,5231,6,0.303251,0.31831,2353.99529,0.001402,0.001314,113,0.000227,0,20,0.509091,0.010207
18031,Decatur County,,IN,1889,31085,32974,8,8,16,1046,1150,2196,6,0.298584,0.312411,461.430458,0.000575,0.000591,166,0.000202,0,20,0.5,0.005105
18033,DeKalb County,,IN,3241,49894,53135,7,8,15,2049,2131,4180,6,0.299044,0.313242,49.945834,0.000274,0.000741,166,0.00016,0,20,0.517857,0.0021
18035,Delaware County,,IN,7935,118324,126259,20,23,43,3240,4435,7675,6,0.348963,0.371942,9563.6049,0.002877,0.005379,166,0.000312,0,20,0.412308,0.020295
18037,Dubois County,,IN,2182,52400,54582,11,12,23,1172,1180,2352,6,0.300093,0.314771,2772.394141,0.000206,0.000951,130,0.000323,0,20,0.294872,0.002082
18039,Elkhart County,,IN,11224,223890,235114,29,33,62,7185,6985,14170,6,0.357099,0.382812,4754.913449,0.007877,0.010224,166,0.00037,0,20,0.403904,0.056658
18041,Fayette County,,IN,1541,27688,29229,6,9,15,706,875,1581,6,0.299229,0.313276,50.426389,0.000051,0.000865,166,0.000171,0,20,0.513889,0.000853
18043,Floyd County,,IN,6735,81949,88684,11,7,18,4778,4874,9652,6,0.302936,0.317652,178.100391,0.001148,0.001049,130,0.000288,0,20,0.472727,0.009723
18045,Fountain County,,IN,1412,20669,22081,7,7,14,967,935,1902,6,0.298799,0.3126,258.146956,0.000713,0.000674,166,0.000184,0,20,0.52381,0.005634
18047,Franklin County,,IN,1463,28793,30256,7,9,16,944,988,1932,6,0.302904,0.317537,465.853092,0.000734,0.001131,113,0.000166,0,20,0.472222,0.004726
18049,Fulton County,,IN,1789,24472,26261,8,10,18,987,1013,2000,6,0.298891,0.313184,52.713772,0.000351,0.000806,166,0.000152,0,20,0.472727,0.002609
18051,Gibson County,,IN,2164,39194,41358,8,8,16,1135,1218,2353,7,0.266288,0.276679,2821.856852,0.000101,0.000047,130,0.000267,0,20,0.464286,0.001174
18053,Grant County,,IN,3978,76586,80564,10,12,22,1335,1979,3314,6,0.299784,0.314651,1017.498666,0.001145,0.001154,166,0.000192,0,20,0.537879,0.008715
18055,Greene County,,IN,2370,37040,39410,9,9,18,1401,1484,2885,6,0.298983,0.313087,448.957922,0.00069,0.000679,166,0.000214,0,20,0.5,0.005934
18057,Hamilton County,,IN,20332,269363,289695,89,78,167,22637,14538,37175,5,0.396134,0.427468,25622.712658,0.035613,0.03364,166,0.00108,0,20,0.412638,0.259042
18059,Hancock County,,IN,5431,76712,82143,13,11,24,5545,3795,9340,6,0.299414,0.31382,22.793643,0.001143,0.001168,166,0.000251,0,20,0.576923,0.009462
18061,Harrison County,,IN,2733,43950,46683,7,5,12,1766,1783,3549,7,0.290101,0.303526,15.521162,0.000479,0.000506,130,0.000205,0,20,0.547619,0.004553
18063,Hendricks County,,IN,11284,146949,158233,30,24,54,11009,7832,18841,6,0.353713,0.377342,2659.591225,0.007515,0.006491,166,0.000462,0,20,0.410924,0.054609
18065,Henry County,,IN,3222,56372,59594,8,11,19,1825,1983,3808,6,0.300713,0.315332,408.429539,0.000893,0.001016,166,0.000169,0,20,0.509091,0.007293
18067,Howard County,,IN,5777,101701,107478,15,17,32,2676,3258,5934,6,0.346264,0.368299,823.368342,0.001307,0.004842,166,0.000262,0,20,0.407895,0.010203
18069,Huntington County,,IN,2461,45530,47991,6,7,13,1085,1316,2401,6,0.29886,0.312812,5.598413,0.000269,0.000762,166,0.000143,0,20,0.607143,0.001981
18071,Jackson County,,IN,2732,49168,51900,8,11,19,1341,1681,3022,6,0.310931,0.327039,162.844632,0.000591,0.001721,166,0.000209,0,20,0.481818,0.005503
18073,Jasper County,,IN,2264,36930,39194,8,9,17,1811,1340,3151,6,0.329745,0.347434,570.372864,0.00145,0.001841,166,0.000156,0,20,0.555556,0.010052
18075,Jay County,,IN,1238,25226,26464,6,7,13,646,705,1351,6,0.298768,0.31264,172.778738,0.000067,0.000581,166,0.000154,0,20,0.309524,0.000842
18077,Jefferson County,,IN,1979,36394,38373,10,12,22,1001,996,1997,6,0.303188,0.318683,344.305954,0.00099,0.001092,166,0.000267,0,20,0.356061,0.008758
18079,Jennings County,,IN,2298,32155,34453,8,8,16,1307,1512,2819,6,0.298676,0.312583,58.361167,0.000602,0.000639,166,0.000202,0,20,0.535714,0.005499
18081,Johnson County,,IN,12072,147236,159308,29,19,48,11446,8596,20042,6,0.345688,0.367274,2322.190042,0.006389,0.003711,166,0.000464,0,20,0.395402,0.048137
18083,Knox County,,IN,2212,40703,42915,8,10,18,832,1025,1857,6,0.299691,0.314066,11800.320141,0.000605,0.0007,130,0.000236,0,20,0.372727,0.005094
18085,Kosciusko County,,IN,5169,92337,97506,17,15,32,2885,3008,5893,6,0.331624,0.350785,1164.380599,0.00355,0.002708,166,0.000253,0,20,0.407895,0.024737
18087,LaGrange County,,IN,2561,43762,46323,9,6,15,1656,1695,3351,7,0.277884,0.289986,17.747308,0.000585,0.00026,166,0.000161,0,20,0.569444,0.003857
18089,Lake County,,IN,28782,546672,575454,46,78,124,22748,21792,44540,5,0.38961,0.421472,7461.633465,0.022671,0.034946,166,0.000492,0,20,0.479871,0.154017
18091,LaPorte County,,IN,5707,122620,128327,11,14,25,3525,3130,6655,6,0.344501,0.365269,53.119689,0.002962,0.004378,166,0.000154,0,20,0.771429,0.019658
18093,Lawrence County,,IN,2608,52708,55316,7,9,16,1229,1346,2575,6,0.298737,0.312784,4562.442993,0.000652,0.000698,166,0.000186,0,20,0.402778,0.005406
18095,Madison County,,IN,7598,147097,154695,17,17,34,4563,4513,9076,6,0.344134,0.365321,702.419698,0.002432,0.004079,166,0.000282,0,20,0.483333,0.018397
18097,Marion County,,IN,66994,969807,1036801,214,178,392,51686,56753,108439,5,0.424818,0.465773,214828.504562,0.070166,0.066445,166,0.002718,0,20,0.248652,0.501603
18099,Marshall County,,IN,3379,54585,57964,11,11,22,2118,2066,4184,6,0.330232,0.348408,455.400505,0.002159,0.001972,166,0.00017,0,20,0.692308,0.015147
18101,Martin County,,IN,654,11972,12626,4,3,7,289,289,578,7,0.231154,0.238139,4.610857,0.000023,0.000007,130,0.000124,0,20,0.416667,0.000454
18103,Miami County,,IN,2780,39518,42298,6,9,15,1561,1592,3153,6,0.299537,0.313849,40.699137,0.000584,0.001054,166,0.000131,0,20,0.680556,0.004897
18105,Monroe County,,IN,10724,111508,122232,40,37,77,5429,5804,11233,6,0.375726,0.402532,12546.637934,0.010827,0.013957,166,0.000596,0,20,0.352941,0.079141
18107,Montgomery County,,IN,2474,43388,45862,8,8,16,1119,1248,2367,6,0.298768,0.312658,9.129945,0.001005,0.000753,166,0.000188,0,20,0.666667,0.008145
18109,Morgan County,,IN,5733,80114,85847,9,14,23,4358,4113,8471,6,0.299475,0.314278,16.902165,0.000986,0.001176,166,0.000207,0,20,0.528571,0.008519
18111,Newton County,,IN,1379,16468,17847,7,6,13,891,829,1720,6,0.284096,0.296283,258.782772,0.001494,0.000367,166,0.000125,0,20,0.553571,0.010002
18113,Noble County,,IN,3693,54160,57853,7,8,15,2276,2602,4878,6,0.298983,0.313127,23.356018,0.000356,0.000821,166,0.000158,0,20,0.696429,0.002705
18115,Ohio County,,IN,571,6927,7498,4,2,6,421,298,719,7,0.232837,0.239567,0.35,0.000504,0.000015,113,0.000116,0,20,0.916667,0.003291
18117,Orange County,,IN,1300,21327,22627,3,8,11,433,741,1174,6,0.29886,0.312841,54.643219,0.000013,0.000646,166,0.000114,0,20,0.375,0.000391
18119,Owen County,,IN,1929,23149,25078,10,7,17,1253,1326,2579,6,0.298523,0.312153,5.921644,0.000765,0.00071,166,0.000216,0,20,0.688889,0.006899
18121,Parke County,,IN,1232,16820,18052,7,8,15,604,806,1410,6,0.298645,0.312428,141.73869,0.000573,0.000656,166,0.000185,0,20,0.642857,0.005087
18123,Perry County,,IN,1123,20634,21757,4,4,8,396,488,884,7,0.266045,0.275745,156.471404,0.000012,0.000037,130,0.000174,0,20,0.4,0.000438
18125,Pike County,,IN,770,14522,15292,5,4,9,520,459,979,7,0.266045,0.275745,1.928651,0.000092,0.000037,130,0.000161,0,20,0.9,0.000859
18127,Porter County,,IN,11480,181070,192550,21,27,48,9812,7590,17402,6,0.34867,0.372113,1339.7517,0.009077,0.008749,166,0.000255,0,20,0.55977,0.063005
18129,Posey County,,IN,1929,31123,33052,3,4,7,1051,1216,2267,7,0.266142,0.275889,7.416667,0.000082,0.00004,130,0.000119,0,20,0.666667,0.000635
18131,Pulaski County,,IN,1084,15465,16549,8,7,15,751,630,1381,7,0.273728,0.285187,13.891794,0.0004,0.000165,166,0.000152,0,20,0.5,0.002928
18133,Putnam County,,IN,2877,39018,41895,9,10,19,1841,1802,3643,6,0.298676,0.312715,8.416046,0.000736,0.000721,166,0.000206,0,20,0.645455,0.006424
18135,Randolph County,,IN,1909,30513,32422,5,7,12,1178,1111,2289,6,0.298829,0.312755,22.107975,0.000088,0.000609,166,0.000116,0,20,0.571429,0.000827
18137,Ripley County,,IN,2077,31839,33916,8,8,16,1350,1199,2549,6,0.302936,0.31748,69.789031,0.000591,0.000981,113,0.000185,0,20,0.433333,0.004119
18139,Rush County,,IN,1472,20701,22173,7,6,13,877,942,1819,6,0.298492,0.31201,409.5222,0.00056,0.000572,166,0.000174,0,20,0.619048,0.004928
18141,St. Joseph County,,IN,16206,298302,314508,36,57,93,8431,10125,18556,6,0.383197,0.412772,5663.113637,0.014931,0.026629,166,0.000403,0,20,0.540984,0.104625
18143,Scott County,,IN,1731,25711,27442,7,7,14,1069,1073,2142,7,0.290274,0.30407,41.95246,0.000472,0.00052,130,0.000215,0,20,0.619048,0.004542
18145,Shelby County,,IN,3129,51086,54215,11,8,19,2181,1998,4179,6,0.299106,0.312932,687.809485,0.000917,0.000908,166,0.000235,0,20,0.563636,0.008316
18147,Spencer County,,IN,1466,24832,26298,5,5,10,947,948,1895,7,0.26624,0.276204,189.74331,0.0001,0.000047,130,0.000179,0,20,0.65,0.000904
18149,Starke County,,IN,1769,26349,28118,8,8,16,1288,1128,2416,6,0.328257,0.345241,320.936012,0.001556,0.001324,166,0.000134,0,20,0.638889,0.010329
18151,Steuben County,,IN,2927,37989,40916,11,9,20,1799,1475,3274,6,0.299198,0.313643,276.880271,0.001196,0.000817,166,0.000187,0,20,0.436364,0.008242
18153,Sullivan County,,IN,1367,22693,24060,4,5,9,694,764,1458,6,0.298707,0.312142,4.238338,0.000047,0.000588,166,0.000125,0,20,0.8,0.000754
18155,Switzerland County,,IN,818,9905,10723,4,6,10,328,427,755,6,0.292845,0.305859,701.590884,0.000502,0.00043,113,0.000144,0,20,0.466667,0.003329
18157,Tippecanoe County,,IN,13250,152825,166075,50,53,103,7706,7261,14967,6,0.376212,0.405246,22099.320659,0.012349,0.019905,166,0.000711,0,20,0.322611,0.089667
18159,Tipton County,,IN,1370,19807,21177,3,4,7,766,855,1621,6,0.29886,0.312016,0,0.00033,0.00085,166,0.000089,0,20,1,0.002551
18161,Union County,,IN,599,8509,9108,5,4,9,430,360,790,7,0.277513,0.289064,94.714964,0.000272,0.000179,166,0.000113,0,20,0.55,0.001785
18163,Vanderburgh County,,IN,11191,194733,205924,26,32,58,6670,6978,13648,6,0.36203,0.386569,65879.552581,0.004405,0.009478,130,0.000655,0,20,0.240398,0.034717
18165,Vermillion County,,IN,1305,19067,20372,6,5,11,824,790,1614,6,0.298707,0.312171,30.019382,0.000074,0.000603,166,0.000166,0,20,0.595238,0.001089
18167,Vigo County,,IN,6811,109626,116437,23,20,43,3285,3368,6653,6,0.344664,0.366123,14360.525907,0.003804,0.003902,166,0.000428,0,20,0.318462,0.028647
18169,Wabash County,,IN,2263,39694,41957,9,10,19,1174,1307,2481,6,0.299137,0.313643,109.990867,0.000887,0.000853,166,0.00017,0,20,0.554545,0.006889
18171,Warren County,,IN,699,10195,10894,3,3,6,382,442,824,7,0.273986,0.284992,0.300433,0.000186,0.000121,166,0.000098,0,20,0.833333,0.001212
18173,Warrick County,,IN,5086,65573,70659,8,9,17,3442,3070,6512,6,0.303631,0.3189,1344.285625,0.000614,0.001063,130,0.000239,0,20,0.458333,0.005171
18175,Washington County,,IN,1663,31533,33196,8,8,16,1097,1054,2151,7,0.290332,0.304299,932.071333,0.000473,0.000516,130,0.00024,0,20,0.464286,0.004593
18177,Wayne County,,IN,4140,79855,83995,11,16,27,1370,2018,3388,6,0.340152,0.360653,2422.754313,0.001499,0.003131,166,0.000195,0,20,0.408088,0.010829
18179,Wells County,,IN,1797,32279,34076,6,6,12,1109,1042,2151,6,0.29886,0.312698,276.423663,0.000261,0.00072,166,0.00015,0,20,0.52381,0.001917
18181,White County,,IN,2130,29240,31370,8,7,15,1112,1216,2328,6,0.298615,0.312354,196.584977,0.001403,0.000683,166,0.000159,0,20,0.511111,0.009647
18183,Whitley County,,IN,2223,39252,41475,6,7,13,1732,1459,3191,6,0.298829,0.312755,4.683303,0.000282,0.000756,166,0.00014,0,20,0.666667,0.002125
19001,Adair County,,IA,585,9225,9810,6,4,10,310,292,602,6,0.287862,0.299181,5.983333,0.000284,0.000226,24,0.000355,0,20,0.5,0.00269
19003,Adams County,,IA,288,4928,5216,1,1,2,46,55,101,7,0.223554,0.228738,1.25,0.000003,0.000002,24,0.000076,0,20,0,0.000116
19005,Allamakee County,,IA,866,16939,17805,3,4,7,175,264,439,7,0.21503,0.221431,51.932043,0.000004,0.000002,24,0.000134,0,20,0.35,0.000323
19007,Appanoose County,,IA,813,14426,15239,3,5,8,158,280,438,6,0.288062,0.299668,4805.472436,0.00026,0.000223,24,0.000128,0,20,0.4,0.002022
19009,Audubon County,,IA,423,7562,7985,1,3,4,40,175,215,6,0.288005,0.299324,2.074242,0.000004,0.000226,24,0.000077,0,20,0.666667,0.00013
19011,Benton County,,IA,2049,30702,32751,5,6,11,1216,1312,2528,6,0.290826,0.303041,23.813818,0.00023,0.000426,24,0.000164,0,20,0.7,0.002103
19013,Black Hawk County,,IA,7959,136307,144266,30,24,54,3776,4274,8050,6,0.34934,0.371449,31762.832247,0.004109,0.003802,24,0.000756,0,20,0.23975,0.030657
19015,Boone County,,IA,1842,30515,32357,5,5,10,914,1033,1947,6,0.288033,0.299553,2.753968,0.000329,0.000301,24,0.000184,0,20,0.7,0.00287
19017,Bremer County,,IA,1540,26992,28532,5,5,10,982,778,1760,6,0.288319,0.300126,316.301367,0.000032,0.000252,24,0.000235,0,20,0.4,0.00077
19019,Buchanan County,,IA,1249,24436,25685,4,4,8,665,662,1327,7,0.267095,0.277392,16.96978,0.000096,0.000116,24,0.000148,0,20,0.65,0.001343
19021,Buena Vista County,,IA,1781,22603,24384,6,10,16,377,652,1029,6,0.294803,0.308792,16140.8016,0.001265,0.000545,24,0.00018,0,20,0.2,0.009866
19023,Butler County,,IA,972,18056,19028,4,3,7,513,472,985,7,0.259012,0.267798,134.400298,0.000034,0.000032,24,0.000186,0,20,0.416667,0.000675
19025,Calhoun County,,IA,716,12002,12718,3,2,5,244,204,448,6,0.287891,0.299009,2.642857,0.000009,0.000222,24,0.000129,0,20,0.583333,0.000319
19027,Carroll County,,IA,1335,26052,27387,5,8,13,292,570,862,6,0.299444,0.312239,1873.549937,0.000263,0.000576,24,0.000166,0,20,0.263889,0.002206
19029,Cass County,,IA,866,16095,16961,6,6,12,383,318,701,6,0.299075,0.311546,3061.099947,0.000648,0.00056,24,0.000186,0,20,0.404762,0.004845
19031,Cedar County,,IA,1368,21857,23225,6,5,11,893,769,1662,6,0.277116,0.288099,4.942048,0.000292,0.000266,24,0.000156,0,20,0.7,0.002645
19033,Cerro Gordo County,,IA,3111,51029,54140,12,14,26,1313,1530,2843,6,0.335447,0.354914,28668.295774,0.000537,0.001571,24,0.000381,0,20,0.302198,0.004777
19035,Cherokee County,,IA,825,14693,15518,3,4,7,204,225,429,6,0.288576,0.300155,25.037864,0.000043,0.00023,24,0.000123,0,20,0.45,0.000586
19037,Chickasaw County,,IA,744,15257,16001,3,3,6,285,253,538,7,0.259035,0.267827,160.467956,0.000032,0.000032,24,0.000151,0,20,0.5,0.00056
19039,Clarke County,,IA,827,10305,11132,3,4,7,298,357,655,6,0.287862,0.299181,1.833333,0.000259,0.000229,24,0.00015,0,20,0.5,0.002057
19041,Clay County,,IA,1264,20344,21608,4,5,9,369,503,872,6,0.288719,0.300498,9107.158827,0.000007,0.000229,24,0.000218,0,20,0.1,0.000444
19043,Clayton County,,IA,1091,21838,22929,7,7,14,498,531,1029,7,0.267414,0.278394,2745.630989,0.000098,0.000148,24,0.000229,0,20,0.392857,0.001602
19045,Clinton County,,IA,2803,57578,60381,9,12,21,1375,1624,2999,6,0.33087,0.34894,1103.330823,0.001401,0.001528,166,0.000222,0,20,0.537879,0.011134
19047,Crawford County,,IA,1107,19167,20274,4,5,9,224,319,543,6,0.28829,0.300097,227.327388,0.000382,0.00025,24,0.000115,0,20,0.303571,0.00283
19049,Dallas County,,IA,5558,59968,65526,22,12,34,6196,3568,9764,6,0.339517,0.359273,2938.996401,0.0051,0.002415,24,0.00054,0,20,0.407115,0.039229
19051,Davis County,,IA,484,9536,10020,2,1,3,164,180,344,7,0.225616,0.231334,0,0.000005,0.000003,24,0.000097,0,20,1,0.000232
19053,Decatur County,,IA,581,8182,8763,2,2,4,128,140,268,6,0.287805,0.298837,0,0.000257,0.000221,24,0.000104,0,20,1,0.001913
19055,Delaware County,,IA,1054,21737,22791,4,6,10,498,626,1124,7,0.267193,0.277878,6.463848,0.000095,0.000147,24,0.000143,0,20,0.633333,0.0013
19057,Des Moines County,,IA,2542,46865,49407,9,10,19,990,1107,2097,6,0.330795,0.348597,11496.721416,0.001404,0.001391,24,0.000256,0,20,0.377778,0.010609
19059,Dickinson County,,IA,1366,19932,21298,4,5,9,432,387,819,6,0.290767,0.303104,6178.545599,0.000002,0.000318,24,0.000239,0,20,0.1,0.000364
19061,Dubuque County,,IA,4257,107404,111661,20,16,36,2344,2208,4552,6,0.347173,0.368379,7374.897834,0.003711,0.003516,24,0.000439,0,20,0.380952,0.027412
19063,Emmet County,,IA,691,11791,12482,3,2,5,166,156,322,7,0.225319,0.231091,124.37058,0.000009,0,24,0.000179,0,20,0,0.000278
19065,Fayette County,,IA,1375,23331,24706,7,7,14,522,722,1244,7,0.26734,0.278279,4022.380465,0.000098,0.000145,24,0.000259,0,20,0.410714,0.001628
19067,Floyd County,,IA,1065,18939,20004,3,4,7,372,492,864,7,0.259289,0.268445,36.981347,0.000012,0.000036,24,0.000158,0,20,0.5,0.000331
19069,Franklin County,,IA,733,12213,12946,3,3,6,183,189,372,7,0.25136,0.259571,10.909524,0.000015,0.000007,24,0.000152,0,20,0.166667,0.000354
19071,Fremont County,,IA,573,8616,9189,4,3,7,261,229,490,7,0.292963,0.304539,26.172163,0.000392,0.000338,24,0.000153,0,20,0.75,0.002962
19073,Greene County,,IA,751,11373,12124,4,6,10,225,363,588,6,0.288119,0.29984,4.748474,0.000264,0.000303,24,0.000169,0,20,0.666667,0.002145
19075,Grundy County,,IA,868,15041,15909,4,5,9,481,458,939,7,0.263468,0.273319,2.713859,0.000038,0.000076,24,0.000149,0,20,0.75,0.000722
19077,Guthrie County,,IA,925,12993,13918,5,4,9,487,499,986,6,0.287862,0.299181,2.2,0.000283,0.000263,24,0.000227,0,20,0.6,0.002557
19079,Hamilton County,,IA,1229,18912,20141,5,6,11,473,640,1113,6,0.288233,0.300069,798.90054,0.000312,0.000264,24,0.000186,0,20,0.6,0.002563
19081,Hancock County,,IA,903,13956,14859,4,4,8,384,394,778,6,0.288262,0.299817,6.46369,0.000018,0.000224,24,0.000133,0,20,0.55,0.00042
19083,Hardin County,,IA,1340,20005,21345,6,7,13,376,558,934,6,0.288347,0.300384,1633.997429,0.000312,0.000292,24,0.000212,0,20,0.446429,0.002666
19085,Harrison County,,IA,1040,17535,18575,3,5,8,473,536,1009,7,0.29314,0.305055,225.499688,0.000535,0.000344,24,0.000102,0,20,0.366667,0.003766
19087,Henry County,,IA,1414,22359,23773,4,6,10,484,601,1085,6,0.273111,0.284364,29.60806,0.000018,0.000186,24,0.00015,0,20,0.566667,0.000492
19089,Howard County,,IA,611,11947,12558,2,2,4,123,116,239,7,0.212176,0.217473,15.4584,0,0.000001,24,0.000127,0,20,0.333333,0.000189
19091,Humboldt County,,IA,709,11968,12677,3,2,5,212,159,371,7,0.22407,0.229837,1.083333,0.000006,0.000003,24,0.000119,0,20,0.333333,0.000301
19093,Ida County,,IA,621,8687,9308,3,2,5,156,167,323,7,0.26247,0.271366,71.610074,0.00004,0.000025,24,0.000121,0,20,0.166667,0.000526
19095,Iowa County,,IA,1087,20044,21131,5,5,10,566,589,1155,6,0.272855,0.283832,11.279965,0.000202,0.000179,24,0.000165,0,20,0.5,0.001847
19097,Jackson County,,IA,1142,24343,25485,4,3,7,618,581,1199,7,0.267365,0.276624,0.54478,0.000174,0.00012,166,0.000125,0,20,0.916667,0.001985
19099,Jasper County,,IA,2632,42874,45506,8,8,16,1270,1403,2673,6,0.290942,0.303414,24.360306,0.00041,0.000477,24,0.000255,0,20,0.622222,0.00388
19101,Jefferson County,,IA,1212,16455,17667,5,6,11,409,468,877,6,0.288662,0.300842,1645.099333,0.000034,0.000305,24,0.000184,0,20,0.25,0.000759
19103,Johnson County,,IA,12072,120582,132654,41,45,86,6348,6903,13251,5,0.37346,0.400727,34706.90529,0.011585,0.016958,24,0.000776,0,20,0.330611,0.081574
19105,Jones County,,IA,1190,22551,23741,4,5,9,675,646,1321,6,0.272778,0.283688,8.217508,0.000225,0.000204,24,0.000128,0,20,0.7,0.001942
19107,Keokuk County,,IA,735,12435,13170,4,6,10,296,425,721,6,0.272395,0.283299,23.840733,0.000009,0.000101,24,0.000162,0,20,0.380952,0.000448
19109,Kossuth County,,IA,1056,19923,20979,1,6,7,46,327,373,6,0.288576,0.300424,61.139287,0.000002,0.000257,24,0.000074,0,20,0.2,0.000094
19111,Lee County,,IA,2166,40504,42670,6,9,15,818,981,1799,6,0.294445,0.307159,8143.068909,0.000077,0.000496,24,0.000233,0,20,0.3,0.001311
19113,Linn County,,IA,11292,233986,245278,43,38,81,7266,6535,13801,6,0.363795,0.390017,52684.160976,0.01065,0.008331,24,0.000873,0,20,0.265957,0.081628
19115,Louisa County,,IA,826,13342,14168,3,4,7,357,487,844,6,0.272242,0.282726,3.542103,0.000155,0.000105,24,0.000104,0,20,0.5,0.001054
19117,Lucas County,,IA,640,9986,10626,2,2,4,141,179,320,6,0.287805,0.298837,0,0.000258,0.000225,24,0.000095,0,20,1,0.001922
19119,Lyon County,,IA,695,14091,14786,2,3,5,191,343,534,7,0.269046,0.279127,0,0.000092,0.000108,24,0.000119,0,20,1,0.001031
19121,Madison County,,IA,1122,17121,18243,4,5,9,869,704,1573,6,0.287891,0.299353,1.833333,0.000278,0.000269,24,0.00022,0,20,0.65,0.002487
19123,Mahaska County,,IA,1533,24877,26410,6,6,12,610,642,1252,6,0.288147,0.299954,1573.355975,0.000265,0.000228,24,0.00021,0,20,0.5,0.002361
19125,Marion County,,IA,2131,37950,40081,6,8,14,865,1082,1947,6,0.288147,0.300126,672.056164,0.000268,0.00031,24,0.00022,0,20,0.444444,0.002418
19127,Marshall County,,IA,2786,45241,48027,9,11,20,968,1414,2382,6,0.291116,0.304101,204.673024,0.000411,0.000511,24,0.000279,0,20,0.563636,0.003937
19129,Mills County,,IA,1175,16176,17351,4,5,9,821,684,1505,7,0.296002,0.307982,11.13509,0.000537,0.000465,24,0.000128,0,20,0.7,0.003882
19131,Mitchell County,,IA,561,12685,13246,4,3,7,244,161,405,7,0.251469,0.259686,2752.86063,0.000021,0.000004,24,0.000149,0,20,0.2,0.000477
19133,Monona County,,IA,606,10865,11471,2,1,3,182,198,380,7,0.262233,0.270845,1.042857,0.000039,0.000025,24,0.000092,0,20,0,0.000437
19135,Monroe County,,IA,551,8857,9408,4,4,8,200,257,457,6,0.288005,0.299439,1.783333,0.000009,0.000227,24,0.00015,0,20,0.75,0.000458
19137,Montgomery County,,IA,821,12618,13439,5,6,11,304,382,686,7,0.293169,0.305284,3001.153021,0.000396,0.000348,24,0.000179,0,20,0.433333,0.003092
19139,Muscatine County,,IA,2622,50054,52676,7,9,16,1224,1390,2614,6,0.334714,0.353419,560.521173,0.000316,0.001589,24,0.000183,0,20,0.569444,0.00298
19141,O'Brien County,,IA,945,17250,18195,3,4,7,295,305,600,7,0.269345,0.279746,3392.133417,0.000003,0.000099,24,0.000178,0,20,0.166667,0.00029
19143,Osceola County,,IA,424,7862,8286,2,2,4,115,135,250,7,0.225354,0.231177,4.683766,0.000003,0,24,0.000129,0,20,0,0.000185
19145,Page County,,IA,961,17508,18469,6,5,11,425,304,729,6,0.288176,0.299868,5961.896697,0.000395,0.000249,24,0.000261,0,20,0.333333,0.003146
19147,Palo Alto County,,IA,655,11080,11735,3,2,5,160,122,282,7,0.224087,0.229654,42.790002,0.000004,0,24,0.000174,0,20,0,0.000272
19149,Plymouth County,,IA,1718,30311,32029,5,5,10,831,771,1602,6,0.288519,0.300321,70.186347,0.000046,0.000247,24,0.000192,0,20,0.366667,0.000802
19151,Pocahontas County,,IA,599,9090,9689,1,3,4,88,142,230,6,0.288547,0.299983,1.073556,0.000004,0.000231,24,0.000066,0,20,0.5,0.000167
19153,Polk County,,IA,25308,458905,484213,111,96,207,20274,18077,38351,5,0.403998,0.436804,230407.150652,0.028246,0.032899,24,0.002456,0,20,0.2291,0.209806
19155,Pottawattamie County,,IA,5849,100827,106676,15,15,30,3744,3623,7367,6,0.33743,0.357291,2744.314466,0.003051,0.002029,24,0.0004,0,20,0.363971,0.023574
19157,Poweshiek County,,IA,1251,20841,22092,8,6,14,556,513,1069,6,0.288119,0.299926,107.978524,0.000401,0.00023,24,0.00024,0,20,0.375,0.003245
19159,Ringgold County,,IA,323,5654,5977,1,2,3,41,117,158,6,0.287805,0.298837,0,0.000255,0.000221,24,0.000072,0,20,1,0.001808
19161,Sac County,,IA,618,12695,13313,3,4,7,170,213,383,6,0.288519,0.30004,170.318186,0.000009,0.000231,24,0.000134,0,20,0.25,0.00037
19163,Scott County,,IA,10639,183824,194463,33,30,63,6015,5676,11691,6,0.364433,0.388087,13025.806518,0.010316,0.009014,166,0.000583,0,20,0.40641,0.077973
19165,Shelby County,,IA,823,14736,15559,3,3,6,297,326,623,7,0.292992,0.304597,14.70332,0.000388,0.00034,24,0.000107,0,20,0.583333,0.002836
19167,Sioux County,,IA,1706,37263,38969,6,6,12,485,687,1172,7,0.269944,0.280908,5479.924406,0.000105,0.000134,24,0.000252,0,20,0.285714,0.001563
19169,Story County,,IA,8413,78100,86513,30,25,55,3751,4213,7964,6,0.356705,0.380052,12583.34512,0.004833,0.006503,24,0.000702,0,20,0.278151,0.03822
19171,Tama County,,IA,1269,21440,22709,6,7,13,669,735,1404,6,0.288605,0.300871,63.163632,0.000104,0.000342,24,0.000201,0,20,0.595238,0.001592
19173,Taylor County,,IA,390,7206,7596,1,1,2,50,57,107,7,0.223726,0.22907,0,0.000002,0.000003,24,0.000095,0,20,0,0.000118
19175,Union County,,IA,856,13634,14490,6,2,8,379,180,559,6,0.287805,0.298837,2910,0.000263,0.000221,24,0.000312,0,20,0.333333,0.002324
19177,Van Buren County,,IA,511,8490,9001,2,2,4,209,166,375,7,0.227646,0.233625,38.767552,0.000015,0.000001,24,0.000086,0,20,0,0.000288
19179,Wapello County,,IA,2419,38936,41355,9,11,20,807,1024,1831,6,0.29132,0.304284,7602.257943,0.000425,0.00042,24,0.000329,0,20,0.310606,0.003528
19181,Warren County,,IA,3487,49979,53466,8,7,15,2549,2369,4918,6,0.28809,0.299897,151.080891,0.000801,0.000306,24,0.000282,0,20,0.416667,0.006548
19183,Washington County,,IA,1417,25190,26607,6,5,11,727,691,1418,6,0.272881,0.283889,915.243924,0.000201,0.000173,24,0.000179,0,20,0.380952,0.001914
19185,Wayne County,,IA,445,7149,7594,1,2,3,75,101,176,6,0.287891,0.299009,0,0.000002,0.000221,24,0.000072,0,20,1,0.000105
19187,Webster County,,IA,2190,41846,44036,7,7,14,661,839,1500,6,0.288433,0.300556,6827.79026,0.000313,0.000291,24,0.000272,0,20,0.321429,0.002714
19189,Winnebago County,,IA,887,13392,14279,4,5,9,254,364,618,6,0.288404,0.30012,3314.660135,0.000016,0.000224,24,0.00014,0,20,0.45,0.000413
19191,Winneshiek County,,IA,1121,22800,23921,4,5,9,300,300,600,7,0.21457,0.220984,346.270641,0.000002,0.000002,24,0.000202,0,20,0.3,0.000394
19193,Woodbury County,,IA,6888,112276,119164,22,22,44,3203,3819,7022,6,0.355398,0.378099,25213.874926,0.003247,0.004705,24,0.000641,0,20,0.264778,0.02608
19195,Worth County,,IA,561,9098,9659,2,3,5,238,277,515,7,0.251426,0.259531,1.542857,0.000014,0.000004,24,0.000097,0,20,0.666667,0.000237
19197,Wright County,,IA,1112,15441,16553,5,7,12,293,429,722,6,0.288404,0.30043,1438.815147,0.000018,0.000266,24,0.000212,0,20,0.5,0.000558
20001,Allen County,,KS,966,14856,15822,2,5,7,151,325,476,6,0.297546,0.309845,2974.617857,0.000009,0.000463,37,0.000101,0,20,0.35,0.00023
20003,Anderson County,,KS,674,9249,9923,3,3,6,221,218,439,6,0.297333,0.309215,3874.172144,0.000479,0.000458,37,0.000108,0,20,0.5,0.00372
20005,Atchison County,,KS,1108,17880,18988,6,7,13,373,502,875,6,0.301648,0.314828,2550.796335,0.000619,0.001058,37,0.000185,0,20,0.607143,0.005372
20007,Barber County,,KS,281,5642,5923,0,2,2,0,84,84,7,0.286996,0.298538,0,0,0.000251,37,0.00005,0,49,1,0
20009,Barton County,,KS,1787,30496,32283,8,7,15,454,607,1061,6,0.30118,0.314393,10027.016775,0.000334,0.000733,37,0.000336,0,20,0.355556,0.002939
20011,Bourbon County,,KS,1065,16238,17303,3,3,6,322,273,595,6,0.297394,0.309359,8.487898,0.000022,0.000458,37,0.000114,0,20,0.333333,0.000395
20013,Brown County,,KS,753,11673,12426,4,4,8,239,226,465,7,0.267218,0.277401,75.914498,0.000013,0.000087,37,0.000216,0,20,0.3,0.000419
20015,Butler County,,KS,5056,66981,72037,7,10,17,3170,2872,6042,6,0.303378,0.317257,152.936811,0.000795,0.001212,37,0.000217,0,20,0.488889,0.00613
20017,Chase County,,KS,215,3174,3389,1,1,2,75,59,134,7,0.231854,0.237792,0,0.000008,0.000022,37,0.000075,0,20,0,0.000255
20019,Chautauqua County,,KS,457,3944,4401,2,2,4,103,148,251,7,0.234281,0.241162,0.7,0.000318,0.000009,37,0.000082,0,20,0.666667,0.002173
20021,Cherokee County,,KS,1515,22500,24015,5,5,10,967,916,1883,7,0.259821,0.269428,4.098098,0.000075,0.000071,37,0.000155,0,20,0.7,0.001111
20023,Cheyenne County,,KS,161,3358,3519,0,0,0,0,0,0,0,0,0,0,0,0,25,0.00005,20,50,0,0
20025,Clark County,,KS,233,2352,2585,1,1,2,53,59,112,7,0.231983,0.238084,0,0.000007,0.000003,37,0.000075,0,20,0,0.000117
20027,Clay County,,KS,641,9950,10591,3,2,5,196,166,362,7,0.272855,0.283489,0,0.000193,0.000175,37,0.000098,0,20,1,0.001669
20029,Cloud County,,KS,761,10468,11229,2,4,6,141,229,370,7,0.267537,0.278128,8846,0.000011,0.000097,37,0.000152,0,20,0.25,0.000319
20031,Coffey County,,KS,666,10116,10782,2,2,4,180,167,347,7,0.231873,0.237964,0.611111,0.000015,0.000023,37,0.000101,0,20,0.833333,0.000418
20033,Comanche County,,KS,163,2135,2298,0,0,0,0,0,0,0,0,0,0,0,0,26,0.00005,21,51,0,0
20035,Cowley County,,KS,2425,37526,39951,5,5,10,894,984,1878,7,0.287692,0.299872,532.409828,0.000335,0.000339,37,0.000169,0,20,0.4,0.002612
20037,Crawford County,,KS,2894,37686,40580,11,13,24,1143,1474,2617,6,0.305929,0.321581,2532.236654,0.000947,0.001699,37,0.000278,0,20,0.37619,0.007399
20039,Decatur County,,KS,232,3573,3805,0,0,0,0,0,0,0,0,0,0,0,0,27,0.00005,22,52,0,0
20041,Dickinson County,,KS,1729,21892,23621,5,6,11,710,747,1457,6,0.300186,0.313093,99.041394,0.000505,0.000723,37,0.00014,0,20,0.642857,0.003895
20043,Doniphan County,,KS,524,8535,9059,1,2,3,233,231,464,7,0.252429,0.260637,30.344927,0.000019,0.000014,37,0.00007,0,20,0,0.000218
20045,Douglas County,,KS,10428,97750,108178,31,32,63,5438,6131,11569,6,0.369759,0.395945,11938.167288,0.008373,0.01291,37,0.000645,0,20,0.397436,0.064756
20047,Edwards County,,KS,348,3562,3910,0,1,1,0,70,70,7,0.232026,0.238174,0,0,0.000003,37,0.00005,0,53,0,0
20049,Elk County,,KS,291,3148,3439,1,2,3,40,87,127,7,0.286954,0.298468,0,0.000306,0.000255,37,0.000064,0,20,1,0.002024
20051,Ellis County,,KS,2287,29297,31584,14,11,25,921,867,1788,6,0.302212,0.316214,34029.177005,0.000932,0.000952,37,0.00056,0,20,0.254167,0.007523
20053,Ellsworth County,,KS,423,6652,7075,1,1,2,60,72,132,7,0.233866,0.240234,0,0.000011,0.000016,37,0.000082,0,20,0,0.000233
20055,Finney County,,KS,3527,41612,45139,11,17,28,838,1283,2121,6,0.342474,0.363305,44155.128533,0.00268,0.003335,37,0.000473,0,20,0.27193,0.020623
20057,Ford County,,KS,2906,34688,37594,7,12,19,635,923,1558,6,0.302024,0.316254,19914.178484,0.000341,0.000873,37,0.000345,0,20,0.211538,0.002727
20059,Franklin County,,KS,2065,27762,29827,9,8,17,1294,1205,2499,6,0.300434,0.313425,715.247535,0.001115,0.000956,37,0.000244,0,20,0.511111,0.00859
20061,Geary County,,KS,9261,31696,40957,30,38,68,2948,4412,7360,6,0.354316,0.380269,8338.176705,0.012201,0.011797,37,0.000442,0,20,0.51797,0.09131
20063,Gove County,,KS,172,3450,3622,0,0,0,0,0,0,0,0,0,0,0,0,28,0.00005,23,54,0,0
20065,Graham County,,KS,187,3105,3292,0,0,0,0,0,0,0,0,0,0,0,0,29,0.00005,24,55,0,0
20067,Grant County,,KS,700,8775,9475,2,1,3,91,42,133,7,0.255129,0.26326,2910,0.000026,0.000021,37,0.000117,0,20,0,0.000339
20069,Gray County,,KS,591,7003,7594,2,2,4,162,164,326,7,0.255263,0.263718,0,0.000033,0.000023,37,0.000098,0,20,1,0.000372
20071,Greeley County,,KS,143,1570,1713,0,0,0,0,0,0,0,0,0,0,0,0,30,0.00005,25,56,0,0
20073,Greenwood County,,KS,695,7249,7944,3,3,6,178,289,467,7,0.287067,0.298812,1.702381,0.000323,0.000276,37,0.000107,0,20,0.666667,0.00242
20075,Hamilton County,,KS,230,2628,2858,1,0,1,40,0,40,0,0,0,0,0.000026,0,37,0.000074,0,19,0,0.000256
20077,Harper County,,KS,485,6796,7281,1,1,2,82,140,222,7,0.286897,0.298239,0,0.000306,0.000249,37,0.000064,0,20,0,0.002024
20079,Harvey County,,KS,2786,37599,40385,6,7,13,1305,1461,2766,6,0.300837,0.313877,53.185371,0.0008,0.000782,37,0.00017,0,20,0.666667,0.006026
20081,Haskell County,,KS,510,4669,5179,1,1,2,66,79,145,7,0.255129,0.26326,0,0.000026,0.000021,37,0.000074,0,20,0,0.000256
20083,Hodgeman County,,KS,137,2271,2408,1,0,1,46,0,46,0,0,0,0,0.000007,0,37,0.000075,0,18,0,0.000117
20085,Jackson County,,KS,1160,15546,16706,5,2,7,648,523,1171,7,0.267021,0.276868,257.622863,0.000105,0.000081,37,0.000192,0,20,0.45,0.001177
20087,Jefferson County,,KS,1701,21442,23143,5,6,11,966,1106,2072,6,0.298615,0.31122,87.715494,0.000792,0.00072,37,0.000132,0,20,0.642857,0.006246
20089,Jewell County,,KS,228,4020,4248,0,0,0,0,0,0,0,0,0,0,0,0,31,0.00005,26,57,0,0
20091,Johnson County,,KS,41295,580498,621793,162,146,308,37375,32317,69692,5,0.422597,0.459147,161116.450235,0.057853,0.060335,37,0.002488,0,20,0.295701,0.430709
20093,Kearny County,,KS,490,4679,5169,1,1,2,108,146,254,7,0.255129,0.26326,0,0.000026,0.000021,37,0.000074,0,20,0,0.000256
20095,Kingman County,,KS,756,9268,10024,3,3,6,315,358,673,7,0.287011,0.298697,1,0.000316,0.00026,37,0.000134,0,20,0.833333,0.002306
20097,Kiowa County,,KS,313,3310,3623,1,1,2,63,44,107,8,0.22304,0.228469,0,0.000002,0.000002,37,0.000093,0,20,0,0.000108
20099,Labette County,,KS,1339,24191,25530,7,7,14,544,582,1126,6,0.30118,0.314479,244.392565,0.000383,0.000765,37,0.000191,0,20,0.553571,0.003214
20101,Lane County,,KS,137,2142,2279,0,0,0,0,0,0,0,0,0,0,0,0,32,0.00005,27,58,0,0
20103,Leavenworth County,,KS,9440,71618,81058,41,29,70,5788,5044,10832,6,0.344501,0.367829,2204.534043,0.015338,0.009041,37,0.000538,0,20,0.521041,0.112996
20105,Lincoln County,,KS,293,3980,4273,1,1,2,46,93,139,7,0.233866,0.240234,0,0.000011,0.000016,37,0.000082,0,20,0,0.000233
20107,Linn County,,KS,798,10358,11156,3,4,7,353,386,739,6,0.297242,0.309187,957.26989,0.000539,0.000464,37,0.000099,0,20,0.45,0.004093
20109,Logan County,,KS,215,3349,3564,1,0,1,60,0,60,0,0,0,0,0,0,37,0.000101,0,10,0,0.000089
20111,Lyon County,,KS,3236,37803,41039,11,11,22,895,1380,2275,6,0.301805,0.315584,10724.74463,0.002772,0.000986,37,0.000326,0,20,0.39011,0.020698
20113,McPherson County,,KS,2344,34208,36552,6,8,14,773,1051,1824,6,0.301805,0.315183,592.984455,0.000338,0.000874,37,0.000209,0,20,0.566667,0.002792
20115,Marion County,,KS,941,14153,15094,2,3,5,228,378,606,7,0.286982,0.29864,0,0.000312,0.000257,37,0.000084,0,20,1,0.002162
20117,Marshall County,,KS,651,12780,13431,2,3,5,118,157,275,7,0.269395,0.279966,2919.296846,0.000095,0.000162,37,0.000111,0,20,0.333333,0.000833
20119,Meade County,,KS,479,5170,5649,2,1,3,109,51,160,7,0.231983,0.238084,0,0.000016,0.000003,37,0.0001,0,20,1,0.000214
20121,Miami County,,KS,2610,33385,35995,7,7,14,1953,1587,3540,6,0.300279,0.313053,18.758087,0.001038,0.000959,37,0.00018,0,20,0.666667,0.00791
20123,Mitchell County,,KS,488,7172,7660,1,1,2,57,48,105,7,0.233885,0.240291,0,0.000001,0.000016,37,0.000083,0,20,1,0.00009
20125,Montgomery County,,KS,2653,36730,39383,10,13,23,1009,1328,2337,6,0.305672,0.321094,2722.357127,0.000808,0.001562,37,0.00028,0,20,0.338095,0.006474
20127,Morris County,,KS,522,6532,7054,1,3,4,70,169,239,7,0.267242,0.277578,0.577062,0.000092,0.000106,37,0.00006,0,20,0.666667,0.000798
20129,Morton County,,KS,347,3859,4206,0,0,0,0,0,0,0,0,0,0,0,0,33,0.00005,28,59,0,0
20131,Nemaha County,,KS,682,12759,13441,3,4,7,180,275,455,6,0.297364,0.309416,374.145612,0.000092,0.000531,37,0.000149,0,20,0.4,0.000902
20133,Neosho County,,KS,1266,17811,19077,6,7,13,440,600,1040,6,0.301024,0.314192,2093.389986,0.000343,0.000717,37,0.00017,0,20,0.547619,0.002647
20135,Ness County,,KS,257,3727,3984,0,1,1,0,45,45,7,0.232137,0.238208,0,0,0.000007,37,0.00005,0,60,0,0
20137,Norton County,,KS,380,5994,6374,1,0,1,41,0,41,0,0,0,0,0,0,35,0.000093,29,61,0,0.000084
20139,Osage County,,KS,1343,18921,20264,6,5,11,712,805,1517,6,0.297455,0.309702,1099.014929,0.000206,0.000625,37,0.000207,0,20,0.547619,0.001939
20141,Osborne County,,KS,325,4805,5130,0,0,0,0,0,0,0,0,0,0,0,0,34,0.00005,30,62,0,0
20143,Ottawa County,,KS,552,7179,7731,1,1,2,231,244,475,7,0.233866,0.240234,0,0.000011,0.000016,37,0.000082,0,20,0,0.000233
20145,Pawnee County,,KS,630,7058,7688,1,1,2,59,104,163,7,0.231485,0.23727,0,0.000006,0.000003,37,0.000091,0,20,0,0.00012
20147,Phillips County,,KS,432,6706,7138,0,1,1,0,41,41,1,1,1,0,0,0,35,0.00005,29,63,0,0
20149,Pottawatomie County,,KS,1766,21933,23699,5,5,10,869,841,1710,6,0.298707,0.311123,158.451787,0.000746,0.000613,37,0.000138,0,20,0.6,0.005831
20151,Pratt County,,KS,849,10588,11437,4,4,8,201,277,478,7,0.287039,0.298869,5879.333333,0.00031,0.00026,37,0.000202,0,20,0.35,0.0023
20153,Rawlins County,,KS,164,2998,3162,0,0,0,0,0,0,0,0,0,0,0,0,36,0.00005,31,64,0,0
20155,Reno County,,KS,3768,69554,73322,14,13,27,1578,1724,3302,6,0.302212,0.316443,2665.529775,0.001112,0.000968,37,0.000422,0,20,0.428571,0.008787
20157,Republic County,,KS,367,6179,6546,1,1,2,47,59,106,8,0.211084,0.216182,0,0.000001,0,37,0.000083,0,20,0,0.00009
20159,Rice County,,KS,797,10963,11760,2,3,5,168,287,455,7,0.287011,0.298697,0.5,0.000014,0.00026,37,0.0001,0,20,0.916667,0.000289
20161,Riley County,,KS,9340,47464,56804,39,36,75,4373,4528,8901,6,0.364296,0.390939,27623.059595,0.010337,0.01229,37,0.000754,0,20,0.349214,0.0813
20163,Rooks County,,KS,357,6051,6408,1,1,2,60,76,136,7,0.232094,0.238118,0,0.000007,0.000007,37,0.000093,0,20,0,0.000164
20165,Rush County,,KS,287,3823,4110,0,2,2,0,125,125,7,0.232193,0.238494,0,0,0.00001,37,0.00005,0,65,1,0
20167,Russell County,,KS,552,7645,8197,1,1,2,82,149,231,7,0.232094,0.238118,0,0.000007,0.000007,37,0.000093,0,20,0,0.000164
20169,Saline County,,KS,4254,62756,67010,16,16,32,1888,2098,3986,6,0.305223,0.320401,30422.814075,0.002125,0.001391,37,0.000601,0,20,0.310458,0.016339
20171,Scott County,,KS,442,5780,6222,1,1,2,50,64,114,7,0.255129,0.26326,0,0.000026,0.000021,37,0.000074,0,20,0,0.000256
20173,Sedgwick County,,KS,26092,519704,545796,97,109,206,16011,17092,33103,6,0.402267,0.43673,146479.14815,0.032037,0.039464,37,0.00173,0,20,0.328903,0.243951
20175,Seward County,,KS,2284,24413,26697,5,9,14,497,763,1260,6,0.308067,0.322841,11603.14105,0.000037,0.001151,37,0.000265,0,20,0.25,0.00064
20177,Shawnee County,,KS,9996,194542,204538,39,34,73,5849,5601,11450,6,0.364114,0.390143,28830.969587,0.010459,0.011556,37,0.000874,0,20,0.334848,0.075932
20179,Sheridan County,,KS,166,3256,3422,0,0,0,0,0,0,0,0,0,0,0,0,38,0.00005,32,66,0,0
20181,Sherman County,,KS,673,6317,6990,1,1,2,58,50,108,8,0.188435,0.191816,0,0,0,37,0.000101,0,20,0,0.000089
20183,Smith County,,KS,305,5012,5317,0,0,0,0,0,0,0,0,0,0,0,0,39,0.00005,33,67,0,0
20185,Stafford County,,KS,351,4990,5341,0,1,1,0,42,42,7,0.231528,0.237361,0,0,0.000003,37,0.00005,0,68,0,0
20187,Stanton County,,KS,227,2376,2603,0,1,1,0,45,45,8,0.203325,0.207513,0,0,0,37,0.00005,0,69,0,0
20189,Stevens County,,KS,648,6184,6832,1,1,2,70,70,140,7,0.235532,0.241838,0,0.000009,0,37,0.000075,0,20,0,0.000098
20191,Sumner County,,KS,2141,27259,29400,3,3,6,981,1197,2178,7,0.286954,0.298583,0,0.000318,0.000257,37,0.000111,0,20,1,0.002277
20193,Thomas County,,KS,817,8341,9158,2,3,5,91,174,265,7,0.232169,0.238576,8847,0.000007,0.000007,37,0.000179,0,20,0,0.000251
20195,Trego County,,KS,237,3682,3919,0,1,1,0,48,48,7,0.232137,0.238208,0,0,0.000007,37,0.00005,0,70,0,0
20197,Wabaunsee County,,KS,759,7722,8481,3,4,7,327,428,755,7,0.269395,0.280081,4.214181,0.00019,0.000169,37,0.000113,0,20,0.666667,0.001598
20199,Wallace County,,KS,100,1855,1955,0,0,0,0,0,0,0,0,0,0,0,0,40,0.00005,34,71,0,0
20201,Washington County,,KS,368,7457,7825,0,1,1,0,63,63,8,0.21228,0.217438,0,0,0.000001,37,0.00005,0,72,0,0
20203,Wichita County,,KS,228,2814,3042,0,0,0,0,0,0,0,0,0,0,0,0,41,0.00005,35,73,0,0
20205,Wilson County,,KS,823,10653,11476,3,3,6,331,324,655,7,0.287039,0.298726,0,0.000324,0.000258,37,0.000103,0,20,1,0.002288
20207,Woodson County,,KS,282,3579,3861,1,0,1,45,0,45,0,0,0,0,0.000004,0,37,0.000067,0,9,0,0.000089
20209,Wyandotte County,,KS,14063,151358,165421,19,24,43,8689,11005,19694,6,0.359392,0.383637,1962.835529,0.006275,0.008154,37,0.000363,0,20,0.535,0.047789
21001,Adair County,,KY,817,16597,17414,4,4,8,358,318,676,7,0.234772,0.242486,82.474736,0.000005,0.000046,130,0.000257,0,20,0.2,0.000457
21003,Allen County,,KY,1213,18889,20102,5,5,10,673,663,1336,7,0.257591,0.26745,41.262103,0.000067,0.000176,130,0.000223,0,20,0.5,0.001872
21005,Anderson County,,KY,1443,23413,24856,8,6,14,1218,847,2065,7,0.284736,0.296796,39.124726,0.000706,0.000233,130,0.00025,0,20,0.611111,0.006091
21007,Ballard County,,KY,591,8996,9587,1,2,3,223,330,553,7,0.239842,0.24703,0,0.000015,0.000023,130,0.000082,0,20,1,0.000286
21009,Barren County,,KY,2316,43192,45508,7,7,14,1368,1240,2608,7,0.290245,0.304041,11895.77003,0.000448,0.000514,130,0.000358,0,20,0.309524,0.004475
21011,Bath County,,KY,722,11609,12331,3,5,8,379,451,830,8,0.226653,0.234221,18.707277,0.000003,0.000006,130,0.000179,0,20,0.45,0.000332
21013,Bell County,,KY,1351,24874,26225,6,6,12,566,708,1274,7,0.291233,0.304826,1681.588137,0.000316,0.000596,130,0.000212,0,20,0.357143,0.003476
21015,Boone County,,KY,11573,119884,131457,24,19,43,10148,7689,17837,6,0.32605,0.3463,7423.775209,0.009724,0.004469,113,0.000387,0,20,0.504274,0.070899
21017,Bourbon County,,KY,1570,20890,22460,6,7,13,802,1070,1872,7,0.284875,0.297197,17.970852,0.000268,0.000241,130,0.000251,0,20,0.595238,0.002355
21019,Boyd County,,KY,2790,50611,53401,9,10,19,1714,1559,3273,6,0.312466,0.329485,7935.068192,0.001011,0.00141,113,0.000294,0,20,0.422222,0.007672
21021,Boyle County,,KY,2283,28512,30795,9,9,18,1389,1385,2774,7,0.292374,0.307002,2157.194659,0.000699,0.00072,130,0.000293,0,20,0.522222,0.006194
21023,Bracken County,,KY,716,10122,10838,5,5,10,438,437,875,6,0.292727,0.305401,165.934284,0.000566,0.000458,113,0.000144,0,20,0.6,0.003685
21025,Breathitt County,,KY,569,12596,13165,2,1,3,131,63,194,8,0.221765,0.227251,7.160534,0.000002,0.000002,130,0.000134,0,20,0,0.000198
21027,Breckinridge County,,KY,1268,20015,21283,5,6,11,704,744,1448,7,0.292169,0.306103,1659.277035,0.00055,0.000577,130,0.000168,0,20,0.466667,0.004648
21029,Bullitt County,,KY,5619,79783,85402,9,11,20,5366,4287,9653,7,0.292169,0.306676,28.827133,0.00058,0.000631,130,0.000265,0,20,0.4,0.005416
21031,Butler County,,KY,929,13838,14767,3,4,7,427,540,967,7,0.23464,0.242279,69.064853,0.00002,0.000039,130,0.000152,0,20,0.583333,0.000646
21033,Caldwell County,,KY,754,13721,14475,4,5,9,322,356,678,7,0.272983,0.283689,6726.012914,0.000157,0.000095,130,0.000213,0,20,0.2,0.00107
21035,Calloway County,,KY,2402,33313,35715,9,6,15,1084,874,1958,6,0.302024,0.316249,2265.1448,0.001853,0.00111,130,0.000256,0,20,0.319444,0.010556
21037,Campbell County,,KY,7593,96025,103618,12,11,23,5274,5837,11111,6,0.299876,0.315218,287.833241,0.001704,0.001589,113,0.000243,0,20,0.651515,0.012648
21039,Carlisle County,,KY,375,5749,6124,4,3,7,218,196,414,7,0.239921,0.247345,2546.947842,0.000021,0.000023,130,0.000175,0,20,0.5,0.000564
21041,Carroll County,,KY,1106,12303,13409,7,8,15,566,607,1173,7,0.290332,0.304356,264.181244,0.000446,0.000574,130,0.000217,0,20,0.361111,0.004269
21043,Carter County,,KY,1217,28927,30144,6,6,12,570,597,1167,7,0.238544,0.246872,324.77142,0.000026,0.000018,113,0.000293,0,20,0.261905,0.000757
21045,Casey County,,KY,775,15146,15921,3,5,8,210,360,570,8,0.226671,0.234239,26.466311,0.000013,0.000025,130,0.000148,0,20,0.45,0.000467
21047,Christian County,,KY,16028,68254,84282,27,44,71,4913,7471,12384,6,0.373892,0.401208,18552.188004,0.011084,0.019144,130,0.000429,0,20,0.530435,0.084267
21049,Clark County,,KY,2592,37603,40195,10,9,19,1680,1439,3119,7,0.292315,0.306945,4969.347739,0.000276,0.000711,130,0.000372,0,20,0.390909,0.002872
21051,Clay County,,KY,821,17675,18496,1,3,4,195,443,638,7,0.284736,0.296452,0,0.000006,0.00022,130,0.000084,0,20,0.666667,0.000159
21053,Clinton County,,KY,425,9520,9945,2,1,3,120,139,259,8,0.221681,0.22712,2910,0.000002,0,130,0.000156,0,20,0,0.000174
21055,Crittenden County,,KY,466,9272,9738,3,2,5,163,94,257,8,0.216341,0.222014,23.397662,0.000001,0.000001,130,0.000156,0,20,0,0.000281
21057,Cumberland County,,KY,292,6804,7096,0,1,1,0,45,45,9,0.181506,0.184636,0,0,0,130,0.00005,0,74,0,0
21059,Daviess County,,KY,4346,105963,110309,14,12,26,2156,2045,4201,6,0.304808,0.320487,12233.868302,0.000792,0.001373,130,0.000413,0,20,0.280952,0.007201
21061,Edmonson County,,KY,898,12300,13198,3,4,7,386,581,967,7,0.290101,0.30344,2.904194,0.000442,0.000513,130,0.000147,0,20,0.75,0.004074
21063,Elliott County,,KY,281,5435,5716,3,2,5,144,106,250,8,0.221968,0.22799,4.758442,0.000002,0.000002,130,0.000174,0,20,0.666667,0.000306
21065,Estill County,,KY,682,14607,15289,3,4,7,374,410,784,7,0.284708,0.29651,0,0.000013,0.000231,130,0.000153,0,20,1,0.000469
21067,Fayette County,,KY,22290,275664,297954,94,91,185,14320,15338,29658,6,0.397541,0.430842,231759.137686,0.027317,0.032448,130,0.002041,0,20,0.243002,0.204353
21069,Fleming County,,KY,891,15395,16286,4,5,9,350,408,758,8,0.222239,0.229061,37.02235,0.000004,0.000005,130,0.000191,0,20,0.45,0.000406
21071,Floyd County,,KY,1744,37170,38914,5,5,10,766,871,1637,7,0.284903,0.296968,4695.587331,0.000255,0.000232,130,0.000199,0,20,0.266667,0.002141
21073,Franklin County,,KY,3502,55087,58589,8,9,17,1539,1954,3493,7,0.292139,0.306601,199.593143,0.000701,0.000711,130,0.00025,0,20,0.5,0.006078
21075,Fulton County,,KY,732,6415,7147,2,4,6,191,438,629,7,0.23647,0.243599,428.037115,0.000015,0.000014,130,0.000109,0,20,0.416667,0.000239
21077,Gallatin County,,KY,780,5830,6610,5,5,10,429,500,929,7,0.263587,0.273598,3.671427,0.000112,0.000128,113,0.000147,0,20,0.75,0.001423
21079,Garrard County,,KY,1388,16484,17872,6,6,12,1124,966,2090,7,0.284792,0.296882,2.109524,0.000273,0.000239,130,0.000223,0,20,0.866667,0.002473
21081,Grant County,,KY,2837,26686,29523,9,9,18,1945,2038,3983,6,0.292992,0.306403,304.651875,0.001074,0.000542,113,0.000211,0,20,0.527273,0.007381
21083,Graves County,,KY,1979,38409,40388,6,7,13,903,1029,1932,6,0.297973,0.310848,1967.44241,0.000025,0.000651,130,0.00026,0,20,0.357143,0.000835
21085,Grayson County,,KY,1191,26616,27807,6,6,12,627,588,1215,7,0.292169,0.306103,399.29942,0.000534,0.000595,130,0.000188,0,20,0.47619,0.004693
21087,Green County,,KY,593,11720,12313,4,2,6,258,215,473,8,0.226195,0.232692,912.639193,0.000433,0.000004,130,0.000176,0,20,0.5,0.003873
21089,Greenup County,,KY,2256,39132,41388,7,6,13,1341,1287,2628,6,0.309114,0.324931,2213.557991,0.001009,0.000933,113,0.000218,0,20,0.619048,0.007472
21091,Hancock County,,KY,680,9677,10357,4,3,7,410,393,803,7,0.234677,0.241962,26.310665,0.000016,0.000011,130,0.000174,0,20,0.25,0.000508
21093,Hardin County,,KY,11572,104720,116292,34,39,73,5359,6440,11799,6,0.363932,0.389645,9599.26174,0.010017,0.012449,130,0.000572,0,20,0.418051,0.070684
21095,Harlan County,,KY,954,27100,28054,5,6,11,267,344,611,7,0.28521,0.297489,843.696034,0.000261,0.000239,130,0.000191,0,20,0.375,0.002174
21097,Harrison County,,KY,1114,19810,20924,6,4,10,604,560,1164,7,0.284652,0.296395,58.559821,0.000266,0.000225,130,0.0002,0,20,0.5,0.002393
21099,Hart County,,KY,1095,18236,19331,5,5,10,654,637,1291,7,0.292169,0.305988,17.752696,0.000543,0.000591,130,0.000186,0,20,0.7,0.004857
21101,Henderson County,,KY,2883,50728,53611,7,8,15,1334,1495,2829,7,0.293199,0.30793,4630.296676,0.000526,0.000732,130,0.00021,0,20,0.517857,0.004541
21103,Henry County,,KY,1296,16711,18007,6,5,11,986,852,1838,7,0.289985,0.303325,4.06011,0.000449,0.000494,130,0.000197,0,20,0.633333,0.00425
21105,Hickman County,,KY,382,5085,5467,2,4,6,100,188,288,7,0.240099,0.247878,20.725388,0,0.000029,130,0.000123,0,20,0.55,0.000185
21107,Hopkins County,,KY,2363,50543,52906,9,11,20,978,1145,2123,7,0.299506,0.315582,5755.559474,0.000668,0.001076,130,0.000258,0,20,0.363636,0.005588
21109,Jackson County,,KY,609,12607,13216,3,2,5,267,304,571,8,0.226794,0.234073,0.533333,0.000013,0.000023,130,0.000144,0,20,0.666667,0.000481
21111,Jefferson County,,KY,38470,786741,825211,169,145,314,26749,29320,56069,6,0.40802,0.447509,241401.430894,0.060555,0.054654,130,0.002617,0,20,0.282316,0.437863
21113,Jessamine County,,KY,4347,43456,47803,9,11,20,3330,2599,5929,7,0.292315,0.307174,58.247459,0.000285,0.000731,130,0.000321,0,20,0.545455,0.00289
21115,Johnson County,,KY,1172,21647,22819,5,5,10,655,451,1106,7,0.284875,0.296882,5427.562707,0.000004,0.000219,130,0.000201,0,20,0.266667,0.000512
21117,Kenton County,,KY,14794,170693,185487,20,27,47,11969,11691,23660,6,0.357011,0.381208,13997.403137,0.00517,0.008758,113,0.000376,0,20,0.411376,0.036297
21119,Knott County,,KY,833,14010,14843,3,3,6,317,410,727,8,0.222307,0.228546,8.797519,0.000005,0.000006,130,0.000161,0,20,0.333333,0.000327
21121,Knox County,,KY,1489,28691,30180,3,4,7,766,798,1564,7,0.284875,0.296796,1.444048,0.000012,0.000222,130,0.000143,0,20,0.666667,0.000378
21123,Larue County,,KY,1071,14732,15803,5,5,10,781,703,1484,7,0.292022,0.305702,4.832255,0.000536,0.000561,130,0.000159,0,20,0.566667,0.0046
21125,Laurel County,,KY,2969,56067,59036,13,11,24,1882,1592,3474,7,0.292609,0.307661,13135.367557,0.00098,0.000714,130,0.000442,0,20,0.269231,0.007038
21127,Lawrence County,,KY,813,14510,15323,5,4,9,355,339,694,7,0.239014,0.247113,113.098303,0.000019,0.000009,113,0.000203,0,20,0.35,0.000549
21129,Lee County,,KY,351,6040,6391,1,2,3,44,86,130,8,0.226774,0.23398,2911,0,0.000015,130,0.000145,0,75,0,0.000086
21131,Leslie County,,KY,463,10592,11055,2,3,5,117,199,316,8,0.226688,0.233821,9.284499,0.000007,0.000012,130,0.000134,0,20,0.166667,0.000268
21133,Letcher County,,KY,904,22681,23585,5,7,12,341,486,827,7,0.285602,0.298234,2948.954898,0.000257,0.000236,130,0.00022,0,20,0.261905,0.002178
21135,Lewis County,,KY,584,13378,13962,4,4,8,309,306,615,7,0.236662,0.244556,108.510284,0.000008,0.000012,130,0.000175,0,20,0.3,0.000462
21137,Lincoln County,,KY,1708,25318,27026,7,8,15,1101,1129,2230,7,0.284931,0.29734,1141.509797,0.000267,0.000238,130,0.000271,0,20,0.517857,0.002509
21139,Livingston County,,KY,763,10132,10895,2,3,5,393,464,857,7,0.23996,0.247402,659.321257,0.000015,0.000024,130,0.000125,0,20,0.333333,0.000385
21141,Logan County,,KY,1550,28376,29926,6,7,13,758,823,1581,6,0.298003,0.310905,1288.833428,0.000031,0.000661,130,0.000239,0,20,0.309524,0.001056
21143,Lyon County,,KY,617,7398,8015,3,2,5,239,190,429,8,0.215779,0.221316,24.913446,0.000016,0.000001,130,0.000162,0,20,0.333333,0.000484
21145,McCracken County,,KY,4699,70634,75333,15,13,28,2440,2262,4702,6,0.315413,0.332291,43381.309548,0.003002,0.001952,130,0.000487,0,20,0.216912,0.024075
21147,McCreary County,,KY,621,14238,14859,2,2,4,178,219,397,8,0.228864,0.236117,102.10069,0.000009,0.000014,130,0.000128,0,20,0,0.000294
21149,McLean County,,KY,729,10584,11313,2,4,6,332,512,844,7,0.235914,0.243545,0.479701,0.000011,0.000015,130,0.000105,0,20,0.666667,0.00026
21151,Madison County,,KY,5757,75392,81149,22,17,39,3201,2993,6194,7,0.293081,0.309264,17419.47014,0.001928,0.000768,130,0.000715,0,20,0.199275,0.015135
21153,Magoffin County,,KY,410,11253,11663,0,2,2,0,161,161,8,0.221892,0.227757,0,0,0.000002,130,0.00005,0,76,1,0
21155,Marion County,,KY,973,19249,20222,5,6,11,524,554,1078,7,0.292051,0.306086,50.48037,0.000692,0.0007,130,0.000183,0,20,0.6,0.005643
21157,Marshall County,,KY,1879,33740,35619,5,5,10,1082,1033,2115,7,0.240059,0.247889,344.131608,0.000029,0.000038,130,0.000254,0,20,0.45,0.000747
21159,Martin County,,KY,484,9758,10242,1,3,4,52,202,254,7,0.237241,0.244747,2.394877,0.000002,0.000001,130,0.000084,0,20,0.666667,0.000097
21161,Mason County,,KY,1318,18153,19471,6,6,12,666,670,1336,7,0.284959,0.297225,2025.600935,0.000082,0.000228,130,0.000195,0,20,0.190476,0.000965
21163,Meade County,,KY,4113,29871,33984,9,11,20,2125,2102,4227,6,0.324053,0.340704,473.783592,0.00242,0.0032,130,0.000175,0,20,0.551282,0.019539
21165,Menifee County,,KY,498,5994,6492,2,1,3,160,203,363,8,0.221748,0.227372,0,0.000002,0.000002,130,0.000132,0,20,1,0.000213
21167,Mercer County,,KY,1454,24021,25475,9,7,16,905,826,1731,7,0.284736,0.296882,14.533272,0.000285,0.000231,130,0.000301,0,20,0.511111,0.002888
21169,Metcalfe County,,KY,612,10340,10952,2,1,3,335,318,653,8,0.224971,0.231163,0,0.000004,0.000003,130,0.000133,0,20,1,0.000216
21171,Monroe County,,KY,451,11713,12164,1,2,3,79,178,257,8,0.224988,0.231335,0,0.000004,0.000004,130,0.000094,0,20,1,0.000129
21173,Montgomery County,,KY,1744,26195,27939,9,7,16,1260,957,2217,7,0.284903,0.297225,8954.367528,0.000269,0.00022,130,0.000423,0,20,0.375,0.002706
21175,Morgan County,,KY,604,11983,12587,2,3,5,106,207,313,8,0.2219,0.228002,14.233333,0.000002,0.000002,130,0.000129,0,20,0.333333,0.000206
21177,Muhlenberg County,,KY,1316,33014,34330,5,6,11,417,548,965,7,0.236297,0.244656,35.557855,0.000025,0.00005,130,0.000183,0,20,0.47619,0.000591
21179,Nelson County,,KY,2429,47445,49874,9,8,17,1882,1503,3385,7,0.294118,0.308692,113.737149,0.000801,0.000779,130,0.00027,0,20,0.472222,0.006671
21181,Nicholas County,,KY,528,7662,8190,2,4,6,173,299,472,7,0.284624,0.296338,0,0.000254,0.000222,130,0.0001,0,20,1,0.001845
21183,Ohio County,,KY,1372,24556,25928,6,5,11,738,709,1447,7,0.235342,0.243414,913.734652,0.00044,0.000046,130,0.000202,0,20,0.375,0.0041
21185,Oldham County,,KY,4369,57131,61500,9,7,16,3430,2485,5915,7,0.292022,0.306143,129.735468,0.001563,0.000719,130,0.000255,0,20,0.472222,0.012088
21187,Owen County,,KY,913,10652,11565,7,7,14,567,572,1139,7,0.263802,0.274342,20.857159,0.000123,0.00014,113,0.000203,0,20,0.452381,0.001724
21189,Owsley County,,KY,205,3802,4007,1,1,2,40,44,84,9,0.184865,0.188718,0,0,0,130,0.000112,0,75,0,0.000086
21191,Pendleton County,,KY,1240,14823,16063,7,6,13,935,882,1817,7,0.263491,0.273483,20.615951,0.000608,0.000144,113,0.000193,0,20,0.642857,0.004487
21193,Perry County,,KY,1194,28578,29772,5,5,10,581,488,1069,7,0.284931,0.29683,9042.290808,0.000254,0.000214,130,0.000293,0,20,0.2,0.002112
21195,Pike County,,KY,2368,57973,60341,6,6,12,920,918,1838,7,0.285238,0.297489,5497.12393,0.000682,0.000222,130,0.000202,0,20,0.309524,0.00567
21197,Powell County,,KY,1026,13209,14235,5,6,11,338,641,979,7,0.284875,0.297082,3213.300866,0.000267,0.000231,130,0.000224,0,20,0.566667,0.002305
21199,Pulaski County,,KY,2874,60651,63525,15,11,26,1289,1192,2481,7,0.292757,0.307976,19091.662789,0.001822,0.000746,130,0.000527,0,20,0.266667,0.013008
21201,Robertson County,,KY,109,1968,2077,0,0,0,0,0,0,0,0,0,0,0,0,42,0.00005,36,77,0,0
21203,Rockcastle County,,KY,734,16351,17085,4,4,8,376,372,748,8,0.227078,0.234989,3.405556,0.000019,0.000039,130,0.00019,0,20,0.666667,0.000715
21205,Rowan County,,KY,1576,19587,21163,8,7,15,713,668,1381,7,0.284959,0.29734,18054.800631,0.000254,0.000214,130,0.000373,0,20,0.232143,0.002416
21207,Russell County,,KY,758,16945,17703,4,2,6,280,229,509,8,0.226547,0.233494,938.160638,0.00043,0.000014,130,0.000186,0,20,0.416667,0.003919
21209,Scott County,,KY,3133,43083,46216,14,11,25,3088,1773,4861,7,0.292345,0.307231,394.115922,0.000751,0.000723,130,0.000413,0,20,0.333333,0.007394
21211,Shelby County,,KY,2674,39622,42296,8,9,17,2172,1711,3883,7,0.29211,0.306544,78.230493,0.000701,0.000737,130,0.000258,0,20,0.486111,0.006117
21213,Simpson County,,KY,1226,18533,19759,5,5,10,747,646,1393,7,0.257568,0.267392,16.707031,0.000072,0.000182,130,0.000212,0,20,0.65,0.001931
21215,Spencer County,,KY,1263,16166,17429,4,4,8,1530,868,2398,7,0.289927,0.303096,0.5,0.000441,0.000486,130,0.000139,0,20,0.833333,0.003958
21217,Taylor County,,KY,1364,24291,25655,5,7,12,541,600,1141,7,0.292227,0.306332,4594.110393,0.000527,0.000598,130,0.000233,0,20,0.428571,0.004531
21219,Todd County,,KY,809,12636,13445,3,3,6,389,401,790,7,0.285518,0.297401,69.854916,0.000438,0.000313,130,0.000098,0,20,0.333333,0.002638
21221,Trigg County,,KY,1024,14498,15522,3,3,6,353,348,701,7,0.285518,0.297372,40.045003,0.000434,0.000327,130,0.000105,0,20,0.416667,0.002634
21223,Trimble County,,KY,703,9401,10104,5,5,10,479,452,931,7,0.29013,0.303612,3.784413,0.000446,0.000497,130,0.000172,0,20,0.75,0.004133
21225,Union County,,KY,988,16169,17157,3,4,7,283,463,746,7,0.266069,0.275745,1146.709408,0.000006,0.000038,130,0.00016,0,20,0.416667,0.000314
21227,Warren County,,KY,6728,103479,110207,28,17,45,4116,3230,7346,6,0.306219,0.322812,17107.406383,0.004558,0.001844,130,0.00076,0,20,0.224138,0.038581
21229,Washington County,,KY,687,12189,12876,5,4,9,377,379,756,7,0.291934,0.305628,24.82506,0.000267,0.000693,130,0.000196,0,20,0.633333,0.002281
21231,Wayne County,,KY,850,19255,20105,2,3,5,322,328,650,7,0.284792,0.296481,8786,0.000006,0.000226,130,0.000224,0,20,0.333333,0.000294
21233,Webster County,,KY,1148,14765,15913,3,5,8,529,718,1247,7,0.266532,0.276633,7.571331,0.000014,0.00005,130,0.000127,0,20,0.7,0.000363
21235,Whitley County,,KY,2074,34106,36180,5,6,11,1079,1157,2236,7,0.28521,0.297655,102.172714,0.000019,0.000251,130,0.000204,0,20,0.452381,0.000712
21237,Wolfe County,,KY,438,6537,6975,2,3,5,102,143,245,8,0.226494,0.233591,35.229348,0.000002,0.000002,130,0.000119,0,20,0.166667,0.0002
21239,Woodford County,,KY,2024,26444,28468,6,7,13,1220,1315,2535,7,0.292051,0.3062,43.618555,0.000695,0.000703,130,0.0002,0,20,0.761905,0.005831
22001,Acadia Parish,,LA,3290,61464,64754,15,10,25,2843,2373,5216,6,0.321228,0.339141,156.776115,0.003358,0.001397,0,0.0002,0,20,0.616667,0.0142
22003,Allen Parish,,LA,1429,22010,23439,9,7,16,1011,817,1828,7,0.275047,0.287366,18.49485,0.001063,0.000282,0,0.000164,0,20,0.472222,0.003382
22005,Ascension Parish,,LA,6330,96218,102548,22,18,40,9279,3790,13069,6,0.324741,0.344175,751.252087,0.004032,0.002333,0,0.000266,0,20,0.433846,0.016579
22007,Assumption Parish,,LA,1414,24485,25899,9,5,14,1252,894,2146,7,0.279271,0.291865,1.434524,0.0019,0.000265,0,0.000132,0,20,0.75,0.004423
22009,Avoyelles Parish,,LA,1666,41825,43491,10,8,18,1636,896,2532,6,0.321192,0.338855,157.358023,0.002942,0.001309,0,0.000147,0,20,0.590909,0.012244
22011,Beauregard Parish,,LA,2869,32065,34934,8,6,14,1810,1329,3139,6,0.324053,0.341907,277.609453,0.002797,0.001755,0,0.000114,0,20,0.544444,0.011761
22013,Bienville Parish,,LA,1055,14565,15620,7,6,13,594,654,1248,7,0.270975,0.28246,34.510911,0.000245,0.000241,0,0.000192,0,20,0.571429,0.00243
22015,Bossier Parish,,LA,12933,110038,122971,39,27,66,9596,7645,17241,6,0.352258,0.376787,12118.610838,0.013344,0.009579,0,0.000555,0,20,0.436047,0.091663
22017,Caddo Parish,,LA,16541,263702,280243,41,44,85,13149,11161,24310,6,0.368821,0.397331,15797.673365,0.012649,0.015992,0,0.00061,0,20,0.423137,0.088124
22019,Calcasieu Parish,,LA,12557,188797,201354,38,44,82,7223,7577,14800,6,0.360684,0.388259,8215.873142,0.008182,0.013569,0,0.000481,0,20,0.373864,0.051133
22021,Caldwell Parish,,LA,658,9654,10312,2,2,4,218,313,531,7,0.263587,0.273655,0,0.000082,0.000053,0,0.000096,0,20,1,0.000548
22023,Cameron Parish,,LA,2134,7587,9721,1,7,8,183,1634,1817,7,0.267414,0.279365,0,0.000105,0.000269,0,0.000059,0,20,0.52381,0.000528
22025,Catahoula Parish,,LA,585,9769,10354,6,4,10,404,258,662,7,0.250366,0.259595,40.041477,0.001415,0.000076,0,0.00016,0,20,0.4,0.002768
22027,Claiborne Parish,,LA,898,15236,16134,6,5,11,479,465,944,7,0.270924,0.282231,20.918089,0.000113,0.000235,0,0.000167,0,20,0.571429,0.001554
22029,Concordia Parish,,LA,1255,19250,20505,6,6,12,714,592,1306,7,0.281895,0.295152,167.13218,0.001748,0.000288,0,0.000123,0,20,0.482143,0.004041
22031,De Soto Parish,,LA,2014,28122,30136,6,6,12,1303,1391,2694,6,0.320909,0.337869,224.789177,0.000212,0.001208,0,0.000173,0,20,0.5,0.002231
22033,East Baton Rouge Parish,,LA,28983,412593,441576,76,102,178,35485,22142,57627,6,0.387226,0.422772,64944.712323,0.020576,0.036005,0,0.001132,0,20,0.317324,0.152359
22035,East Carroll Parish,,LA,566,7246,7812,3,4,7,200,294,494,6,0.314289,0.329147,328.414437,0.00077,0.000941,0,0.000102,0,20,0.5,0.001138
22037,East Feliciana Parish,,LA,1517,19640,21157,5,3,8,1228,1096,2324,7,0.279217,0.291521,1.166667,0.001082,0.000204,0,0.000131,0,20,0.65,0.002889
22039,Evangeline Parish,,LA,1641,33204,34845,12,7,19,1251,1094,2345,7,0.280888,0.294133,18.649635,0.002126,0.000412,0,0.000185,0,20,0.659091,0.005976
22041,Franklin Parish,,LA,1145,20648,21793,6,3,9,566,529,1095,7,0.263611,0.273827,508.932381,0.002223,0.000064,0,0.000148,0,20,0.5,0.008485
22043,Grant Parish,,LA,1451,19215,20666,7,4,11,1226,905,2131,7,0.250301,0.259509,1285.077702,0.001129,0.000075,0,0.000165,0,20,0.428571,0.008324
22045,Iberia Parish,,LA,4174,79544,83718,14,11,25,3472,2892,6364,6,0.32514,0.343568,58.717665,0.00318,0.002191,0,0.000184,0,20,0.654412,0.013977
22047,Iberville Parish,,LA,2076,31983,34059,8,6,14,2070,1500,3570,7,0.279297,0.292036,1.333333,0.001869,0.000266,0,0.000144,0,20,0.708333,0.004221
22049,Jackson Parish,,LA,1132,15845,16977,5,4,9,669,552,1221,7,0.263778,0.274273,77.171012,0.000877,0.000071,0,0.00013,0,20,0.35,0.00175
22051,Jefferson Parish,,LA,79318,349425,428743,44,241,285,43017,69191,112208,5,0.438716,0.484931,47143.697479,0.017915,0.078276,0,0.000485,0,20,0.238866,0.126386
22053,Jefferson Davis Parish,,LA,2045,32489,34534,9,8,17,1367,1346,2713,6,0.320485,0.337738,240.643649,0.002501,0.001204,0,0.000146,0,20,0.654545,0.011078
22055,Lafayette Parish,,LA,14346,208531,222877,42,42,84,14721,10090,24811,6,0.357582,0.384788,2867.021829,0.010637,0.013916,0,0.000522,0,20,0.390196,0.070258
22057,Lafourche Parish,,LA,4898,96904,101802,15,14,29,4402,3148,7550,6,0.32715,0.346753,169.917751,0.00245,0.001783,0,0.000183,0,20,0.625,0.006814
22059,La Salle Parish,,LA,758,13578,14336,5,5,10,370,355,725,7,0.264786,0.275705,51.112219,0.000118,0.000117,0,0.00019,0,20,0.4,0.001175
22061,Lincoln Parish,,LA,3592,37712,41304,13,13,26,1693,1734,3427,6,0.327961,0.347136,1765.252513,0.002154,0.003106,0,0.000245,0,20,0.516667,0.0065
22063,Livingston Parish,,LA,7528,111896,119424,24,18,42,9818,4702,14520,6,0.324958,0.344519,986.236906,0.004054,0.001838,0,0.000344,0,20,0.435,0.017072
22065,Madison Parish,,LA,851,11649,12500,5,4,9,271,379,650,7,0.264041,0.274629,44.081338,0.000786,0.000078,0,0.000154,0,20,0.366667,0.001384
22067,Morehouse Parish,,LA,1849,31151,33000,6,6,12,795,984,1779,6,0.317097,0.332978,648.174672,0.000693,0.001001,0,0.000155,0,20,0.392857,0.00194
22069,Natchitoches Parish,,LA,2516,36640,39156,15,13,28,1591,1361,2952,6,0.32627,0.34512,3984.889279,0.003768,0.002333,0,0.000256,0,20,0.419118,0.019663
22071,Orleans Parish,,LA,212441,162570,375011,33,358,391,8896,202527,211423,5,0.460297,0.515063,68862.241056,0.015794,0.099063,0,0.000331,0,20,0.16543,0.110433
22073,Ouachita Parish,,LA,9354,155302,164656,33,38,71,6397,5442,11839,6,0.357758,0.384284,36069.063434,0.006747,0.010426,0,0.00061,0,20,0.291667,0.040999
22075,Plaquemines Parish,,LA,9383,19151,28534,5,37,42,1690,6146,7836,6,0.35213,0.377921,267.558757,0.002882,0.008515,0,0.000065,0,20,0.416074,0.010452
22077,Pointe Coupee Parish,,LA,1334,23062,24396,9,5,14,1285,824,2109,7,0.279297,0.291922,2.592857,0.00188,0.000243,0,0.000154,0,20,0.694444,0.004411
22079,Rapides Parish,,LA,7199,137250,144449,29,24,53,5966,3987,9953,6,0.333486,0.355298,9011.297112,0.005713,0.004541,0,0.000449,0,20,0.35322,0.030723
22081,Red River Parish,,LA,634,9369,10003,3,4,7,300,341,641,7,0.270874,0.282031,0.801074,0.000217,0.000233,0,0.000096,0,20,0.833333,0.001884
22083,Richland Parish,,LA,1407,20609,22016,5,4,9,843,773,1616,7,0.263802,0.274273,15.135054,0.000083,0.000081,0,0.000174,0,20,0.466667,0.000907
22085,Sabine Parish,,LA,1230,23173,24403,6,5,11,559,526,1085,7,0.276065,0.288248,11.991299,0.000978,0.000262,0,0.000123,0,20,0.666667,0.003476
22087,St. Bernard Parish,,LA,43399,11962,55361,2,91,93,248,38154,38402,6,0.370701,0.405424,5.884512,0.001376,0.022869,0,0.000053,0,20,0.263004,0.00202
22089,St. Charles Parish,,LA,5044,49855,54899,10,16,26,5137,2827,7964,6,0.331662,0.35201,9.244925,0.002293,0.004162,0,0.000108,0,20,0.686275,0.005518
22091,St. Helena Parish,,LA,908,13108,14016,5,3,8,1133,621,1754,7,0.279244,0.291578,0,0.001691,0.000229,0,0.00009,0,20,0.95,0.003896
22093,St. James Parish,,LA,1166,24462,25628,7,5,12,1337,703,2040,6,0.305448,0.319777,0.166667,0.001891,0.000366,0,0.000094,0,20,0.857143,0.003999
22095,St. John the Baptist Parish,,LA,4626,47087,51713,9,12,21,5317,2722,8039,6,0.331435,0.351208,64.380491,0.002215,0.003302,0,0.000111,0,20,0.730769,0.005257
22097,St. Landry Parish,,LA,4385,86312,90697,20,13,33,4613,3023,7636,6,0.324523,0.343259,359.685768,0.003551,0.001568,0,0.000282,0,20,0.521429,0.016114
22099,St. Martin Parish,,LA,3194,54022,57216,13,8,21,3324,2352,5676,6,0.321086,0.338683,1.137566,0.003061,0.001325,0,0.000179,0,20,0.769231,0.013128
22101,St. Mary Parish,,LA,3249,58782,62031,14,10,24,2482,1845,4327,6,0.324342,0.342629,163.376272,0.00328,0.001472,0,0.000184,0,20,0.686813,0.013738
22103,St. Tammany Parish,,LA,25573,171692,197265,44,107,151,23574,16856,40430,6,0.397813,0.433133,10941.724578,0.018332,0.040201,0,0.000468,0,20,0.388432,0.127103
22105,Tangipahoa Parish,,LA,6606,99016,105622,20,17,37,9583,3630,13213,6,0.330757,0.351037,954.249151,0.00494,0.002712,0,0.000228,0,20,0.516304,0.022996
22107,Tensas Parish,,LA,368,5390,5758,2,0,2,147,0,147,0,0,0,0,0.000771,0,0,0.000068,0,12,0.5,0.001065
22109,Terrebonne Parish,,LA,6047,116373,122420,15,15,30,5029,3350,8379,6,0.329446,0.349765,313.534108,0.003757,0.002718,0,0.000175,0,20,0.653595,0.014849
22111,Union Parish,,LA,1501,22969,24470,5,6,11,894,963,1857,7,0.265003,0.276181,77.473079,0.000731,0.000085,0,0.000119,0,20,0.333333,0.001962
22113,Vermilion Parish,,LA,3220,58321,61541,15,10,25,2668,2302,4970,6,0.321228,0.339141,92.490175,0.003071,0.001408,0,0.000203,0,20,0.638095,0.013395
22115,Vernon Parish,,LA,11622,49003,60625,33,39,72,3414,5558,8972,6,0.366176,0.393351,5056.54498,0.011415,0.014627,0,0.000393,0,20,0.499495,0.076906
22117,Washington Parish,,LA,2973,39237,42210,11,9,20,2251,1284,3535,6,0.326124,0.344399,2003.135324,0.002261,0.002185,0,0.000148,0,20,0.587912,0.005648
22119,Webster Parish,,LA,2477,41749,44226,9,7,16,1387,1517,2904,7,0.271126,0.282861,2076.802784,0.00189,0.000223,0,0.000193,0,20,0.411111,0.010343
22121,West Baton Rouge Parish,,LA,1934,23971,25905,9,5,14,2153,1421,3574,7,0.279271,0.291865,1.086905,0.001882,0.000252,0,0.000157,0,20,0.722222,0.004458
22123,West Carroll Parish,,LA,880,11902,12782,3,5,8,280,447,727,7,0.263802,0.274388,18.36063,0.000096,0.00007,0,0.000107,0,20,0.55,0.000652
22125,West Feliciana Parish,,LA,873,10223,11096,4,2,6,641,496,1137,7,0.27919,0.291349,1.094595,0.001657,0.000168,0,0.000099,0,20,0.75,0.003464
22127,Winn Parish,,LA,876,14373,15249,3,5,8,277,389,666,7,0.264858,0.275877,23.785277,0.000019,0.000141,0,0.00013,0,20,0.5,0.000522
23001,Androscoggin County,,ME,7199,116319,123518,17,16,33,5115,4419,9534,6,0.338175,0.358076,1034.34746,0.003287,0.00415,44,0.000252,0,20,0.534211,0.022216
23003,Aroostook County,,ME,2817,80444,83261,13,9,22,1197,1208,2405,7,0.274736,0.287283,209.385015,0.002574,0.000464,44,0.000192,0,20,0.549451,0.015157
23005,Cumberland County,,ME,21481,313614,335095,71,80,151,14937,15431,30368,6,0.377873,0.410326,27018.491303,0.029328,0.037529,44,0.000716,0,20,0.483987,0.196428
23007,Franklin County,,ME,1791,31435,33226,7,7,14,972,994,1966,7,0.274684,0.286939,0.166667,0.000544,0.000467,44,0.000142,0,20,0.97619,0.003745
23009,Hancock County,,ME,3065,60144,63209,8,8,16,1402,1277,2679,6,0.301742,0.317108,274.676551,0.001236,0.001143,44,0.000147,0,20,0.785714,0.008436
23011,Kennebec County,,ME,7541,135728,143269,23,24,47,5296,5109,10405,6,0.338293,0.359462,2230.644186,0.004336,0.005229,44,0.00031,0,20,0.491379,0.026924
23013,Knox County,,ME,2555,44467,47022,7,7,14,1008,1264,2272,7,0.274684,0.286939,23.071256,0.001103,0.000445,44,0.000136,0,20,0.847222,0.007787
23015,Lincoln County,,ME,2580,40398,42978,8,10,18,1469,1569,3038,6,0.301805,0.317451,64.89764,0.001241,0.001199,44,0.000145,0,20,0.788889,0.008557
23017,Oxford County,,ME,3339,61263,64602,12,8,20,2363,2093,4456,7,0.274762,0.287197,37.547581,0.002729,0.00049,44,0.000159,0,20,0.730769,0.015799
23019,Penobscot County,,ME,8404,161204,169608,29,24,53,5511,4946,10457,6,0.336416,0.357194,4895.156305,0.006624,0.004305,44,0.000362,0,20,0.472782,0.039825
23021,Piscataquis County,,ME,1134,18465,19599,3,3,6,437,506,943,7,0.274373,0.285971,0,0.000176,0.000293,44,0.000093,0,20,1,0.00132
23023,Sagadahoc County,,ME,4224,40690,44914,9,8,17,2598,2482,5080,7,0.298707,0.314677,146.711104,0.00359,0.001072,44,0.000138,0,20,0.654545,0.025399
23025,Somerset County,,ME,3191,53423,56614,14,9,23,2545,2122,4667,7,0.274736,0.287283,85.807413,0.00186,0.000461,44,0.000227,0,20,0.593407,0.011056
23027,Waldo County,,ME,2595,41649,44244,8,8,16,1637,1446,3083,7,0.27471,0.287111,1.719048,0.00053,0.000448,44,0.000156,0,20,0.821429,0.003725
23029,Washington County,,ME,1670,35554,37224,4,6,10,401,710,1111,7,0.274658,0.286767,0,0.000086,0.000435,44,0.000108,0,20,1,0.001114
23031,York County,,ME,13857,227766,241623,41,44,85,9796,9720,19516,6,0.354144,0.379381,9956.87394,0.011966,0.017971,44,0.000447,0,20,0.453535,0.076492
24001,Allegany County,,MD,3090,74646,77736,12,12,24,1427,1465,2892,6,0.303188,0.319777,4477.267954,0.00316,0.002578,43,0.000239,0,20,0.429487,0.021624
24003,Anne Arundel County,,MD,51987,581426,633413,153,171,324,38006,41560,79566,6,0.404391,0.447325,25528.368952,0.070206,0.073609,43,0.001416,0,20,0.363153,0.483292
24005,Baltimore County,,MD,67167,889869,957036,143,154,297,60324,58761,119085,6,0.401213,0.441838,19174.790653,0.067337,0.07133,43,0.001265,0,20,0.448994,0.446857
24009,Calvert County,,MD,6742,101144,107886,12,17,29,5050,3245,8295,6,0.338648,0.359101,2.495369,0.005721,0.008009,43,0.000138,0,20,0.808824,0.038814
24011,Caroline County,,MD,2503,34499,37002,11,8,19,2488,1691,4179,7,0.292698,0.308073,1.413351,0.002812,0.001487,43,0.000156,0,20,0.854545,0.019382
24013,Carroll County,,MD,11329,198329,209658,15,22,37,9346,7595,16941,6,0.319675,0.339611,44.138973,0.005981,0.006986,43,0.000182,0,20,0.608696,0.041435
24015,Cecil County,,MD,6660,107285,113945,18,14,32,5738,3869,9607,6,0.313307,0.331117,37.901183,0.007301,0.005236,43,0.000182,0,20,0.831579,0.046679
24017,Charles County,,MD,14701,159454,174155,29,44,73,11956,9423,21379,6,0.36055,0.387566,310.191964,0.014805,0.0226,43,0.000281,0,20,0.630204,0.099199
24019,Dorchester County,,MD,1937,35084,37021,8,9,17,1407,1227,2634,6,0.299969,0.315619,3.352693,0.001926,0.002434,43,0.000135,0,20,0.888889,0.013241
24021,Frederick County,,MD,20711,257831,278542,51,65,116,16263,14631,30894,6,0.369336,0.39953,4295.975712,0.026315,0.031586,43,0.000535,0,20,0.534026,0.18623
24023,Garrett County,,MD,1349,33126,34475,7,4,11,544,487,1031,7,0.235895,0.244304,1828.051304,0.002117,0.000033,43,0.000155,0,20,0.428571,0.014194
24025,Harford County,,MD,19048,283564,302612,52,53,105,15203,12731,27934,6,0.36375,0.392446,879.576283,0.026645,0.027507,43,0.00046,0,20,0.622066,0.178662
24027,Howard County,,MD,30222,298918,329140,77,91,168,23874,23716,47590,6,0.386403,0.420086,3203.493638,0.04341,0.047906,43,0.000656,0,20,0.577815,0.285949
24029,Kent County,,MD,1182,21090,22272,4,5,9,499,474,973,7,0.290245,0.305232,0.476672,0.001096,0.001238,43,0.000085,0,20,0.85,0.007552
24031,Montgomery County,,MD,87395,1034153,1121548,217,229,446,61414,76523,137937,5,0.426061,0.473167,49922.298855,0.091885,0.09355,43,0.002048,0,20,0.307193,0.624745
24033,Prince George's County,,MD,85421,922817,1008238,146,187,333,61950,75852,137802,5,0.414885,0.458499,24989.231085,0.069524,0.076602,43,0.001343,0,20,0.349498,0.470977
24035,Queen Anne's County,,MD,3586,50046,53632,12,14,26,3114,2259,5373,6,0.305159,0.322268,66.074062,0.004251,0.003668,43,0.000163,0,20,0.691176,0.02928
24037,St. Mary's County,,MD,8362,110411,118773,24,29,53,6002,3968,9970,6,0.346017,0.369937,81.980029,0.01097,0.014501,43,0.000258,0,20,0.666667,0.078441
24039,Somerset County,,MD,1441,21315,22756,4,6,10,912,933,1845,6,0.302149,0.317766,16.020708,0.00018,0.002004,43,0.000114,0,20,0.809524,0.001907
24041,Talbot County,,MD,2825,40710,43535,13,11,24,2038,1529,3567,6,0.303536,0.319656,24.73844,0.004657,0.002957,43,0.000166,0,20,0.785714,0.031742
24043,Washington County,,MD,9670,158677,168347,21,24,45,8767,6232,14999,6,0.342192,0.363368,5720.55,0.007002,0.00703,43,0.00034,0,20,0.521164,0.052265
24045,Wicomico County,,MD,6199,97879,104078,21,19,40,4714,3667,8381,6,0.341349,0.361707,916.931564,0.006049,0.006859,43,0.000265,0,20,0.583004,0.040583
24047,Worcester County,,MD,4390,57091,61481,18,12,30,3172,2628,5800,6,0.304489,0.321231,468.331382,0.005618,0.003544,43,0.000217,0,20,0.696078,0.037793
24510,Baltimore city,,MD,50555,571373,621928,109,101,210,37939,44390,82329,5,0.391392,0.426174,6453.665682,0.0559,0.051273,43,0.000949,0,20,0.5655,0.372005
25001,Barnstable County,,MA,14405,263743,278148,41,63,104,8756,9379,18135,6,0.362572,0.391741,4348.701451,0.021371,0.029735,44,0.000378,0,20,0.592527,0.138486
25003,Berkshire County,,MA,5872,149579,155451,21,25,46,2229,2646,4875,6,0.34312,0.364931,550.1083,0.008234,0.010417,44,0.000185,0,20,0.668719,0.047481
25005,Bristol County,,MA,28066,616530,644596,39,78,117,20118,22565,42683,6,0.373029,0.404742,1041.387506,0.018989,0.037663,44,0.000329,0,20,0.578956,0.125937
25007,Dukes County,,MA,1066,18765,19831,2,5,7,152,255,407,6,0.301899,0.31685,0,0.000952,0.00202,44,0.000062,0,20,1,0.006075
25009,Essex County,,MA,43626,824230,867856,75,118,193,32187,36847,69034,5,0.387742,0.424828,4384.442354,0.037872,0.056258,44,0.000633,0,20,0.524457,0.255228
25011,Franklin County,,MA,4895,81885,86780,13,10,23,3226,2805,6031,6,0.304139,0.319845,2.829163,0.004346,0.003026,44,0.000131,0,20,0.826923,0.024934
25013,Hampden County,,MA,20263,513441,533704,52,76,128,11956,14722,26678,6,0.377041,0.408952,1165.174492,0.027155,0.03867,44,0.000406,0,20,0.620168,0.175645
25015,Hampshire County,,MA,11904,159420,171324,26,31,57,7764,8159,15923,6,0.352813,0.377721,295.003801,0.012113,0.015657,44,0.00021,0,20,0.771429,0.072681
25017,Middlesex County,,MA,114272,1630821,1745093,222,240,462,86717,104275,190992,5,0.430856,0.47819,72510.241426,0.09183,0.092928,44,0.002008,0,20,0.29895,0.62504
25019,Nantucket County,,MA,873,11345,12218,2,1,3,95,128,223,7,0.266118,0.276515,0,0.000731,0.000166,44,0.000061,0,20,1,0.00401
25021,Norfolk County,,MA,55827,734021,789848,110,135,245,46677,49728,96405,5,0.394951,0.433792,9821.450237,0.055006,0.064527,44,0.000891,0,20,0.496415,0.362582
25023,Plymouth County,,MA,30107,561282,591389,40,77,117,23215,24753,47968,6,0.3716,0.403081,817.910964,0.021987,0.037926,44,0.000337,0,20,0.575463,0.147239
25025,Suffolk County,,MA,81427,648983,730410,154,150,304,57334,74582,131916,5,0.406709,0.446856,14612.172485,0.070104,0.070479,44,0.0013,0,20,0.43952,0.46057
25027,Worcester County,,MA,39690,898510,938200,101,136,237,29762,31517,61279,5,0.391392,0.430527,8126.245942,0.051482,0.062325,44,0.000824,0,20,0.46958,0.346937
26001,Alcona County,,MI,747,12464,13211,6,3,9,493,277,770,6,0.30062,0.315155,0.488095,0.002036,0.000569,45,0.000107,0,20,0.866667,0.01036
26003,Alger County,,MI,459,10147,10606,1,1,2,123,101,224,7,0.248888,0.256571,0,0.000019,0.000027,166,0.000082,0,20,0,0.000263
26005,Allegan County,,MI,8234,130333,138567,14,16,30,5910,5753,11663,6,0.344746,0.365813,361.515248,0.003714,0.004205,45,0.000173,0,20,0.665441,0.021934
26007,Alpena County,,MI,1685,35274,36959,7,7,14,496,477,973,6,0.306542,0.322308,31.517025,0.002162,0.001341,45,0.000164,0,20,0.535714,0.011452
26009,Antrim County,,MI,1830,27020,28850,9,7,16,1036,946,1982,6,0.301211,0.316672,5.269724,0.001802,0.000888,45,0.000168,0,20,0.722222,0.009272
26011,Arenac County,,MI,1234,19073,20307,7,7,14,668,707,1375,7,0.27791,0.290287,0.378968,0.001778,0.000235,45,0.000108,0,20,0.916667,0.009287
26013,Baraga County,,MI,390,9040,9430,2,2,4,125,157,282,7,0.248931,0.2568,0,0.000031,0.000032,166,0.00012,0,20,1,0.000389
26015,Barry County,,MI,4392,69973,74365,11,10,21,3207,2884,6091,6,0.301711,0.317692,17.284223,0.001831,0.001172,45,0.000136,0,20,0.727273,0.009242
26017,Bay County,,MI,5437,132366,137803,15,19,34,2967,3207,6174,6,0.339359,0.360584,376.708315,0.002911,0.005021,45,0.00018,0,20,0.610526,0.014501
26019,Benzie County,,MI,1518,20325,21843,6,3,9,899,689,1588,7,0.256342,0.265178,7.413875,0.001791,0.000062,45,0.000166,0,20,0.7,0.010027
26021,Berrien County,,MI,9456,176259,185715,24,29,53,4346,5143,9489,6,0.357626,0.382027,382.849111,0.007515,0.01163,166,0.000245,0,20,0.575758,0.045791
26023,Branch County,,MI,3308,49328,52636,8,10,18,1480,1797,3277,6,0.307319,0.323843,75.001283,0.001869,0.001427,45,0.000122,0,20,0.555556,0.010448
26025,Calhoun County,,MI,8258,153175,161433,17,24,41,4208,4862,9070,6,0.35128,0.374565,392.818645,0.004192,0.007036,45,0.000183,0,20,0.568333,0.023063
26027,Cass County,,MI,3786,57458,61244,7,7,14,2706,2660,5366,6,0.328331,0.345212,1.042846,0.001539,0.001282,166,0.000109,0,20,0.904762,0.009866
26029,Charlevoix County,,MI,2035,31143,33178,7,7,14,821,997,1818,6,0.301211,0.316672,3.593666,0.001821,0.000887,45,0.000137,0,20,0.839286,0.010307
26031,Cheboygan County,,MI,1786,31140,32926,9,7,16,789,688,1477,6,0.301273,0.316758,18.339102,0.001932,0.000943,45,0.000167,0,20,0.545455,0.010046
26033,Chippewa County,,MI,2156,38681,40837,6,5,11,387,409,796,6,0.301711,0.317102,20.677311,0.001782,0.000914,45,0.00014,0,20,0.666667,0.009924
26035,Clare County,,MI,2145,32368,34513,12,9,21,1262,985,2247,6,0.30638,0.322279,71.938886,0.002534,0.001344,45,0.000154,0,20,0.724359,0.012361
26037,Clinton County,,MI,6282,83763,90045,15,19,34,4773,4391,9164,6,0.330945,0.350452,195.670958,0.002624,0.003274,45,0.00017,0,20,0.678571,0.013434
26039,Crawford County,,MI,1068,14972,16040,5,2,7,348,260,608,7,0.234962,0.24237,0.392857,0.00179,0.000041,45,0.000093,0,20,0.9,0.009556
26041,Delta County,,MI,1795,44826,46621,5,6,11,489,513,1002,7,0.263587,0.274431,3555.839748,0.000966,0.000151,166,0.000199,0,20,0.452381,0.007353
26043,Dickinson County,,MI,1551,32166,33717,7,8,15,600,599,1199,7,0.263611,0.274717,6006.505714,0.000097,0.000121,166,0.000302,0,20,0.321429,0.001538
26045,Eaton County,,MI,10632,125787,136419,20,26,46,7640,7630,15270,6,0.346305,0.368975,571.254284,0.004713,0.006913,45,0.000198,0,20,0.594017,0.025106
26047,Emmet County,,MI,2475,37792,40267,8,10,18,1189,1134,2323,6,0.307124,0.323414,16.030893,0.001822,0.001732,45,0.00016,0,20,0.711111,0.010477
26049,Genesee County,,MI,21603,500106,521709,46,86,132,13190,15365,28555,6,0.383753,0.417085,11351.052773,0.0135,0.032532,45,0.000478,0,20,0.36011,0.090992
26051,Gladwin County,,MI,1691,28774,30465,11,10,21,1216,906,2122,6,0.306445,0.32248,33.362663,0.002253,0.001509,45,0.000143,0,20,0.827273,0.011538
26053,Gogebic County,,MI,972,16595,17567,2,2,4,147,182,329,7,0.248995,0.25691,2918.385384,0,0.000027,166,0.000179,0,78,0,0.00017
26055,Grand Traverse County,,MI,5906,98289,104195,26,22,48,4286,3379,7665,6,0.344501,0.366449,7561.616952,0.005705,0.005004,45,0.000422,0,20,0.43254,0.034235
26057,Gratiot County,,MI,2655,43922,46577,10,11,21,1480,1642,3122,6,0.289207,0.303162,9.025351,0.000941,0.000569,45,0.000131,0,20,0.621212,0.004441
26059,Hillsdale County,,MI,3325,52343,55668,10,12,22,1989,1989,3978,6,0.307709,0.324685,133.729382,0.001858,0.001797,45,0.000136,0,20,0.602564,0.010268
26061,Houghton County,,MI,2297,35391,37688,6,6,12,391,508,899,6,0.330119,0.347818,10998.046154,0.000696,0.001552,166,0.000266,0,20,0.291667,0.004295
26063,Huron County,,MI,1767,43058,44825,7,10,17,798,914,1712,6,0.306477,0.322537,0.694094,0.002095,0.001594,45,0.000098,0,20,0.866667,0.010656
26065,Ingham County,,MI,24955,281690,306645,52,81,133,14394,18465,32859,5,0.391814,0.424158,13091.694928,0.013393,0.034987,45,0.00056,0,20,0.399251,0.088806
26067,Ionia County,,MI,4097,68449,72546,9,10,19,2841,2771,5612,6,0.301586,0.317491,10.068772,0.000912,0.001066,45,0.000127,0,20,0.727273,0.004501
26069,Iosco County,,MI,1961,29234,31195,10,9,19,1203,824,2027,6,0.306413,0.322308,42.796913,0.002184,0.001471,45,0.000162,0,20,0.711111,0.011233
26071,Iron County,,MI,686,13447,14133,1,2,3,62,141,203,7,0.248973,0.256915,0,0.000001,0.000028,166,0.000082,0,20,1,0.000108
26073,Isabella County,,MI,4884,59332,64216,21,24,45,2901,2855,5756,6,0.345196,0.367428,816.978837,0.003599,0.005358,45,0.000236,0,20,0.576923,0.018001
26075,Jackson County,,MI,8160,176936,185096,18,19,37,5201,4586,9787,6,0.344501,0.366105,153.739166,0.004902,0.005055,45,0.000171,0,20,0.694805,0.025433
26077,Kalamazoo County,,MI,17346,261981,279327,44,57,101,10917,11234,22151,6,0.378857,0.408522,3615.609139,0.012739,0.023726,45,0.000421,0,20,0.427273,0.080078
26079,Kalkaska County,,MI,1285,18689,19974,6,3,9,725,596,1321,6,0.300682,0.315269,1.978308,0.00206,0.000593,45,0.000109,0,20,0.866667,0.010551
26081,Kent County,,MI,34430,674772,709202,94,122,216,22924,26707,49631,5,0.404167,0.44083,54900.551471,0.030999,0.049833,45,0.001051,0,20,0.348057,0.216168
26083,Keweenaw County,,MI,146,2201,2347,1,1,2,96,52,148,7,0.248209,0.255448,0,0.000012,0.000005,166,0.000088,0,20,0,0.000126
26085,Lake County,,MI,1067,10647,11714,6,7,13,424,540,964,6,0.288062,0.300939,6.349457,0.000418,0.000333,45,0.000151,0,20,0.571429,0.00262
26087,Lapeer County,,MI,6174,107783,113957,7,10,17,4620,3960,8580,6,0.307059,0.323425,1.059242,0.002095,0.00197,45,0.000098,0,20,0.866667,0.010656
26089,Leelanau County,,MI,1622,25313,26935,4,2,6,723,688,1411,7,0.256275,0.264892,0,0.001111,0.000058,45,0.000128,0,20,0.833333,0.006251
26091,Lenawee County,,MI,5353,116688,122041,10,16,26,3248,3029,6277,6,0.341149,0.362274,129.463195,0.002654,0.004197,45,0.000124,0,20,0.666667,0.013577
26093,Livingston County,,MI,12157,211559,223716,21,27,48,10817,7752,18569,6,0.349298,0.372497,351.849906,0.006303,0.009326,45,0.000196,0,20,0.599754,0.036594
26095,Luce County,,MI,422,6420,6842,0,2,2,0,94,94,7,0.250322,0.258521,0,0,0.000034,45,0.00005,0,79,0,0
26097,Mackinac County,,MI,1127,13488,14615,4,5,9,293,346,639,6,0.306316,0.322572,1513.748202,0.000964,0.001028,45,0.000108,0,20,0.375,0.00496
26099,Macomb County,,MI,45746,1002461,1048207,71,122,193,38392,37461,75853,5,0.401767,0.438568,14438.71184,0.027893,0.05156,45,0.000696,0,20,0.386991,0.195241
26101,Manistee County,,MI,1570,27868,29438,7,6,13,664,611,1275,6,0.288033,0.300767,114.218849,0.001159,0.000353,45,0.000178,0,20,0.547619,0.006619
26103,Marquette County,,MI,3644,70553,74197,17,14,31,1214,1091,2305,6,0.331322,0.35051,28219.614926,0.003456,0.002385,166,0.000522,0,20,0.226316,0.020379
26105,Mason County,,MI,1659,33349,35008,6,7,13,696,669,1365,6,0.288462,0.301501,5.768648,0.000565,0.000462,45,0.000136,0,20,0.595238,0.003085
26107,Mecosta County,,MI,3395,39948,43343,14,13,27,1987,1883,3870,6,0.307124,0.323843,176.406534,0.002905,0.001854,45,0.000191,0,20,0.579167,0.014468
26109,Menominee County,,MI,1472,28116,29588,4,4,8,648,756,1404,7,0.262186,0.272197,3.483811,0.000029,0.000088,166,0.000164,0,20,0.75,0.000668
26111,Midland County,,MI,5586,98909,104495,14,17,31,2692,2866,5558,6,0.343484,0.364588,1124.54197,0.00257,0.004151,45,0.000183,0,20,0.576316,0.01281
26113,Missaukee County,,MI,1078,16445,17523,5,2,7,514,422,936,7,0.231651,0.238688,1.465152,0.00045,0.000024,45,0.000132,0,20,0.55,0.002693
26115,Monroe County,,MI,9008,182433,191441,11,16,27,7200,5890,13090,6,0.344746,0.366105,11.708205,0.003209,0.004956,45,0.000121,0,20,0.753676,0.01535
26117,Montcalm County,,MI,4766,68807,73573,11,12,23,3490,3127,6617,6,0.290564,0.305017,34.522175,0.001609,0.000663,45,0.000149,0,20,0.653846,0.008312
26119,Montmorency County,,MI,768,10974,11742,5,3,8,308,259,567,6,0.30062,0.315155,0.763492,0.001638,0.000576,45,0.000104,0,20,0.75,0.008778
26121,Muskegon County,,MI,7970,190540,198510,17,19,36,4566,4776,9342,6,0.345852,0.367572,1371.371258,0.004071,0.005839,45,0.000228,0,20,0.528139,0.022346
26123,Newaygo County,,MI,3453,54457,57910,9,8,17,2116,2159,4275,6,0.288233,0.301243,32.4495,0.001291,0.000418,45,0.000149,0,20,0.638889,0.007253
26125,Oakland County,,MI,86802,1392059,1478861,180,242,422,64237,75775,140012,5,0.429647,0.477285,112635.269684,0.068959,0.088323,45,0.001965,0,20,0.268588,0.485736
26127,Oceana County,,MI,1819,29976,31795,6,6,12,1111,1057,2168,6,0.293554,0.307211,36.706862,0.00078,0.000618,45,0.00012,0,20,0.733333,0.005012
26129,Ogemaw County,,MI,1466,23730,25196,10,10,20,846,730,1576,6,0.306477,0.322537,33.322134,0.002195,0.001489,45,0.000136,0,20,0.833333,0.011246
26131,Ontonagon County,,MI,463,7971,8434,0,2,2,0,104,104,7,0.248359,0.255872,0,0,0.000005,166,0.00005,0,80,0,0
26133,Osceola County,,MI,1861,25918,27779,8,7,15,901,1003,1904,6,0.288119,0.301054,643.899485,0.000716,0.000336,45,0.000197,0,20,0.5,0.003735
26135,Oscoda County,,MI,536,9451,9987,3,0,3,142,0,142,0,0,0,0,0.001762,0,45,0.000067,0,1,1,0.009163
26137,Otsego County,,MI,2075,28488,30563,13,12,25,1046,820,1866,6,0.306833,0.323368,1393.661972,0.003128,0.001733,45,0.000231,0,20,0.565934,0.015554
26139,Ottawa County,,MI,16692,292868,309560,34,42,76,12859,11877,24736,6,0.360997,0.388242,5251.841573,0.009385,0.015881,45,0.000394,0,20,0.424202,0.061691
26141,Presque Isle County,,MI,828,16348,17176,4,3,7,297,229,526,6,0.30062,0.315155,0.666667,0.00138,0.000567,45,0.000103,0,20,0.75,0.007896
26143,Roscommon County,,MI,1820,27201,29021,7,12,19,889,787,1676,6,0.306833,0.323368,1592.762768,0.002128,0.001828,45,0.00013,0,20,0.643939,0.010666
26145,Saginaw County,,MI,10717,235276,245993,27,39,66,5146,6866,12012,6,0.366868,0.394227,2897.29363,0.004645,0.013153,45,0.000285,0,20,0.43134,0.025989
26147,St. Clair County,,MI,8906,199978,208884,10,20,30,6021,5715,11736,6,0.34647,0.368328,392.896569,0.004039,0.007178,45,0.000127,0,20,0.654762,0.025914
26149,St. Joseph County,,MI,3994,71107,75101,10,13,23,2078,2310,4388,6,0.32967,0.347904,3150.157935,0.001901,0.00158,166,0.000152,0,20,0.480769,0.011786
26151,Sanilac County,,MI,2558,52037,54595,8,9,17,1837,1616,3453,6,0.306413,0.322308,0.428571,0.002111,0.001483,45,0.000105,0,20,0.916667,0.010825
26153,Schoolcraft County,,MI,459,9113,9572,2,2,4,84,109,193,7,0.248952,0.256857,4.39564,0.000009,0.000034,166,0.000097,0,20,0.333333,0.000275
26155,Shiawassee County,,MI,4666,85714,90380,10,11,21,3002,2872,5874,6,0.3068,0.323196,26.946664,0.002955,0.001859,45,0.00011,0,20,0.886364,0.013965
26157,Tuscola County,,MI,3799,68748,72547,11,10,21,2233,2334,4567,6,0.306768,0.323024,5.326951,0.002283,0.001714,45,0.000128,0,20,0.787879,0.011558
26159,Van Buren County,,MI,5600,85358,90958,11,12,23,3921,3684,7605,6,0.342353,0.362526,85.248057,0.002066,0.00271,45,0.00015,0,20,0.67033,0.013554
26161,Washtenaw County,,MI,30181,347060,377241,78,107,185,19910,22498,42408,5,0.401435,0.436661,6435.646839,0.033808,0.053573,45,0.000739,0,20,0.482794,0.234703
26163,Wayne County,,MI,98481,2034828,2133309,162,249,411,52042,87124,139166,5,0.43381,0.481541,93397.64723,0.065625,0.087181,45,0.001616,0,20,0.25786,0.459117
26165,Wexford County,,MI,2574,36363,38937,11,8,19,1528,1223,2751,6,0.301336,0.316959,2420.149593,0.002334,0.000945,45,0.000233,0,20,0.536364,0.012122
27001,Aitkin County,,MN,1018,14673,15691,6,4,10,599,412,1011,6,0.304584,0.31831,0,0.001293,0.000668,24,0.000148,0,20,1,0.009195
27003,Anoka County,,MN,27298,373738,401036,42,52,94,24051,22497,46548,6,0.367378,0.394868,8280.445356,0.008349,0.012048,24,0.000787,0,20,0.280195,0.066273
27005,Becker County,,MN,2046,36389,38435,8,7,15,1208,1041,2249,6,0.305159,0.31957,5986.867772,0.000695,0.000693,24,0.000305,0,20,0.458333,0.005833
27007,Beltrami County,,MN,2725,42383,45108,15,11,26,1396,1147,2543,6,0.305962,0.321123,4012.596692,0.001437,0.001202,24,0.000355,0,20,0.425,0.01087
27009,Benton County,,MN,4811,41303,46114,12,11,23,3347,3656,7003,6,0.335292,0.354381,83.771635,0.001436,0.002156,24,0.000261,0,20,0.846154,0.011008
27011,Big Stone County,,MN,356,6245,6601,0,0,0,0,0,0,0,0,0,0,0,0,46,0.00005,37,81,0,0
27013,Blue Earth County,,MN,5498,61033,66531,22,18,40,3785,3701,7486,6,0.3068,0.323116,11220.623537,0.001493,0.001412,24,0.00046,0,20,0.327899,0.012294
27015,Brown County,,MN,1591,32089,33680,6,6,12,549,615,1164,6,0.308295,0.323047,808.249308,0.000848,0.00088,24,0.000169,0,20,0.428571,0.007105
27017,Carlton County,,MN,2026,37558,39584,6,6,12,1236,1096,2332,6,0.304744,0.318797,1.592857,0.001095,0.000992,24,0.000145,0,20,0.9,0.008099
27019,Carver County,,MN,7477,96668,104145,15,17,32,6773,5089,11862,6,0.336845,0.357165,555.856486,0.004532,0.002849,24,0.000267,0,20,0.65,0.034382
27021,Cass County,,MN,2529,32048,34577,10,9,19,1552,1515,3067,6,0.304776,0.319227,5.42851,0.001333,0.000942,24,0.000233,0,20,0.69697,0.009956
27023,Chippewa County,,MN,933,15046,15979,4,5,9,349,319,668,6,0.30484,0.318797,6301.640148,0.000024,0.000611,24,0.000191,0,20,0.3,0.000442
27025,Chisago County,,MN,4360,60418,64778,10,13,23,3941,3268,7209,6,0.335369,0.354725,154.873268,0.001433,0.00238,24,0.000203,0,20,0.653846,0.010606
27027,Clay County,,MN,4289,56219,60508,13,9,22,2996,2542,5538,6,0.336028,0.355057,2466.38338,0.001009,0.002182,24,0.00036,0,20,0.4,0.008021
27029,Clearwater County,,MN,630,9109,9739,2,2,4,210,240,450,7,0.234488,0.241335,0.583333,0.000015,0.000016,24,0.0001,0,20,0.5,0.000331
27031,Cook County,,MN,329,6146,6475,1,1,2,58,46,104,7,0.2601,0.269196,0,0.000052,0.000047,24,0.000073,0,20,0,0.000527
27033,Cottonwood County,,MN,828,14486,15314,4,4,8,209,199,408,7,0.235095,0.242607,80.753143,0.000006,0.000014,24,0.000157,0,20,0.3,0.000385
27035,Crow Wing County,,MN,3957,68303,72260,24,19,43,3448,2408,5856,6,0.336261,0.356615,773.343087,0.002647,0.002421,24,0.00052,0,20,0.51087,0.02226
27037,Dakota County,,MN,35830,455475,491305,83,99,182,29600,29019,58619,5,0.398849,0.431798,48378.453689,0.023295,0.032446,24,0.001424,0,20,0.287961,0.171303
27039,Dodge County,,MN,1591,22516,24107,4,5,9,944,937,1881,6,0.304744,0.318625,1.304762,0.0001,0.000681,24,0.000121,0,20,0.8,0.001112
27041,Douglas County,,MN,2395,41998,44393,14,14,28,1381,1188,2569,6,0.305704,0.32126,4579.128487,0.001475,0.001292,24,0.00035,0,20,0.5,0.011323
27043,Faribault County,,MN,947,18421,19368,3,4,7,351,348,699,6,0.304872,0.318591,2.642857,0.000025,0.000609,24,0.000108,0,20,0.75,0.000465
27045,Fillmore County,,MN,1452,25395,26847,6,5,11,734,806,1540,6,0.268673,0.278877,4942.938527,0.000092,0.000085,24,0.000224,0,20,0.333333,0.001244
27047,Freeborn County,,MN,1761,37353,39114,9,8,17,760,762,1522,6,0.305063,0.319404,1229.129373,0.00098,0.000871,24,0.000207,0,20,0.694444,0.007573
27049,Goodhue County,,MN,3223,53750,56973,11,9,20,1988,1861,3849,6,0.304904,0.319399,179.637317,0.001484,0.001222,24,0.000231,0,20,0.672727,0.011172
27051,Grant County,,MN,470,7375,7845,1,2,3,92,170,262,7,0.234262,0.241135,0,0.00001,0.00003,24,0.000071,0,20,1,0.000195
27053,Hennepin County,,MN,97087,1247163,1344250,251,235,486,73024,86595,159619,5,0.437594,0.482411,372763.158214,0.075936,0.077732,24,0.00374,0,20,0.207816,0.542642
27055,Houston County,,MN,1126,24377,25503,4,4,8,545,611,1156,6,0.269245,0.279605,995.989961,0.000044,0.000114,24,0.000158,0,20,0.5,0.000825
27057,Hubbard County,,MN,1472,21409,22881,7,8,15,682,661,1343,6,0.305287,0.319914,17.569517,0.000776,0.000717,24,0.000204,0,20,0.541667,0.006253
27059,Isanti County,,MN,3084,40554,43638,12,13,25,3280,2182,5462,6,0.304968,0.32,5.227951,0.001482,0.001337,24,0.000239,0,20,0.794872,0.011241
27061,Itasca County,,MN,2228,50162,52390,10,9,19,1165,1043,2208,6,0.304808,0.319284,4.305531,0.001378,0.001206,24,0.000245,0,20,0.811111,0.010364
27063,Jackson County,,MN,718,12703,13421,2,4,6,127,199,326,7,0.237125,0.244474,289.366821,0.000006,0.000001,24,0.0001,0,20,0.166667,0.000192
27065,Kanabec County,,MN,1261,18263,19524,7,7,14,929,731,1660,6,0.304648,0.318769,0.779401,0.001061,0.000989,24,0.000154,0,20,0.821429,0.007977
27067,Kandiyohi County,,MN,2821,48864,51685,12,14,26,1139,1456,2595,6,0.336845,0.356649,11837.639589,0.001247,0.002506,24,0.000293,0,20,0.37619,0.009937
27069,Kittson County,,MN,335,5630,5965,0,0,0,0,0,0,0,0,0,0,0,0,47,0.00005,38,82,0,0
27071,Koochiching County,,MN,696,15262,15958,1,3,4,79,171,250,6,0.304584,0.318196,0,0.000052,0.000648,24,0.000073,0,20,1,0.000527
27073,Lac qui Parle County,,MN,496,9009,9505,1,1,2,47,49,96,7,0.233641,0.23972,0,0.000005,0,24,0.000083,0,20,0,0.000095
27075,Lake County,,MN,672,12373,13045,2,1,3,280,288,568,7,0.2601,0.269196,0,0.000656,0.000047,24,0.000086,0,20,1,0.004955
27077,Lake of the Woods County,,MN,381,4954,5335,1,1,2,65,61,126,7,0.233979,0.240241,0,0.000005,0,24,0.000066,0,20,0,0.000089
27079,Le Sueur County,,MN,2102,30301,32403,10,9,19,1669,1398,3067,6,0.304936,0.319376,4.393687,0.001273,0.001137,24,0.000216,0,20,0.733333,0.009818
27081,Lincoln County,,MN,398,6678,7076,2,2,4,128,115,243,7,0.235647,0.24279,4.949242,0.000015,0.00001,24,0.000123,0,20,0,0.00029
27083,Lyon County,,MN,2056,28969,31025,9,9,18,614,743,1357,6,0.306348,0.321409,13135.703655,0.001043,0.001157,24,0.0003,0,20,0.288889,0.00819
27085,McLeod County,,MN,2697,44214,46911,12,10,22,1932,1478,3410,6,0.30484,0.319399,13.390295,0.001418,0.001186,24,0.000242,0,20,0.636364,0.01078
27087,Mahnomen County,,MN,350,4986,5336,1,1,2,84,92,176,7,0.233829,0.240052,0,0.000005,0.000005,24,0.000087,0,20,0,0.000142
27089,Marshall County,,MN,643,11908,12551,4,3,7,318,273,591,7,0.25915,0.268634,2.44364,0.000073,0.000031,24,0.000128,0,20,0.666667,0.000648
27091,Martin County,,MN,1341,26080,27421,3,7,10,205,451,656,6,0.305191,0.319422,4296.933144,0.000016,0.000882,24,0.000116,0,20,0.303571,0.000398
27093,Meeker County,,MN,1620,27209,28829,5,6,11,1060,879,1939,6,0.304776,0.318797,2.095635,0.00069,0.000681,24,0.000138,0,20,0.766667,0.005459
27095,Mille Lacs County,,MN,1964,28350,30314,12,12,24,1716,1267,2983,6,0.304872,0.319742,3.681385,0.001476,0.001106,24,0.000246,0,20,0.818681,0.01121
27097,Morrison County,,MN,2034,38943,40977,12,9,21,1355,1236,2591,6,0.304712,0.319112,2.752056,0.0014,0.001034,24,0.000256,0,20,0.818182,0.01066
27099,Mower County,,MN,2347,44309,46656,7,11,18,938,1172,2110,6,0.30564,0.320567,4739.522997,0.001015,0.001149,24,0.000192,0,20,0.509091,0.00771
27101,Murray County,,MN,503,10604,11107,2,2,4,139,112,251,7,0.234829,0.241645,42.198687,0.000014,0.000008,24,0.000095,0,20,0.333333,0.000259
27103,Nicollet County,,MN,3560,33897,37457,10,9,19,2365,2341,4706,6,0.305127,0.319633,975.938294,0.000976,0.001183,24,0.000239,0,20,0.522727,0.007556
27105,Nobles County,,MN,1430,24312,25742,3,7,10,174,507,681,6,0.306316,0.321054,6312.661332,0.000091,0.0007,24,0.000138,0,20,0.261905,0.001107
27107,Norman County,,MN,631,8185,8816,3,4,7,186,372,558,7,0.264017,0.27403,10.036101,0.000077,0.00006,24,0.000145,0,20,0.75,0.000825
27109,Olmsted County,,MN,9889,165922,175811,33,35,68,5621,5667,11288,5,0.36636,0.391684,19031.010023,0.008001,0.009413,24,0.00065,0,20,0.375,0.061113
27111,Otter Tail County,,MN,3337,65695,69032,16,14,30,2026,1812,3838,6,0.305512,0.321002,3818.2258,0.002424,0.001216,24,0.000395,0,20,0.48366,0.019348
27113,Pennington County,,MN,956,15629,16585,5,7,12,337,485,822,7,0.259451,0.269809,6230.585825,0.000073,0.00005,24,0.000182,0,20,0.380952,0.000735
27115,Pine County,,MN,2092,29081,31173,11,11,22,1593,1280,2873,6,0.304904,0.319656,10.526576,0.001447,0.001283,24,0.000236,0,20,0.709091,0.01081
27117,Pipestone County,,MN,644,11065,11709,1,2,3,91,139,230,7,0.269096,0.279127,0,0.000091,0.000106,24,0.000083,0,20,1,0.000924
27119,Polk County,,MN,2239,35049,37288,8,11,19,1020,1191,2211,6,0.306026,0.321208,9617.101475,0.000683,0.000723,24,0.000288,0,20,0.354545,0.005389
27121,Pope County,,MN,821,13297,14118,4,4,8,344,351,695,6,0.304584,0.31831,2970.5,0.000656,0.000631,24,0.000138,0,20,0.583333,0.005085
27123,Ramsey County,,MN,53687,526618,580305,110,111,221,36832,46522,83354,5,0.403886,0.438431,61251.958283,0.034947,0.040828,24,0.001686,0,20,0.290605,0.257878
27125,Red Lake County,,MN,334,4854,5188,2,2,4,96,122,218,7,0.234394,0.241049,0,0.000006,0.000006,24,0.000095,0,20,1,0.000237
27127,Redwood County,,MN,1146,19209,20355,6,7,13,500,484,984,6,0.305159,0.319462,20.383153,0.000947,0.000901,24,0.000173,0,20,0.464286,0.007102
27129,Renville County,,MN,1375,20083,21458,4,5,9,386,584,970,6,0.308263,0.322875,16.784244,0.000639,0.000876,24,0.000123,0,20,0.55,0.004941
27131,Rice County,,MN,4142,65489,69631,13,15,28,2844,2480,5324,6,0.305352,0.32075,290.657999,0.002498,0.001418,24,0.000264,0,20,0.629167,0.019784
27133,Rock County,,MN,538,10969,11507,2,1,3,162,161,323,7,0.268872,0.278594,0,0.000096,0.000098,24,0.0001,0,20,1,0.001022
27135,Roseau County,,MN,1082,19965,21047,2,7,9,136,385,521,6,0.305416,0.319931,5985.521295,0,0.000654,24,0.000128,0,20,0.238095,0.000185
27137,St. Louis County,,MN,10396,214477,224873,40,33,73,5886,6367,12253,6,0.351492,0.375727,17834.910928,0.006115,0.006756,24,0.000877,0,20,0.303136,0.049352
27139,Scott County,,MN,10899,137433,148332,22,22,44,11148,7636,18784,6,0.339874,0.361323,1138.135236,0.005562,0.00431,24,0.000416,0,20,0.526667,0.043498
27141,Sherburne County,,MN,7681,92283,99964,19,17,36,8322,5741,14063,6,0.335524,0.355412,287.715845,0.002604,0.002508,24,0.000366,0,20,0.618421,0.021338
27143,Sibley County,,MN,1152,18453,19605,6,8,14,533,697,1230,6,0.304872,0.319147,4.184957,0.000684,0.000888,24,0.000158,0,20,0.708333,0.005755
27145,Stearns County,,MN,10653,157956,168609,29,27,56,7787,7798,15585,6,0.350814,0.373877,2822.543073,0.003868,0.004945,24,0.000621,0,20,0.424395,0.031619
27147,Steele County,,MN,2693,44047,46740,10,10,20,1499,1401,2900,6,0.305159,0.319805,175.088471,0.001295,0.001159,24,0.000221,0,20,0.711111,0.009711
27149,Stevens County,,MN,594,10260,10854,1,2,3,54,104,158,6,0.304489,0.31791,0,0.000005,0.000594,24,0.00008,0,20,1,0.000129
27151,Swift County,,MN,730,11913,12643,1,2,3,115,170,285,7,0.252057,0.260124,0,0.000019,0.00001,24,0.000068,0,20,1,0.000179
27153,Todd County,,MN,1648,26190,27838,8,10,18,728,979,1707,6,0.304808,0.319399,6.681469,0.000713,0.000728,24,0.00021,0,20,0.618182,0.006163
27155,Traverse County,,MN,243,4362,4605,0,0,0,0,0,0,0,0,0,0,0,0,48,0.00005,39,83,0,0
27157,Wabasha County,,MN,1575,25549,27124,6,5,11,934,908,1842,6,0.304744,0.318683,252.807449,0.000947,0.000859,24,0.000158,0,20,0.666667,0.007009
27159,Wadena County,,MN,1204,15265,16469,5,7,12,423,605,1028,6,0.305159,0.31957,5.482143,0.000643,0.000687,24,0.000151,0,20,0.666667,0.005274
27161,Waseca County,,MN,1536,22452,23988,9,8,17,990,881,1871,6,0.304936,0.319261,35.024486,0.001128,0.000927,24,0.000209,0,20,0.655556,0.009098
27163,Washington County,,MN,19999,261013,281012,34,36,70,19194,15242,34436,6,0.360238,0.385418,3050.141972,0.01027,0.01028,24,0.000549,0,20,0.418051,0.077258
27165,Watonwan County,,MN,778,12551,13329,4,4,8,222,260,482,7,0.237029,0.24476,2092.055999,0.000235,0.000026,24,0.000131,0,20,0.4,0.002449
27167,Wilkin County,,MN,618,8284,8902,3,4,7,299,341,640,7,0.26385,0.273697,0,0.000065,0.000068,24,0.000133,0,20,0.916667,0.000875
27169,Winona County,,MN,3132,52123,55255,11,11,22,1322,1690,3012,6,0.305319,0.320344,3626.300554,0.001929,0.001214,24,0.000277,0,20,0.429487,0.014429
27171,Wright County,,MN,8717,130538,139255,20,22,42,9946,6239,16185,6,0.335834,0.356443,515.339872,0.002716,0.00256,24,0.000412,0,20,0.559783,0.022304
27173,Yellow Medicine County,,MN,799,12459,13258,2,4,6,149,294,443,6,0.304744,0.31854,18.266336,0.000014,0.000605,24,0.000111,0,20,0.583333,0.000255
28001,Adams County,,MS,1875,31012,32887,8,9,17,1076,831,1907,6,0.32301,0.34146,4719.346727,0.001946,0.001354,0,0.00014,0,20,0.435897,0.004594
28003,Alcorn County,,MS,1814,34770,36584,7,5,12,1034,794,1828,7,0.236355,0.244,1569.360171,0.00061,0.000021,130,0.000241,0,20,0.47619,0.005386
28005,Amite County,,MS,876,12785,13661,6,3,9,530,366,896,7,0.279432,0.291951,203.053053,0.001661,0.000196,0,0.00013,0,20,0.5,0.003706
28007,Attala County,,MS,942,18364,19306,6,4,10,459,313,772,7,0.267709,0.278738,113.339961,0.000163,0.000166,0,0.000195,0,20,0.452381,0.001628
28009,Benton County,,MS,629,8111,8740,5,5,10,451,466,917,6,0.3068,0.320229,1.661111,0.000637,0.000747,130,0.000192,0,20,0.75,0.005986
28011,Bolivar County,,MS,2173,35689,37862,6,8,14,807,1083,1890,6,0.307774,0.322176,15.241988,0.000757,0.000947,0,0.000131,0,20,0.680556,0.006089
28013,Calhoun County,,MS,723,15865,16588,4,3,7,248,269,517,7,0.236816,0.244012,5.992099,0.00002,0.000021,130,0.000178,0,20,0.833333,0.000607
28015,Carroll County,,MS,765,9764,10529,3,3,6,408,362,770,7,0.235494,0.242179,8.77118,0.000013,0.000017,130,0.000143,0,20,0.666667,0.000377
28017,Chickasaw County,,MS,1220,19709,20929,5,5,10,609,757,1366,7,0.236125,0.243485,9.238351,0.000009,0.000017,130,0.000218,0,20,0.65,0.00065
28019,Choctaw County,,MS,609,7376,7985,3,4,7,191,291,482,7,0.247323,0.256127,4.392857,0.000019,0.000035,130,0.000124,0,20,0.416667,0.000456
28021,Claiborne County,,MS,607,9812,10419,1,2,3,111,296,407,7,0.267709,0.278481,0,0.000009,0.000123,0,0.000076,0,20,1,0.000151
28023,Clarke County,,MS,1490,18641,20131,5,4,9,1009,886,1895,7,0.257522,0.267226,21.314697,0.000819,0.00006,0,0.00014,0,20,0.4,0.001609
28025,Clay County,,MS,1240,21432,22672,7,6,13,640,639,1279,7,0.260753,0.271112,214.935271,0.000113,0.000077,130,0.000204,0,20,0.428571,0.001215
28027,Coahoma County,,MS,1775,28518,30293,7,10,17,653,957,1610,6,0.307611,0.322119,853.46934,0.000625,0.000908,130,0.000185,0,20,0.436364,0.005384
28029,Copiah County,,MS,1624,30239,31863,7,5,12,977,924,1901,7,0.267906,0.279311,3.983577,0.001541,0.000208,0,0.000148,0,20,0.607143,0.003551
28031,Covington County,,MS,1131,19128,20259,9,5,14,779,586,1365,7,0.249315,0.258739,17.50384,0.001318,0.000068,0,0.0002,0,20,0.611111,0.003286
28033,DeSoto County,,MS,11306,150306,161612,49,22,71,14029,6723,20752,6,0.348879,0.371489,12491.777321,0.014476,0.004309,130,0.000838,0,20,0.276395,0.102524
28035,Forrest County,,MS,7279,64450,71729,28,24,52,5385,4310,9695,6,0.331548,0.353356,13147.872401,0.00286,0.003205,0,0.000534,0,20,0.288826,0.00917
28037,Franklin County,,MS,645,8409,9054,3,4,7,199,324,523,7,0.244415,0.252777,4.172373,0.000016,0.000064,0,0.000106,0,20,0.416667,0.000434
28039,George County,,MS,1074,20551,21625,5,3,8,869,506,1375,7,0.281486,0.293388,3.742004,0.000895,0.000317,0,0.000115,0,20,0.8,0.003834
28041,Greene County,,MS,633,10827,11460,4,4,8,263,246,509,7,0.279781,0.291532,415.481983,0.000438,0.000263,0,0.000119,0,20,0.6,0.002697
28043,Grenada County,,MS,1471,24050,25521,7,8,15,736,599,1335,6,0.307546,0.321775,9254.941181,0.000601,0.00078,130,0.00025,0,20,0.319444,0.005286
28045,Hancock County,,MS,9311,29801,39112,7,29,36,2265,4670,6935,6,0.34446,0.368717,129.55688,0.002522,0.005983,0,0.000076,0,20,0.46092,0.00512
28047,Harrison County,,MS,38460,154819,193279,47,173,220,7640,26457,34097,6,0.42457,0.465057,47612.160997,0.019007,0.058954,0,0.0006,0,20,0.284138,0.134435
28049,Hinds County,,MS,18059,255559,273618,54,50,104,12932,13086,26018,6,0.365348,0.394393,43880.696303,0.013473,0.014217,0,0.000915,0,20,0.282986,0.089246
28051,Holmes County,,MS,1228,20831,22059,5,5,10,457,694,1151,7,0.267882,0.279197,318.558065,0.001869,0.000176,0,0.000143,0,20,0.52381,0.009074
28053,Humphreys County,,MS,580,10055,10635,1,3,4,61,197,258,7,0.267783,0.278738,0.576923,0.000007,0.000122,0,0.000065,0,20,0.5,0.000134
28055,Issaquena County,,MS,126,892,1018,0,0,0,0,0,0,0,0,0,0,0,0,49,0.00005,40,84,0,0
28057,Itawamba County,,MS,1815,25101,26916,6,7,13,1180,1215,2395,7,0.237726,0.246148,103.414,0.000012,0.000035,130,0.000227,0,20,0.357143,0.000864
28059,Jackson County,,MS,17142,122252,139394,28,62,90,6930,9514,16444,6,0.376455,0.407176,10265.782731,0.01028,0.024007,0,0.000379,0,20,0.435096,0.065533
28061,Jasper County,,MS,1219,18773,19992,5,4,9,744,656,1400,7,0.249165,0.258338,10.204087,0.000805,0.000044,0,0.000141,0,20,0.45,0.001497
28063,Jefferson County,,MS,465,7923,8388,1,2,3,68,172,240,7,0.244332,0.252261,0,0.000769,0.000034,0,0.000051,0,20,0.5,0.000941
28065,Jefferson Davis County,,MS,753,12246,12999,7,6,13,453,475,928,7,0.249379,0.259026,8.86564,0.000803,0.000082,0,0.000182,0,20,0.52381,0.001826
28067,Jones County,,MS,3502,63508,67010,12,14,26,1956,1913,3869,6,0.325431,0.344324,4320.553522,0.001494,0.001403,0,0.0003,0,20,0.433333,0.004068
28069,Kemper County,,MS,562,8857,9419,2,2,4,211,246,457,7,0.257294,0.266453,0,0.000039,0.00004,0,0.000106,0,20,1,0.000431
28071,Lafayette County,,MS,3417,35233,38650,17,14,31,1656,1501,3157,6,0.309937,0.325939,6368.131507,0.002696,0.001561,130,0.000451,0,20,0.362745,0.011559
28073,Lamar County,,MS,4991,42846,47837,21,14,35,3937,2780,6717,7,0.299383,0.314539,2607.175637,0.003041,0.000567,0,0.000364,0,20,0.403162,0.009757
28075,Lauderdale County,,MS,5561,77433,82994,21,22,43,2487,2650,5137,6,0.346264,0.36945,15959.753051,0.00499,0.004926,0,0.00041,0,20,0.359879,0.027437
28077,Lawrence County,,MS,966,14179,15145,7,8,15,448,558,1006,7,0.268104,0.280113,82.630052,0.000886,0.000222,0,0.000177,0,20,0.477778,0.002395
28079,Leake County,,MS,1277,21505,22782,7,6,13,752,696,1448,7,0.267931,0.279483,63.693919,0.000206,0.000189,0,0.000242,0,20,0.571429,0.001987
28081,Lee County,,MS,5321,84877,90198,19,18,37,3705,3302,7007,6,0.308852,0.324897,16194.331735,0.001363,0.000967,130,0.000549,0,20,0.321053,0.010144
28083,Leflore County,,MS,2117,33042,35159,9,11,20,792,1132,1924,6,0.307871,0.322692,3391.466385,0.001524,0.00095,130,0.000211,0,20,0.428571,0.007262
28085,Lincoln County,,MS,1853,35190,37043,11,8,19,1296,960,2256,7,0.268277,0.280514,1033.543572,0.002179,0.000245,0,0.000214,0,20,0.474359,0.005038
28087,Lowndes County,,MS,5080,60644,65724,18,21,39,1964,1903,3867,6,0.348044,0.370727,15575.214105,0.004049,0.005118,130,0.000375,0,20,0.346154,0.024973
28089,Madison County,,MS,8307,87039,95346,37,22,59,7857,5371,13228,6,0.356924,0.381266,10301.326055,0.005901,0.005567,0,0.000674,0,20,0.289037,0.033124
28091,Marion County,,MS,1428,26161,27589,8,7,15,841,682,1523,7,0.252057,0.262287,47.43046,0.001877,0.00011,0,0.000156,0,20,0.477778,0.003948
28093,Marshall County,,MS,2768,36836,39604,8,7,15,2143,1906,4049,6,0.306897,0.32063,186.027584,0.001602,0.000766,130,0.000256,0,20,0.535714,0.01307
28095,Monroe County,,MS,2036,40134,42170,8,9,17,1033,1261,2294,7,0.266264,0.278214,2696.02016,0.000637,0.000108,130,0.000259,0,20,0.433333,0.005597
28097,Montgomery County,,MS,816,12304,13120,2,2,4,291,314,605,7,0.235247,0.24152,0,0.000006,0.000005,130,0.000117,0,20,1,0.000227
28099,Neshoba County,,MS,1586,30386,31972,7,5,12,721,652,1373,7,0.257454,0.267198,89.094391,0.000153,0.000051,0,0.000235,0,20,0.357143,0.001681
28101,Newton County,,MS,1391,23079,24470,5,5,10,690,687,1377,7,0.264449,0.275199,25.791246,0.000858,0.000077,0,0.00015,0,20,0.5,0.001804
28103,Noxubee County,,MS,719,12796,13515,3,3,6,207,283,490,7,0.260426,0.270024,11.090256,0.000058,0.000065,130,0.000112,0,20,0.666667,0.000662
28105,Oktibbeha County,,MS,3764,36368,40132,20,15,35,1725,1592,3317,6,0.328146,0.348373,16417.865451,0.003895,0.002342,130,0.000388,0,20,0.397233,0.018486
28107,Panola County,,MS,2199,36563,38762,9,8,17,1280,1404,2684,6,0.30693,0.320802,1124.487808,0.000663,0.00077,130,0.000281,0,20,0.555556,0.006509
28109,Pearl River County,,MS,3509,45435,48944,14,13,27,5437,1384,6821,6,0.327187,0.346632,912.433107,0.002692,0.00164,0,0.000174,0,20,0.485294,0.006343
28111,Perry County,,MS,809,12391,13200,4,3,7,408,375,783,7,0.249208,0.258224,1.32021,0.000042,0.000057,0,0.000135,0,20,0.666667,0.000647
28113,Pike County,,MS,2374,39582,41956,14,11,25,2126,1155,3281,7,0.280997,0.295673,1852.756347,0.002467,0.000471,0,0.000251,0,20,0.419118,0.006767
28115,Pontotoc County,,MS,1857,29818,31675,8,7,15,1411,1152,2563,7,0.237512,0.245776,330.497897,0.00006,0.000042,130,0.000309,0,20,0.464286,0.001904
28117,Prentiss County,,MS,1527,25467,26994,6,6,12,807,992,1799,7,0.236336,0.244057,10.065873,0.000018,0.000025,130,0.00024,0,20,0.6,0.000813
28119,Quitman County,,MS,660,8343,9003,3,4,7,201,335,536,6,0.306736,0.32,0.25,0.000019,0.000632,130,0.000128,0,20,0.916667,0.000442
28121,Rankin County,,MS,10488,132806,143294,41,33,74,10087,6604,16691,6,0.349256,0.37429,17281.462252,0.00442,0.006286,0,0.00077,0,20,0.244898,0.022112
28123,Scott County,,MS,1718,29283,31001,6,7,13,804,971,1775,7,0.26798,0.279712,34.582697,0.000205,0.000198,0,0.000195,0,20,0.52381,0.001882
28125,Sharkey County,,MS,458,6039,6497,1,0,1,58,0,58,0,0,0,0,0.000038,0,0,0.000057,0,11,0,0.000247
28127,Simpson County,,MS,1837,26824,28661,7,9,16,886,1105,1991,7,0.268203,0.280457,153.741993,0.00062,0.000246,0,0.00019,0,20,0.488889,0.002765
28129,Smith County,,MS,813,14744,15557,6,6,12,492,455,947,7,0.25915,0.269589,43.981365,0.000521,0.000069,0,0.000163,0,20,0.452381,0.001939
28131,Stone County,,MS,1088,13925,15013,6,4,10,1083,445,1528,7,0.29837,0.311532,0,0.000905,0.000214,0,0.000091,0,20,0.785714,0.002353
28133,Sunflower County,,MS,1799,27214,29013,6,8,14,817,942,1759,6,0.307676,0.322005,3089.963514,0.000646,0.00088,0,0.000138,0,20,0.527778,0.005345
28135,Tallahatchie County,,MS,1015,14484,15499,6,8,14,326,595,921,6,0.306962,0.320859,180.927335,0.000615,0.000659,130,0.000185,0,20,0.482143,0.005297
28137,Tate County,,MS,2031,28341,30372,6,6,12,1583,1353,2936,6,0.306865,0.320458,2.452381,0.00065,0.000773,130,0.000215,0,20,0.8,0.00621
28139,Tippah County,,MS,1128,23185,24313,6,6,12,533,589,1122,6,0.306994,0.320687,2293.462183,0.000606,0.000638,130,0.00023,0,20,0.633333,0.005303
28141,Tishomingo County,,MS,1073,18917,19990,5,6,11,464,616,1080,7,0.237609,0.245776,48.193589,0.000014,0.000034,130,0.000203,0,20,0.466667,0.000661
28143,Tunica County,,MS,1414,12028,13442,9,6,15,1131,928,2059,6,0.306833,0.320401,1196.963568,0.001294,0.00074,130,0.000226,0,20,0.5,0.007917
28145,Union County,,MS,1585,27986,29571,9,8,17,1050,1035,2085,6,0.307059,0.321031,2269.318864,0.000658,0.000666,130,0.000316,0,20,0.541667,0.006584
28147,Walthall County,,MS,992,14453,15445,6,4,10,744,485,1229,7,0.251578,0.261113,4.74597,0.001575,0.000073,0,0.000106,0,20,0.52381,0.002555
28149,Warren County,,MS,2914,55320,58234,13,8,21,1506,957,2463,6,0.322331,0.340258,4936.62633,0.002408,0.001181,0,0.000244,0,20,0.404167,0.00587
28151,Washington County,,MS,3893,58081,61974,8,17,25,809,1767,2576,6,0.346058,0.368408,3934.535512,0.003648,0.004901,0,0.00013,0,20,0.460784,0.02038
28153,Wayne County,,MS,914,21198,22112,5,5,10,388,368,756,7,0.273934,0.285751,63.695336,0.000497,0.000123,0,0.000147,0,20,0.433333,0.001708
28155,Webster County,,MS,751,11769,12520,3,4,7,303,286,589,7,0.247386,0.256328,15.03539,0.000019,0.000036,130,0.000127,0,20,0.333333,0.000457
28157,Wilkinson County,,MS,536,9135,9671,2,2,4,266,138,404,7,0.279217,0.291406,0,0.001048,0.000173,0,0.00006,0,20,0.833333,0.00227
28159,Winston County,,MS,1009,20880,21889,5,6,11,289,443,732,7,0.259243,0.269761,208.127706,0.000477,0.000068,130,0.000173,0,20,0.261905,0.001702
28161,Yalobusha County,,MS,963,13388,14351,6,5,11,509,518,1027,7,0.259035,0.268626,8.927778,0.00065,0.000148,130,0.000199,0,20,0.7,0.006126
28163,Yazoo County,,MS,1352,25885,27237,8,4,12,598,699,1297,7,0.267906,0.279168,121.718798,0.001617,0.000203,0,0.000192,0,20,0.553571,0.009894
29001,Adair County,,MO,1949,21232,23181,7,9,16,501,642,1143,6,0.306122,0.32047,21466.050628,0.000096,0.001274,37,0.000344,0,20,0.2,0.001377
29003,Andrew County,,MO,1653,19488,21141,3,5,8,1226,1141,2367,7,0.270019,0.28074,69.507506,0.000023,0.000169,37,0.000122,0,20,0.633333,0.000414
29005,Atchison County,,MO,426,6682,7108,0,1,1,0,65,65,7,0.22615,0.23176,0,0,0.000001,37,0.00005,0,85,0,0
29007,Audrain County,,MO,1659,27202,28861,7,7,14,839,921,1760,6,0.30379,0.317405,1141.056584,0.000722,0.000706,37,0.000221,0,20,0.392857,0.005841
29009,Barry County,,MO,2692,35442,38134,11,11,22,1754,1587,3341,7,0.281786,0.294448,93.500785,0.000836,0.000721,37,0.000321,0,20,0.598485,0.00904
29011,Barton County,,MO,1035,14090,15125,4,5,9,423,527,950,7,0.279378,0.29065,6.843245,0.000059,0.000246,37,0.000132,0,20,0.6,0.000904
29013,Bates County,,MO,1202,18253,19455,5,4,9,734,559,1293,6,0.300155,0.31248,46.547529,0.000872,0.000835,37,0.000149,0,20,0.55,0.006779
29015,Benton County,,MO,1543,17949,19492,8,6,14,846,729,1575,6,0.292315,0.304416,14.381485,0.001039,0.00053,37,0.000193,0,20,0.821429,0.008216
29017,Bollinger County,,MO,774,12614,13388,4,3,7,441,405,846,7,0.235857,0.243046,16.603671,0.000025,0.000021,37,0.000164,0,20,0.4,0.000564
29019,Boone County,,MO,12040,147692,159732,55,43,98,7731,6344,14075,6,0.368215,0.395687,61504.746231,0.012266,0.012278,37,0.001115,0,20,0.252404,0.09039
29021,Buchanan County,,MO,5666,89895,95561,17,18,35,2906,3562,6468,6,0.337235,0.357314,25791.729326,0.001784,0.002482,37,0.000428,0,20,0.304762,0.014123
29023,Butler County,,MO,2707,42368,45075,10,10,20,1330,1273,2603,6,0.305223,0.319759,14499.410171,0.000856,0.000825,37,0.000394,0,20,0.295455,0.007043
29025,Caldwell County,,MO,726,9834,10560,6,6,12,416,415,831,6,0.291788,0.303843,62.063988,0.000505,0.000466,37,0.000187,0,20,0.607143,0.004185
29027,Callaway County,,MO,3441,44163,47604,12,10,22,2296,2028,4324,6,0.306768,0.321415,1376.794221,0.001499,0.001477,37,0.000303,0,20,0.484848,0.0123
29029,Camden County,,MO,3650,39552,43202,17,14,31,2344,1810,4154,6,0.310599,0.326277,484.081712,0.004329,0.002211,37,0.000338,0,20,0.549708,0.034196
29031,Cape Girardeau County,,MO,4825,77432,82257,19,18,37,2897,2585,5482,6,0.308328,0.324519,21997.440893,0.001398,0.001767,37,0.000535,0,20,0.271429,0.012027
29033,Carroll County,,MO,691,10989,11680,4,4,8,181,267,448,6,0.291671,0.303414,2.396825,0.000386,0.000461,37,0.000137,0,20,0.65,0.00306
29035,Carter County,,MO,470,6290,6760,1,1,2,119,105,224,7,0.233866,0.240088,0,0.000006,0.000007,37,0.000084,0,20,0,0.000153
29037,Cass County,,MO,7820,102707,110527,21,16,37,7076,5234,12310,6,0.341589,0.36197,2045.629645,0.004718,0.003297,37,0.000444,0,20,0.390476,0.03594
29039,Cedar County,,MO,1128,13353,14481,5,5,10,322,540,862,7,0.279297,0.290576,19.647213,0.000534,0.000252,37,0.000165,0,20,0.547619,0.004598
29041,Chariton County,,MO,541,9112,9653,2,2,4,168,176,344,7,0.226812,0.232693,3.108333,0.000005,0.000001,37,0.000126,0,20,0,0.000201
29043,Christian County,,MO,7139,69903,77042,28,15,43,6485,4736,11221,6,0.338333,0.35819,4524.012129,0.0081,0.002896,37,0.000636,0,20,0.376984,0.062798
29045,Clark County,,MO,404,8043,8447,1,1,2,124,109,233,7,0.227486,0.23311,0,0.000004,0.000001,24,0.000072,0,20,0,0.000105
29047,Clay County,,MO,18983,230819,249802,53,42,95,18104,13716,31820,6,0.369149,0.396249,30122.656853,0.013574,0.013784,37,0.001042,0,20,0.30369,0.099835
29049,Clinton County,,MO,2223,22412,24635,7,8,15,1273,1465,2738,6,0.291963,0.304387,65.512663,0.000559,0.000526,37,0.000218,0,20,0.625,0.004641
29051,Cole County,,MO,5846,82026,87872,21,19,40,3519,3593,7112,6,0.33383,0.353477,9880.951999,0.003348,0.003173,37,0.000467,0,20,0.385375,0.026309
29053,Cooper County,,MO,1314,17703,19017,5,5,10,675,665,1340,6,0.293022,0.305252,111.952268,0.000112,0.000453,37,0.000169,0,20,0.533333,0.001347
29055,Crawford County,,MO,1537,24830,26367,7,6,13,973,799,1772,6,0.303251,0.316489,48.780492,0.001091,0.000869,37,0.000165,0,20,0.660714,0.008402
29057,Dade County,,MO,691,8400,9091,3,6,9,297,433,730,7,0.279244,0.290576,34.562251,0.00016,0.000254,37,0.000122,0,20,0.5,0.00179
29059,Dallas County,,MO,1429,16016,17445,6,6,12,757,792,1549,7,0.279056,0.290175,3.75,0.000189,0.000278,37,0.000243,0,20,0.666667,0.002818
29061,Daviess County,,MO,652,9207,9859,4,4,8,203,231,434,7,0.269744,0.280081,518.518653,0.000378,0.000115,37,0.000153,0,20,0.6,0.003011
29063,DeKalb County,,MO,867,10111,10978,6,5,11,516,478,994,6,0.291876,0.303872,56.149602,0.000136,0.000474,37,0.000194,0,20,0.642857,0.001595
29065,Dent County,,MO,975,14684,15659,3,4,7,272,413,685,7,0.279137,0.290089,2969.949034,0.000615,0.000205,37,0.000103,0,20,0.466667,0.004628
29067,Douglas County,,MO,947,12618,13565,5,6,11,377,531,908,7,0.279163,0.290376,100.683602,0.000184,0.00026,37,0.000185,0,20,0.6,0.002486
29069,Dunklin County,,MO,2095,31331,33426,10,11,21,933,1217,2150,7,0.28078,0.294992,2385.228644,0.000267,0.000311,5,0.0003,0,20,0.3,0.003345
29071,Franklin County,,MO,6153,116392,122545,14,18,32,4543,4043,8586,6,0.309542,0.325641,211.453476,0.001655,0.002045,37,0.000334,0,20,0.494152,0.013492
29073,Gasconade County,,MO,1204,17658,18862,7,5,12,744,626,1370,6,0.303188,0.31626,1034.783872,0.000851,0.000604,37,0.000206,0,20,0.404762,0.006749
29075,Gentry County,,MO,468,7445,7913,1,3,4,66,164,230,7,0.252385,0.260654,2969,0.000019,0.000015,37,0.00007,0,20,0.333333,0.000218
29077,Greene County,,MO,20328,269636,289964,91,69,160,16263,13750,30013,6,0.386711,0.416707,103560.405733,0.023857,0.019971,37,0.001739,0,20,0.253659,0.181654
29079,Grundy County,,MO,752,10854,11606,1,2,3,57,142,199,7,0.225984,0.231702,0.666667,0.000004,0.000007,37,0.000076,0,20,0,0.000121
29081,Harrison County,,MO,611,9509,10120,1,1,2,45,42,87,7,0.269694,0.279594,48.032636,0,0.000105,37,0.00007,0,20,0,0.000087
29083,Henry County,,MO,1764,23785,25549,7,9,16,998,1016,2014,6,0.301899,0.315332,56.823439,0.000559,0.001171,37,0.000207,0,20,0.736111,0.004768
29085,Hickory County,,MO,750,8665,9415,4,4,8,282,352,634,7,0.27903,0.289889,15.482724,0.000532,0.000202,37,0.000166,0,20,0.7,0.004579
29087,Holt County,,MO,445,5803,6248,2,3,5,155,217,372,7,0.252363,0.260596,0,0.000023,0.000015,37,0.000095,0,20,1,0.000324
29089,Howard County,,MO,797,10734,11531,3,3,6,421,448,869,7,0.269245,0.279608,2.1,0.000102,0.000097,37,0.000142,0,20,0.666667,0.001063
29091,Howell County,,MO,2532,39991,42523,8,10,18,791,1082,1873,7,0.279566,0.29155,9176.991906,0.00017,0.000278,37,0.000312,0,20,0.290909,0.00253
29093,Iron County,,MO,862,10446,11308,5,4,9,416,393,809,7,0.253198,0.261897,948.904729,0.000638,0.000051,37,0.000173,0,20,0.7,0.005124
29095,Jackson County,,MO,46079,707090,753169,125,119,244,32298,36754,69052,5,0.411366,0.446094,115111.577155,0.044733,0.0477,37,0.002033,0,20,0.3078,0.32996
29097,Jasper County,,MO,7804,113456,121260,30,26,56,5216,4624,9840,6,0.349508,0.372365,13634.024743,0.006465,0.005068,37,0.000672,0,20,0.33428,0.052607
29099,Jefferson County,,MO,14147,247210,261357,24,22,46,12958,10607,23565,6,0.310036,0.326873,3907.6291,0.004322,0.002034,37,0.000559,0,20,0.344615,0.035169
29101,Johnson County,,MO,6280,49786,56066,13,18,31,2414,2695,5109,6,0.338884,0.359267,937.194374,0.003468,0.005219,37,0.000286,0,20,0.507895,0.028669
29103,Knox County,,MO,357,4655,5012,0,2,2,0,113,113,7,0.234493,0.240913,0,0,0.000001,37,0.00005,0,86,0,0
29105,Laclede County,,MO,2300,37131,39431,8,9,17,1188,1124,2312,7,0.282607,0.294946,81.322212,0.000626,0.000381,37,0.000235,0,20,0.466667,0.005793
29107,Lafayette County,,MO,2747,36582,39329,6,9,15,1685,1774,3459,6,0.302118,0.315475,15.477417,0.000555,0.001076,37,0.00017,0,20,0.652778,0.004559
29109,Lawrence County,,MO,3035,38955,41990,7,7,14,1645,1806,3451,7,0.279271,0.290748,6.420003,0.000238,0.000352,37,0.000229,0,20,0.690476,0.003521
29111,Lewis County,,MO,623,10950,11573,2,2,4,253,280,533,7,0.24908,0.256817,0,0.000023,0.000018,37,0.000097,0,20,1,0.000332
29113,Lincoln County,,MO,3446,53273,56719,9,7,16,4429,2335,6764,6,0.303251,0.316604,12.682213,0.001204,0.001047,37,0.0002,0,20,0.680556,0.009295
29115,Linn County,,MO,1003,15004,16007,3,4,7,214,297,511,7,0.275673,0.286928,902.661135,0.000004,0.000204,37,0.000161,0,20,0.3,0.000311
29117,Livingston County,,MO,979,15262,16241,5,6,11,356,323,679,6,0.291817,0.3039,7884.224274,0.000482,0.000459,37,0.000179,0,20,0.333333,0.003905
29119,McDonald County,,MO,1931,19743,21674,6,7,13,1102,1304,2406,7,0.274011,0.285668,2.842406,0.000287,0.000412,5,0.000188,0,20,0.809524,0.003773
29121,Macon County,,MO,1095,18300,19395,4,5,9,379,445,824,7,0.269444,0.280267,4937.748397,0.000109,0.000097,37,0.00019,0,20,0.25,0.001155
29123,Madison County,,MO,725,12352,13077,2,3,5,288,279,567,7,0.251556,0.259566,3.170139,0.000018,0.000016,37,0.000115,0,20,0.333333,0.000318
29125,Maries County,,MO,583,8974,9557,3,4,7,232,289,521,7,0.25056,0.259045,38.761082,0.000093,0.000044,37,0.000116,0,20,0.5,0.000989
29127,Marion County,,MO,1909,31660,33569,7,8,15,941,964,1905,6,0.304043,0.317824,4096.10493,0.000719,0.000921,37,0.000237,0,20,0.375,0.005783
29129,Mercer County,,MO,314,3927,4241,0,0,0,0,0,0,0,0,0,0,0,0,50,0.00005,41,87,0,0
29131,Miller County,,MO,2122,24400,26522,8,8,16,1227,1353,2580,7,0.283958,0.296567,361.355479,0.000829,0.000439,37,0.000204,0,20,0.680556,0.006981
29133,Mississippi County,,MO,754,12967,13721,3,3,6,347,357,704,7,0.241835,0.249303,0,0.000025,0.000016,37,0.000128,0,20,1,0.000438
29135,Moniteau County,,MO,1200,16476,17676,4,7,11,505,721,1226,7,0.269494,0.280639,4.228253,0.000036,0.000163,37,0.000146,0,20,0.642857,0.000763
29137,Monroe County,,MO,691,10323,11014,5,4,9,339,308,647,7,0.269444,0.280095,1469.287352,0.000111,0.000107,37,0.00021,0,20,0.35,0.001326
29139,Montgomery County,,MO,1125,13428,14553,7,8,15,765,707,1472,6,0.303758,0.317463,15.463216,0.000859,0.000942,37,0.000208,0,20,0.571429,0.006848
29141,Morgan County,,MO,1660,20326,21986,9,7,16,1002,871,1873,6,0.29314,0.30571,734.152782,0.001715,0.000518,37,0.000206,0,20,0.688889,0.013309
29143,New Madrid County,,MO,1320,18756,20076,6,6,12,593,787,1380,7,0.243882,0.252344,82.477793,0.000028,0.000023,37,0.000215,0,20,0.566667,0.00079
29145,Newton County,,MO,4783,57973,62756,11,13,24,2907,3077,5984,6,0.300155,0.315166,519.551049,0.000829,0.001346,37,0.000295,0,20,0.505495,0.008363
29147,Nodaway County,,MO,1497,21223,22720,6,7,13,350,516,866,6,0.292139,0.304559,3844.323416,0.000128,0.000517,37,0.000202,0,20,0.291667,0.001487
29149,Oregon County,,MO,653,9551,10204,2,3,5,197,275,472,7,0.27919,0.290032,417.576416,0.000002,0.000187,37,0.000111,0,20,0.666667,0.000216
29151,Osage County,,MO,733,15445,16178,4,3,7,343,368,711,7,0.250452,0.258673,2.719185,0.000041,0.000044,37,0.000156,0,20,0.416667,0.000751
29153,Ozark County,,MO,754,9121,9875,3,5,8,226,381,607,7,0.279351,0.290547,6.725844,0.000011,0.000247,37,0.000131,0,20,0.6,0.000533
29155,Pemiscot County,,MO,1294,18177,19471,4,5,9,467,625,1092,7,0.241214,0.250114,90.454481,0.000023,0.000036,5,0.000145,0,20,0.4,0.000534
29157,Perry County,,MO,1095,21002,22097,5,5,10,508,491,999,6,0.303441,0.316661,750.499234,0.000625,0.000638,37,0.000188,0,20,0.433333,0.004876
29159,Pettis County,,MO,3045,43618,46663,12,12,24,1586,1502,3088,6,0.302967,0.317108,339.713591,0.00125,0.001265,37,0.000287,0,20,0.456044,0.010313
29161,Phelps County,,MO,3809,42842,46651,14,13,27,1636,1482,3118,6,0.309114,0.324633,1365.657319,0.00144,0.001696,37,0.000312,0,20,0.466667,0.012094
29163,Pike County,,MO,1161,18437,19598,6,8,14,460,663,1123,6,0.303885,0.317663,2798.030254,0.000841,0.000922,37,0.000178,0,20,0.392857,0.006579
29165,Platte County,,MO,11997,89739,101736,25,21,46,8412,8402,16814,6,0.356836,0.380235,3427.139347,0.006137,0.00707,37,0.000497,0,20,0.496032,0.046911
29167,Polk County,,MO,2439,29438,31877,10,6,16,1624,1285,2909,6,0.295431,0.307526,454.292393,0.00156,0.000604,37,0.000319,0,20,0.433333,0.014006
29169,Pulaski County,,MO,7950,39045,46995,29,33,62,3316,3464,6780,6,0.347297,0.371489,6547.342095,0.009521,0.009688,136,0.000418,0,20,0.492857,0.071052
29171,Putnam County,,MO,366,5853,6219,1,1,2,51,94,145,7,0.234394,0.240538,0,0.00001,0.000001,37,0.000083,0,20,0,0.000107
29173,Ralls County,,MO,857,11493,12350,2,3,5,397,487,884,7,0.233397,0.239928,0.342857,0.000014,0.000018,37,0.000094,0,20,0.666667,0.00028
29175,Randolph County,,MO,1861,25429,27290,7,6,13,710,890,1600,6,0.29311,0.305538,5181.358398,0.000128,0.000445,37,0.000291,0,20,0.285714,0.001693
29177,Ray County,,MO,1966,27023,28989,7,6,13,1352,1162,2514,6,0.300186,0.312766,25.99036,0.000552,0.000956,37,0.000201,0,20,0.571429,0.004575
29179,Reynolds County,,MO,425,6416,6841,1,1,2,47,53,100,7,0.251469,0.259107,1.319444,0.000002,0.00001,37,0.000072,0,20,0,0.000122
29181,Ripley County,,MO,902,13265,14167,2,1,3,303,281,584,7,0.233866,0.240088,0,0.000007,0.000007,37,0.00011,0,20,1,0.000252
29183,St. Charles County,,MO,23776,392741,416517,72,64,136,24336,17148,41484,6,0.385788,0.416117,23980.81509,0.028523,0.028468,37,0.001062,0,20,0.429564,0.209009
29185,St. Clair County,,MO,775,8588,9363,6,5,11,396,365,761,7,0.27919,0.290347,7.272944,0.000413,0.000242,37,0.000216,0,20,0.571429,0.003664
29186,Ste. Genevieve County,,MO,1263,21485,22748,5,4,9,878,754,1632,6,0.303157,0.316088,2.295238,0.000862,0.000633,37,0.000152,0,20,0.75,0.006462
29187,St. Francois County,,MO,3576,60954,64530,13,12,25,2738,2173,4911,6,0.335834,0.35488,11521.634947,0.001345,0.002232,37,0.000393,0,20,0.429167,0.011134
29189,St. Louis County,,MO,79035,1163624,1242659,196,202,398,59737,69140,128877,5,0.434653,0.476071,193706.194759,0.075219,0.077256,37,0.002616,0,20,0.290408,0.542264
29195,Saline County,,MO,1645,23825,25470,5,7,12,464,682,1146,6,0.29314,0.30571,49.572365,0.000487,0.000566,37,0.000152,0,20,0.571429,0.003959
29197,Schuyler County,,MO,254,4263,4517,1,1,2,60,63,123,7,0.234394,0.240538,0,0.00001,0.000001,37,0.000083,0,20,0,0.000107
29199,Scotland County,,MO,271,5434,5705,0,1,1,0,43,43,7,0.234437,0.240627,0,0,0.000001,37,0.00005,0,88,0,0
29201,Scott County,,MO,2950,42850,45800,6,8,14,1632,1721,3353,6,0.31531,0.330928,6082.498167,0.000616,0.001397,37,0.00021,0,20,0.430556,0.00498
29203,Shannon County,,MO,416,7958,8374,1,1,2,107,129,236,8,0.218501,0.223938,0,0.000002,0.000001,37,0.000077,0,20,0,0.000117
29205,Shelby County,,MO,493,7594,8087,2,2,4,118,121,239,8,0.212455,0.217962,4.278571,0.000001,0.000002,37,0.000104,0,20,0,0.000184
29207,Stoddard County,,MO,1890,32064,33954,8,7,15,972,950,1922,7,0.243902,0.252545,1354.551444,0.000634,0.00003,37,0.000274,0,20,0.464286,0.005257
29209,Stone County,,MO,3209,30305,33514,13,7,20,1762,1859,3621,7,0.279297,0.290805,484.635378,0.00507,0.000351,37,0.00031,0,20,0.543956,0.038982
29211,Sullivan County,,MO,671,7549,8220,1,2,3,50,108,158,7,0.253617,0.262028,18.43571,0.00001,0.000015,37,0.000083,0,20,0,0.000107
29213,Taney County,,MO,4357,43596,47953,16,8,24,2035,1752,3787,6,0.296364,0.309416,1611.219395,0.004396,0.000877,37,0.000371,0,20,0.522876,0.034694
29215,Texas County,,MO,1692,23427,25119,6,7,13,678,671,1349,7,0.282689,0.29486,71.072613,0.00025,0.000282,37,0.00018,0,20,0.5,0.002783
29217,Vernon County,,MO,1464,21077,22541,7,8,15,577,686,1263,6,0.295732,0.308328,556.673437,0.000234,0.000631,37,0.000232,0,20,0.392857,0.002939
29219,Warren County,,MO,2752,32142,34894,7,7,14,2819,1945,4764,6,0.303663,0.317176,3.317973,0.001092,0.001116,37,0.000169,0,20,0.821429,0.008396
29221,Washington County,,MO,1399,22134,23533,6,5,11,1030,908,1938,6,0.303157,0.316203,263.987288,0.000873,0.000645,37,0.000173,0,20,0.8,0.006671
29223,Wayne County,,MO,997,11991,12988,4,4,8,356,408,764,7,0.253506,0.262475,12.277427,0.000622,0.000056,37,0.00015,0,20,0.65,0.004992
29225,Webster County,,MO,2987,35923,38910,7,6,13,1903,1943,3846,7,0.279056,0.290175,430.806336,0.001188,0.000268,37,0.000232,0,20,0.589286,0.011027
29227,Worth County,,MO,154,2436,2590,0,0,0,0,0,0,0,0,0,0,0,0,51,0.00005,42,89,0,0
29229,Wright County,,MO,1479,18308,19787,6,6,12,607,928,1535,7,0.27911,0.290261,5.197835,0.000166,0.000265,37,0.000201,0,20,0.642857,0.002235
29510,St. Louis city,,MO,39012,300411,339423,50,61,111,25589,33613,59202,5,0.395649,0.425178,15477.271153,0.024046,0.028922,37,0.000701,0,20,0.519608,0.175143
30001,Beaverhead County,,MT,841,8765,9606,3,4,7,154,258,412,7,0.264209,0.274963,0,0.000152,0.000296,6,0.000123,0,20,1,0.001994
30003,Big Horn County,,MT,882,12201,13083,2,3,5,254,428,682,7,0.258897,0.268684,1,0.000084,0.000102,6,0.000111,0,20,0.666667,0.000972
30005,Blaine County,,MT,538,6798,7336,2,2,4,111,148,259,7,0.258851,0.268454,0,0.000076,0.000094,6,0.000098,0,20,1,0.000737
30007,Broadwater County,,MT,422,4756,5178,2,2,4,179,183,362,7,0.258093,0.267449,0,0.000103,0.000156,6,0.000105,0,20,1,0.001468
30009,Carbon County,,MT,996,10057,11053,1,1,2,333,372,705,7,0.258805,0.268225,0,0.000083,0.000091,6,0.00008,0,20,0,0.000878
30011,Carter County,,MT,80,1393,1473,0,0,0,0,0,0,0,0,0,0,0,0,52,0.00005,43,90,0,0
30013,Cascade County,,MT,7545,88870,96415,27,29,56,2742,3208,5950,6,0.348795,0.372801,28039.830524,0.008054,0.009349,6,0.000622,0,20,0.356855,0.065931
30015,Chouteau County,,MT,355,5081,5436,1,1,2,46,69,115,7,0.258621,0.267733,0,0.000073,0.000062,6,0.000068,0,20,0,0.000616
30017,Custer County,,MT,972,12276,13248,2,2,4,143,225,368,7,0.261104,0.271166,5.039952,0.000084,0.000204,6,0.000111,0,20,0.666667,0.000972
30019,Daniels County,,MT,127,2255,2382,0,0,0,0,0,0,0,0,0,0,0,0,53,0.00005,44,91,0,0
30021,Dawson County,,MT,668,9833,10501,1,1,2,71,63,134,7,0.258805,0.268225,0,0.000083,0.000091,6,0.00008,0,20,0,0.000878
30023,Deer Lodge County,,MT,702,9535,10237,2,3,5,144,269,413,7,0.261667,0.271721,4.082081,0.000012,0.000205,6,0.000102,0,20,0.75,0.000287
30025,Fallon County,,MT,188,3281,3469,0,0,0,0,0,0,0,0,0,0,0,0,54,0.00005,45,92,0,0
30027,Fergus County,,MT,902,12885,13787,3,4,7,203,301,504,7,0.263087,0.274075,0,0.000228,0.000309,6,0.000125,0,20,1,0.002498
30029,Flathead County,,MT,5373,92614,97987,30,25,55,3416,2443,5859,6,0.343403,0.366123,7349.283155,0.010756,0.007535,6,0.00055,0,20,0.556818,0.087173
30031,Gallatin County,,MT,7593,82898,90491,47,31,78,4812,3562,8374,6,0.347753,0.371959,28188.867918,0.014543,0.009339,6,0.000989,0,20,0.382801,0.115152
30033,Garfield County,,MT,52,1354,1406,0,0,0,0,0,0,0,0,0,0,0,0,55,0.00005,46,93,0,0
30035,Glacier County,,MT,774,13460,14234,4,5,9,221,276,497,7,0.263182,0.273792,21.622427,0.000201,0.000238,6,0.000133,0,20,0.65,0.002279
30037,Golden Valley County,,MT,114,1066,1180,0,0,0,0,0,0,0,0,0,0,0,0,56,0.00005,47,94,0,0
30039,Granite County,,MT,263,2865,3128,1,1,2,46,70,116,7,0.258897,0.268117,0,0.000069,0.000082,6,0.000071,0,20,0,0.000798
30041,Hill County,,MT,1249,17954,19203,6,6,12,406,506,912,7,0.263205,0.274591,42.962432,0.000314,0.000393,6,0.000206,0,20,0.761905,0.003619
30043,Jefferson County,,MT,1091,11535,12626,3,3,6,529,512,1041,7,0.258162,0.267735,0,0.000113,0.000166,6,0.00013,0,20,1,0.00166
30045,Judith Basin County,,MT,174,2201,2375,0,0,0,0,0,0,0,0,0,0,0,0,57,0.00005,48,95,0,0
30047,Lake County,,MT,1968,26538,28506,8,5,13,809,815,1624,7,0.273291,0.286343,20.373662,0.001297,0.000546,6,0.000214,0,20,0.694444,0.012204
30049,Lewis and Clark County,,MT,4532,66266,70798,20,15,35,2509,2223,4732,6,0.337274,0.3576,6011.823292,0.005509,0.003895,6,0.000489,0,20,0.463158,0.046245
30051,Liberty County,,MT,165,2185,2350,0,0,0,0,0,0,0,0,0,0,0,0,58,0.00005,49,96,0,0
30053,Lincoln County,,MT,1496,18703,20199,2,4,6,257,477,734,7,0.273265,0.286172,0,0.000127,0.000506,6,0.000089,0,20,1,0.00157
30055,McCone County,,MT,80,2043,2123,0,0,0,0,0,0,0,0,0,0,0,0,59,0.00005,50,97,0,0
30057,Madison County,,MT,587,7109,7696,1,1,2,146,110,256,7,0.258047,0.26722,0,0.000072,0.000113,6,0.000077,0,20,0,0.001005
30059,Meagher County,,MT,173,2296,2469,0,0,0,0,0,0,0,0,0,0,0,0,60,0.00005,51,98,0,0
30061,Mineral County,,MT,445,4039,4484,1,1,2,135,124,259,7,0.258897,0.268117,0,0.000069,0.000082,6,0.000071,0,20,0,0.000798
30063,Missoula County,,MT,8962,104964,113926,36,33,69,5182,4970,10152,6,0.349298,0.373757,30080.929562,0.010541,0.008864,6,0.000792,0,20,0.407539,0.088753
30065,Musselshell County,,MT,465,4320,4785,1,1,2,90,129,219,7,0.258805,0.268225,0,0.000083,0.000091,6,0.00008,0,20,0,0.000878
30067,Park County,,MT,1435,16757,18192,3,3,6,501,452,953,7,0.264161,0.274734,0,0.000225,0.000286,6,0.000127,0,20,1,0.00268
30069,Petroleum County,,MT,39,405,444,0,0,0,0,0,0,0,0,0,0,0,0,61,0.00005,52,99,0,0
30071,Phillips County,,MT,273,4715,4988,0,1,1,0,43,43,7,0.258848,0.268305,0,0,0.000091,6,0.00005,0,100,0,0
30073,Pondera County,,MT,494,7007,7501,2,3,5,95,178,273,7,0.258989,0.268592,0.465909,0.000074,0.000107,6,0.000091,0,20,0.666667,0.000723
30075,Powder River County,,MT,65,1595,1660,0,0,0,0,0,0,0,0,0,0,0,0,62,0.00005,53,101,0,0
30077,Powell County,,MT,520,5789,6309,2,3,5,95,157,252,7,0.259012,0.268632,60.483548,0.00008,0.000125,6,0.000096,0,20,0.75,0.000989
30079,Prairie County,,MT,94,1298,1392,0,0,0,0,0,0,0,0,0,0,0,0,63,0.00005,54,102,0,0
30081,Ravalli County,,MT,3088,39933,43021,12,9,21,1480,1341,2821,6,0.334829,0.353671,123.484796,0.005227,0.002558,6,0.000266,0,20,0.839744,0.042875
30083,Richland County,,MT,640,11136,11776,1,1,2,71,98,169,7,0.258805,0.268225,0,0.000083,0.000091,6,0.00008,0,20,0,0.000878
30085,Roosevelt County,,MT,772,10626,11398,0,3,3,0,211,211,7,0.260116,0.270104,0,0,0.000092,6,0.00005,0,104,0.166667,0
30087,Rosebud County,,MT,916,10119,11035,2,3,5,187,407,594,7,0.258851,0.268569,0.5,0.000084,0.000093,6,0.000111,0,20,0.666667,0.000972
30089,Sanders County,,MT,833,10774,11607,2,4,6,132,303,435,7,0.261503,0.271965,0,0.000127,0.000303,6,0.000089,0,20,0.833333,0.00157
30091,Sheridan County,,MT,251,4352,4603,0,0,0,0,0,0,0,0,0,0,0,0,64,0.00005,55,105,0,0
30093,Silver Bow County,,MT,2394,35042,37436,10,10,20,952,1038,1990,6,0.321725,0.339135,3956.493897,0.001285,0.001381,6,0.000295,0,20,0.518182,0.012174
30095,Stillwater County,,MT,830,9496,10326,1,1,2,307,271,578,7,0.258805,0.268225,0,0.000083,0.000091,6,0.00008,0,20,0,0.000878
30097,Sweet Grass County,,MT,339,3854,4193,1,2,3,62,94,156,7,0.261104,0.271166,0,0.000083,0.000204,6,0.00008,0,20,1,0.000878
30099,Teton County,,MT,499,7332,7831,1,1,2,109,147,256,7,0.258621,0.267733,0,0.000073,0.000062,6,0.000068,0,20,0,0.000616
30101,Toole County,,MT,491,5402,5893,0,1,1,0,48,48,7,0.258664,0.267813,0,0,0.000062,6,0.00005,0,106,0,0
30103,Treasure County,,MT,60,936,996,0,0,0,0,0,0,0,0,0,0,0,0,65,0.00005,56,107,0,0
30105,Valley County,,MT,570,8341,8911,1,1,2,40,70,110,7,0.258848,0.268305,0,0.000001,0.000091,6,0.000064,0,103,0.5,0.000084
30107,Wheatland County,,MT,190,2113,2303,0,0,0,0,0,0,0,0,0,0,0,0,66,0.00005,57,108,0,0
30109,Wibaux County,,MT,102,1030,1132,0,0,0,0,0,0,0,0,0,0,0,0,67,0.00005,58,109,0,0
30111,Yellowstone County,,MT,9109,154548,163657,51,40,91,5885,4768,10653,6,0.34913,0.374387,73608.414601,0.011754,0.01073,6,0.001385,0,20,0.268182,0.096423
31001,Adams County,,NE,2124,33846,35970,8,7,15,764,986,1750,7,0.298186,0.310937,11810.888114,0.000572,0.000582,24,0.000336,0,20,0.333333,0.004325
31003,Antelope County,,NE,549,8113,8662,2,2,4,112,199,311,7,0.27919,0.289963,0,0.000191,0.000132,24,0.000099,0,20,1,0.001319
31005,Arthur County,,NE,-2,-2,-4,0,0,0,0,0,0,0,0,0,0,0,0,68,0.00005,59,110,0,0
31007,Banner County,,NE,-2,-2,-4,0,0,0,0,0,0,0,0,0,0,0,0,69,0.00005,60,111,0,0
31009,Blaine County,,NE,-2,-2,-4,0,0,0,0,0,0,0,0,0,0,0,0,70,0.00005,61,112,0,0
31011,Boone County,,NE,339,6839,7178,1,1,2,51,48,99,8,0.229949,0.235852,0,0,0.000005,24,0.000085,0,20,1,0.000087
31013,Box Butte County,,NE,916,13859,14775,3,2,5,176,143,319,7,0.279619,0.290387,2174.664145,0.000017,0.000131,24,0.00013,0,20,0.416667,0.000313
31015,Boyd County,,NE,142,2574,2716,0,0,0,0,0,0,0,0,0,0,0,0,71,0.00005,62,113,0,0
31017,Brown County,,NE,221,3730,3951,0,0,0,0,0,0,0,0,0,0,0,0,72,0.00005,63,114,0,0
31019,Buffalo County,,NE,3774,47493,51267,16,12,28,1835,1760,3595,6,0.335408,0.354536,13756.777597,0.000745,0.001676,24,0.000553,0,20,0.242647,0.006242
31021,Burt County,,NE,555,8255,8810,3,4,7,233,271,504,7,0.295312,0.307397,0,0.000379,0.00045,24,0.000121,0,20,1,0.002711
31023,Butler County,,NE,701,10521,11222,3,4,7,264,359,623,7,0.295371,0.307483,305.194455,0.000181,0.000444,24,0.000135,0,20,0.75,0.001411
31025,Cass County,,NE,2543,29043,31586,5,6,11,1591,1581,3172,7,0.297942,0.310364,3.178912,0.000702,0.000596,24,0.000153,0,20,0.766667,0.004909
31027,Cedar County,,NE,640,11328,11968,0,4,4,0,225,225,7,0.27942,0.290637,0,0,0.000133,24,0.00005,0,115,0.416667,0
31029,Chase County,,NE,308,4549,4857,0,0,0,0,0,0,0,0,0,0,0,0,73,0.00005,64,116,0,0
31031,Cherry County,,NE,512,6606,7118,1,1,2,50,44,94,8,0.207733,0.212377,0,0.000001,0,24,0.000112,0,117,0,0.000086
31033,Cheyenne County,,NE,1059,11501,12560,0,5,5,0,325,325,7,0.281897,0.293719,0,0,0.000212,8,0.00005,0,119,0.3,0
31035,Clay County,,NE,608,7765,8373,1,2,3,125,247,372,7,0.279137,0.289849,0,0.000005,0.000132,24,0.000091,0,20,1,0.000131
31037,Colfax County,,NE,868,11358,12226,3,4,7,264,383,647,7,0.29314,0.304969,1.95,0.000013,0.000323,24,0.000138,0,20,0.666667,0.000382
31039,Cuming County,,NE,712,11367,12079,1,4,5,87,282,369,7,0.295431,0.307626,0,0.000005,0.000449,24,0.000077,0,20,1,0.000143
31041,Custer County,,NE,814,13027,13841,2,4,6,97,280,377,7,0.279432,0.290553,5.866545,0.000187,0.000152,24,0.000112,0,20,0.916667,0.001339
31043,Dakota County,,NE,2137,22902,25039,6,6,12,1218,1235,2453,7,0.293406,0.305645,4840.960099,0.001452,0.000339,24,0.000177,0,20,0.380952,0.010496
31045,Dawes County,,NE,888,8413,9301,1,5,6,62,257,319,7,0.262968,0.273211,778.870196,0,0.000076,24,0.000092,0,20,0.3,0.000089
31047,Dawson County,,NE,2023,28009,30032,9,8,17,621,833,1454,7,0.295732,0.308531,11605.062048,0.00181,0.000465,24,0.000307,0,20,0.269231,0.014013
31049,Deuel County,,NE,201,2196,2397,0,0,0,0,0,0,0,0,0,0,0,0,74,0.00005,65,120,0,0
31051,Dixon County,,NE,539,7075,7614,2,3,5,136,189,325,7,0.262422,0.271447,205.914923,0.000039,0.000037,24,0.0001,0,20,0.333333,0.000492
31053,Dodge County,,NE,2593,41862,44455,10,9,19,1333,1547,2880,7,0.298217,0.311223,4521.300504,0.000733,0.000581,24,0.000287,0,20,0.455556,0.005486
31055,Douglas County,,NE,34533,549002,583535,117,123,240,24471,25910,50381,6,0.414117,0.449124,168165.934422,0.040148,0.047714,24,0.002051,0,20,0.315058,0.29679
31057,Dundy County,,NE,152,2296,2448,0,0,0,0,0,0,0,0,0,0,0,0,75,0.00005,66,121,0,0
31059,Fillmore County,,NE,414,7665,8079,2,2,4,134,142,276,7,0.27911,0.289791,0,0.000177,0.000129,24,0.000112,0,20,1,0.001288
31061,Franklin County,,NE,268,3960,4228,0,1,1,0,44,44,7,0.25123,0.258904,0,0,0.000006,24,0.00005,0,122,0,0
31063,Frontier County,,NE,287,2893,3180,0,1,1,0,54,54,8,0.228296,0.234009,0,0,0.000014,24,0.00005,0,123,0,0
31065,Furnas County,,NE,396,5965,6361,1,1,2,42,61,103,7,0.25123,0.258907,0,0.000001,0.000006,24,0.000073,0,20,0.5,0.000097
31067,Gage County,,NE,1567,26516,28083,4,4,8,775,684,1459,7,0.295252,0.307283,62.46791,0.000177,0.000442,24,0.000222,0,20,0.4,0.00148
31069,Garden County,,NE,134,2290,2424,0,0,0,0,0,0,0,0,0,0,0,0,76,0.00005,67,124,0,0
31071,Garfield County,,NE,128,2076,2204,0,0,0,0,0,0,0,0,0,0,0,0,77,0.00005,68,125,0,0
31073,Gosper County,,NE,267,2402,2669,1,1,2,53,73,126,8,0.228253,0.233917,0,0.000004,0.000014,24,0.000083,0,20,0,0.000202
31075,Grant County,,NE,-2,-2,-4,0,0,0,0,0,0,0,0,0,0,0,0,78,0.00005,69,126,0,0
31077,Greeley County,,NE,158,3004,3162,1,0,1,40,0,40,0,0,0,0,0.000013,0,24,0.000073,0,2,0,0.000203
31079,Hall County,,NE,4053,62471,66524,12,14,26,1745,2016,3761,6,0.335563,0.354994,12877.332994,0.001769,0.001659,24,0.000378,0,20,0.3125,0.013165
31081,Hamilton County,,NE,809,11278,12087,4,4,8,357,384,741,7,0.279244,0.290307,178.069301,0.000194,0.000143,24,0.000159,0,20,0.666667,0.001583
31083,Harlan County,,NE,261,3721,3982,0,0,0,0,0,0,0,0,0,0,0,0,79,0.00005,70,127,0,0
31085,Hayes County,,NE,77,1099,1176,0,0,0,0,0,0,0,0,0,0,0,0,80,0.00005,71,128,0,0
31087,Hitchcock County,,NE,273,3411,3684,1,1,2,86,68,154,8,0.218452,0.223699,0,0.000001,0.000001,24,0.000073,0,20,0,0.000097
31089,Holt County,,NE,726,12235,12961,0,3,3,0,187,187,7,0.295383,0.307406,0,0,0.000443,24,0.00005,0,129,1,0
31091,Hooker County,,NE,59,1058,1117,0,0,0,0,0,0,0,0,0,0,0,0,81,0.00005,72,130,0,0
31093,Howard County,,NE,544,7446,7990,1,2,3,221,238,459,7,0.251295,0.259165,0,0.000013,0.000014,24,0.000073,0,20,1,0.000203
31095,Jefferson County,,NE,509,9210,9719,3,2,5,189,191,380,7,0.279083,0.289734,0.5,0.000178,0.000129,24,0.000151,0,20,0.666667,0.001376
31097,Johnson County,,NE,474,4846,5320,2,3,5,125,247,372,7,0.27911,0.289906,0.5,0.000178,0.000133,24,0.000098,0,20,0.666667,0.001301
31099,Kearney County,,NE,774,7541,8315,2,4,6,314,396,710,7,0.279297,0.290393,1,0.000014,0.000138,24,0.000132,0,20,0.75,0.000252
31101,Keith County,,NE,790,9263,10053,2,2,4,132,184,316,7,0.279297,0.290038,2910,0.000005,0.000132,24,0.000127,0,20,0.333333,0.000224
31103,Keya Paha County,,NE,46,1070,1116,0,0,0,0,0,0,0,0,0,0,0,0,82,0.00005,73,131,0,0
31105,Kimball County,,NE,349,4212,4561,1,2,3,58,94,152,7,0.261334,0.270844,0,0.000002,0.000075,8,0.000059,0,118,0.666667,0.000084
31107,Knox County,,NE,490,10130,10620,1,3,4,67,176,243,7,0.25386,0.262271,9.492857,0.000018,0.000005,24,0.000076,0,20,0.333333,0.00014
31109,Lancaster County,,NE,17937,299858,317795,77,73,150,10771,10709,21480,6,0.38702,0.41756,162416.15969,0.016436,0.022408,24,0.001971,0,20,0.20011,0.130688
31111,Lincoln County,,NE,2536,41209,43745,10,8,18,840,896,1736,7,0.299568,0.312775,3365.99307,0.000637,0.000667,24,0.000325,0,20,0.325758,0.005148
31113,Logan County,,NE,71,984,1055,0,0,0,0,0,0,0,0,0,0,0,0,83,0.00005,74,132,0,0
31115,Loup County,,NE,46,722,768,0,0,0,0,0,0,0,0,0,0,0,0,84,0.00005,75,133,0,0
31117,McPherson County,,NE,-2,-2,-4,0,0,0,0,0,0,0,0,0,0,0,0,85,0.00005,76,134,0,0
31119,Madison County,,NE,3413,41333,44746,12,13,25,1252,1672,2924,6,0.338727,0.358625,18572.324682,0.000567,0.002259,24,0.000389,0,20,0.220833,0.004604
31121,Merrick County,,NE,763,8788,9551,3,5,8,260,386,646,7,0.295491,0.307827,498.686774,0.000014,0.000459,24,0.000138,0,20,0.6,0.000394
31123,Morrill County,,NE,488,5514,6002,1,1,2,118,178,296,7,0.252254,0.259963,0,0.000017,0.000004,24,0.000072,0,20,0,0.000138
31125,Nance County,,NE,316,3968,4284,1,2,3,59,108,167,8,0.229967,0.236024,2969,0.000005,0.000005,24,0.000082,0,20,0.5,0.000139
31127,Nemaha County,,NE,485,7817,8302,3,3,6,226,169,395,7,0.279137,0.289963,2969.5,0.000179,0.000132,24,0.000136,0,20,0.5,0.001388
31129,Nuckolls County,,NE,372,5510,5882,0,1,1,0,59,59,8,0.229755,0.235439,0,0,0.000004,24,0.00005,0,135,0,0
31131,Otoe County,,NE,1257,18553,19810,5,6,11,678,719,1397,7,0.297973,0.310421,120.616574,0.000551,0.000571,24,0.000175,0,20,0.533333,0.003942
31133,Pawnee County,,NE,202,2859,3061,0,0,0,0,0,0,0,0,0,0,0,0,86,0.00005,77,136,0,0
31135,Perkins County,,NE,280,3640,3920,0,1,1,0,40,40,8,0.21838,0.223508,0,0,0,24,0.00005,0,137,0,0
31137,Phelps County,,NE,750,11158,11908,3,3,6,171,251,422,7,0.279217,0.290106,38.936632,0.000018,0.000133,24,0.00015,0,20,0.666667,0.000451
31139,Pierce County,,NE,612,8888,9500,2,2,4,200,252,452,7,0.27919,0.289963,128.317019,0.000018,0.000132,24,0.000097,0,20,0.666667,0.000227
31141,Platte County,,NE,2246,37950,40196,11,11,22,1006,1197,2203,7,0.298553,0.312054,17020.535236,0.000597,0.000594,24,0.000415,0,20,0.294872,0.004666
31143,Polk County,,NE,450,6537,6987,2,2,4,114,137,251,8,0.230021,0.236196,2.309524,0.000008,0.000006,24,0.000122,0,20,0,0.000247
31145,Red Willow County,,NE,943,12712,13655,2,5,7,126,303,429,7,0.279485,0.290782,8846,0.000174,0.000138,24,0.000135,0,20,0.35,0.001266
31147,Richardson County,,NE,552,10141,10693,1,2,3,47,122,169,7,0.27911,0.289791,0,0.000001,0.000129,24,0.000089,0,20,1,0.0001
31149,Rock County,,NE,104,1695,1799,0,0,0,0,0,0,0,0,0,0,0,0,87,0.00005,78,138,0,0
31151,Saline County,,NE,1327,15576,16903,4,3,7,470,693,1163,7,0.27911,0.289906,4.580521,0.000182,0.00013,24,0.000201,0,20,0.416667,0.001584
31153,Sarpy County,,NE,18756,163122,181878,47,48,95,14633,12412,27045,6,0.380442,0.408053,20507.215257,0.015932,0.019137,24,0.000863,0,20,0.372404,0.119818
31155,Saunders County,,NE,1825,23714,25539,5,5,10,1032,1126,2158,7,0.297973,0.310307,0.892857,0.000702,0.000574,24,0.000151,0,20,0.9,0.00493
31157,Scotts Bluff County,,NE,2655,39203,41858,10,12,22,763,1004,1767,6,0.337313,0.356701,11132.315709,0.000507,0.002158,24,0.000312,0,20,0.286765,0.004885
31159,Seward County,,NE,1331,18373,19704,3,3,6,596,596,1192,7,0.279137,0.289963,1.666667,0.000178,0.00013,24,0.000169,0,20,0.666667,0.001391
31161,Sheridan County,,NE,511,6313,6824,2,2,4,98,106,204,8,0.220271,0.225984,2981.03028,0.000001,0,24,0.000098,0,20,0.166667,0.00018
31163,Sherman County,,NE,245,3568,3813,0,1,1,0,58,58,7,0.25123,0.258904,0,0,0.000006,24,0.00005,0,139,0,0
31165,Sioux County,,NE,90,1341,1431,0,0,0,0,0,0,0,0,0,0,0,0,88,0.00005,79,140,0,0
31167,Stanton County,,NE,507,7537,8044,1,1,2,201,144,345,7,0.253043,0.26092,0,0.000018,0.000004,24,0.000076,0,20,0,0.00014
31169,Thayer County,,NE,438,6246,6684,1,2,3,42,101,143,7,0.279083,0.289734,0,0.000174,0.000129,24,0.000073,0,20,1,0.001179
31171,Thomas County,,NE,81,755,836,0,0,0,0,0,0,0,0,0,0,0,0,89,0.00005,80,141,0,0
31173,Thurston County,,NE,532,7349,7881,1,3,4,84,240,324,7,0.279888,0.291069,6.597973,0.000003,0.000164,24,0.000075,0,20,0.666667,0.000172
31175,Valley County,,NE,323,4939,5262,0,1,1,0,47,47,7,0.279099,0.289635,0,0,0.000128,24,0.00005,0,142,0,0
31177,Washington County,,NE,1718,22864,24582,6,5,11,1123,1063,2186,7,0.297973,0.310307,22.174241,0.000703,0.000571,24,0.000173,0,20,0.666667,0.005026
31179,Wayne County,,NE,735,9427,10162,3,3,6,214,186,400,7,0.295342,0.30734,180.862015,0.000019,0.000443,24,0.000115,0,20,0.4,0.000315
31181,Webster County,,NE,267,4327,4594,1,1,2,41,77,118,8,0.229713,0.235348,0,0.000005,0.000004,24,0.000091,0,20,0,0.000131
31183,Wheeler County,,NE,61,994,1055,0,0,0,0,0,0,0,0,0,0,0,0,90,0.00005,81,143,0,0
31185,York County,,NE,1158,16046,17204,6,6,12,428,574,1002,7,0.295371,0.307741,1896.470454,0.00019,0.000443,24,0.000277,0,20,0.333333,0.001773
32001,Churchill County,,NV,2919,25454,28373,13,10,23,1451,1097,2548,6,0.335408,0.354147,875.513721,0.006426,0.003789,6,0.0002,0,20,0.595833,0.049923
32003,Clark County,,NV,104515,1790152,1894667,461,404,865,139505,86657,226162,5,0.47095,0.528041,298005.248095,0.1272,0.115269,6,0.005297,0,20,0.128269,0.902433
32005,Douglas County,,NV,5625,51025,56650,20,15,35,3680,3355,7035,6,0.343566,0.36425,2917.199538,0.010054,0.007663,6,0.000257,0,20,0.774892,0.07199
32007,Elko County,,NV,4079,48889,52968,22,17,39,2316,1820,4136,6,0.342756,0.36362,3542.421125,0.006527,0.005777,6,0.000444,0,20,0.512681,0.054875
32009,Esmeralda County,,NV,122,759,881,0,0,0,0,0,0,0,0,0,0,0,0,91,0.00005,82,144,0,0
32011,Eureka County,,NV,119,1395,1514,0,0,0,0,0,0,0,0,0,0,0,0,92,0.00005,83,145,0,0
32013,Humboldt County,,NV,1506,17082,18588,5,4,9,565,453,1018,6,0.320626,0.336758,529.784027,0.000376,0.001321,6,0.000165,0,20,0.566667,0.003539
32015,Lander County,,NV,513,5731,6244,3,2,5,173,134,307,7,0.255308,0.263598,0,0.000338,0.000054,6,0.000118,0,20,1,0.002941
32017,Lincoln County,,NV,346,4039,4385,1,1,2,206,121,327,6,0.320202,0.335727,0,0.000894,0.000987,6,0.000061,0,20,0,0.007348
32019,Lyon County,,NV,5398,47544,52942,27,12,39,7383,3143,10526,6,0.342152,0.362188,847.717255,0.011308,0.004584,6,0.000324,0,20,0.663218,0.080012
32021,Mineral County,,NV,487,4912,5399,2,2,4,105,118,223,7,0.270547,0.283283,0,0.000313,0.000369,6,0.000078,0,20,1,0.002772
32023,Nye County,,NV,4068,38325,42393,13,11,24,4342,1803,6145,6,0.342675,0.362589,445.463828,0.007433,0.005764,6,0.000188,0,20,0.685714,0.05446
32027,Pershing County,,NV,483,4999,5482,1,3,4,69,193,262,7,0.272192,0.284869,0,0.000283,0.000334,6,0.000061,0,20,0.666667,0.002299
32029,Storey County,,NV,444,3745,4189,1,2,3,289,231,520,7,0.270547,0.283283,0,0.000283,0.000369,6,0.000061,0,20,1,0.002299
32031,Washoe County,,NV,28389,422269,450658,111,108,219,23067,20538,43605,6,0.370795,0.407572,31068.071234,0.036227,0.0365,6,0.001362,0,20,0.377863,0.280406
32033,White Pine County,,NV,737,8976,9713,3,3,6,349,231,580,6,0.320591,0.336586,0,0.000984,0.001319,6,0.000098,0,20,1,0.008375
32510,Carson City,,NV,6827,58095,64922,16,13,29,3801,4403,8204,6,0.343484,0.363906,14.681625,0.008473,0.005675,6,0.000207,0,20,0.813725,0.062581
33001,Belknap County,,NH,5506,71307,76813,15,12,27,4115,3614,7729,6,0.311563,0.328534,35.653768,0.004249,0.003122,44,0.000156,0,20,0.833333,0.024116
33003,Carroll County,,NH,3491,54406,57897,18,13,31,2865,1917,4782,6,0.302589,0.318872,54.130813,0.005167,0.002547,44,0.000181,0,20,0.777778,0.028713
33005,Cheshire County,,NH,5640,86546,92186,19,20,39,3257,2932,6189,6,0.337118,0.357709,186.201486,0.006123,0.005936,44,0.000188,0,20,0.667984,0.034994
33007,Coos County,,NH,2139,39051,41190,7,11,18,770,1095,1865,7,0.280509,0.294757,4914.869651,0.001399,0.001006,44,0.000133,0,20,0.685897,0.009363
33009,Grafton County,,NH,7999,93076,101075,30,25,55,5098,4602,9700,6,0.342474,0.364822,3144.542431,0.008842,0.007604,44,0.000304,0,20,0.571023,0.052426
33011,Hillsborough County,,NH,30238,468041,498279,77,96,173,23012,23217,46229,6,0.38099,0.415269,8188.442808,0.036579,0.048582,44,0.000672,0,20,0.530442,0.248225
33013,Merrimack County,,NH,11951,165670,177621,26,27,53,9685,8327,18012,6,0.349718,0.3726,1094.67555,0.008142,0.011755,44,0.000257,0,20,0.649733,0.050413
33015,Rockingham County,,NH,24600,351607,376207,44,61,105,20817,19279,40096,6,0.363659,0.391781,2726.320782,0.020297,0.028146,44,0.000399,0,20,0.577114,0.134904
33017,Strafford County,,NH,9753,131307,141060,21,23,44,7668,6404,14072,6,0.340311,0.361667,337.665195,0.004847,0.007889,44,0.000226,0,20,0.597884,0.028353
33019,Sullivan County,,NH,3281,48060,51341,10,9,19,2200,1701,3901,7,0.276879,0.290221,75.338241,0.001985,0.000731,44,0.000143,0,20,0.690909,0.012202
34001,Atlantic County,,NJ,15000,326018,341018,40,59,99,10402,10658,21060,6,0.363432,0.392199,457.781026,0.022027,0.031986,17,0.000279,0,20,0.752163,0.127757
34003,Bergen County,,NJ,60569,1020008,1080577,93,153,246,45244,54216,99460,6,0.392236,0.433998,2346.198164,0.051592,0.071907,17,0.000695,0,20,0.506483,0.330292
34005,Burlington County,,NJ,33831,526947,560778,86,123,209,26539,26116,52655,6,0.392236,0.430149,4429.889026,0.044527,0.060141,17,0.000686,0,20,0.5307,0.287946
34007,Camden County,,NJ,33279,584106,617385,62,87,149,26707,27996,54703,6,0.377432,0.410344,997.35112,0.03457,0.046439,17,0.000459,0,20,0.691328,0.220069
34009,Cape May County,,NJ,7157,112402,119559,18,25,43,4129,4490,8619,6,0.324632,0.345647,38.254092,0.007113,0.011151,17,0.000148,0,20,0.825397,0.037467
34011,Cumberland County,,NJ,6778,162507,169285,15,13,28,4845,3863,8708,6,0.312701,0.329765,11.755217,0.006798,0.0045,17,0.000132,0,20,0.850877,0.038607
34013,Essex County,,NJ,57788,814012,871800,80,129,209,37331,51527,88858,5,0.391972,0.430258,1161.761051,0.044644,0.06343,17,0.000562,0,20,0.589833,0.277096
34015,Gloucester County,,NJ,16561,325974,342535,28,40,68,18144,12624,30768,6,0.358154,0.384021,239.960843,0.012793,0.020835,17,0.000204,0,20,0.756707,0.071121
34017,Hudson County,,NJ,64216,637671,701887,106,132,238,43490,58077,101567,5,0.399013,0.43756,2803.595977,0.056846,0.064916,17,0.000809,0,20,0.556991,0.364395
34019,Hunterdon County,,NJ,9235,148461,157696,26,26,52,7069,5572,12641,6,0.344583,0.366753,3.132382,0.012241,0.011833,17,0.000166,0,20,0.892992,0.062216
34021,Mercer County,,NJ,25738,392532,418270,63,87,150,18076,20500,38576,6,0.378956,0.412383,651.342336,0.035265,0.046993,17,0.000466,0,20,0.695264,0.223524
34023,Middlesex County,,NJ,81058,898489,979547,114,187,301,54976,73240,128216,5,0.417623,0.459966,7073.423849,0.060842,0.084678,17,0.000891,0,20,0.433651,0.39557
34025,Monmouth County,,NJ,38768,720059,758827,65,137,202,28194,32658,60852,6,0.386762,0.426466,813.799215,0.036274,0.065012,17,0.000463,0,20,0.538267,0.231222
34027,Morris County,,NJ,36628,568355,604983,81,130,211,28433,30570,59003,5,0.393616,0.432045,1659.633623,0.044841,0.063043,17,0.000589,0,20,0.536867,0.284626
34029,Ocean County,,NJ,28838,636973,665811,60,114,174,28841,22558,51399,6,0.377628,0.414078,965.19799,0.030624,0.050202,17,0.000439,0,20,0.507628,0.19498
34031,Passaic County,,NJ,36251,563634,599885,50,98,148,22911,30976,53887,6,0.3794,0.414078,411.623294,0.028013,0.04839,17,0.000336,0,20,0.628218,0.168306
34033,Salem County,,NJ,3918,76955,80873,10,9,19,3295,2414,5709,6,0.293258,0.308488,0.265225,0.003196,0.002375,17,0.000109,0,20,0.955556,0.018566
34035,Somerset County,,NJ,29106,362889,391995,59,96,155,25005,24100,49105,6,0.375629,0.40984,483.469722,0.033784,0.050598,17,0.000404,0,20,0.668315,0.206755
34037,Sussex County,,NJ,10686,177274,187960,22,32,54,8281,6664,14945,6,0.347173,0.370372,11.299369,0.010501,0.0138,17,0.000149,0,20,0.792042,0.053959
34039,Union County,,NJ,44934,595081,640015,59,107,166,32382,39359,71741,6,0.382291,0.418173,618.82811,0.033234,0.053645,17,0.000428,0,20,0.632918,0.2102
34041,Warren County,,NJ,9196,127184,136380,21,24,45,7323,6110,13433,6,0.342272,0.363786,4.052511,0.008724,0.009201,17,0.000146,0,20,0.896011,0.044405
35001,Bernalillo County,,NM,40959,640853,681812,173,144,317,35703,31420,67123,5,0.411598,0.449519,67689.564186,0.067104,0.05696,6,0.002126,0,20,0.344337,0.48905
35003,Catron County,,NM,268,2828,3096,0,0,0,0,0,0,0,0,0,0,0,0,93,0.00005,84,146,0,0
35005,Chaves County,,NM,3820,58572,62392,14,20,34,1507,2041,3548,6,0.343322,0.365269,1393.599145,0.005189,0.006962,6,0.000221,0,20,0.606884,0.040348
35006,Cibola County,,NM,1859,23089,24948,4,7,11,869,1184,2053,6,0.332914,0.350928,0.535714,0.000586,0.002027,6,0.00011,0,20,0.928571,0.005508
35007,Colfax County,,NM,1116,13924,15040,1,5,6,75,278,353,6,0.3125,0.325974,2.7501,0.000442,0.001349,8,0.000063,0,20,0.6,0.003884
35009,Curry County,,NM,5876,46222,52098,16,24,40,1621,2168,3789,6,0.348837,0.372646,7744.159687,0.005984,0.009478,6,0.000267,0,20,0.544615,0.049034
35011,De Baca County,,NM,190,2046,2236,0,0,0,0,0,0,0,0,0,0,0,0,94,0.00005,85,147,0,0
35013,Dona Ana County,,NM,12397,188906,201303,43,46,89,9104,8182,17286,6,0.36212,0.38957,7188.458163,0.018352,0.019975,6,0.000613,0,20,0.477141,0.144762
35015,Eddy County,,NM,2953,51821,54774,10,10,20,1127,1223,2350,6,0.335447,0.354301,53.444222,0.002475,0.002539,6,0.000189,0,20,0.781818,0.020961
35017,Grant County,,NM,2115,29346,31461,9,7,16,769,913,1682,6,0.334214,0.352268,110.311093,0.003453,0.002916,6,0.000169,0,20,0.618182,0.029147
35019,Guadalupe County,,NM,339,4344,4683,2,1,3,110,97,207,6,0.291612,0.303688,0,0.000448,0.000521,6,0.000082,0,20,1,0.00401
35021,Harding County,,NM,57,699,756,0,0,0,0,0,0,0,0,0,0,0,0,95,0.00005,86,148,0,0
35023,Hidalgo County,,NM,448,4905,5353,1,4,5,60,197,257,6,0.300093,0.313219,0,0.000155,0.001063,6,0.000062,0,20,0.833333,0.001209
35025,Lea County,,NM,3177,57828,61005,14,14,28,1243,1399,2642,6,0.341509,0.361821,1371.029184,0.003162,0.003512,6,0.000269,0,20,0.48366,0.027318
35027,Lincoln County,,NM,1855,19256,21111,7,7,14,795,634,1429,6,0.334252,0.352325,2.335251,0.001201,0.002299,6,0.000142,0,20,0.833333,0.010185
35028,Los Alamos County,,NM,2091,22495,24586,6,5,11,674,695,1369,6,0.291759,0.304433,4.682691,0.001162,0.000961,6,0.000141,0,20,0.7,0.010423
35029,Luna County,,NM,1797,24973,26770,6,5,11,686,655,1341,6,0.334099,0.351867,1.460581,0.003092,0.002189,6,0.000126,0,20,0.9,0.02452
35031,McKinley County,,NM,8244,84742,92986,10,13,23,5660,6935,12595,6,0.340072,0.360195,114.592236,0.002974,0.00527,6,0.000187,0,20,0.736264,0.024598
35033,Mora County,,NM,303,4820,5123,2,2,4,143,130,273,6,0.291642,0.30386,0,0.000448,0.000525,6,0.000082,0,20,1,0.00401
35035,Otero County,,NM,7145,59188,66333,19,18,37,2127,2587,4714,6,0.34997,0.372915,210.308692,0.009335,0.009643,6,0.00025,0,20,0.74,0.070129
35037,Quay County,,NM,727,8739,9466,2,3,5,114,186,300,6,0.292022,0.304519,60.642213,0.000516,0.000568,6,0.000072,0,20,0.833333,0.004356
35039,Rio Arriba County,,NM,2218,40462,42680,6,6,12,1320,1470,2790,6,0.291905,0.304777,3.401429,0.000735,0.000924,6,0.000154,0,20,0.733333,0.007404
35041,Roosevelt County,,NM,1867,17043,18910,3,4,7,492,582,1074,6,0.332914,0.350556,68.152754,0.000132,0.001661,6,0.00009,0,20,0.733333,0.000995
35043,Sandoval County,,NM,10096,112690,122786,35,19,54,11961,6817,18778,6,0.348503,0.371627,1688.54999,0.016045,0.009302,6,0.000469,0,20,0.576102,0.12368
35045,San Juan County,,NM,11905,138309,150214,35,30,65,7631,8532,16163,6,0.348211,0.372572,1817.547965,0.011538,0.010163,6,0.000573,0,20,0.455128,0.092694
35047,San Miguel County,,NM,1827,26395,28222,3,5,8,588,980,1568,6,0.291729,0.304376,2.5,0.000562,0.00082,6,0.000111,0,20,0.5,0.005304
35049,Santa Fe County,,NM,10466,137959,148425,40,32,72,5941,6567,12508,6,0.352258,0.376942,3615.374554,0.021594,0.014974,6,0.000503,0,20,0.656799,0.15932
35051,Sierra County,,NM,915,10255,11170,2,2,4,169,278,447,6,0.291671,0.303918,0,0.000597,0.000663,6,0.000074,0,20,1,0.005093
35053,Socorro County,,NM,1352,16387,17739,2,3,5,332,554,886,6,0.2917,0.304089,0,0.000466,0.000721,6,0.000082,0,20,1,0.004406
35055,Taos County,,NM,2005,31405,33410,5,6,11,521,733,1254,6,0.33341,0.351501,101.621142,0.001616,0.002385,6,0.000116,0,20,0.607143,0.0129
35057,Torrance County,,NM,1392,13447,14839,3,4,7,761,801,1562,6,0.2917,0.304204,0,0.000582,0.00087,6,0.000095,0,20,1,0.00571
35059,Union County,,NM,315,4144,4459,0,0,0,0,0,0,0,0,0,0,0,0,96,0.00005,87,149,0,0
35061,Valencia County,,NM,5028,68668,73696,16,11,27,3666,3243,6909,6,0.334444,0.353562,898.686566,0.007417,0.003123,6,0.000247,0,20,0.588235,0.056235
36001,Albany County,,NY,22586,332931,355517,60,80,140,16786,17910,34696,6,0.372313,0.404055,18967.342189,0.024487,0.037647,97,0.00053,0,20,0.518769,0.149102
36003,Allegany County,,NY,2791,48761,51552,8,9,17,1317,1405,2722,6,0.294922,0.309616,1947.469159,0.001294,0.000913,97,0.000174,0,20,0.486111,0.006717
36005,Bronx County,,NY,95890,1270241,1366131,111,173,284,60802,88243,149045,5,0.406879,0.449868,5168.269389,0.058125,0.072939,17,0.000853,0,20,0.426841,0.374173
36007,Broome County,,NY,10111,219320,229431,37,51,88,5254,5553,10807,6,0.356968,0.383843,9271.924752,0.013075,0.02217,97,0.00039,0,20,0.497078,0.082153
36009,Cattaraugus County,,NY,4821,89082,93903,7,7,14,2421,2623,5044,6,0.294803,0.309158,20.966037,0.001331,0.000899,97,0.000136,0,20,0.619048,0.006585
36011,Cayuga County,,NY,3975,86802,90777,8,10,18,2108,2275,4383,6,0.296576,0.311375,22.626292,0.001231,0.001279,97,0.000131,0,20,0.622222,0.006411
36013,Chautauqua County,,NY,5817,145804,151621,7,14,21,1999,2470,4469,6,0.344297,0.364674,237.967648,0.002152,0.006982,97,0.000115,0,20,0.648352,0.01155
36015,Chemung County,,NY,4491,97114,101605,9,11,20,1874,1992,3866,6,0.29703,0.312234,240.630669,0.001354,0.001344,97,0.000157,0,20,0.490909,0.006957
36017,Chenango County,,NY,2952,58298,61250,9,7,16,1669,1454,3123,6,0.281977,0.295229,18.521592,0.002167,0.000558,97,0.000135,0,20,0.583333,0.010113
36019,Clinton County,,NY,3488,89895,93383,11,10,21,1218,1234,2452,6,0.283875,0.298614,1901.140571,0.002284,0.000927,97,0.000179,0,20,0.512821,0.013094
36021,Columbia County,,NY,3801,69953,73754,15,11,26,2180,2011,4191,6,0.307124,0.323711,3.248503,0.005414,0.003348,17,0.00014,0,20,0.8,0.029903
36023,Cortland County,,NY,2866,50163,53029,7,7,14,1401,1310,2711,6,0.281977,0.2952,14.640304,0.000771,0.000516,97,0.000121,0,20,0.571429,0.003927
36025,Delaware County,,NY,2907,47906,50813,16,7,23,1667,1457,3124,6,0.303315,0.318001,69.700269,0.005309,0.00111,97,0.000175,0,20,0.616667,0.028793
36027,Dutchess County,,NY,18068,322441,340509,37,79,116,12471,12748,25219,6,0.366499,0.398144,1830.80651,0.020514,0.037964,17,0.000272,0,20,0.568353,0.122933
36029,Erie County,,NY,35192,1045709,1080901,104,164,268,17310,27011,44321,5,0.407906,0.449404,28976.897452,0.05146,0.075519,97,0.000956,0,20,0.431765,0.349527
36031,Essex County,,NY,2424,41511,43935,9,8,17,1267,1107,2374,7,0.275099,0.288033,235.416738,0.000727,0.000447,97,0.000173,0,20,0.5,0.004415
36033,Franklin County,,NY,2210,49890,52100,3,5,8,794,1034,1828,7,0.26739,0.278783,0,0.000031,0.000247,97,0.000093,0,20,0.9,0.000535
36035,Fulton County,,NY,2918,62412,65330,6,6,12,1684,1510,3194,7,0.274917,0.287403,2971.603192,0.000709,0.000468,97,0.000108,0,20,0.571429,0.003776
36037,Genesee County,,NY,3443,70261,73704,6,6,12,1802,1978,3780,6,0.294624,0.308729,1.85,0.001278,0.000884,97,0.000122,0,20,0.766667,0.006402
36039,Greene County,,NY,2815,50573,53388,16,11,27,2261,1579,3840,6,0.307384,0.32425,50.698828,0.006471,0.002608,17,0.000147,0,20,0.754902,0.033652
36041,Hamilton County,,NY,402,5772,6174,1,0,1,51,0,51,0,0,0,0,0.000004,0,97,0.000066,0,5,0,0.000122
36043,Herkimer County,,NY,3685,71300,74985,7,8,15,1739,2027,3766,6,0.2917,0.306352,36.314772,0.000911,0.001051,97,0.000123,0,20,0.589286,0.004599
36045,Jefferson County,,NY,15744,118502,134246,47,69,116,5445,7189,12634,6,0.379005,0.410584,9554.543217,0.019172,0.030748,97,0.000529,0,20,0.499279,0.138577
36047,Kings County,,NY,158507,2315130,2473637,207,246,453,99236,149414,248650,5,0.429077,0.477446,33554.130998,0.09191,0.095886,17,0.001822,0,20,0.319925,0.622889
36049,Lewis County,,NY,1347,27690,29037,3,3,6,639,576,1215,7,0.276222,0.28801,0,0.000398,0.000266,97,0.000073,0,20,1,0.002035
36051,Livingston County,,NY,4087,69595,73682,8,8,16,2490,2532,5022,6,0.294833,0.30933,10.249606,0.001239,0.000901,97,0.000155,0,20,0.642857,0.00665
36053,Madison County,,NY,4526,74170,78696,8,9,17,2837,2686,5523,6,0.304393,0.319954,56.766151,0.000873,0.001658,97,0.000133,0,20,0.527273,0.004514
36055,Monroe County,,NY,33121,845912,879033,115,164,279,19115,25580,44695,5,0.407164,0.448688,42331.374545,0.053873,0.075099,97,0.001061,0,20,0.440436,0.360532
36057,Montgomery County,,NY,3308,57473,60781,12,8,20,2238,2055,4293,7,0.275021,0.287861,208.55758,0.003541,0.000574,97,0.000158,0,20,0.568182,0.021518
36059,Nassau County,,NY,81763,1565375,1647138,89,200,289,56356,74820,131176,6,0.407107,0.453316,5203.939367,0.050918,0.084959,17,0.000702,0,20,0.399577,0.33455
36061,New York County,,NY,162607,1497194,1659801,255,227,482,135996,149056,285052,5,0.433875,0.478952,58834.239631,0.100977,0.091357,17,0.002382,0,20,0.305576,0.686512
36063,Niagara County,,NY,10136,250747,260883,13,22,35,6083,6082,12165,6,0.350054,0.372411,1755.40895,0.004827,0.011402,97,0.000199,0,20,0.543478,0.033986
36065,Oneida County,,NY,10205,258429,268634,29,37,66,4920,5648,10568,6,0.356399,0.381415,3885.382522,0.0121,0.017895,97,0.000288,0,20,0.606312,0.073353
36067,Onondaga County,,NY,23396,519214,542610,75,115,190,13303,16700,30003,5,0.391603,0.42791,23229.721895,0.035206,0.055866,97,0.000678,0,20,0.529522,0.231293
36069,Ontario County,,NY,7186,120932,128118,12,11,23,4483,4231,8714,6,0.333716,0.352669,937.844676,0.002818,0.002267,97,0.000185,0,20,0.538462,0.017787
36071,Orange County,,NY,25368,402253,427621,53,115,168,19180,18555,37735,6,0.380641,0.417486,1841.328787,0.028993,0.051406,17,0.000385,0,20,0.47479,0.179402
36073,Orleans County,,NY,2517,46729,49246,4,4,8,1484,1482,2966,6,0.294564,0.308385,0,0.001264,0.000865,97,0.000086,0,20,1,0.006119
36075,Oswego County,,NY,6807,135354,142161,12,15,27,3880,3963,7843,6,0.337548,0.357514,200.074881,0.003048,0.004621,97,0.000156,0,20,0.57619,0.019031
36077,Otsego County,,NY,3949,66101,70050,15,15,30,1739,1852,3591,6,0.307319,0.324708,221.094508,0.004625,0.003245,97,0.000198,0,20,0.602339,0.02627
36079,Putnam County,,NY,7893,112160,120053,13,19,32,5731,5461,11192,6,0.322152,0.341919,0.430678,0.007053,0.008579,17,0.000107,0,20,0.885965,0.03645
36081,Queens County,,NY,157604,2253812,2411416,174,232,406,100259,148745,249004,5,0.423273,0.470773,19754.089505,0.081381,0.092879,17,0.001449,0,20,0.338911,0.546027
36083,Rensselaer County,,NY,11468,176139,187607,27,28,55,8525,8034,16559,6,0.349802,0.372944,2563.647909,0.009513,0.011515,97,0.000258,0,20,0.582353,0.051487
36085,Richmond County,,NY,25585,494773,520358,33,82,115,19661,21592,41253,6,0.372504,0.40457,201.324833,0.018774,0.039064,17,0.000225,0,20,0.645582,0.108409
36087,Rockland County,,NY,17282,333416,350698,34,69,103,9569,13404,22973,6,0.365073,0.39555,185.592603,0.019562,0.035657,17,0.000227,0,20,0.725466,0.112486
36089,St. Lawrence County,,NY,4731,112378,117109,13,15,28,1597,1678,3275,6,0.31378,0.331838,1546.324493,0.003016,0.002651,97,0.000169,0,20,0.477941,0.013838
36091,Saratoga County,,NY,16931,249720,266651,56,61,117,12730,11993,24723,6,0.364388,0.393889,14881.222908,0.022569,0.026906,97,0.000522,0,20,0.45807,0.140656
36093,Schenectady County,,NY,10071,173335,183406,25,28,53,7922,6656,14578,6,0.348294,0.371695,2018.762288,0.00877,0.013721,97,0.000244,0,20,0.63798,0.045667
36095,Schoharie County,,NY,1711,31626,33337,10,7,17,941,889,1830,7,0.274969,0.287632,5.901846,0.002332,0.000588,97,0.000141,0,20,0.611111,0.011111
36097,Schuyler County,,NY,1364,20705,22069,5,5,10,811,736,1547,7,0.264931,0.275043,2.394056,0.000172,0.000156,97,0.00012,0,20,0.7,0.001411
36099,Seneca County,,NY,2261,37353,39614,9,9,18,1228,1270,2498,6,0.291437,0.305979,115.696902,0.001785,0.000866,97,0.00015,0,20,0.688889,0.009018
36101,Steuben County,,NY,5478,109063,114541,16,13,29,2536,2638,5174,6,0.302904,0.319719,453.22569,0.0027,0.002096,97,0.000243,0,20,0.400735,0.013869
36103,Suffolk County,,NY,75667,1758610,1834277,124,241,365,49036,66788,115824,5,0.409975,0.46043,13806.95948,0.06268,0.091782,17,0.00107,0,20,0.312993,0.428239
36105,Sullivan County,,NY,5056,79722,84778,16,21,37,3824,2697,6521,6,0.343079,0.364444,136.21696,0.007217,0.009382,17,0.000147,0,20,0.771667,0.037385
36107,Tioga County,,NY,3577,60106,63683,5,7,12,1918,2131,4049,6,0.28225,0.295659,15.421869,0.000325,0.000516,97,0.000104,0,20,0.595238,0.001894
36109,Tompkins County,,NY,8280,89321,97601,28,37,65,3138,4220,7358,6,0.358861,0.38394,10207.013973,0.013604,0.017344,97,0.000295,0,20,0.622561,0.087891
36111,Ulster County,,NY,10610,195670,206280,27,39,66,7485,6328,13813,6,0.353413,0.37811,472.968516,0.012678,0.019159,17,0.000219,0,20,0.67759,0.071303
36113,Warren County,,NY,5111,75505,80616,14,7,21,3579,3113,6692,7,0.274969,0.287632,53.646523,0.003295,0.000537,97,0.000187,0,20,0.5,0.015832
36115,Washington County,,NY,4049,67212,71261,8,7,15,2959,2675,5634,7,0.275021,0.287747,12.548556,0.000909,0.000493,97,0.000145,0,20,0.553571,0.004632
36117,Wayne County,,NY,6137,111460,117597,9,11,20,3789,3889,7678,6,0.308197,0.324381,68.947324,0.001336,0.002012,97,0.000153,0,20,0.575758,0.006958
36119,Westchester County,,NY,57939,1014021,1071960,97,176,273,40264,51783,92047,5,0.401213,0.444874,4912.879588,0.052741,0.076477,17,0.000741,0,20,0.440368,0.34022
36121,Wyoming County,,NY,2485,46227,48712,7,6,13,1685,1526,3211,6,0.294713,0.308872,2.606332,0.001285,0.000857,97,0.000135,0,20,0.809524,0.006554
36123,Yates County,,NY,1585,28028,29613,7,6,13,804,876,1680,6,0.289581,0.303545,55.382038,0.000651,0.000486,97,0.000144,0,20,0.666667,0.003875
37001,Alamance County,,NC,7643,150588,158231,20,19,39,5427,4592,10019,6,0.313442,0.331082,213.76191,0.00566,0.005165,99,0.000369,0,20,0.584416,0.051126
37003,Alexander County,,NC,2162,38863,41025,7,6,13,1548,1344,2892,6,0.301055,0.315447,1.457443,0.000849,0.001141,99,0.000178,0,20,0.857143,0.009329
37005,Alleghany County,,NC,578,11151,11729,2,4,6,98,226,324,7,0.235076,0.242716,291.129563,0.000022,0.000022,99,0.000107,0,20,0.5,0.000293
37007,Anson County,,NC,1346,25752,27098,5,5,10,591,811,1402,6,0.300806,0.31496,1.374242,0.00079,0.001165,99,0.000136,0,20,0.75,0.008804
37009,Ashe County,,NC,1187,26358,27545,4,4,8,422,437,859,7,0.235799,0.243621,1684.59369,0.000046,0.000038,99,0.000178,0,20,0.333333,0.000749
37011,Avery County,,NC,1107,16229,17336,4,5,9,284,455,739,6,0.301586,0.315916,240.284311,0.000054,0.000867,99,0.00014,0,20,0.25,0.000743
37013,Beaufort County,,NC,2648,48828,51476,8,6,14,1111,1316,2427,6,0.301492,0.316231,1592.290277,0.001105,0.001614,99,0.000216,0,20,0.458333,0.010738
37015,Bertie County,,NC,1283,21402,22685,5,6,11,475,688,1163,6,0.300155,0.314748,224.962358,0.000101,0.000956,99,0.000174,0,20,0.433333,0.001466
37017,Bladen County,,NC,1779,31719,33498,6,8,14,837,1061,1898,6,0.311763,0.327354,1.201103,0.000882,0.002775,99,0.000161,0,20,0.857143,0.00861
37019,Brunswick County,,NC,6004,87268,93272,48,16,64,7238,2906,10144,6,0.314935,0.332428,440.153986,0.01852,0.005088,99,0.000628,0,20,0.460408,0.129604
37021,Buncombe County,,NC,14696,232789,247485,82,57,139,10667,8648,19315,6,0.365211,0.393121,45437.431182,0.032994,0.022565,99,0.001478,0,20,0.430158,0.26059
37023,Burke County,,NC,4890,95208,100098,11,13,24,2798,3006,5804,6,0.306962,0.323265,878.850313,0.001053,0.002686,99,0.000264,0,20,0.557143,0.011871
37025,Cabarrus County,,NC,11796,166781,178577,56,18,74,11914,7505,19419,6,0.30895,0.326346,527.118778,0.028954,0.005139,99,0.000668,0,20,0.62595,0.205414
37027,Caldwell County,,NC,4206,88971,93177,8,13,21,2301,2478,4779,6,0.306994,0.323293,19.121331,0.000861,0.003208,99,0.00021,0,20,0.708791,0.009663
37029,Camden County,,NC,1034,9714,10748,5,4,9,724,511,1235,7,0.27562,0.287048,306.190751,0.000927,0.000272,164,0.00016,0,20,0.8,0.00647
37031,Carteret County,,NC,4873,66839,71712,19,12,31,2707,2110,4817,6,0.33794,0.357864,195.722711,0.004751,0.006024,99,0.000309,0,20,0.590909,0.039057
37033,Caswell County,,NC,1486,24092,25578,9,8,17,1166,1079,2245,6,0.288719,0.302228,646.674801,0.001641,0.001208,99,0.000189,0,20,0.625,0.015273
37035,Catawba County,,NC,10152,168856,179008,30,26,56,6633,6478,13111,6,0.311297,0.330533,707.964366,0.01071,0.006394,99,0.00051,0,20,0.477952,0.086984
37037,Chatham County,,NC,4496,58904,63400,14,11,25,3662,2786,6448,6,0.306703,0.322417,23.129399,0.004871,0.003315,99,0.000248,0,20,0.766667,0.041407
37039,Cherokee County,,NC,1397,24863,26260,10,4,14,693,326,1019,8,0.211806,0.217824,4502.885321,0.004517,0.000104,17,0.000374,0,20,0.490909,0.035719
37041,Chowan County,,NC,918,15445,16363,6,5,11,430,366,796,7,0.247155,0.257275,869.747574,0.000925,0.000155,164,0.000197,0,20,0.404762,0.006504
37043,Clay County,,NC,713,9329,10042,3,3,6,309,311,620,9,0.174827,0.17846,128.907876,0.000002,0.000076,17,0.000335,0,20,0.666667,0.000857
37045,Cleveland County,,NC,5252,104257,109509,11,14,25,3047,3346,6393,6,0.306994,0.323603,63.782722,0.001232,0.003993,99,0.000261,0,20,0.6625,0.014336
37047,Columbus County,,NC,2207,53602,55809,7,9,16,1109,1288,2397,6,0.312332,0.328299,14.41674,0.001725,0.003729,99,0.000182,0,20,0.888889,0.017374
37049,Craven County,,NC,11857,103483,115340,41,41,82,5473,5402,10875,6,0.36316,0.390006,4939.01239,0.018094,0.020705,99,0.000517,0,20,0.569303,0.133031
37051,Cumberland County,,NC,45647,310879,356526,196,190,386,26298,31486,57784,6,0.421251,0.464828,42164.484343,0.076949,0.074851,99,0.002156,0,20,0.304628,0.549232
37053,Currituck County,,NC,2157,22713,24870,7,7,14,1593,1117,2710,6,0.30823,0.324026,69.217086,0.001422,0.00207,164,0.000167,0,20,0.714286,0.009748
37055,Dare County,,NC,3405,34770,38175,12,8,20,1001,994,1995,6,0.308393,0.324427,3021.322473,0.003743,0.00194,164,0.000218,0,20,0.521978,0.02999
37057,Davidson County,,NC,9301,175876,185177,20,19,39,6811,6467,13278,6,0.30693,0.324061,376.371556,0.004162,0.00409,99,0.000413,0,20,0.494071,0.039757
37059,Davie County,,NC,2538,42631,45169,9,8,17,1951,1546,3497,6,0.306026,0.32134,50.384958,0.002122,0.002796,99,0.000213,0,20,0.847222,0.02108
37061,Duplin County,,NC,2608,49834,52442,9,11,20,1647,1731,3378,6,0.311463,0.327543,8.016037,0.002193,0.00337,99,0.00019,0,20,0.75,0.018223
37063,Durham County,,NC,24246,242732,266978,110,90,200,18057,18268,36325,5,0.392501,0.425876,12241.642757,0.053052,0.044193,99,0.0012,0,20,0.503562,0.371339
37065,Edgecombe County,,NC,4725,58392,63117,9,8,17,3153,3728,6881,6,0.305897,0.321947,24.626685,0.001898,0.002086,99,0.000195,0,20,0.680556,0.015946
37067,Forsyth County,,NC,21352,353177,374529,101,70,171,16932,15210,32142,6,0.381589,0.412635,19226.388894,0.044543,0.033628,99,0.00131,0,20,0.458966,0.326028
37069,Franklin County,,NC,4102,52640,56742,8,8,16,3036,2757,5793,6,0.305833,0.321082,19.060637,0.00117,0.002361,99,0.000171,0,20,0.655556,0.011028
37071,Gaston County,,NC,11098,211384,222482,30,26,56,8554,7671,16225,6,0.32176,0.342148,441.361868,0.009824,0.008697,99,0.00056,0,20,0.545238,0.085962
37073,Gates County,,NC,694,11207,11901,7,3,10,675,210,885,7,0.253727,0.262767,9.7547,0.001466,0.000118,164,0.00015,0,20,0.690476,0.010058
37075,Graham County,,NC,380,8332,8712,0,0,0,0,0,0,0,0,0,0,0,0,98,0.00005,88,150,0,0
37077,Granville County,,NC,3324,52815,56139,9,9,18,2733,2056,4789,6,0.301336,0.31626,23.905788,0.001283,0.00213,99,0.000196,0,20,0.522222,0.012215
37079,Greene County,,NC,1361,18002,19363,4,4,8,849,919,1768,7,0.264931,0.275129,0.394295,0.000232,0.000204,99,0.000103,0,20,0.833333,0.001968
37081,Guilford County,,NC,30227,478290,508517,179,111,290,26439,22676,49115,5,0.392978,0.428643,60473.665346,0.068426,0.048279,99,0.0022,0,20,0.334642,0.478579
37083,Halifax County,,NC,3018,57901,60919,10,7,17,1290,1679,2969,6,0.301398,0.316145,2360.241577,0.002587,0.001518,99,0.0002,0,20,0.472727,0.018619
37085,Harnett County,,NC,9770,95652,105422,23,22,45,6966,6020,12986,6,0.335099,0.355607,426.076622,0.008663,0.00835,99,0.000359,0,20,0.535385,0.070744
37087,Haywood County,,NC,3088,60081,63169,12,5,17,1527,1056,2583,6,0.301429,0.315796,347.412296,0.005494,0.001192,99,0.000251,0,20,0.587912,0.044937
37089,Henderson County,,NC,6749,104473,111222,30,13,43,4466,3197,7663,6,0.308524,0.325132,1025.593177,0.012508,0.003924,99,0.000512,0,20,0.547379,0.106762
37091,Hertford County,,NC,1350,21827,23177,5,6,11,589,653,1242,6,0.300124,0.314691,838.908449,0.000724,0.000969,99,0.000165,0,20,0.452381,0.00557
37093,Hoke County,,NC,5418,36160,41578,10,11,21,3906,2898,6804,6,0.325977,0.343288,125.670243,0.003714,0.003652,99,0.000177,0,20,0.647436,0.030682
37095,Hyde County,,NC,392,4866,5258,0,2,2,0,122,122,7,0.246904,0.256282,0,0,0.000122,99,0.00005,0,151,1,0
37097,Iredell County,,NC,9678,157452,167130,59,28,87,8490,5673,14163,6,0.323549,0.343889,8308.775422,0.025887,0.007749,99,0.00081,0,20,0.481647,0.189372
37099,Jackson County,,NC,2433,30075,32508,7,6,13,1004,1041,2045,6,0.301492,0.316025,3252.683867,0.000907,0.00118,99,0.000324,0,20,0.482143,0.010033
37101,Johnston County,,NC,10309,151577,161886,40,25,65,9305,7098,16403,6,0.315824,0.334948,720.662573,0.01739,0.005651,99,0.000505,0,20,0.488889,0.124067
37103,Jones County,,NC,830,9855,10685,3,4,7,442,510,952,7,0.293288,0.306882,0,0.000745,0.000666,99,0.000079,0,20,0.916667,0.004626
37105,Lee County,,NC,3989,56253,60242,10,8,18,2399,2219,4618,6,0.309048,0.324221,12.356014,0.003466,0.002441,99,0.000191,0,20,0.818182,0.029818
37107,Lenoir County,,NC,3547,63365,66912,9,14,23,1653,2245,3898,6,0.314051,0.331019,399.958549,0.001628,0.004349,99,0.000182,0,20,0.7,0.013347
37109,Lincoln County,,NC,5219,76602,81821,13,14,27,4378,3563,7941,6,0.307806,0.324267,46.47558,0.004601,0.003363,99,0.000254,0,20,0.568627,0.03684
37111,McDowell County,,NC,2101,45226,47327,5,8,13,884,987,1871,7,0.268252,0.279671,1475.127224,0.000218,0.000492,99,0.000189,0,20,0.428571,0.002765
37113,Macon County,,NC,1853,33238,35091,13,3,16,821,291,1112,7,0.26766,0.278016,6162.380105,0.005936,0.000275,99,0.000401,0,20,0.512821,0.047242
37115,Madison County,,NC,1220,19506,20726,2,2,4,616,622,1238,7,0.267586,0.27773,0.833333,0.000184,0.000257,99,0.000115,0,20,0.666667,0.002521
37117,Martin County,,NC,1377,26625,28002,6,6,12,689,821,1510,6,0.300062,0.314605,1101.000257,0.000795,0.000961,99,0.000192,0,20,0.566667,0.007477
37119,Mecklenburg County,,NC,64571,847378,911949,340,218,558,76119,54700,130819,5,0.429774,0.474593,207500.913641,0.106958,0.083633,99,0.00413,0,20,0.203703,0.756821
37121,Mitchell County,,NC,724,16535,17259,3,4,7,239,299,538,7,0.267685,0.278188,5.255249,0.000013,0.00026,99,0.000143,0,20,0.5,0.000318
37123,Montgomery County,,NC,1509,27014,28523,7,7,14,771,857,1628,6,0.301336,0.316048,6.017657,0.001179,0.001485,99,0.000159,0,20,0.642857,0.011488
37125,Moore County,,NC,5325,87705,93030,21,18,39,2949,2451,5400,6,0.312701,0.32996,278.647607,0.007176,0.004693,99,0.000335,0,20,0.535573,0.0574
37127,Nash County,,NC,7611,100484,108095,14,16,30,5381,5294,10675,6,0.314153,0.33142,63.187503,0.003827,0.004732,99,0.000258,0,20,0.676471,0.033037
37129,New Hanover County,,NC,16579,176631,193210,100,56,156,12810,10917,23727,6,0.366176,0.39425,6969.578771,0.039983,0.022531,99,0.00124,0,20,0.419597,0.282576
37131,Northampton County,,NC,1521,21468,22989,3,5,8,612,779,1391,6,0.300124,0.314548,21.698473,0.000027,0.00085,99,0.000123,0,20,0.35,0.000471
37133,Onslow County,,NC,33067,154484,187551,137,162,299,15496,18317,33813,6,0.414471,0.455619,21562.135945,0.061286,0.071013,99,0.001357,0,20,0.381684,0.419805
37135,Orange County,,NC,13565,115507,129072,49,38,87,8039,9236,17275,6,0.366038,0.392285,3054.8587,0.025331,0.019479,99,0.000622,0,20,0.602597,0.184781
37137,Pamlico County,,NC,999,13006,14005,2,3,5,290,414,704,7,0.268277,0.27927,0,0.000835,0.000262,99,0.000075,0,20,1,0.007048
37139,Pasquotank County,,NC,3265,38285,41550,17,11,28,2450,1414,3864,6,0.308459,0.324885,3800.563931,0.004344,0.001936,164,0.000368,0,20,0.363971,0.03265
37141,Pender County,,NC,3715,43056,46771,9,8,17,3279,2319,5598,6,0.313544,0.329502,6.433034,0.002897,0.003215,99,0.000191,0,20,0.833333,0.023576
37143,Perquimans County,,NC,973,12244,13217,5,3,8,650,425,1075,7,0.235857,0.24318,1.907738,0.000914,0.000048,164,0.000161,0,20,0.75,0.006446
37145,Person County,,NC,2192,40800,42992,7,8,15,1182,1260,2442,6,0.301523,0.316403,1805.366398,0.001234,0.00203,99,0.000166,0,20,0.642857,0.01134
37147,Pitt County,,NC,9870,141457,151327,49,36,85,7092,5734,12826,6,0.327666,0.351312,13347.46826,0.01457,0.010025,99,0.000805,0,20,0.347811,0.108703
37149,Polk County,,NC,1347,20168,21515,5,5,10,714,735,1449,7,0.281214,0.293423,0.402572,0.000587,0.001007,99,0.000166,0,20,0.9,0.008054
37151,Randolph County,,NC,7599,148984,156583,14,16,30,5191,5102,10293,6,0.306671,0.323316,31.412391,0.002364,0.004288,99,0.000283,0,20,0.584795,0.023043
37153,Richmond County,,NC,2502,47085,49587,9,16,25,844,1423,2267,6,0.312601,0.329559,114.470633,0.001522,0.004146,99,0.000208,0,20,0.541667,0.015796
37155,Robeson County,,NC,5383,121885,127268,18,16,34,2728,3241,5969,6,0.312601,0.329559,382.222154,0.005073,0.004018,99,0.000299,0,20,0.55,0.041892
37157,Rockingham County,,NC,4493,101788,106281,11,13,24,2684,2795,5479,6,0.306509,0.322686,765.866859,0.001458,0.002961,99,0.000247,0,20,0.525641,0.014237
37159,Rowan County,,NC,7722,143383,151105,17,16,33,4802,4788,9590,6,0.311297,0.328184,38.762288,0.003872,0.00441,99,0.000356,0,20,0.634211,0.037595
37161,Rutherford County,,NC,2843,65698,68541,11,11,22,1291,1486,2777,6,0.306639,0.322606,320.328856,0.002599,0.002261,99,0.000264,0,20,0.516484,0.024617
37163,Sampson County,,NC,3190,62426,65616,10,11,21,1804,2088,3892,6,0.312064,0.328156,32.870933,0.002348,0.003395,99,0.000202,0,20,0.718182,0.021495
37165,Scotland County,,NC,2484,37472,39956,8,11,19,1121,1518,2639,6,0.312433,0.3287,57.781934,0.001751,0.003512,99,0.000162,0,20,0.7,0.015856
37167,Stanly County,,NC,3105,64174,67279,6,10,16,1627,1723,3350,6,0.306219,0.321913,17.081226,0.000809,0.002787,99,0.000187,0,20,0.655556,0.010597
37169,Stokes County,,NC,3006,50527,53533,7,6,13,2307,2125,4432,6,0.284041,0.296838,44.061981,0.000811,0.000934,99,0.000173,0,20,0.619048,0.008211
37171,Surry County,,NC,3624,76970,80594,9,13,22,1861,2202,4063,6,0.306542,0.322715,21418.766542,0.001326,0.002802,99,0.000287,0,20,0.461538,0.013272
37173,Swain County,,NC,1006,17726,18732,1,4,5,335,519,854,7,0.26766,0.27813,0,0.000009,0.000352,99,0.000096,0,20,0.833333,0.000168
37175,Transylvania County,,NC,1970,30832,32802,4,5,9,566,788,1354,6,0.301711,0.316254,2.477298,0.000649,0.001679,99,0.000162,0,20,0.7,0.007019
37177,Tyrrell County,,NC,277,3871,4148,2,1,3,136,57,193,7,0.230824,0.237181,9.216957,0.000022,0,164,0.000106,0,20,0,0.000415
37179,Union County,,NC,10581,175385,185966,80,26,106,15188,6728,21916,6,0.343566,0.364834,2426.581257,0.03974,0.008375,99,0.000854,0,20,0.542544,0.270453
37181,Vance County,,NC,2724,46245,48969,5,7,12,1468,1768,3236,6,0.301242,0.315888,4.716747,0.001059,0.002101,99,0.00013,0,20,0.666667,0.009367
37183,Wake County,,NC,53039,821214,874253,329,226,555,69039,43222,112261,5,0.427878,0.473339,189446.578309,0.106092,0.086859,99,0.003789,0,20,0.207108,0.740183
37185,Warren County,,NC,1364,17116,18480,4,6,10,509,856,1365,6,0.300093,0.314576,9.269402,0.000719,0.000878,99,0.000123,0,20,0.566667,0.00652
37187,Washington County,,NC,793,14129,14922,4,6,10,213,440,653,6,0.300062,0.314605,3067.679147,0.000021,0.000958,99,0.000232,0,20,0.433333,0.000557
37189,Watauga County,,NC,3646,36400,40046,16,15,31,1570,1681,3251,6,0.307871,0.324616,13410.421008,0.003304,0.003597,99,0.000359,0,20,0.408497,0.031441
37191,Wayne County,,NC,9024,119153,128177,22,29,51,3164,4165,7329,6,0.355051,0.378534,3572.951551,0.007064,0.01133,99,0.00034,0,20,0.502016,0.056477
37193,Wilkes County,,NC,2920,72715,75635,13,11,24,1266,1480,2746,6,0.306445,0.322314,3985.624626,0.001525,0.002336,99,0.000316,0,20,0.538462,0.016376
37195,Wilson County,,NC,4422,82552,86974,12,15,27,2320,2725,5045,6,0.312299,0.329015,402.657769,0.003006,0.004244,99,0.00023,0,20,0.679167,0.02618
37197,Yadkin County,,NC,2161,41329,43490,7,9,16,1658,1454,3112,6,0.301617,0.316707,16.497492,0.000422,0.001985,99,0.000199,0,20,0.791667,0.005369
37199,Yancey County,,NC,785,17765,18550,4,3,7,376,300,676,7,0.267635,0.277959,1379.173309,0.000183,0.000258,99,0.000171,0,20,0.583333,0.002406
38001,Adams County,,ND,184,2795,2979,0,0,0,0,0,0,0,0,0,0,0,0,100,0.00005,89,152,0,0
38003,Barnes County,,ND,802,12704,13506,2,3,5,231,343,574,7,0.263874,0.273629,0,0.000055,0.000051,24,0.000118,0,20,1,0.000614
38005,Benson County,,ND,433,7035,7468,1,1,2,108,150,258,8,0.210717,0.21581,0,0.000001,0.000001,24,0.000089,0,20,0,0.000097
38007,Billings County,,ND,101,948,1049,0,0,0,0,0,0,0,0,0,0,0,0,101,0.00005,90,153,0,0
38009,Bottineau County,,ND,511,7818,8329,1,1,2,79,120,199,7,0.257477,0.266258,0,0.000049,0.000048,24,0.000077,0,20,0,0.000495
38011,Bowman County,,ND,229,3701,3930,0,0,0,0,0,0,0,0,0,0,0,0,102,0.00005,91,154,0,0
38013,Burke County,,ND,181,2563,2744,1,1,2,42,57,99,7,0.257477,0.266258,0,0.000049,0.000048,24,0.000077,0,20,0,0.000495
38015,Burleigh County,,ND,5201,87791,92992,21,15,36,3719,2758,6477,6,0.336845,0.35685,40543.932625,0.00119,0.001958,24,0.00092,0,20,0.17316,0.010193
38017,Cass County,,ND,11153,152355,163508,54,39,93,8179,6666,14845,6,0.358022,0.383236,102411.714605,0.00528,0.00702,24,0.001762,0,20,0.146448,0.044977
38019,Cavalier County,,ND,301,5447,5748,0,1,1,0,60,60,7,0.263701,0.273031,0,0,0.000041,24,0.00005,0,155,0,0
38021,Dickey County,,ND,441,6124,6565,0,1,1,0,44,44,7,0.263701,0.273031,0,0,0.000041,24,0.00005,0,156,0,0
38023,Divide County,,ND,142,2525,2667,0,0,0,0,0,0,0,0,0,0,0,0,103,0.00005,92,157,0,0
38025,Dunn County,,ND,229,3839,4068,1,1,2,49,76,125,8,0.210732,0.216004,0,0.000001,0.000001,24,0.000095,0,20,0,0.000101
38027,Eddy County,,ND,193,2856,3049,0,0,0,0,0,0,0,0,0,0,0,0,104,0.00005,93,158,0,0
38029,Emmons County,,ND,206,4505,4711,1,1,2,42,95,137,7,0.251992,0.2599,0,0.000015,0.000009,24,0.000102,0,20,0,0.000199
38031,Foster County,,ND,247,4240,4487,0,1,1,0,45,45,7,0.263701,0.273031,0,0,0.000041,24,0.00005,0,159,0,0
38033,Golden Valley County,,ND,156,1951,2107,0,0,0,0,0,0,0,0,0,0,0,0,105,0.00005,94,160,0,0
38035,Grand Forks County,,ND,7821,68942,76763,21,28,49,2371,3313,5684,6,0.349466,0.373299,38586.029997,0.003202,0.007936,24,0.000592,0,20,0.278409,0.0267
38037,Grant County,,ND,160,3015,3175,0,0,0,0,0,0,0,0,0,0,0,0,106,0.00005,95,161,0,0
38039,Griggs County,,ND,195,3093,3288,0,1,1,0,52,52,7,0.263701,0.273031,0,0,0.000041,24,0.00005,0,162,0,0
38041,Hettinger County,,ND,127,3012,3139,1,1,2,40,48,88,8,0.210732,0.216004,0,0.000001,0.000001,24,0.000095,0,20,0,0.000101
38043,Kidder County,,ND,127,3114,3241,0,1,1,0,47,47,7,0.252035,0.259983,0,0,0.000009,24,0.00005,0,163,0,0
38045,LaMoure County,,ND,260,5246,5506,0,1,1,0,53,53,7,0.263701,0.273031,0,0,0.000041,24,0.00005,0,164,0,0
38047,Logan County,,ND,130,2366,2496,0,0,0,0,0,0,0,0,0,0,0,0,107,0.00005,96,165,0,0
38049,McHenry County,,ND,447,6470,6917,1,1,2,156,181,337,7,0.257477,0.266258,0,0.000049,0.000048,24,0.000077,0,20,0,0.000495
38051,McIntosh County,,ND,191,3599,3790,0,0,0,0,0,0,0,0,0,0,0,0,108,0.00005,97,166,0,0
38053,McKenzie County,,ND,336,5598,5934,1,1,2,52,57,109,8,0.210656,0.215775,0,0.000001,0.000001,24,0.00012,0,20,0,0.000107
38055,McLean County,,ND,699,10551,11250,2,3,5,191,359,550,7,0.266801,0.277334,0,0.000064,0.000098,24,0.000129,0,20,1,0.000693
38057,Mercer County,,ND,632,10366,10998,1,2,3,53,200,253,7,0.26385,0.273457,0,0.000015,0.00005,24,0.000102,0,20,1,0.000199
38059,Morton County,,ND,2323,29965,32288,5,3,8,1506,1407,2913,7,0.263922,0.273743,28.081575,0.00012,0.000051,24,0.000242,0,20,0.75,0.001409
38061,Mountrail County,,ND,599,8037,8636,1,2,3,81,189,270,7,0.257727,0.266876,0,0.000049,0.000057,24,0.000077,0,20,1,0.000495
38063,Nelson County,,ND,301,4038,4339,0,2,2,0,106,106,7,0.266771,0.276993,0,0,0.000066,24,0.00005,0,167,1,0
38065,Oliver County,,ND,161,2370,2531,0,1,1,0,49,49,7,0.252035,0.259983,0,0,0.000009,24,0.00005,0,168,0,0
38067,Pembina County,,ND,662,9803,10465,2,3,5,132,238,370,7,0.266752,0.277088,0,0.000062,0.000066,24,0.000095,0,20,0.833333,0.000413
38069,Pierce County,,ND,319,5024,5343,0,0,0,0,0,0,0,0,0,0,0,0,109,0.00005,98,169,0,0
38071,Ramsey County,,ND,872,13289,14161,3,4,7,267,405,672,7,0.266948,0.277592,5878,0.000116,0.000075,24,0.000182,0,20,0.5,0.000927
38073,Ransom County,,ND,501,6882,7383,1,2,3,64,217,281,7,0.263682,0.273125,0,0.000054,0.000041,24,0.000089,0,20,1,0.000518
38075,Renville County,,ND,259,3016,3275,1,1,2,86,117,203,7,0.257477,0.266258,0,0.000049,0.000048,24,0.000077,0,20,0,0.000495
38077,Richland County,,ND,1598,19244,20842,3,6,9,445,824,1269,7,0.266875,0.277718,10.167756,0.000064,0.000093,24,0.000141,0,20,0.533333,0.000875
38079,Rolette County,,ND,640,14099,14739,3,4,7,182,283,465,7,0.26798,0.279007,0,0.000126,0.000123,24,0.000147,0,20,1,0.001015
38081,Sargent County,,ND,261,5211,5472,3,1,4,149,61,210,7,0.263659,0.272953,0,0.000056,0.000041,24,0.000146,0,20,0.666667,0.000705
38083,Sheridan County,,ND,81,1790,1871,0,0,0,0,0,0,0,0,0,0,0,0,110,0.00005,99,170,0,0
38085,Sioux County,,ND,288,3794,4082,2,2,4,107,161,268,7,0.252079,0.260215,11752,0.000015,0.000009,24,0.000229,0,20,0,0.000288
38087,Slope County,,ND,43,835,878,0,0,0,0,0,0,0,0,0,0,0,0,111,0.00005,100,171,0,0
38089,Stark County,,ND,1489,26292,27781,5,7,12,317,569,886,7,0.266972,0.278193,11761.70902,0.00007,0.0001,24,0.000372,0,20,0.404762,0.000994
38091,Steele County,,ND,172,2475,2647,0,1,1,0,44,44,7,0.263701,0.273031,0,0,0.000041,24,0.00005,0,172,0,0
38093,Stutsman County,,ND,1335,23873,25208,3,5,8,311,577,888,7,0.266948,0.277707,11.383055,0.00007,0.000076,24,0.000174,0,20,0.65,0.00081
38095,Towner County,,ND,219,3021,3240,0,0,0,0,0,0,0,0,0,0,0,0,112,0.00005,101,173,0,0
38097,Traill County,,ND,767,9318,10085,2,2,4,237,330,567,7,0.266728,0.276916,0,0.000116,0.000066,24,0.000107,0,20,1,0.00084
38099,Walsh County,,ND,775,13619,14394,2,3,5,185,351,536,7,0.266752,0.277088,0,0.000062,0.000066,24,0.000095,0,20,0.833333,0.000413
38101,Ward County,,ND,6955,66781,73736,25,25,50,2081,2492,4573,6,0.346718,0.369662,45471.668848,0.006204,0.006322,24,0.000793,0,20,0.284483,0.049669
38103,Wells County,,ND,329,5414,5743,0,1,1,0,75,75,7,0.263701,0.273031,0,0,0.000041,24,0.00005,0,174,0,0
38105,Williams County,,ND,1192,23232,24424,6,4,10,389,312,701,7,0.26685,0.277563,5955.339179,0.00012,0.000098,24,0.000329,0,20,0.366667,0.001483
39001,Adams County,,OH,1541,30163,31704,7,7,14,915,963,1878,6,0.292992,0.306088,148.33721,0.000588,0.000513,113,0.000173,0,20,0.52381,0.004258
39003,Allen County,,OH,5900,122159,128059,16,19,35,2619,3308,5927,6,0.342192,0.363603,646.119245,0.00364,0.003762,113,0.000236,0,20,0.481579,0.022171
39005,Ashland County,,OH,3169,59881,63050,12,11,23,2251,1930,4181,6,0.307937,0.324296,207.821811,0.002299,0.001806,113,0.000171,0,20,0.628788,0.013656
39007,Ashtabula County,,OH,5440,117236,122676,10,12,22,2883,2949,5832,6,0.337705,0.357096,65.169081,0.002413,0.002951,113,0.000123,0,20,0.727273,0.013205
39009,Athens County,,OH,4272,51646,55918,13,14,27,1571,1767,3338,6,0.333333,0.352079,940.158387,0.002009,0.002781,113,0.000291,0,20,0.367647,0.013429
39011,Auglaize County,,OH,3300,57864,61164,10,11,21,1915,2158,4073,6,0.307774,0.323843,22.409648,0.001234,0.001186,113,0.000182,0,20,0.560606,0.008876
39013,Belmont County,,OH,3157,76582,79739,8,8,16,1704,1589,3293,6,0.309509,0.326231,5957.437019,0.000944,0.001382,113,0.00022,0,20,0.361111,0.006871
39015,Brown County,,OH,3430,49335,52765,8,8,16,2630,2605,5235,6,0.292963,0.306203,200.310109,0.000943,0.000813,113,0.000172,0,20,0.696429,0.006441
39017,Butler County,,OH,25472,389685,415157,56,64,120,21256,18616,39872,6,0.383046,0.413591,16909.815429,0.020732,0.028405,113,0.000645,0,20,0.43526,0.14121
39019,Carroll County,,OH,2121,32772,34893,6,5,11,1467,1472,2939,7,0.272702,0.28356,172.187252,0.000635,0.000183,113,0.000119,0,20,0.633333,0.003354
39021,Champaign County,,OH,2875,46171,49046,9,9,18,2067,2050,4117,6,0.307871,0.323499,10.874715,0.001354,0.001217,113,0.000168,0,20,0.722222,0.009523
39023,Clark County,,OH,7621,160796,168417,11,13,24,4246,4549,8795,6,0.338411,0.358087,198.188341,0.002069,0.003147,113,0.000185,0,20,0.576923,0.013639
39025,Clermont County,,OH,14641,219145,233786,22,22,44,11576,10264,21840,6,0.355833,0.379026,1877.695246,0.008091,0.007748,113,0.00033,0,20,0.601538,0.057452
39027,Clinton County,,OH,3345,47379,50724,14,11,25,3033,2353,5386,6,0.309114,0.325309,96.153615,0.00233,0.001956,113,0.000235,0,20,0.631868,0.016056
39029,Columbiana County,,OH,5085,122292,127377,13,13,26,3099,2939,6038,6,0.312802,0.331208,289.314038,0.003026,0.003139,113,0.000171,0,20,0.571429,0.018024
39031,Coshocton County,,OH,1895,43336,45231,9,8,17,1080,1122,2202,6,0.30638,0.321787,131.225178,0.001381,0.000913,113,0.000156,0,20,0.555556,0.008808
39033,Crawford County,,OH,3405,54457,57862,7,9,16,1681,2092,3773,6,0.306348,0.321844,7.050433,0.000809,0.000893,113,0.000144,0,20,0.555556,0.006016
39035,Cuyahoga County,,OH,70059,1473817,1543876,158,207,365,36143,59970,96113,5,0.42575,0.47004,46826.602426,0.071012,0.086683,113,0.001478,0,20,0.344178,0.482487
39037,Darke County,,OH,3081,65158,68239,7,10,17,1455,1918,3373,6,0.30823,0.324215,218.311305,0.000497,0.001219,113,0.000138,0,20,0.577778,0.003453
39039,Defiance County,,OH,2667,48100,50767,8,10,18,1591,1589,3180,6,0.307481,0.323877,109.990656,0.000579,0.001112,113,0.00016,0,20,0.555556,0.003331
39041,Delaware County,,OH,13659,173684,187343,43,37,80,14647,9140,23787,6,0.366453,0.393053,4088.322459,0.014595,0.015799,113,0.000487,0,20,0.468553,0.09682
39043,Erie County,,OH,5244,93036,98280,12,14,26,3098,3078,6176,6,0.341469,0.362068,104.954743,0.003086,0.004163,113,0.000153,0,20,0.714286,0.017516
39045,Fairfield County,,OH,10837,156919,167756,17,19,36,8964,7541,16505,6,0.34167,0.362365,445.920747,0.003542,0.005071,113,0.000244,0,20,0.445887,0.020921
39047,Fayette County,,OH,2034,32323,34357,8,8,16,1309,1341,2650,6,0.307904,0.323442,11.757785,0.001333,0.001203,113,0.000162,0,20,0.678571,0.009341
39049,Franklin County,,OH,78834,1243673,1322507,268,273,541,61784,67776,129560,5,0.440976,0.490132,333740.244235,0.089884,0.092338,113,0.003086,0,20,0.220641,0.623042
39051,Fulton County,,OH,3337,53383,56720,7,7,14,2034,2103,4137,6,0.306736,0.322302,175.014052,0.001137,0.000951,113,0.000122,0,20,0.666667,0.007285
39053,Gallia County,,OH,1605,31692,33297,5,7,12,754,759,1513,6,0.306865,0.322205,542.553815,0.000734,0.000729,113,0.000163,0,20,0.452381,0.005534
39055,Geauga County,,OH,6242,108830,115072,8,12,20,4547,4136,8683,6,0.345852,0.366237,10.261289,0.002238,0.004494,113,0.000103,0,20,0.878205,0.012562
39057,Greene County,,OH,16445,169435,185880,43,40,83,10891,10966,21857,6,0.368962,0.395682,4661.274357,0.016074,0.017826,113,0.000526,0,20,0.441569,0.114396
39059,Guernsey County,,OH,2264,46115,48379,8,8,16,1015,1175,2190,6,0.306606,0.322119,996.820695,0.001822,0.00111,113,0.000161,0,20,0.511111,0.011235
39061,Hamilton County,,OH,53613,906556,960169,119,136,255,30816,44363,75179,5,0.412942,0.450115,63695.321419,0.051441,0.062265,113,0.001283,0,20,0.400508,0.358666
39063,Hancock County,,OH,5084,87113,92197,13,12,25,2925,2508,5433,6,0.3081,0.324559,239.144491,0.002519,0.001627,113,0.000197,0,20,0.470833,0.015468
39065,Hardin County,,OH,2093,33847,35940,8,8,16,1167,1218,2385,6,0.306348,0.32173,9.672024,0.000805,0.000785,113,0.000166,0,20,0.553571,0.006275
39067,Harrison County,,OH,1100,17439,18539,4,6,10,578,708,1286,6,0.306509,0.321718,50.095832,0.000049,0.000869,113,0.000121,0,20,0.666667,0.000667
39069,Henry County,,OH,2155,36538,38693,7,9,16,1378,1423,2801,6,0.306768,0.322589,10.300418,0.000408,0.000961,113,0.000137,0,20,0.652778,0.002447
39071,Highland County,,OH,2913,47670,50583,12,13,25,2270,2054,4324,6,0.30918,0.325653,115.511641,0.002012,0.001974,113,0.000224,0,20,0.602564,0.013972
39073,Hocking County,,OH,1947,31597,33544,7,8,15,1339,1341,2680,6,0.306284,0.321615,3.4,0.000847,0.000799,113,0.000147,0,20,0.678571,0.00625
39075,Holmes County,,OH,1733,43102,44835,5,6,11,834,1209,2043,7,0.272727,0.283732,1.63254,0.000237,0.000206,113,0.000111,0,20,0.633333,0.00178
39077,Huron County,,OH,4387,73811,78198,11,15,26,2600,2791,5391,6,0.337705,0.357554,145.465207,0.001775,0.003003,113,0.00016,0,20,0.652381,0.011278
39079,Jackson County,,OH,1925,35586,37511,8,7,15,948,1031,1979,6,0.306477,0.321787,16.925706,0.00078,0.00074,113,0.00021,0,20,0.472222,0.00611
39081,Jefferson County,,OH,3270,79916,83186,10,12,22,1407,1665,3072,6,0.310433,0.327967,1567.86005,0.002146,0.002293,113,0.000201,0,20,0.462121,0.014421
39083,Knox County,,OH,3583,64281,67864,12,8,20,2235,1804,4039,6,0.306316,0.321672,57.241535,0.00205,0.000924,113,0.000192,0,20,0.522727,0.01288
39085,Lake County,,OH,12944,278767,291711,20,31,51,9506,9033,18539,6,0.362526,0.386684,294.686749,0.007999,0.015558,113,0.000207,0,20,0.672014,0.05407
39087,Lawrence County,,OH,3108,66185,69293,8,8,16,1927,1733,3660,6,0.307221,0.322795,1142.217772,0.000775,0.000736,113,0.000236,0,20,0.486111,0.006032
39089,Licking County,,OH,10616,186270,196886,15,23,38,7867,6885,14752,6,0.342313,0.363952,1319.651687,0.003729,0.005657,113,0.000244,0,20,0.401667,0.025994
39091,Logan County,,OH,3404,54932,58336,10,11,21,1902,2005,3907,6,0.307578,0.323528,14.740489,0.001249,0.001243,113,0.000184,0,20,0.6,0.008963
39093,Lorain County,,OH,15816,344389,360205,31,49,80,11929,10645,22574,6,0.376797,0.405063,1904.482938,0.013222,0.022931,113,0.000311,0,20,0.530049,0.08949
39095,Lucas County,,OH,24524,492305,516829,60,89,149,13078,17598,30676,5,0.39538,0.428385,18805.290098,0.021811,0.039305,113,0.000608,0,20,0.418788,0.148444
39097,Madison County,,OH,3430,44104,47534,9,9,18,2599,2468,5067,6,0.307871,0.323499,11.280066,0.000952,0.00131,113,0.000177,0,20,0.572727,0.007192
39099,Mahoning County,,OH,12327,275532,287859,21,39,60,6764,8224,14988,6,0.367192,0.393477,1207.539905,0.00846,0.018101,113,0.00023,0,20,0.582503,0.059636
39101,Marion County,,OH,3533,71390,74923,8,9,17,1818,2013,3831,6,0.336884,0.355664,273.07562,0.000901,0.001934,113,0.000169,0,20,0.513889,0.006825
39103,Medina County,,OH,12171,201609,213780,20,27,47,10313,8136,18449,6,0.360639,0.384656,471.452321,0.005318,0.010632,113,0.000211,0,20,0.598925,0.032798
39105,Meigs County,,OH,1217,24008,25225,5,6,11,608,665,1273,6,0.306865,0.32209,549.68798,0.00075,0.000732,113,0.00016,0,20,0.533333,0.005597
39107,Mercer County,,OH,2113,52314,54427,9,9,18,1162,1090,2252,6,0.307774,0.323614,860.607987,0.001224,0.001102,113,0.000168,0,20,0.597222,0.008669
39109,Miami County,,OH,7398,122047,129445,15,15,30,4820,4707,9527,6,0.309673,0.326741,99.012457,0.002244,0.00211,113,0.000228,0,20,0.558333,0.01529
39111,Monroe County,,OH,822,17295,18117,4,3,7,297,315,612,7,0.237067,0.245062,54.025279,0.000017,0.000014,113,0.000163,0,20,0.166667,0.000521
39113,Montgomery County,,OH,35765,617322,653087,102,117,219,21218,26978,48196,5,0.412473,0.447457,36433.073885,0.041553,0.053962,113,0.001147,0,20,0.398815,0.300251
39115,Morgan County,,OH,892,15794,16686,5,5,10,397,557,954,6,0.306316,0.32126,3.058333,0.000762,0.000737,113,0.00014,0,20,0.75,0.005677
39117,Morrow County,,OH,2485,37019,39504,7,6,13,1994,1686,3680,6,0.306219,0.321271,2.160256,0.000942,0.000861,113,0.00014,0,20,0.738095,0.006892
39119,Muskingum County,,OH,4019,99525,103544,9,11,20,2332,2428,4760,6,0.308393,0.324885,1326.754827,0.0015,0.001535,113,0.000183,0,20,0.44697,0.010136
39121,Noble County,,OH,629,13374,14003,3,4,7,401,367,768,7,0.236489,0.244444,922.378704,0.000731,0.000032,113,0.00011,0,20,0.5,0.005336
39123,Ottawa County,,OH,3105,50613,53718,10,8,18,1914,1775,3689,6,0.310599,0.32768,5.251144,0.00204,0.002244,113,0.000137,0,20,0.790909,0.012288
39125,Paulding County,,OH,1373,23875,25248,6,5,11,708,823,1531,7,0.277645,0.289522,14.734992,0.000276,0.000189,113,0.000131,0,20,0.566667,0.001964
39127,Perry County,,OH,2309,38490,40799,7,8,15,1814,1802,3616,6,0.306284,0.321615,3.770635,0.000845,0.000801,113,0.000151,0,20,0.714286,0.006233
39129,Pickaway County,,OH,3895,56295,60190,10,9,19,3641,2730,6371,6,0.306316,0.321787,14.243829,0.000972,0.000907,113,0.000195,0,20,0.490909,0.007378
39131,Pike County,,OH,1518,29794,31312,5,5,10,887,901,1788,6,0.306316,0.3213,1.6171,0.000755,0.000738,113,0.000138,0,20,0.8,0.005694
39133,Portage County,,OH,12430,169626,182056,16,24,40,8740,8688,17428,6,0.357802,0.380687,266.154854,0.003657,0.00983,113,0.000173,0,20,0.661667,0.020881
39135,Preble County,,OH,2946,49592,52538,8,9,17,2064,1967,4031,6,0.308459,0.324416,67.05111,0.001454,0.001492,113,0.000132,0,20,0.644444,0.009183
39137,Putnam County,,OH,1771,44758,46529,8,9,17,909,1100,2009,6,0.3068,0.322646,64.820707,0.000429,0.000985,113,0.000157,0,20,0.583333,0.002712
39139,Richland County,,OH,7077,146793,153870,17,19,36,3627,4101,7728,6,0.338845,0.359404,275.021499,0.002697,0.003832,113,0.000228,0,20,0.491342,0.015781
39141,Ross County,,OH,3818,82134,85952,11,14,25,2422,2333,4755,6,0.308786,0.325395,79.829341,0.001236,0.001539,113,0.00025,0,20,0.412088,0.008955
39143,Sandusky County,,OH,3583,75169,78752,7,10,17,2180,2320,4500,6,0.308197,0.324639,1.433493,0.001165,0.001655,113,0.00012,0,20,0.822222,0.007497
39145,Scioto County,,OH,3009,76846,79855,10,10,20,1346,1466,2812,6,0.306833,0.322635,4836.156722,0.001187,0.000753,113,0.000271,0,20,0.309091,0.008559
39147,Seneca County,,OH,3584,68391,71975,9,12,21,2009,2267,4276,6,0.308165,0.324868,16.389759,0.001173,0.001586,113,0.000151,0,20,0.636364,0.007797
39149,Shelby County,,OH,3102,60571,63673,11,11,22,1896,1874,3770,6,0.309147,0.325367,58.734291,0.001849,0.001633,113,0.000183,0,20,0.672727,0.012586
39151,Stark County,,OH,17357,445811,463168,43,53,96,11161,11670,22831,6,0.374373,0.402595,12816.902684,0.016328,0.023565,113,0.000486,0,20,0.445628,0.117898
39153,Summit County,,OH,32053,621736,653789,62,102,164,22329,24370,46699,5,0.398357,0.432812,10839.865628,0.027813,0.049472,113,0.000631,0,20,0.472072,0.195247
39155,Trumbull County,,OH,10728,256754,267482,16,24,40,5710,6719,12429,6,0.349802,0.372291,607.157836,0.005176,0.008683,113,0.00018,0,20,0.621377,0.034791
39157,Tuscarawas County,,OH,4882,112099,116981,11,12,23,2735,2858,5593,6,0.314085,0.331552,1408.523026,0.002072,0.002487,113,0.000182,0,20,0.484848,0.012571
39159,Union County,,OH,3701,52601,56302,9,8,17,3069,2295,5364,6,0.306284,0.321615,8.825433,0.000958,0.000868,113,0.000172,0,20,0.527778,0.007161
39161,Van Wert County,,OH,1624,36715,38339,8,8,16,911,880,1791,6,0.307254,0.323247,308.490288,0.001014,0.000922,113,0.000164,0,20,0.446429,0.007286
39163,Vinton County,,OH,873,13635,14508,6,4,10,682,565,1247,6,0.306155,0.320928,1.9,0.000768,0.000729,113,0.000154,0,20,0.633333,0.005804
39165,Warren County,,OH,18193,221282,239475,43,40,83,16641,12883,29524,6,0.374855,0.401907,3590.437759,0.019455,0.018435,113,0.000513,0,20,0.593614,0.137619
39167,Washington County,,OH,3555,70192,73747,9,8,17,1491,1612,3103,6,0.306962,0.322463,5396.069757,0.000795,0.000737,113,0.000307,0,20,0.319444,0.006223
39169,Wayne County,,OH,6546,135000,141546,11,12,23,4023,3763,7786,6,0.308002,0.324525,200.42994,0.002357,0.001831,113,0.000149,0,20,0.69697,0.01359
39171,Williams County,,OH,2473,46589,49062,8,11,19,1246,1358,2604,6,0.307546,0.324107,136.507946,0.000356,0.001134,113,0.000164,0,20,0.463636,0.002221
39173,Wood County,,OH,11023,134945,145968,27,25,52,7516,7164,14680,6,0.354144,0.377526,3010.306481,0.006809,0.007424,113,0.000313,0,20,0.404356,0.043483
39175,Wyandot County,,OH,1667,27269,28936,6,6,12,944,1055,1999,6,0.306284,0.321386,3.510256,0.00077,0.000746,113,0.000132,0,20,0.666667,0.005821
40001,Adair County,,OK,1302,21701,23003,4,6,10,781,761,1542,6,0.293081,0.305945,3.641045,0.000241,0.0007,5,0.000145,0,20,0.8,0.003099
40003,Alfalfa County,,OK,361,5164,5525,2,1,3,98,69,167,7,0.256569,0.264995,0,0.000036,0.000055,5,0.000102,0,20,1,0.000658
40005,Atoka County,,OK,919,13417,14336,6,5,11,464,392,856,7,0.243821,0.252058,933.565684,0.000415,0.000035,5,0.000225,0,20,0.333333,0.003797
40007,Beaver County,,OK,499,5650,6149,2,1,3,110,96,206,7,0.235532,0.241838,0,0.000013,0,37,0.000096,0,20,1,0.00019
40009,Beckham County,,OK,1453,19595,21048,6,5,11,752,550,1302,6,0.293672,0.306621,5881.294571,0.000622,0.000427,5,0.000249,0,20,0.5,0.004971
40011,Blaine County,,OK,882,10326,11208,2,6,8,114,417,531,6,0.293761,0.306907,104.741172,0.000411,0.000482,5,0.000086,0,20,0.6,0.003465
40013,Bryan County,,OK,2565,32785,35350,16,12,28,1711,1336,3047,6,0.32176,0.339318,6687.711206,0.002712,0.003182,5,0.000396,0,20,0.408088,0.024502
40015,Caddo County,,OK,2071,28063,30134,7,7,14,1000,1273,2273,6,0.297516,0.311151,7.008852,0.000756,0.000735,5,0.000193,0,20,0.738095,0.006374
40017,Canadian County,,OK,9251,105107,114358,23,20,43,8548,6516,15064,6,0.32926,0.349885,2765.800084,0.005082,0.003812,5,0.000524,0,20,0.369565,0.043746
40019,Carter County,,OK,3071,47622,50693,17,16,33,1574,1552,3126,6,0.316476,0.333929,6555.50329,0.003585,0.002532,5,0.000406,0,20,0.412281,0.031522
40021,Cherokee County,,OK,3105,38493,41598,13,13,26,1905,1918,3823,6,0.29926,0.314233,102.985599,0.001107,0.001313,5,0.000342,0,20,0.538095,0.010822
40023,Choctaw County,,OK,875,13875,14750,5,5,10,398,426,824,6,0.293969,0.307165,279.368277,0.000443,0.000424,5,0.000158,0,20,0.5,0.003821
40025,Cimarron County,,OK,246,2913,3159,0,0,0,0,0,0,0,0,0,0,0,0,114,0.00005,102,175,0,0
40027,Cleveland County,,OK,22402,227568,249970,64,50,114,19671,16218,35889,6,0.364433,0.392875,20601.428952,0.020369,0.016113,5,0.001112,0,20,0.320618,0.152799
40029,Coal County,,OK,401,4915,5316,2,2,4,123,193,316,7,0.229894,0.236432,1.494048,0.000008,0.00001,5,0.000113,0,20,0,0.000288
40031,Comanche County,,OK,15815,107953,123768,49,67,116,5722,7808,13530,6,0.37866,0.409971,14270.364902,0.017961,0.025738,5,0.000692,0,20,0.444306,0.133589
40033,Cotton County,,OK,538,6067,6605,3,2,5,287,236,523,7,0.279996,0.292329,0,0.000394,0.000287,5,0.00009,0,20,1,0.002667
40035,Craig County,,OK,1110,13695,14805,5,5,10,581,599,1180,6,0.292051,0.30441,0.346465,0.000414,0.000396,5,0.000163,0,20,0.95,0.003667
40037,Creek County,,OK,6247,68760,75007,13,15,28,4449,4618,9067,6,0.29837,0.31323,920.957142,0.000931,0.001037,5,0.000342,0,20,0.520833,0.008649
40039,Custer County,,OK,2297,24349,26646,11,7,18,1158,1127,2285,6,0.298064,0.311741,1920.645711,0.000939,0.000929,5,0.00033,0,20,0.381818,0.008396
40041,Delaware County,,OK,2838,33348,36186,15,11,26,1974,1645,3619,6,0.293465,0.307234,348.84676,0.001942,0.000777,5,0.00035,0,20,0.452381,0.016285
40043,Dewey County,,OK,361,4913,5274,1,2,3,46,105,151,7,0.229858,0.236289,0,0.000005,0.000012,5,0.00009,0,20,0.5,0.000135
40045,Ellis County,,OK,387,3819,4206,1,1,2,68,113,181,7,0.227149,0.233094,0,0.000005,0.000004,5,0.00009,0,20,0,0.000135
40047,Garfield County,,OK,4978,61128,66106,24,19,43,1947,1949,3896,6,0.345073,0.366816,22547.576094,0.007052,0.004541,5,0.000596,0,20,0.332308,0.056812
40049,Garvin County,,OK,1896,26982,28878,8,9,17,1097,1050,2147,6,0.298217,0.312257,12.484589,0.000561,0.000957,5,0.000219,0,20,0.694444,0.005595
40051,Grady County,,OK,3601,47310,50911,9,10,19,2860,2378,5238,6,0.301711,0.31614,20.317913,0.001141,0.001106,5,0.000218,0,20,0.7,0.009427
40053,Grant County,,OK,408,4784,5192,1,2,3,98,179,277,7,0.258414,0.267452,0,0.000035,0.000072,5,0.000077,0,20,1,0.000544
40055,Greer County,,OK,380,4851,5231,1,2,3,88,121,209,7,0.245487,0.254197,0,0.000026,0.000028,5,0.000069,0,20,1,0.000287
40057,Harmon County,,OK,239,2952,3191,1,1,2,48,50,98,7,0.245404,0.253854,0,0.000026,0.000024,5,0.000069,0,20,0,0.000287
40059,Harper County,,OK,326,3635,3961,1,1,2,53,76,129,7,0.227149,0.233094,0,0.000005,0.000004,5,0.00009,0,20,0,0.000135
40061,Haskell County,,OK,697,11929,12626,3,3,6,237,257,494,7,0.242338,0.250088,0.882155,0.000028,0.000027,5,0.000125,0,20,0.5,0.000538
40063,Hughes County,,OK,986,11535,12521,5,7,12,454,509,963,6,0.292257,0.30504,388.748801,0.000409,0.000377,5,0.000156,0,20,0.625,0.003594
40065,Jackson County,,OK,3644,27570,31214,14,15,29,883,1105,1988,6,0.325176,0.346025,12615.207266,0.003054,0.003374,5,0.000328,0,20,0.350877,0.024701
40067,Jefferson County,,OK,542,5617,6159,2,2,4,152,211,363,7,0.242036,0.249538,0,0.000029,0.000054,5,0.000092,0,20,1,0.000651
40069,Johnston County,,OK,740,9557,10297,6,5,11,437,397,834,7,0.243923,0.252315,7.247275,0.000438,0.000063,5,0.000205,0,20,0.633333,0.004062
40071,Kay County,,OK,3477,48634,52111,12,12,24,1336,1577,2913,6,0.324994,0.344181,1322.722369,0.002194,0.002227,5,0.000289,0,20,0.512821,0.017995
40073,Kingfisher County,,OK,1119,15829,16948,5,5,10,532,552,1084,6,0.293732,0.306735,1.085256,0.000458,0.000646,5,0.000144,0,20,0.8,0.004354
40075,Kiowa County,,OK,839,9311,10150,5,6,11,308,407,715,6,0.298799,0.31232,410.112616,0.000614,0.000556,5,0.000144,0,20,0.47619,0.004672
40077,Latimer County,,OK,890,11236,12126,3,2,5,330,363,693,7,0.230495,0.237234,6.036721,0.000015,0.000014,5,0.000126,0,20,0.166667,0.000427
40079,Le Flore County,,OK,2743,44309,47052,8,9,17,1317,1587,2904,6,0.299198,0.31366,3975.502818,0.000828,0.00096,5,0.000266,0,20,0.388889,0.007033
40081,Lincoln County,,OK,2629,31907,34536,10,8,18,1787,1784,3571,6,0.298095,0.311913,932.312382,0.001003,0.000923,5,0.000244,0,20,0.666667,0.008701
40083,Logan County,,OK,3211,35051,38262,9,9,18,2266,2055,4321,6,0.298217,0.312257,290.890725,0.002176,0.00101,5,0.000205,0,20,0.654545,0.017646
40085,Love County,,OK,819,8837,9656,2,3,5,250,361,611,6,0.294594,0.307239,1.601231,0.000044,0.000656,5,0.000093,0,20,0.666667,0.000609
40087,McClain County,,OK,2906,31424,34330,7,6,13,2606,1996,4602,6,0.293672,0.306735,3.357798,0.000938,0.000595,5,0.000186,0,20,0.857143,0.008023
40089,McCurtain County,,OK,1645,30990,32635,7,8,15,449,519,968,6,0.294564,0.308282,1662.497418,0.000464,0.000472,5,0.000226,0,20,0.267857,0.004267
40091,McIntosh County,,OK,1431,17130,18561,7,6,13,717,757,1474,6,0.298095,0.311684,5.395547,0.001245,0.000773,5,0.000179,0,20,0.732143,0.009604
40093,Major County,,OK,591,8139,8730,2,1,3,221,160,381,7,0.256569,0.264995,0,0.000039,0.000055,5,0.000089,0,20,0.5,0.000657
40095,Marshall County,,OK,1105,13199,14304,5,5,10,494,496,990,6,0.293732,0.306735,182.036498,0.000488,0.000587,5,0.000167,0,20,0.666667,0.004416
40097,Mayes County,,OK,2785,39487,42272,12,10,22,1769,1757,3526,6,0.298309,0.312543,49.536959,0.000948,0.000826,5,0.000319,0,20,0.613636,0.009364
40099,Murray County,,OK,983,11846,12829,5,5,10,445,488,933,6,0.293761,0.306793,0,0.000541,0.000574,5,0.00015,0,20,1,0.004973
40101,Muskogee County,,OK,4509,69119,73628,16,14,30,2458,2771,5229,6,0.31859,0.335756,3761.092618,0.00178,0.001766,5,0.000414,0,20,0.429167,0.015574
40103,Noble County,,OK,1310,11892,13202,5,5,10,623,696,1319,6,0.293791,0.30685,1.163345,0.000495,0.000491,5,0.000146,0,20,0.85,0.004362
40105,Nowata County,,OK,830,10658,11488,4,4,8,454,478,932,6,0.292227,0.304485,1.847324,0.000422,0.000401,5,0.000124,0,20,0.833333,0.003575
40107,Okfuskee County,,OK,880,9986,10866,4,7,11,345,550,895,6,0.298064,0.311741,9.152863,0.000024,0.00075,5,0.000142,0,20,0.678571,0.000612
40109,Oklahoma County,,OK,50339,683344,733683,156,156,312,37517,40150,77667,5,0.415418,0.45457,177168.77921,0.048572,0.049209,5,0.002481,0,20,0.247973,0.368477
40111,Okmulgee County,,OK,3015,37737,40752,10,8,18,1722,1779,3501,6,0.298125,0.31197,788.338156,0.000821,0.000805,5,0.000261,0,20,0.590909,0.00725
40113,Osage County,,OK,3764,41011,44775,9,10,19,2738,2764,5502,6,0.298186,0.312314,20.237775,0.00088,0.00101,5,0.00023,0,20,0.777778,0.007635
40115,Ottawa County,,OK,2412,33089,35501,9,10,19,1349,1322,2671,6,0.298553,0.312904,346.633539,0.000548,0.000832,5,0.000262,0,20,0.5,0.005716
40117,Pawnee County,,OK,1519,15823,17342,4,4,8,867,924,1791,6,0.291963,0.304124,0,0.000446,0.00038,5,0.000119,0,20,1,0.003428
40119,Payne County,,OK,6916,59097,66013,20,24,44,3195,3766,6961,6,0.353584,0.377474,1992.254648,0.003259,0.006736,5,0.000438,0,20,0.44,0.028934
40121,Pittsburg County,,OK,2694,42590,45284,10,11,21,1101,1042,2143,6,0.298278,0.3126,4438.277111,0.000915,0.000933,5,0.000318,0,20,0.363636,0.008067
40123,Pontotoc County,,OK,2694,33658,36352,11,11,22,1137,1314,2451,6,0.298278,0.3126,5318.722947,0.000934,0.000934,5,0.000319,0,20,0.445455,0.008367
40125,Pottawatomie County,,OK,5013,65508,70521,12,9,21,3254,3045,6299,6,0.298156,0.312142,20.329241,0.00101,0.00097,5,0.000292,0,20,0.568182,0.008901
40127,Pushmataha County,,OK,781,10074,10855,4,5,9,210,347,557,7,0.243902,0.252121,551.724353,0.000389,0.000031,5,0.000153,0,20,0.5,0.003387
40129,Roger Mills County,,OK,278,3680,3958,1,1,2,86,119,205,7,0.227024,0.232836,0,0.000003,0.000005,5,0.000093,0,20,0,0.000131
40131,Rogers County,,OK,6332,84540,90872,20,17,37,5629,4475,10104,6,0.332533,0.352743,1110.8469,0.003717,0.002228,5,0.000458,0,20,0.399209,0.031352
40133,Seminole County,,OK,1998,21873,23871,8,7,15,1167,1218,2385,6,0.298095,0.311798,13.023465,0.000915,0.000902,5,0.000211,0,20,0.714286,0.007812
40135,Sequoyah County,,OK,2455,38920,41375,8,7,15,1337,1379,2716,6,0.298339,0.312257,24.622753,0.000856,0.000834,5,0.000215,0,20,0.571429,0.007275
40137,Stephens County,,OK,2671,43783,46454,12,11,23,1341,1209,2550,6,0.304012,0.318958,2876.193095,0.003341,0.001246,5,0.00026,0,20,0.565934,0.02746
40139,Texas County,,OK,1961,19883,21844,3,5,8,273,445,718,6,0.295042,0.308545,597.69866,0.00002,0.000557,37,0.000123,0,20,0.333333,0.000345
40141,Tillman County,,OK,630,7781,8411,3,3,6,188,212,400,7,0.280455,0.293045,15.056414,0.000227,0.00031,5,0.000111,0,20,0.75,0.001616
40143,Tulsa County,,OK,41455,593720,635175,136,131,267,31749,32071,63820,5,0.412006,0.448373,99337.995236,0.043919,0.048692,5,0.002153,0,20,0.291509,0.338601
40145,Wagoner County,,OK,6312,63210,69522,16,10,26,6273,4686,10959,6,0.298217,0.312371,517.631145,0.003566,0.000955,5,0.000355,0,20,0.558333,0.030118
40147,Washington County,,OK,3677,52708,56385,14,13,27,1913,2007,3920,6,0.323513,0.342566,553.082242,0.00324,0.001961,5,0.000289,0,20,0.516667,0.026761
40149,Washita County,,OK,1079,11109,12188,4,4,8,502,529,1031,6,0.293643,0.306449,1.158333,0.000397,0.000428,5,0.000166,0,20,0.75,0.003439
40151,Woods County,,OK,685,8334,9019,2,3,5,85,151,236,7,0.256704,0.265568,100.226885,0.000417,0.000059,5,0.00009,0,20,0.666667,0.00356
40153,Woodward County,,OK,1276,19828,21104,7,7,14,456,470,926,6,0.29388,0.307251,15942.566513,0.000543,0.000597,5,0.000326,0,20,0.25,0.005244
41001,Baker County,,OR,1230,15778,17008,5,5,10,315,378,693,6,0.286502,0.300493,22.059516,0.000568,0.00096,6,0.000137,0,20,0.766667,0.005988
41003,Benton County,,OR,8406,77117,85523,30,22,52,4983,5674,10657,6,0.343363,0.36496,58.301992,0.011473,0.007457,6,0.000426,0,20,0.753119,0.093624
41005,Clackamas County,,OR,32286,379008,411294,65,64,129,29898,27307,57205,6,0.363841,0.394135,4369.019814,0.021708,0.024808,6,0.000833,0,20,0.512009,0.1707
41007,Clatsop County,,OR,2813,34947,37760,14,14,28,1268,1353,2621,6,0.318764,0.335893,83.264713,0.004581,0.003649,6,0.000247,0,20,0.767974,0.039754
41009,Columbia County,,OR,3451,49960,53411,11,11,22,3225,2195,5420,6,0.333028,0.351781,9.543553,0.003092,0.003128,6,0.000206,0,20,0.916667,0.028092
41011,Coos County,,OR,4339,61181,65520,25,18,43,2407,2382,4789,6,0.329857,0.349422,67.420768,0.009499,0.003735,6,0.000358,0,20,0.80291,0.076496
41013,Crook County,,OR,1663,20292,21955,7,5,12,1434,826,2260,6,0.283819,0.297085,0.354532,0.001339,0.000992,6,0.000161,0,20,0.964286,0.012995
41015,Curry County,,OR,2083,22487,24570,9,8,17,760,818,1578,6,0.284041,0.297887,4.956827,0.002387,0.001332,6,0.000166,0,20,0.836364,0.019977
41017,Deschutes County,,OR,10789,145823,156612,77,50,127,14279,7487,21766,6,0.34792,0.374215,18952.905683,0.021644,0.015088,6,0.001078,0,20,0.457978,0.168294
41019,Douglas County,,OR,6091,106901,112992,40,25,65,4583,3760,8343,6,0.341429,0.363402,207.043869,0.013679,0.008107,6,0.000482,0,20,0.696013,0.106302
41021,Gilliam County,,OR,192,1874,2066,0,0,0,0,0,0,0,0,0,0,0,0,115,0.00005,103,176,0,0
41023,Grant County,,OR,663,7339,8002,1,1,2,56,50,106,7,0.258139,0.267819,0,0.000117,0.000168,6,0.000069,0,20,0,0.001433
41025,Harney County,,OR,602,6994,7596,1,1,2,74,72,146,7,0.258139,0.267819,0,0.000117,0.000168,6,0.000069,0,20,0,0.001433
41027,Hood River County,,OR,1773,22973,24746,5,7,12,589,974,1563,6,0.287976,0.302073,2.229093,0.000916,0.001349,6,0.00013,0,20,0.785714,0.008643
41029,Jackson County,,OR,11672,202037,213709,61,49,110,9121,7863,16984,6,0.348253,0.374233,776.803119,0.019544,0.017535,6,0.000696,0,20,0.605072,0.150488
41031,Jefferson County,,OR,1877,20110,21987,10,6,16,1216,983,2199,6,0.286784,0.300452,15.279443,0.002662,0.001388,6,0.000199,0,20,0.911111,0.023435
41033,Josephine County,,OR,4888,79668,84556,33,22,55,4089,2856,6945,6,0.342272,0.3637,250.173472,0.012961,0.006986,6,0.000387,0,20,0.730094,0.097445
41035,Klamath County,,OR,4467,64851,69318,34,24,58,2794,2340,5134,6,0.33794,0.359307,2488.473439,0.013094,0.006793,6,0.000454,0,20,0.708974,0.100189
41037,Lake County,,OR,593,7199,7792,3,2,5,155,124,279,7,0.258231,0.268134,0.131156,0.000228,0.00027,6,0.000097,0,20,0.666667,0.002807
41039,Lane County,,OR,19846,340344,360190,87,69,156,15879,14226,30105,6,0.359526,0.390057,3669.564209,0.02701,0.025321,6,0.001035,0,20,0.480885,0.207149
41041,Lincoln County,,OR,3961,42781,46742,24,18,42,2298,2400,4698,6,0.313747,0.330659,83.296545,0.008246,0.004357,6,0.000386,0,20,0.826154,0.069623
41043,Linn County,,OR,7690,111489,119179,35,24,59,7481,5450,12931,6,0.343647,0.365538,258.45513,0.012445,0.007647,6,0.000505,0,20,0.722222,0.101115
41045,Malheur County,,OR,2386,26930,29316,6,7,13,902,1244,2146,7,0.272115,0.284797,32.851081,0.000364,0.000502,6,0.000193,0,20,0.5,0.004604
41047,Marion County,,OR,19793,304115,323908,64,51,115,17629,15609,33238,6,0.348044,0.374433,1623.668616,0.020196,0.016444,6,0.000817,0,20,0.543052,0.158572
41049,Morrow County,,OR,1083,11416,12499,2,2,4,486,542,1028,7,0.262044,0.272452,0,0.000166,0.00016,6,0.000076,0,20,1,0.001522
41051,Multnomah County,,OR,59185,680580,739765,174,127,301,53173,51508,104681,5,0.395434,0.433322,41480.075855,0.064089,0.048206,6,0.002069,0,20,0.333644,0.470323
41053,Polk County,,OR,6538,67647,74185,27,17,44,6665,4989,11654,6,0.341389,0.361867,107.970307,0.010474,0.005483,6,0.000394,0,20,0.816502,0.084537
41055,Sherman County,,OR,166,1760,1926,0,1,1,0,56,56,7,0.223734,0.230194,0,0,0.000011,6,0.00005,0,177,0,0
41057,Tillamook County,,OR,2019,25295,27314,10,10,20,982,975,1957,6,0.288204,0.302875,0.451166,0.001582,0.002044,6,0.000205,0,20,0.945455,0.016099
41059,Umatilla County,,OR,5414,73626,79040,23,26,49,2783,3231,6014,6,0.34385,0.366054,3165.00984,0.006097,0.007536,6,0.000391,0,20,0.593596,0.052386
41061,Union County,,OR,2082,26268,28350,7,10,17,600,837,1437,6,0.289754,0.304777,5899.999743,0.000882,0.001808,6,0.000213,0,20,0.536364,0.009075
41063,Wallowa County,,OR,554,7553,8107,1,1,2,40,54,94,7,0.224676,0.231295,0,0.000014,0.000007,6,0.000068,0,20,0,0.000162
41065,Wasco County,,OR,1763,23597,25360,9,8,17,981,773,1754,6,0.288119,0.302474,2914.284195,0.001384,0.001665,6,0.000212,0,20,0.625,0.013649
41067,Washington County,,OR,42918,523038,565956,135,109,244,41929,36463,78392,5,0.386917,0.422543,19263.576061,0.049902,0.041306,6,0.001654,0,20,0.380019,0.376244
41069,Wheeler County,,OR,112,1253,1365,0,0,0,0,0,0,0,0,0,0,0,0,116,0.00005,104,178,0,0
41071,Yamhill County,,OR,6463,90544,97007,32,16,48,6353,4361,10714,6,0.339438,0.359817,159.663062,0.011868,0.005109,6,0.000458,0,20,0.784274,0.096122
42001,Adams County,,PA,6198,117095,123293,16,11,27,5073,3760,8833,6,0.301554,0.318116,6.084173,0.005483,0.003092,43,0.000189,0,20,0.79085,0.037852
42003,Allegheny County,,PA,56415,1412143,1468558,205,226,431,35629,47056,82685,5,0.42457,0.471535,165433.013509,0.082543,0.08913,43,0.002184,0,20,0.309717,0.576808
42005,Armstrong County,,PA,3403,79618,83021,6,6,12,2057,2172,4229,6,0.298278,0.313299,2.074242,0.000935,0.000798,43,0.000128,0,20,0.766667,0.006138
42007,Beaver County,,PA,8490,206476,214966,12,23,35,4492,4694,9186,6,0.348628,0.371352,925.327339,0.002381,0.007999,43,0.000173,0,20,0.436594,0.016451
42009,Bedford County,,PA,1844,59365,61209,11,7,18,1072,773,1845,6,0.298676,0.314032,205.565443,0.001247,0.000777,43,0.000216,0,20,0.436364,0.008873
42011,Berks County,,PA,17454,473729,491183,59,61,120,16066,11898,27964,6,0.365119,0.394599,2134.898216,0.026869,0.031169,43,0.000482,0,20,0.62963,0.167493
42013,Blair County,,PA,4484,147317,151801,12,11,23,1932,2021,3953,6,0.299352,0.31575,66.94296,0.001647,0.001935,43,0.000214,0,20,0.608974,0.011975
42015,Bradford County,,PA,3062,72365,75427,8,11,19,1184,1434,2618,7,0.266508,0.279396,484.190265,0.00039,0.000497,97,0.000176,0,20,0.363636,0.002893
42017,Bucks County,,PA,38883,756408,795291,97,126,223,32672,31898,64570,5,0.387071,0.425069,7915.733544,0.048149,0.058147,43,0.000765,0,20,0.493058,0.315449
42019,Butler County,,PA,9747,216862,226609,21,23,44,7122,5620,12742,6,0.353972,0.376695,2297.360313,0.005976,0.008428,43,0.000262,0,20,0.472906,0.040015
42021,Cambria County,,PA,5934,166740,172674,15,16,31,2597,3222,5819,6,0.314901,0.333053,109.377683,0.003249,0.002833,43,0.000228,0,20,0.540936,0.021614
42023,Cameron County,,PA,349,6467,6816,0,2,2,0,123,123,7,0.230155,0.237179,0,0,0,43,0.00005,0,179,0,0
42025,Carbon County,,PA,3760,71914,75674,16,9,25,3583,2383,5966,6,0.292668,0.308322,1.194125,0.006629,0.002521,43,0.000136,0,20,0.895833,0.035895
42027,Centre County,,PA,9189,133036,142225,38,36,74,4113,4025,8138,6,0.363296,0.388952,9760.241017,0.013031,0.016627,43,0.000438,0,20,0.494203,0.088564
42029,Chester County,,PA,29944,555233,585177,111,101,212,28631,23028,51659,6,0.383804,0.418929,5922.441203,0.054521,0.050411,43,0.000916,0,20,0.519514,0.356008
42031,Clarion County,,PA,2091,44534,46625,7,8,15,989,1027,2016,6,0.298492,0.313872,4393.673498,0.000804,0.000811,43,0.000164,0,20,0.553571,0.005644
42033,Clearfield County,,PA,3599,91811,95410,12,9,21,1693,1820,3513,6,0.298768,0.314502,1343.200701,0.001803,0.001075,43,0.000203,0,20,0.551282,0.011927
42035,Clinton County,,PA,1873,41355,43228,2,2,4,876,843,1719,7,0.266948,0.276899,0,0.000159,0.000123,43,0.000072,0,20,1,0.001041
42037,Columbia County,,PA,3202,70500,73702,11,10,21,1896,1645,3541,6,0.292874,0.308837,647.907536,0.002227,0.001808,43,0.000171,0,20,0.681818,0.014519
42039,Crawford County,,PA,4256,99024,103280,8,8,16,2158,2069,4227,6,0.302432,0.318528,16.164585,0.001167,0.001375,43,0.000134,0,20,0.611111,0.007044
42041,Cumberland County,,PA,15347,266931,282278,65,48,113,12728,10154,22882,6,0.357406,0.383814,9748.049013,0.026621,0.019056,43,0.000634,0,20,0.490868,0.176768
42043,Dauphin County,,PA,17603,311054,328657,63,58,121,12760,12662,25422,6,0.363523,0.391592,12175.771778,0.024587,0.024462,43,0.000631,0,20,0.495495,0.160262
42045,Delaware County,,PA,33469,631266,664735,77,92,169,26974,28108,55082,5,0.386146,0.419788,1834.30263,0.039923,0.049166,43,0.000585,0,20,0.648248,0.251792
42047,Elk County,,PA,1308,41847,43155,4,5,9,360,481,841,6,0.298431,0.313414,2890.371945,0.000021,0.00076,43,0.000136,0,20,0.433333,0.000552
42049,Erie County,,PA,10990,314077,325067,35,54,89,4379,5422,9801,6,0.373748,0.402297,8061.720108,0.011884,0.024447,43,0.000425,0,20,0.420891,0.08126
42051,Fayette County,,PA,4751,153509,158260,8,7,15,2639,2668,5307,6,0.314459,0.331123,629.999993,0.001024,0.001646,43,0.000187,0,20,0.5,0.006433
42053,Forest County,,PA,364,5509,5873,1,2,3,45,99,144,7,0.229985,0.237014,0,0.000006,0.000012,43,0.000068,0,20,1,0.000137
42055,Franklin County,,PA,6638,175391,182029,26,16,42,5762,3325,9087,6,0.301554,0.320006,2156.337501,0.007948,0.003147,43,0.000354,0,20,0.502299,0.055626
42057,Fulton County,,PA,793,17608,18401,4,4,8,476,439,915,7,0.25632,0.265473,7.211231,0.000088,0.00013,43,0.000142,0,20,0.55,0.001335
42059,Greene County,,PA,1754,39700,41454,5,4,9,936,887,1823,6,0.298768,0.313677,2.706815,0.000961,0.000699,43,0.000124,0,20,0.9,0.005972
42061,Huntingdon County,,PA,1962,48990,50952,8,9,17,1053,1076,2129,6,0.298921,0.314719,245.67459,0.000571,0.001055,43,0.00019,0,20,0.522222,0.004846
42063,Indiana County,,PA,4245,93417,97662,11,10,21,1897,2188,4085,6,0.298676,0.314416,23.819232,0.001834,0.00103,43,0.000186,0,20,0.551282,0.012438
42065,Jefferson County,,PA,2443,53675,56118,8,8,16,1371,1370,2741,6,0.298492,0.313872,2267.242611,0.000755,0.000859,43,0.00019,0,20,0.466667,0.005562
42067,Juniata County,,PA,1107,28148,29255,7,5,12,637,587,1224,7,0.268524,0.279511,1.528586,0.00087,0.000417,43,0.000149,0,20,0.857143,0.006732
42069,Lackawanna County,,PA,8251,237317,245568,36,30,66,5520,4658,10178,6,0.349005,0.371959,3069.782694,0.014715,0.01269,43,0.000306,0,20,0.633422,0.0807
42071,Lancaster County,,PA,20065,616454,636519,87,80,167,15457,12922,28379,6,0.378168,0.410189,14337.784082,0.039292,0.03547,43,0.000735,0,20,0.491209,0.251637
42073,Lawrence County,,PA,3754,104544,108298,7,8,15,1751,2028,3779,6,0.298523,0.313929,1.240295,0.001245,0.000938,43,0.000102,0,20,0.785714,0.007025
42075,Lebanon County,,PA,6222,157315,163537,21,12,33,4957,3606,8563,6,0.314119,0.331483,20.284881,0.007924,0.004537,43,0.000209,0,20,0.790043,0.049843
42077,Lehigh County,,PA,22389,389791,412180,68,79,147,21461,17083,38544,6,0.375484,0.40752,1459.96795,0.033519,0.041326,43,0.00049,0,20,0.653927,0.205079
42079,Luzerne County,,PA,11989,360252,372241,60,52,112,9248,7449,16697,6,0.354965,0.381329,15134.252059,0.024908,0.021203,43,0.00052,0,20,0.577261,0.150404
42081,Lycoming County,,PA,5195,134202,139397,17,22,39,2049,2692,4741,6,0.301398,0.320561,7604.314309,0.002835,0.003889,43,0.000291,0,20,0.438735,0.019597
42083,McKean County,,PA,1991,48948,50939,7,6,13,670,586,1256,6,0.298584,0.313814,3107.104675,0.000908,0.000751,43,0.000174,0,20,0.285714,0.005907
42085,Mercer County,,PA,5518,134892,140410,11,15,26,2703,2849,5552,6,0.338215,0.358036,325.738623,0.001404,0.003635,43,0.000161,0,20,0.557143,0.008139
42087,Mifflin County,,PA,1792,54278,56070,9,8,17,856,885,1741,7,0.271076,0.282976,15.555306,0.001006,0.000535,43,0.000183,0,20,0.655556,0.007643
42089,Monroe County,,PA,12177,173313,185490,42,60,102,12490,8468,20958,6,0.353241,0.38067,304.765652,0.017369,0.025379,17,0.00028,0,20,0.633681,0.093039
42091,Montgomery County,,PA,56821,919288,976109,134,161,295,46465,49827,96292,5,0.402323,0.444072,14077.484317,0.065489,0.073519,43,0.001094,0,20,0.445484,0.428412
42093,Montour County,,PA,1511,20573,22084,5,4,9,783,768,1551,7,0.262328,0.272615,27.458665,0.000235,0.000252,43,0.000117,0,20,0.9,0.00208
42095,Northampton County,,PA,18929,334803,353732,49,64,113,18784,14097,32881,6,0.36943,0.398929,655.763092,0.023411,0.031531,43,0.000337,0,20,0.69863,0.135817
42097,Northumberland County,,PA,5002,105925,110927,14,18,32,2878,3406,6284,6,0.300713,0.318872,1470.382906,0.002483,0.003343,43,0.000221,0,20,0.615789,0.017126
42099,Perry County,,PA,2654,55542,58196,8,8,16,2002,1886,3888,7,0.277698,0.290685,24.961388,0.000891,0.000994,43,0.000167,0,20,0.722222,0.00696
42101,Philadelphia County,,PA,84238,1418068,1502306,178,175,353,57323,76085,133408,5,0.410437,0.453345,25614.716188,0.07991,0.078584,43,0.001564,0,20,0.408477,0.53803
42103,Pike County,,PA,4562,57980,62542,31,21,52,5767,2563,8330,6,0.338372,0.35929,37.899263,0.012452,0.007204,17,0.000199,0,20,0.769162,0.061362
42105,Potter County,,PA,1281,20261,21542,4,3,7,390,361,751,7,0.232856,0.240795,31.801519,0.000019,0.000031,43,0.000133,0,20,0.083333,0.000551
42107,Schuylkill County,,PA,5038,168794,173832,18,17,35,4109,3083,7192,6,0.294564,0.311569,12.829209,0.005184,0.00414,43,0.000195,0,20,0.773684,0.031543
42109,Snyder County,,PA,1921,42545,44466,9,6,15,1391,1031,2422,7,0.266826,0.277689,49.103683,0.000685,0.000236,43,0.000185,0,20,0.680556,0.005886
42111,Somerset County,,PA,3018,89566,92584,8,8,16,1467,1296,2763,6,0.299106,0.314891,981.728377,0.000971,0.001116,43,0.000184,0,20,0.433333,0.006563
42113,Sullivan County,,PA,429,7008,7437,2,2,4,125,178,303,7,0.231817,0.240187,0,0.000034,0.000025,97,0.000075,0,20,1,0.000374
42115,Susquehanna County,,PA,2430,49821,52251,10,5,15,1453,1276,2729,7,0.266094,0.277764,71.402699,0.002097,0.000479,43,0.000157,0,20,0.522222,0.013599
42117,Tioga County,,PA,2331,45482,47813,9,7,16,844,813,1657,6,0.282689,0.297142,1864.144048,0.001749,0.000735,97,0.000167,0,20,0.347222,0.011552
42119,Union County,,PA,2473,41264,43737,6,5,11,1390,1275,2665,7,0.23178,0.24056,11.677733,0.000537,0.000066,43,0.00013,0,20,0.690476,0.004201
42121,Venango County,,PA,2693,64425,67118,8,6,14,1132,1240,2372,6,0.2984,0.313471,3.651667,0.00106,0.000805,43,0.000138,0,20,0.732143,0.006519
42123,Warren County,,PA,1927,48194,50121,5,6,11,631,818,1449,6,0.298553,0.313729,5.094702,0.000952,0.000774,43,0.000111,0,20,0.666667,0.00576
42125,Washington County,,PA,9777,243151,252928,14,22,36,6564,5856,12420,6,0.34934,0.371942,1339.483398,0.003531,0.00802,43,0.000227,0,20,0.416667,0.023245
42127,Wayne County,,PA,3356,53755,57111,21,10,31,2503,1674,4177,6,0.305287,0.321163,68.65871,0.008704,0.002564,17,0.00018,0,20,0.749012,0.046265
42129,Westmoreland County,,PA,15688,443717,459405,29,49,78,10495,10663,21158,6,0.370653,0.398356,5174.195142,0.010888,0.02017,43,0.000364,0,20,0.468672,0.077668
42131,Wyoming County,,PA,1991,33041,35032,4,4,8,1113,1258,2371,7,0.262422,0.27273,1.145922,0.000271,0.000327,43,0.000108,0,20,0.833333,0.002296
42133,York County,,PA,19766,504054,523820,66,70,136,21497,13350,34847,6,0.372742,0.403339,6981.396452,0.02704,0.031352,43,0.0006,0,20,0.496629,0.176491
44001,Bristol County,,RI,3768,55080,58848,8,6,14,2025,2239,4264,6,0.302118,0.317251,0.212835,0.00361,0.001873,44,0.000092,0,20,0.930556,0.019632
44003,Kent County,,RI,13533,199090,212623,19,37,56,9271,10030,19301,6,0.354532,0.380137,195.531244,0.009207,0.020386,44,0.000165,0,20,0.770513,0.056136
44005,Newport County,,RI,9158,92489,101647,23,30,53,3298,4557,7855,6,0.354273,0.37858,216.754708,0.010385,0.016334,44,0.000205,0,20,0.659159,0.065352
44007,Providence County,,RI,36697,674471,711168,75,125,200,21558,29881,51439,5,0.391708,0.429467,3024.96168,0.040826,0.061604,44,0.000602,0,20,0.526476,0.270372
44009,Washington County,,RI,9118,143162,152280,18,29,47,5560,5909,11469,6,0.347421,0.37083,52.959311,0.00785,0.015309,44,0.000148,0,20,0.829637,0.045777
45001,Abbeville County,,SC,1574,26559,28133,5,5,10,767,1056,1823,7,0.279512,0.291269,578.181374,0.000356,0.000596,99,0.000151,0,20,0.7,0.004906
45003,Aiken County,,SC,9307,160588,169895,38,30,68,5537,5362,10899,6,0.339557,0.362216,7329.370688,0.015115,0.010984,99,0.000577,0,20,0.492271,0.12164
45005,Allendale County,,SC,700,9745,10445,3,5,8,223,385,608,7,0.286164,0.299809,3.195145,0.000109,0.000988,99,0.000096,0,20,0.6,0.001288
45007,Anderson County,,SC,8970,189173,198143,31,20,51,6788,5525,12313,6,0.315071,0.333545,1243.492691,0.011029,0.00602,99,0.000539,0,20,0.553977,0.093889
45009,Bamberg County,,SC,1007,15570,16577,3,4,7,320,499,819,7,0.285574,0.298549,0.868853,0.000186,0.000658,99,0.000096,0,20,0.833333,0.002006
45011,Barnwell County,,SC,1298,23835,25133,5,8,13,596,673,1269,7,0.290419,0.30494,82.204594,0.000543,0.001475,99,0.000128,0,20,0.642857,0.004839
45013,Beaufort County,,SC,15308,141912,157220,109,69,178,10468,7580,18048,6,0.372028,0.403184,10255.944268,0.053763,0.032761,99,0.001135,0,20,0.486286,0.369191
45015,Berkeley County,,SC,18914,156763,175677,53,45,98,13557,12650,26207,6,0.357406,0.384227,1673.808597,0.023506,0.019397,99,0.00067,0,20,0.528846,0.178578
45017,Calhoun County,,SC,1084,15353,16437,3,3,6,676,731,1407,7,0.285518,0.298319,0,0.000562,0.000654,99,0.000095,0,20,1,0.005183
45019,Charleston County,,SC,32044,323024,355068,138,112,250,22622,23605,46227,6,0.396944,0.433076,27008.862304,0.059334,0.051833,99,0.001624,0,20,0.405507,0.418267
45021,Cherokee County,,SC,2443,56887,59330,8,7,15,1573,1540,3113,7,0.279781,0.292099,153.933272,0.001235,0.0011,99,0.000204,0,20,0.666667,0.014425
45023,Chester County,,SC,2112,36760,38872,5,5,10,1154,1416,2570,6,0.303188,0.317938,42.597593,0.00116,0.001584,99,0.000155,0,20,0.7,0.011971
45025,Chesterfield County,,SC,2194,46377,48571,9,12,21,1191,1343,2534,6,0.303758,0.319685,55.543533,0.001046,0.002905,99,0.000214,0,20,0.596154,0.012535
45027,Clarendon County,,SC,2012,33030,35042,7,7,14,941,1082,2023,7,0.290101,0.304156,5.496282,0.001185,0.001246,99,0.000139,0,20,0.803571,0.009796
45029,Colleton County,,SC,2319,40534,42853,7,8,15,1075,1262,2337,7,0.290101,0.304694,5.926256,0.001316,0.001884,99,0.000153,0,20,0.857143,0.012701
45031,Darlington County,,SC,4358,73880,78238,13,14,27,2583,2910,5493,6,0.30548,0.322016,192.843927,0.001949,0.002822,99,0.000259,0,20,0.595238,0.01845
45033,Dillon County,,SC,1570,33286,34856,6,7,13,751,800,1551,7,0.287067,0.30096,8.463071,0.000348,0.001003,99,0.000152,0,20,0.690476,0.00462
45035,Dorchester County,,SC,12217,119763,131980,47,22,69,11792,7417,19209,6,0.331511,0.353116,405.215984,0.021245,0.008632,99,0.000587,0,20,0.601295,0.15615
45037,Edgefield County,,SC,1766,24756,26522,4,6,10,1057,1196,2253,7,0.276196,0.288669,17.582075,0.000433,0.000703,99,0.000115,0,20,0.733333,0.00411
45039,Fairfield County,,SC,1422,24796,26218,5,4,9,757,861,1618,7,0.285546,0.298491,2.316351,0.000567,0.000648,99,0.000146,0,20,0.6,0.005422
45041,Florence County,,SC,7936,138258,146194,26,26,52,4897,5028,9925,6,0.321582,0.34189,1137.733985,0.006108,0.007558,99,0.000461,0,20,0.5,0.057047
45043,Georgetown County,,SC,4295,63227,67522,14,12,26,2186,2345,4531,6,0.31103,0.327778,74.95848,0.005155,0.004078,99,0.000254,0,20,0.720833,0.043721
45045,Greenville County,,SC,25056,434187,459243,152,75,227,23425,17065,40490,6,0.38738,0.41937,25147.570862,0.06296,0.034576,99,0.001818,0,20,0.394293,0.451016
45047,Greenwood County,,SC,3694,70954,74648,15,14,29,1958,2175,4133,6,0.305704,0.322543,2721.688403,0.001553,0.002942,99,0.000337,0,20,0.53268,0.018766
45049,Hampton County,,SC,1115,20712,21827,5,7,12,495,556,1051,7,0.290014,0.304408,85.73189,0.000685,0.001524,99,0.000129,0,20,0.547619,0.006629
45051,Horry County,,SC,14985,240474,255459,165,66,231,17506,7610,25116,6,0.372742,0.403305,22591.982477,0.057621,0.0262,99,0.0018,0,20,0.305114,0.389513
45053,Jasper County,,SC,1494,18815,20309,3,4,7,860,830,1690,7,0.281677,0.294534,10.314843,0.000566,0.000787,99,0.000093,0,20,0.666667,0.005656
45055,Kershaw County,,SC,3615,62344,65959,11,14,25,2447,2086,4533,6,0.305608,0.322216,76.722812,0.001078,0.003321,99,0.000258,0,20,0.648352,0.01245
45057,Lancaster County,,SC,3262,67570,70832,8,10,18,1948,2119,4067,6,0.303694,0.31937,15.329493,0.001463,0.002681,99,0.000215,0,20,0.711111,0.01748
45059,Laurens County,,SC,3948,67982,71930,10,10,20,2480,2779,5259,7,0.29013,0.304557,38.807647,0.001286,0.001855,99,0.000238,0,20,0.689394,0.01323
45061,Lee County,,SC,1324,19335,20659,5,5,10,771,843,1614,7,0.286474,0.29962,0,0.000617,0.000594,99,0.000119,0,20,1,0.005009
45063,Lexington County,,SC,17332,256153,273485,67,45,112,14960,12141,27101,6,0.354921,0.380481,13207.044771,0.024018,0.017027,99,0.001008,0,20,0.400407,0.190814
45065,McCormick County,,SC,518,9534,10052,2,5,7,150,317,467,7,0.274166,0.286229,11.544106,0.000027,0.000514,99,0.000096,0,20,0.5,0.000372
45067,Marion County,,SC,2021,35737,37758,5,6,11,834,1195,2029,6,0.303441,0.318454,16.080326,0.000679,0.001787,99,0.000135,0,20,0.9,0.007358
45069,Marlboro County,,SC,1705,30037,31742,7,10,17,667,1076,1743,6,0.30823,0.324404,39.012374,0.000558,0.002417,99,0.000151,0,20,0.611111,0.004827
45071,Newberry County,,SC,1702,38233,39935,8,8,16,1050,1000,2050,7,0.288805,0.302621,111.20993,0.000931,0.001291,99,0.000202,0,20,0.597222,0.010332
45073,Oconee County,,SC,3625,75787,79412,7,7,14,1469,1708,3177,6,0.302526,0.317984,0,0.001879,0.002154,99,0.000166,0,20,1,0.017973
45075,Orangeburg County,,SC,5171,93668,98839,15,19,34,2375,3289,5664,6,0.315106,0.334611,489.864228,0.003041,0.005531,99,0.000286,0,20,0.564327,0.027253
45077,Pickens County,,SC,7691,112540,120231,15,15,30,4789,4993,9782,6,0.312769,0.330836,70.767222,0.004637,0.005137,99,0.000288,0,20,0.716374,0.038922
45079,Richland County,,SC,30164,343528,373692,143,119,262,25710,22687,48397,6,0.399232,0.436695,57079.309844,0.057234,0.049902,99,0.00179,0,20,0.37469,0.415437
45081,Saluda County,,SC,1122,19133,20255,5,5,10,641,715,1356,7,0.26292,0.273291,10.290172,0.000633,0.000326,99,0.000135,0,20,0.7,0.006264
45083,Spartanburg County,,SC,12686,285943,298629,53,36,89,9609,8301,17910,6,0.335408,0.359318,5633.659764,0.01867,0.012269,99,0.000805,0,20,0.448568,0.144325
45085,Sumter County,,SC,9507,113106,122613,28,37,65,3180,4504,7684,6,0.358684,0.384507,2761.352726,0.01018,0.015905,99,0.000435,0,20,0.497886,0.082972
45087,Union County,,SC,1261,31482,32743,3,6,9,443,732,1175,7,0.288662,0.302105,6.361396,0.000114,0.001104,99,0.000115,0,20,0.8,0.001582
45089,Williamsburg County,,SC,2022,35823,37845,5,9,14,713,1269,1982,6,0.304744,0.320309,12.346734,0.000691,0.002572,99,0.000136,0,20,0.833333,0.007576
45091,York County,,SC,11259,210203,221462,88,35,123,13671,6539,20210,6,0.350771,0.374324,3422.68477,0.037939,0.012635,99,0.001119,0,20,0.486338,0.2796
46003,Aurora County,,SD,211,3280,3491,1,1,2,56,67,123,8,0.213312,0.218653,0,0.000001,0.000001,24,0.00012,0,20,0,0.00012
46005,Beadle County,,SD,1291,17914,19205,4,5,9,257,408,665,7,0.271202,0.282529,2920.416667,0.000164,0.000174,24,0.000224,0,20,0.533333,0.001837
46007,Bennett County,,SD,236,3103,3339,1,2,3,53,100,153,7,0.262186,0.271641,0,0.000001,0.000072,24,0.000082,0,20,1,0.000093
46009,Bon Homme County,,SD,400,7107,7507,1,2,3,92,164,256,7,0.268922,0.278823,0,0.000001,0.000099,24,0.000102,0,20,1,0.000106
46011,Brookings County,,SD,2557,28405,30962,13,13,26,1014,1229,2243,6,0.307676,0.323505,8471.306841,0.000182,0.000779,24,0.000685,0,20,0.258242,0.002865
46013,Brown County,,SD,2405,41236,43641,10,9,19,716,798,1514,6,0.308034,0.323562,17439.544142,0.000174,0.000817,24,0.000569,0,20,0.301282,0.002487
46015,Brule County,,SD,436,4980,5416,0,2,2,0,111,111,7,0.269014,0.279014,0,0,0.0001,24,0.00005,0,180,1,0
46017,Buffalo County,,SD,148,1938,2086,0,0,0,0,0,0,0,0,0,0,0,0,117,0.00005,105,181,0,0
46019,Butte County,,SD,1090,9715,10805,3,4,7,428,516,944,7,0.263277,0.273434,0,0.000087,0.0001,24,0.000128,0,20,0.916667,0.001011
46021,Campbell County,,SD,116,1806,1922,0,0,0,0,0,0,0,0,0,0,0,0,118,0.00005,106,182,0,0
46023,Charles Mix County,,SD,569,9753,10322,2,2,4,94,180,274,7,0.268971,0.278938,0,0.000092,0.0001,24,0.000153,0,20,1,0.001044
46025,Clark County,,SD,334,3946,4280,1,1,2,51,93,144,8,0.214175,0.220099,0,0.000002,0.000006,24,0.000093,0,20,0,0.000158
46027,Clay County,,SD,1644,11431,13075,5,6,11,464,712,1176,7,0.271785,0.283434,58.981592,0.000173,0.000206,24,0.000243,0,20,0.633333,0.002034
46029,Codington County,,SD,2087,30928,33015,12,12,24,1027,1007,2034,7,0.272523,0.285639,18331.965025,0.00077,0.000223,24,0.000605,0,20,0.275641,0.006852
46031,Corson County,,SD,369,3517,3886,2,2,4,101,136,237,8,0.20137,0.205693,5878,0,0,24,0.000298,0,20,0,0.000176
46033,Custer County,,SD,845,7666,8511,2,2,4,302,284,586,7,0.262091,0.271469,0,0.000073,0.000072,24,0.000145,0,20,1,0.000805
46035,Davison County,,SD,1707,21679,23386,10,7,17,735,594,1329,7,0.271126,0.282586,20582.170536,0.000167,0.000172,24,0.000577,0,20,0.111111,0.002346
46037,Day County,,SD,418,6707,7125,3,2,5,151,123,274,7,0.235647,0.242635,2,0.000094,0.000007,24,0.000172,0,20,0.75,0.001174
46039,Deuel County,,SD,372,5467,5839,2,2,4,143,165,308,7,0.235723,0.242836,0,0.000008,0.000007,24,0.000138,0,20,1,0.000287
46041,Dewey County,,SD,512,6568,7080,1,2,3,59,115,174,7,0.262115,0.271527,2970,0.000072,0.000071,24,0.000079,0,20,0,0.000709
46043,Douglas County,,SD,230,3747,3977,0,1,1,0,43,43,8,0.213354,0.218749,0,0,0.000001,24,0.00005,0,183,0,0
46045,Edmunds County,,SD,279,4475,4754,1,1,2,96,115,211,7,0.235513,0.24212,0,0.000006,0.000001,24,0.000104,0,20,0,0.000121
46047,Fall River County,,SD,705,7463,8168,3,2,5,163,187,350,7,0.262091,0.271469,1,0.000073,0.000072,24,0.000156,0,20,0.5,0.000889
46049,Faulk County,,SD,174,2500,2674,0,0,0,0,0,0,0,0,0,0,0,0,119,0.00005,107,184,0,0
46051,Grant County,,SD,571,9230,9801,1,3,4,43,168,211,7,0.269046,0.279224,0,0.000002,0.000104,24,0.000093,0,20,0.833333,0.000158
46053,Gregory County,,SD,254,4873,5127,0,1,1,0,49,49,7,0.268915,0.27867,0,0,0.000098,24,0.00005,0,185,0,0
46055,Haakon County,,SD,198,2314,2512,1,0,1,45,0,45,0,0,0,0,0.000072,0,24,0.000079,0,0,0,0.000709
46057,Hamlin County,,SD,501,6143,6644,2,3,5,205,276,481,7,0.269071,0.279282,0,0.000008,0.000106,24,0.000138,0,20,1,0.000287
46059,Hand County,,SD,223,4082,4305,0,0,0,0,0,0,0,0,0,0,0,0,120,0.00005,108,186,0,0
46061,Hanson County,,SD,228,3552,3780,1,1,2,44,74,118,8,0.213312,0.218653,0,0.000001,0.000001,24,0.00012,0,20,0,0.00012
46063,Harding County,,SD,80,1551,1631,0,0,0,0,0,0,0,0,0,0,0,0,121,0.00005,109,187,0,0
46065,Hughes County,,SD,1590,19508,21098,4,5,9,442,555,997,7,0.271152,0.282414,5878,0.000169,0.000172,24,0.000232,0,20,0.6,0.00185
46067,Hutchinson County,,SD,513,8722,9235,1,2,3,40,178,218,7,0.268971,0.278938,0,0.000001,0.0001,24,0.00012,0,20,1,0.00012
46069,Hyde County,,SD,143,1805,1948,0,0,0,0,0,0,0,0,0,0,0,0,122,0.00005,110,188,0,0
46071,Jackson County,,SD,203,2826,3029,0,1,1,0,55,55,7,0.262111,0.271376,0,0,0.000071,24,0.00005,0,189,0,0
46073,Jerauld County,,SD,196,2639,2835,0,1,1,0,53,53,8,0.213401,0.218778,0,0,0.000001,24,0.00005,0,190,0,0
46075,Jones County,,SD,80,1242,1322,0,0,0,0,0,0,0,0,0,0,0,0,123,0.00005,111,191,0,0
46077,Kingsbury County,,SD,390,6363,6753,2,1,3,137,92,229,7,0.235304,0.241965,0,0.000097,0.000001,24,0.000128,0,20,1,0.001054
46079,Lake County,,SD,878,11880,12758,2,3,5,284,377,661,7,0.268996,0.27911,0,0.000097,0.000109,24,0.000128,0,20,1,0.001054
46081,Lawrence County,,SD,2419,24011,26430,6,6,12,875,1026,1901,7,0.271937,0.283531,1906.015682,0.00119,0.00019,24,0.00021,0,20,0.5,0.010494
46083,Lincoln County,,SD,3807,37311,41118,15,10,25,4005,2530,6535,6,0.307741,0.32315,1907.394935,0.001197,0.000771,24,0.000584,0,20,0.314286,0.009945
46085,Lyman County,,SD,260,4060,4320,0,0,0,0,0,0,0,0,0,0,0,0,124,0.00005,112,192,0,0
46087,McCook County,,SD,482,6652,7134,1,1,2,113,163,276,7,0.268872,0.278594,0,0.000091,0.000098,24,0.000083,0,20,0,0.000924
46089,McPherson County,,SD,159,2772,2931,0,1,1,0,44,44,7,0.235556,0.242209,0,0,0.000001,24,0.00005,0,193,0,0
46091,Marshall County,,SD,293,4880,5173,0,1,1,0,43,43,8,0.212064,0.217003,0,0,0,24,0.00005,0,194,0,0
46093,Meade County,,SD,4894,28993,33887,5,7,12,2031,2103,4134,6,0.320414,0.335945,640.869345,0.000551,0.001713,24,0.000162,0,20,0.458333,0.004621
46095,Mellette County,,SD,146,1910,2056,0,0,0,0,0,0,0,0,0,0,0,0,125,0.00005,113,195,0,0
46097,Miner County,,SD,187,2792,2979,0,0,0,0,0,0,0,0,0,0,0,0,126,0.00005,114,196,0,0
46099,Minnehaha County,,SD,13430,195499,208929,62,49,111,9361,8272,17633,6,0.367703,0.394731,164343.347976,0.012677,0.011731,24,0.001895,0,20,0.157155,0.098966
46101,Moody County,,SD,478,7739,8217,2,2,4,166,189,355,7,0.268971,0.278938,0,0.000097,0.0001,24,0.000128,0,20,1,0.001054
46103,Pennington County,,SD,9545,103855,113400,41,36,77,4925,4608,9533,6,0.355095,0.379926,89413.366254,0.009166,0.009284,24,0.001199,0,20,0.211841,0.075057
46105,Perkins County,,SD,229,3483,3712,0,0,0,0,0,0,0,0,0,0,0,0,127,0.00005,115,197,0,0
46107,Potter County,,SD,155,3082,3237,0,0,0,0,0,0,0,0,0,0,0,0,128,0.00005,116,198,0,0
46109,Roberts County,,SD,678,11303,11981,3,3,6,143,163,306,7,0.269046,0.279224,2910.333333,0.000003,0.000105,24,0.000162,0,20,0.4,0.000328
46111,Sanborn County,,SD,200,2912,3112,0,1,1,0,41,41,8,0.213354,0.218749,0,0,0.000001,24,0.00005,0,199,0,0
46113,Shannon County,,SD,631,11680,12311,2,3,5,224,284,508,7,0.262257,0.271928,8913.709401,0.000073,0.000071,24,0.000114,0,20,0.166667,0.000795
46115,Spink County,,SD,424,7380,7804,1,1,2,80,115,195,7,0.235513,0.24212,0,0.000006,0.000001,24,0.000104,0,20,0,0.000121
46117,Stanley County,,SD,393,3489,3882,1,1,2,203,194,397,8,0.213327,0.218624,0,0.000001,0.000001,24,0.00009,0,20,0,0.000105
46119,Sully County,,SD,107,1877,1984,0,0,0,0,0,0,0,0,0,0,0,0,129,0.00005,117,200,0,0
46121,Todd County,,SD,508,8412,8920,1,2,3,44,129,173,7,0.262177,0.271626,2911,0,0.000071,24,0.000145,0,117,0,0.000086
46123,Tripp County,,SD,443,6945,7388,0,1,1,0,44,44,7,0.268915,0.27867,0,0,0.000098,24,0.00005,0,201,0,0
46125,Turner County,,SD,716,9766,10482,2,2,4,313,391,704,7,0.268897,0.278766,0,0.000097,0.000108,24,0.000133,0,20,1,0.00111
46127,Union County,,SD,1546,15901,17447,6,7,13,1038,771,1809,7,0.295342,0.308193,155.256168,0.00014,0.000457,24,0.00025,0,20,0.52381,0.00181
46129,Walworth County,,SD,507,6399,6906,1,1,2,88,53,141,9,0.167627,0.170146,0,0,0,24,0.000177,0,20,0,0.000089
46135,Yankton County,,SD,1594,23953,25547,6,4,10,557,525,1082,7,0.268971,0.279167,3086.096073,0.0001,0.000109,24,0.000242,0,20,0.233333,0.001476
46137,Ziebach County,,SD,100,1186,1286,1,0,1,54,0,54,0,0,0,0,0.000001,0,24,0.000084,0,15,0,0.000091
47001,Anderson County,,TN,5470,77472,82942,7,9,16,3196,3288,6484,6,0.299475,0.313116,93.663509,0.000335,0.001158,130,0.000244,0,20,0.486111,0.004263
47003,Bedford County,,TN,2688,45541,48229,10,8,18,1901,1541,3442,6,0.297576,0.310389,1137.731376,0.000868,0.000908,130,0.000303,0,20,0.588889,0.010067
47005,Benton County,,TN,1070,16744,17814,3,5,8,316,448,764,7,0.25197,0.260947,9.017929,0.000026,0.00005,130,0.000124,0,20,0.45,0.000435
47007,Bledsoe County,,TN,831,11128,11959,4,4,8,463,423,886,7,0.274891,0.285954,8.436763,0.000219,0.00027,130,0.000177,0,20,0.583333,0.002494
47009,Blount County,,TN,6872,127318,134190,29,13,42,5264,3780,9044,6,0.3,0.314548,1536.26009,0.010676,0.001419,130,0.00059,0,20,0.392473,0.081212
47011,Bradley County,,TN,5948,98120,104068,19,14,33,3404,3052,6456,6,0.308557,0.324914,2594.022428,0.006252,0.002246,130,0.000435,0,20,0.414286,0.050597
47013,Campbell County,,TN,1802,37481,39283,5,6,11,876,986,1862,7,0.286164,0.298486,3278.297506,0.00032,0.00046,130,0.000185,0,20,0.3,0.003337
47015,Cannon County,,TN,1044,13814,14858,4,5,9,706,701,1407,6,0.297424,0.309788,0.442857,0.000642,0.000855,130,0.000157,0,20,0.9,0.006603
47017,Carroll County,,TN,2055,31134,33189,7,8,15,1249,1366,2615,6,0.308753,0.323305,1130.048495,0.000651,0.001275,130,0.000216,0,20,0.642857,0.005596
47019,Carter County,,TN,3491,56265,59756,6,8,14,1913,2249,4162,7,0.286361,0.299035,1016.556825,0.00035,0.000454,130,0.000209,0,20,0.464286,0.004036
47021,Cheatham County,,TN,3577,41271,44848,9,9,18,2694,2535,5229,6,0.301273,0.314868,6.695982,0.001164,0.001535,130,0.000258,0,20,0.875,0.012321
47023,Chester County,,TN,1199,15663,16862,6,4,10,700,623,1323,6,0.306736,0.32,1,0.000639,0.000649,130,0.000197,0,20,0.8,0.005423
47025,Claiborne County,,TN,1605,32593,34198,7,8,15,885,928,1813,7,0.286305,0.298944,561.710628,0.000323,0.000393,130,0.000255,0,20,0.303571,0.003658
47027,Clay County,,TN,443,8047,8490,2,3,5,131,196,327,7,0.231062,0.237907,6.535714,0.000008,0.00003,130,0.000104,0,20,0.333333,0.000239
47029,Cocke County,,TN,1708,35785,37493,5,5,10,864,986,1850,7,0.28563,0.297552,0.2,0.000328,0.000472,130,0.00024,0,20,0.95,0.004141
47031,Coffee County,,TN,3696,55089,58785,13,10,23,2289,2096,4385,6,0.299198,0.313013,5847.53283,0.002091,0.001221,130,0.000365,0,20,0.433333,0.019078
47033,Crockett County,,TN,1133,15464,16597,6,4,10,699,618,1317,7,0.251404,0.26003,2.2,0.000651,0.000048,130,0.000182,0,20,0.766667,0.005477
47035,Cumberland County,,TN,2691,56408,59099,20,10,30,1383,995,2378,6,0.299938,0.314089,8656.565922,0.006123,0.001456,130,0.000482,0,20,0.413043,0.053112
47037,Davidson County,,TN,55399,608702,664101,216,146,362,41817,44683,86500,5,0.422781,0.459885,196033.987924,0.078305,0.061717,130,0.003244,0,20,0.287616,0.574889
47039,Decatur County,,TN,766,11398,12164,3,2,5,249,340,589,7,0.251122,0.259223,1421.677059,0.000032,0.000032,130,0.000131,0,20,0.333333,0.000519
47041,DeKalb County,,TN,1332,18108,19440,8,7,15,814,816,1630,6,0.297546,0.310246,515.257215,0.000681,0.000909,130,0.000281,0,20,0.678571,0.007644
47043,Dickson County,,TN,3348,49948,53296,10,9,19,2364,2077,4441,6,0.301305,0.314926,18.474104,0.00117,0.001499,130,0.00028,0,20,0.766667,0.012448
47045,Dyer County,,TN,2473,41884,44357,10,11,21,1270,1339,2609,6,0.309081,0.324135,5694.82925,0.00142,0.001501,130,0.000294,0,20,0.386364,0.006761
47047,Fayette County,,TN,2555,37658,40213,6,6,12,3546,1797,5343,6,0.3068,0.320344,5.221825,0.000657,0.000767,130,0.000195,0,20,0.6,0.00621
47049,Fentress County,,TN,655,16893,17548,4,2,6,267,197,464,7,0.230971,0.237615,1.436111,0.000029,0.000073,130,0.00017,0,20,0.5,0.001036
47051,Franklin County,,TN,2552,42939,45491,9,9,18,1289,1463,2752,6,0.299506,0.313385,3159.032846,0.000855,0.001419,130,0.000288,0,20,0.488889,0.008947
47053,Gibson County,,TN,2976,52091,55067,9,9,18,2117,1852,3969,6,0.30895,0.323706,763.811324,0.000663,0.001287,130,0.000276,0,20,0.533333,0.005848
47055,Giles County,,TN,1797,32172,33969,8,8,16,1011,1074,2085,6,0.298983,0.312354,51.287489,0.000923,0.001241,130,0.000238,0,20,0.571429,0.009946
47057,Grainger County,,TN,1502,21392,22894,7,7,14,1053,1026,2079,7,0.285855,0.298171,8.622252,0.000335,0.000477,130,0.000295,0,20,0.642857,0.004384
47059,Greene County,,TN,2867,71850,74717,10,7,17,1498,1336,2834,7,0.286051,0.298457,161.863435,0.000374,0.000473,130,0.000395,0,20,0.611111,0.005335
47061,Grundy County,,TN,740,14547,15287,3,4,7,193,384,577,7,0.230916,0.237987,8.925678,0.000022,0.00003,130,0.000135,0,20,0.416667,0.000522
47063,Hamblen County,,TN,4201,62153,66354,11,10,21,2339,2576,4915,7,0.286164,0.29903,1558.936602,0.001166,0.000549,130,0.000432,0,20,0.462121,0.010482
47065,Hamilton County,,TN,18558,345946,364504,80,64,144,11984,11945,23929,6,0.378463,0.408276,63740.908722,0.028216,0.025811,130,0.001454,0,20,0.336264,0.214816
47067,Hancock County,,TN,312,4649,4961,1,2,3,63,146,209,8,0.222596,0.228635,0,0.000004,0.000012,130,0.000094,0,20,1,0.000139
47069,Hardeman County,,TN,1428,27219,28647,5,7,12,711,854,1565,6,0.308688,0.323076,16.635973,0.000635,0.001267,130,0.000173,0,20,0.595238,0.005297
47071,Hardin County,,TN,1426,26356,27782,6,8,14,603,670,1273,6,0.307189,0.32126,1864.24164,0.00064,0.000669,130,0.000216,0,20,0.410714,0.005465
47073,Hawkins County,,TN,3856,59009,62865,11,9,20,2526,2436,4962,7,0.286164,0.298886,5856.813845,0.000362,0.000474,130,0.000459,0,20,0.418182,0.00482
47075,Haywood County,,TN,1252,21847,23099,7,8,15,712,894,1606,6,0.308721,0.323247,405.176299,0.000646,0.001291,130,0.000221,0,20,0.535714,0.005686
47077,Henderson County,,TN,1406,29259,30665,7,7,14,904,751,1655,6,0.30693,0.320687,1054.293519,0.000644,0.00066,130,0.000257,0,20,0.547619,0.005525
47079,Henry County,,TN,1998,33563,35561,7,7,14,820,853,1673,6,0.308786,0.323247,1960.48122,0.001099,0.001275,130,0.000212,0,20,0.428571,0.00985
47081,Hickman County,,TN,1844,22899,24743,7,7,14,1197,1247,2444,6,0.297516,0.31016,7.160035,0.000842,0.001172,130,0.000212,0,20,0.714286,0.009318
47083,Houston County,,TN,527,8131,8658,3,3,6,219,254,473,7,0.285294,0.297057,6.116656,0.000293,0.000233,130,0.000111,0,20,0.5,0.002021
47085,Humphreys County,,TN,1087,19751,20838,5,6,11,557,460,1017,6,0.301118,0.314267,1066.11335,0.000502,0.000852,130,0.000174,0,20,0.4,0.005133
47087,Jackson County,,TN,937,11236,12173,2,3,5,350,489,839,7,0.230989,0.237787,1.285714,0.000014,0.000031,130,0.000108,0,20,0.666667,0.000423
47089,Jefferson County,,TN,4166,48440,52606,11,9,20,3065,2803,5868,7,0.286079,0.298743,106.58838,0.001392,0.000573,130,0.000415,0,20,0.530303,0.014341
47091,Johnson County,,TN,806,16090,16896,2,4,6,169,335,504,7,0.244702,0.253558,19.389192,0.000031,0.000104,130,0.000093,0,20,0.5,0.000462
47093,Knox County,,TN,26012,417716,443728,120,93,213,21158,17653,38811,6,0.399561,0.433288,115695.760225,0.047933,0.039105,130,0.001997,0,20,0.377854,0.362764
47095,Lake County,,TN,414,5243,5657,2,2,4,137,245,382,7,0.236201,0.242792,0,0.000022,0.000016,130,0.0001,0,20,1,0.000289
47097,Lauderdale County,,TN,1500,25613,27113,5,6,11,833,906,1739,6,0.306897,0.320487,50.900925,0.001098,0.000681,130,0.000152,0,20,0.666667,0.009693
47099,Lawrence County,,TN,2054,42756,44810,6,7,13,782,957,1739,6,0.297759,0.310561,2651.913839,0.000527,0.00089,130,0.000216,0,20,0.428571,0.005519
47101,Lewis County,,TN,669,11743,12412,3,3,6,248,264,512,7,0.243494,0.251168,3811.935949,0.000029,0.000047,130,0.000124,0,20,0.333333,0.000586
47103,Lincoln County,,TN,1617,35316,36933,9,9,18,1014,1045,2059,6,0.298983,0.312497,784.13077,0.000775,0.001224,130,0.000282,0,20,0.555556,0.008421
47105,Loudon County,,TN,3407,49016,52423,8,8,16,2344,2244,4588,7,0.286474,0.299413,86.466977,0.001038,0.000769,130,0.000271,0,20,0.569444,0.008797
47107,McMinn County,,TN,3123,52749,55872,9,10,19,1923,1974,3897,7,0.287464,0.301109,111.236768,0.000552,0.000966,130,0.000312,0,20,0.522222,0.006559
47109,McNairy County,,TN,1549,26135,27684,7,6,13,890,821,1711,6,0.30693,0.320573,889.007289,0.000644,0.000659,130,0.000239,0,20,0.47619,0.005654
47111,Macon County,,TN,1144,22111,23255,7,8,15,698,673,1371,6,0.297637,0.310475,4383.553894,0.000546,0.001011,130,0.000261,0,20,0.517857,0.006583
47113,Madison County,,TN,6804,101254,108058,23,20,43,4032,4002,8034,6,0.335253,0.355504,11377.52809,0.003512,0.003404,130,0.000593,0,20,0.242165,0.023352
47115,Marion County,,TN,1424,30120,31544,6,7,13,852,845,1697,7,0.274995,0.286613,285.358998,0.000212,0.000245,130,0.000216,0,20,0.392857,0.002366
47117,Marshall County,,TN,1834,31953,33787,7,7,14,1361,1114,2475,6,0.297516,0.31016,3.062659,0.000838,0.00117,130,0.000221,0,20,0.761905,0.009314
47119,Maury County,,TN,5173,82151,87324,17,13,30,4007,3042,7049,6,0.32144,0.338975,8968.798662,0.005561,0.002803,130,0.00036,0,20,0.435673,0.03486
47121,Meigs County,,TN,988,11094,12082,5,5,10,716,655,1371,7,0.274839,0.28604,2.957368,0.000236,0.000282,130,0.000182,0,20,0.7,0.002689
47123,Monroe County,,TN,2495,43360,45855,8,7,15,1599,1611,3210,7,0.286446,0.299242,98.806465,0.001102,0.000691,130,0.000258,0,20,0.625,0.010373
47125,Montgomery County,,TN,22110,155115,177225,77,90,167,11607,12500,24107,6,0.398739,0.432342,34613.551716,0.029213,0.036664,130,0.001082,0,20,0.39368,0.217488
47127,Moore County,,TN,480,6494,6974,3,4,7,284,270,554,7,0.230788,0.237604,0,0.000028,0.000036,130,0.000141,0,20,1,0.000584
47129,Morgan County,,TN,1178,19815,20993,3,5,8,525,803,1328,7,0.28577,0.29781,72.284555,0.000317,0.000425,130,0.00012,0,20,0.6,0.003162
47131,Obion County,,TN,2177,35458,37635,8,8,16,1142,1076,2218,6,0.30895,0.323591,8116.071367,0.000626,0.001272,130,0.000259,0,20,0.4,0.005424
47133,Overton County,,TN,1201,21747,22948,4,6,10,675,720,1395,7,0.231099,0.238474,2950.646695,0.000014,0.000077,130,0.000185,0,20,0.309524,0.000591
47135,Perry County,,TN,533,7536,8069,1,3,4,46,158,204,8,0.204239,0.209589,2.95,0,0.000001,130,0.000085,0,20,0,0.000094
47137,Pickett County,,TN,248,5028,5276,0,1,1,0,65,65,8,0.18777,0.191598,0,0,0,130,0.00005,0,202,0,0
47139,Polk County,,TN,1351,16402,17753,4,4,8,753,849,1602,7,0.274943,0.286126,720.334114,0.000226,0.000289,130,0.000185,0,20,0.5,0.002637
47141,Putnam County,,TN,4800,67153,71953,18,15,33,2733,2456,5189,6,0.300186,0.31512,16002.316581,0.003248,0.001742,130,0.000562,0,20,0.326316,0.029409
47143,Rhea County,,TN,1711,30576,32287,6,7,13,828,914,1742,7,0.286558,0.299442,45.103462,0.000237,0.000693,130,0.000234,0,20,0.5,0.00311
47145,Roane County,,TN,3348,56955,60303,9,9,18,2000,2119,4119,7,0.285939,0.298612,35.645856,0.000362,0.00053,130,0.000307,0,20,0.5,0.004954
47147,Robertson County,,TN,4539,68737,73276,12,10,22,4173,3099,7272,6,0.301398,0.315183,1120.787787,0.001763,0.001524,130,0.000343,0,20,0.621212,0.01733
47149,Rutherford County,,TN,17648,240251,257899,77,47,124,18646,11666,30312,6,0.37346,0.402262,25469.193458,0.028501,0.018984,130,0.001362,0,20,0.35983,0.20667
47151,Scott County,,TN,767,21861,22628,2,3,5,165,273,438,7,0.285827,0.297569,908.058764,0.000004,0.000375,130,0.000131,0,20,0.333333,0.000207
47153,Sequatchie County,,TN,821,12795,13616,3,3,6,527,432,959,7,0.27471,0.285524,1.654589,0.000204,0.000222,130,0.000133,0,20,0.666667,0.001993
47155,Sevier County,,TN,6360,85753,92113,29,11,40,3870,3201,7071,6,0.302024,0.316575,1403.232383,0.009952,0.001566,130,0.000614,0,20,0.427586,0.081497
47157,Shelby County,,TN,52089,1013906,1065995,234,226,460,37097,40992,78089,5,0.442115,0.485407,350676.775074,0.078872,0.075679,130,0.003323,0,20,0.228884,0.570332
47159,Smith County,,TN,1342,19855,21197,9,8,17,941,874,1815,6,0.297637,0.310533,1239.560807,0.000712,0.00104,130,0.00031,0,20,0.611111,0.008652
47161,Stewart County,,TN,1082,13575,14657,2,3,5,456,454,910,7,0.28535,0.297171,3.801004,0.000286,0.000237,130,0.000092,0,20,0.333333,0.001894
47163,Sullivan County,,TN,8999,167148,176147,23,17,40,5912,5642,11554,6,0.313173,0.330458,45074.797132,0.002671,0.002513,130,0.000763,0,20,0.229345,0.025611
47165,Sumner County,,TN,11383,158061,169444,39,22,61,9832,7168,17000,6,0.343606,0.366466,14114.095722,0.017061,0.005059,130,0.000723,0,20,0.486505,0.127108
47167,Tipton County,,TN,4218,62857,67075,9,7,16,3513,2505,6018,6,0.308688,0.323076,180.650012,0.002623,0.001356,130,0.000203,0,20,0.390909,0.018714
47169,Trousdale County,,TN,577,7927,8504,5,4,9,506,380,886,7,0.255959,0.265411,0,0.000551,0.000181,130,0.000183,0,20,1,0.006392
47171,Unicoi County,,TN,1145,18171,19316,2,4,6,596,731,1327,7,0.241835,0.250163,0,0.000022,0.000082,130,0.000108,0,20,0.916667,0.000673
47173,Union County,,TN,1471,18547,20018,5,5,10,1034,1106,2140,7,0.285686,0.297667,3.309524,0.00033,0.000457,130,0.000193,0,20,0.633333,0.003994
47175,Van Buren County,,TN,393,5376,5769,2,2,4,134,161,295,7,0.229858,0.236011,0,0.00001,0.000009,130,0.000121,0,20,1,0.00029
47177,Warren County,,TN,1940,41947,43887,9,10,19,922,959,1881,6,0.298339,0.311964,6002.855956,0.000664,0.001143,130,0.00034,0,20,0.445455,0.007479
47179,Washington County,,TN,8485,117778,126263,23,14,37,5797,4626,10423,6,0.309278,0.326609,12594.42765,0.007121,0.002417,130,0.000586,0,20,0.355072,0.058679
47181,Wayne County,,TN,762,15555,16317,4,3,7,270,292,562,7,0.238701,0.246354,646.991627,0.000028,0.000019,130,0.000145,0,20,0.333333,0.000569
47183,Weakley County,,TN,2357,32365,34722,9,9,18,1138,1241,2379,6,0.30895,0.323706,1364.883267,0.001144,0.001503,130,0.000255,0,20,0.544444,0.010291
47185,White County,,TN,1402,25728,27130,6,5,11,737,743,1480,7,0.231117,0.23836,1352.343098,0.000513,0.000083,130,0.000249,0,20,0.47619,0.00575
47187,Williamson County,,TN,14198,168781,182979,72,44,116,13866,9745,23611,6,0.380691,0.408087,8743.675758,0.035823,0.021166,130,0.001009,0,20,0.548618,0.269101
47189,Wilson County,,TN,8405,112093,120498,20,17,37,7519,5478,12997,6,0.303568,0.319467,1244.483018,0.005064,0.002156,130,0.000499,0,20,0.43083,0.042925
48001,Anderson County,,TX,3309,43751,47060,13,15,28,1957,1811,3768,6,0.329932,0.348929,66.907356,0.004125,0.004841,136,0.000238,0,20,0.647059,0.036026
48003,Andrews County,,TX,1014,14256,15270,4,2,6,340,384,724,7,0.260846,0.271095,0.60989,0.000181,0.000166,136,0.00013,0,20,0.833333,0.002075
48005,Angelina County,,TX,4725,84714,89439,25,22,47,2900,2632,5532,6,0.330832,0.350739,988.964461,0.005827,0.005896,136,0.000394,0,20,0.460317,0.045804
48007,Aransas County,,TX,2420,20695,23115,9,6,15,1113,1056,2169,6,0.325103,0.342698,162.992912,0.003352,0.002858,136,0.000179,0,20,0.847222,0.029616
48009,Archer County,,TX,918,8783,9701,3,1,4,578,492,1070,7,0.271228,0.282483,0,0.000196,0.000147,136,0.000107,0,20,0.666667,0.001531
48011,Armstrong County,,TX,265,2019,2284,1,2,3,54,128,182,7,0.263802,0.273976,0,0.000101,0.000179,136,0.000067,0,20,1,0.000798
48013,Atascosa County,,TX,3413,43192,46605,9,5,14,2332,2163,4495,6,0.313882,0.328946,8.062974,0.002051,0.00171,136,0.00024,0,20,0.611111,0.018622
48015,Austin County,,TX,2114,28074,30188,6,5,11,1255,1277,2532,6,0.320167,0.336879,1.866667,0.001248,0.001444,136,0.000144,0,20,0.7,0.011234
48017,Bailey County,,TX,625,6914,7539,2,4,6,105,231,336,7,0.267956,0.279692,3.932307,0.000004,0.000185,6,0.000087,0,20,0.583333,0.0002
48019,Bandera County,,TX,1686,17649,19335,4,4,8,900,878,1778,6,0.309871,0.324485,0.5,0.001626,0.000896,136,0.000132,0,20,0.85,0.014138
48021,Bastrop County,,TX,5818,63801,69619,14,15,29,4679,3991,8670,6,0.330644,0.349834,104.819784,0.005077,0.006202,136,0.000257,0,20,0.692982,0.043956
48023,Baylor County,,TX,331,3704,4035,0,1,1,0,55,55,7,0.27127,0.282558,0,0,0.000147,136,0.00005,0,203,0,0
48025,Bee County,,TX,1815,24176,25991,9,8,17,926,913,1839,6,0.325176,0.343041,244.183588,0.00217,0.002867,136,0.000185,0,20,0.711111,0.018859
48027,Bell County,,TX,42259,258262,300521,150,144,294,28189,27955,56144,6,0.410032,0.449702,26485.798449,0.057148,0.055382,136,0.001762,0,20,0.335585,0.415412
48029,Bexar County,,TX,84520,1620713,1705233,337,285,622,90493,69566,160059,5,0.448728,0.49791,188570.369533,0.103574,0.08838,136,0.004192,0,20,0.185037,0.749218
48031,Blanco County,,TX,776,9140,9916,4,5,9,293,379,672,6,0.313882,0.328946,0.125,0.001399,0.001831,136,0.00011,0,20,0.9,0.012922
48033,Borden County,,TX,53,638,691,0,0,0,0,0,0,0,0,0,0,0,0,131,0.00005,118,204,0,0
48035,Bosque County,,TX,1550,17351,18901,7,7,14,972,864,1836,6,0.319359,0.335115,21.100256,0.001936,0.001914,136,0.000165,0,20,0.607143,0.016125
48037,Bowie County,,TX,6590,91096,97686,25,20,45,4463,3750,8213,6,0.334022,0.355029,13183.704656,0.006861,0.006725,136,0.000473,0,20,0.373153,0.054875
48039,Brazoria County,,TX,19717,284232,303949,52,39,91,21006,13656,34662,6,0.355008,0.381197,1150.781937,0.020337,0.015643,136,0.000642,0,20,0.494253,0.15235
48041,Brazos County,,TX,14918,133926,148844,46,45,91,8610,9447,18057,6,0.364616,0.391558,2662.030448,0.013524,0.017456,136,0.000737,0,20,0.438596,0.107983
48043,Brewster County,,TX,1077,8330,9407,3,4,7,207,282,489,6,0.293022,0.306163,87.603538,0.000759,0.000597,136,0.000104,0,20,0.85,0.006908
48045,Briscoe County,,TX,110,1742,1852,0,0,0,0,0,0,0,0,0,0,0,0,132,0.00005,119,205,0,0
48047,Brooks County,,TX,482,8070,8552,4,4,8,234,276,510,7,0.282634,0.295381,0,0.000494,0.00055,136,0.000096,0,20,1,0.004512
48049,Brown County,,TX,2525,36377,38902,17,18,35,1240,1227,2467,6,0.329596,0.349542,10709.423875,0.005312,0.005337,136,0.000405,0,20,0.490476,0.046761
48051,Burleson County,,TX,1581,17127,18708,5,4,9,673,806,1479,6,0.320132,0.336707,0.45,0.001644,0.001102,136,0.000131,0,20,0.9,0.014059
48053,Burnet County,,TX,3644,38871,42515,12,14,26,2438,2226,4664,6,0.330607,0.349662,117.221459,0.005362,0.005547,136,0.000219,0,20,0.666667,0.040655
48055,Caldwell County,,TX,3424,33417,36841,9,10,19,2132,2379,4511,6,0.325321,0.343471,13.544455,0.002716,0.003595,136,0.000202,0,20,0.833333,0.025713
48057,Calhoun County,,TX,1458,21254,22712,5,6,11,661,660,1321,6,0.320591,0.337652,3.007105,0.001178,0.00143,136,0.000127,0,20,0.766667,0.009987
48059,Callahan County,,TX,1491,13100,14591,3,1,4,762,689,1451,7,0.267439,0.278193,0,0.000199,0.000119,136,0.000104,0,20,1,0.00166
48061,Cameron County,,TX,16121,380201,396322,51,44,95,9249,10066,19315,6,0.3659,0.393184,1571.239936,0.022908,0.020912,136,0.000651,0,20,0.509982,0.184841
48063,Camp County,,TX,1164,12027,13191,5,6,11,543,536,1079,7,0.258575,0.268684,1.959524,0.000814,0.000176,136,0.000157,0,20,0.738095,0.006714
48065,Carson County,,TX,656,6409,7065,4,4,8,363,410,773,7,0.26385,0.274319,0,0.0002,0.000195,136,0.000139,0,20,1,0.002018
48067,Cass County,,TX,2203,31218,33421,10,9,19,1182,1239,2421,6,0.315345,0.330888,82.117277,0.002694,0.001108,136,0.000228,0,20,0.618182,0.022566
48069,Castro County,,TX,862,7666,8528,3,6,9,154,473,627,7,0.268401,0.280425,8.256091,0.00009,0.000338,136,0.000113,0,20,0.733333,0.001109
48071,Chambers County,,TX,2717,31846,34563,4,7,11,1946,1869,3815,6,0.320238,0.337222,0,0.001178,0.001773,136,0.000097,0,20,0.928571,0.009707
48073,Cherokee County,,TX,3094,46911,50005,10,12,22,1673,1846,3519,6,0.326124,0.344513,3.798676,0.00276,0.003955,136,0.00019,0,20,0.848485,0.023384
48075,Childress County,,TX,463,5894,6357,0,0,0,0,0,0,0,0,0,0,0,0,133,0.00005,120,206,0,0
48077,Clay County,,TX,1129,11265,12394,2,3,5,535,634,1169,7,0.271329,0.282913,0.611111,0.000198,0.000169,136,0.000087,0,20,0.666667,0.001491
48079,Cochran County,,TX,337,3481,3818,1,2,3,92,155,247,7,0.26685,0.27783,0,0.000001,0.000138,136,0.00008,0,20,1,0.000103
48081,Coke County,,TX,381,3213,3594,1,1,2,128,113,241,7,0.266703,0.277246,0,0.000154,0.000115,136,0.000064,0,20,0,0.001021
48083,Coleman County,,TX,654,8211,8865,2,2,4,138,202,340,7,0.267562,0.278594,0,0.00019,0.00016,136,0.000083,0,20,1,0.001501
48085,Collin County,,TX,62065,664701,726766,231,160,391,80073,52186,132259,5,0.422045,0.461019,42073.136993,0.088621,0.064036,136,0.002639,0,20,0.297147,0.625556
48087,Collingsworth County,,TX,271,2956,3227,0,0,0,0,0,0,0,0,0,0,0,0,134,0.00005,121,207,0,0
48089,Colorado County,,TX,1375,21263,22638,5,7,12,657,714,1371,6,0.320591,0.337766,3.751242,0.001222,0.002174,136,0.000131,0,20,0.619048,0.010955
48091,Comal County,,TX,8018,98067,106085,37,23,60,9071,5308,14379,6,0.348921,0.372096,431.551188,0.014977,0.010395,136,0.000546,0,20,0.566783,0.119639
48093,Comanche County,,TX,1082,13303,14385,4,3,7,396,376,772,7,0.248103,0.256602,3.493688,0.00156,0.000075,136,0.000116,0,20,0.9,0.013164
48095,Concho County,,TX,295,2635,2930,1,1,2,57,138,195,7,0.266703,0.277246,0,0.000154,0.000115,136,0.000064,0,20,0,0.001021
48097,Cooke County,,TX,3125,38855,41980,8,8,16,1654,1908,3562,6,0.319044,0.335109,1336.299911,0.002542,0.00308,136,0.000195,0,20,0.660714,0.023176
48099,Coryell County,,TX,22918,57612,80530,57,66,123,9344,14371,23715,6,0.376407,0.407875,5819.191299,0.022559,0.026811,136,0.000722,0,20,0.457806,0.165796
48101,Cottle County,,TX,138,1688,1826,0,0,0,0,0,0,0,0,0,0,0,0,135,0.00005,122,208,0,0
48103,Crane County,,TX,390,4297,4687,1,2,3,106,141,247,7,0.260846,0.271095,0,0.000068,0.000166,136,0.000069,0,20,1,0.000774
48105,Crockett County,,TX,379,3939,4318,1,1,2,60,87,147,7,0.266703,0.277246,0,0.000154,0.000115,136,0.000064,0,20,0,0.001021
48107,Crosby County,,TX,660,6494,7154,1,1,2,238,375,613,7,0.266801,0.277601,0,0.000138,0.000136,136,0.000067,0,20,0,0.001211
48109,Culberson County,,TX,298,2754,3052,0,1,1,0,41,41,6,0.292387,0.304626,0,0,0.00043,6,0.00005,0,209,0,0
48111,Dallam County,,TX,674,6723,7397,2,1,3,88,112,200,7,0.260449,0.269881,0,0.000084,0.000095,136,0.000099,0,20,1,0.001029
48113,Dallas County,,TX,174887,2267086,2441973,324,321,645,140201,159719,299920,5,0.458918,0.509467,252178.204405,0.100585,0.098514,136,0.004084,0,20,0.174753,0.719816
48115,Dawson County,,TX,983,12974,13957,3,5,8,254,477,731,7,0.267169,0.27889,4.92974,0.000245,0.000248,136,0.000102,0,20,0.6,0.002354
48117,Deaf Smith County,,TX,1594,19425,21019,4,6,10,547,718,1265,6,0.314357,0.329794,139.806421,0.000185,0.001198,136,0.000123,0,20,0.6,0.001888
48119,Delta County,,TX,499,4935,5434,4,3,7,295,267,562,7,0.249379,0.257937,0,0.000878,0.000103,136,0.000111,0,20,1,0.007006
48121,Denton County,,TX,58343,560682,619025,209,146,355,70759,48021,118780,5,0.416846,0.454989,38796.394621,0.078468,0.056847,136,0.002547,0,20,0.29453,0.564596
48123,DeWitt County,,TX,1400,19147,20547,4,6,10,518,709,1227,6,0.324886,0.342354,10.844384,0.001646,0.002976,136,0.000111,0,20,0.833333,0.013909
48125,Dickens County,,TX,172,2083,2255,0,0,0,0,0,0,0,0,0,0,0,0,137,0.00005,123,210,0,0
48127,Dimmit County,,TX,807,9859,10666,2,3,5,165,309,474,6,0.309838,0.324313,0,0.000692,0.00082,136,0.000105,0,20,1,0.006171
48129,Donley County,,TX,320,3412,3732,2,2,4,87,128,215,7,0.263802,0.273976,0,0.000181,0.000179,136,0.000091,0,20,1,0.001697
48131,Duval County,,TX,958,11896,12854,3,2,5,372,499,871,7,0.272064,0.283363,0,0.000276,0.000263,136,0.000084,0,20,1,0.002465
48133,Eastland County,,TX,1413,17512,18925,6,7,13,445,548,993,6,0.314731,0.329759,441.521447,0.000959,0.001153,136,0.000177,0,20,0.444444,0.008891
48135,Ector County,,TX,7490,134692,142182,34,32,66,5113,4617,9730,6,0.342716,0.366913,19148.284087,0.009983,0.008823,136,0.000692,0,20,0.395122,0.085939
48137,Edwards County,,TX,185,2038,2223,0,0,0,0,0,0,0,0,0,0,0,0,138,0.00005,124,211,0,0
48139,Ellis County,,TX,10314,137482,147796,30,23,53,11241,7115,18356,6,0.345893,0.368247,283.760536,0.013952,0.008715,136,0.000421,0,20,0.630125,0.104928
48141,El Paso County,,TX,39009,803703,842712,152,142,294,27753,27175,54928,5,0.413059,0.451249,45220.799598,0.055349,0.055565,6,0.001883,0,20,0.318128,0.408257
48143,Erath County,,TX,2757,30381,33138,14,13,27,1438,1355,2793,6,0.321192,0.338213,1066.728356,0.003402,0.00255,136,0.000354,0,20,0.4875,0.031732
48145,Falls County,,TX,1253,14997,16250,3,4,7,594,717,1311,6,0.317894,0.332927,6.963174,0.001309,0.001366,136,0.000088,0,20,0.583333,0.010298
48147,Fannin County,,TX,2353,30112,32465,7,8,15,1557,1462,3019,6,0.319149,0.335252,2.927115,0.002579,0.003125,136,0.000154,0,20,0.875,0.023318
48149,Fayette County,,TX,1515,24241,25756,9,9,18,723,756,1479,6,0.320767,0.338253,28.50751,0.002551,0.002314,136,0.000193,0,20,0.6,0.022974
48151,Fisher County,,TX,296,3805,4101,1,0,1,41,0,41,0,0,0,0,0.000009,0,136,0.000088,0,13,0,0.000175
48153,Floyd County,,TX,721,7465,8186,2,2,4,233,347,580,7,0.26685,0.27783,0,0.000172,0.000156,136,0.000084,0,20,1,0.001471
48155,Foard County,,TX,87,1414,1501,0,0,0,0,0,0,0,0,0,0,0,0,139,0.00005,125,212,0,0
48157,Fort Bend County,,TX,37289,477131,514420,119,80,199,52691,30948,83639,6,0.387071,0.419805,9831.808611,0.055768,0.036157,136,0.001269,0,20,0.43259,0.392733
48159,Franklin County,,TX,1224,10144,11368,6,5,11,627,509,1136,6,0.314731,0.329485,118.087837,0.001581,0.00086,136,0.00016,0,20,0.733333,0.013464
48161,Freestone County,,TX,1514,17696,19210,8,8,16,814,772,1586,6,0.326489,0.344233,16.84097,0.002604,0.002843,136,0.000166,0,20,0.696429,0.021896
48163,Frio County,,TX,1065,13899,14964,3,3,6,339,470,809,6,0.309838,0.324313,0.833333,0.000708,0.000832,136,0.000119,0,20,0.666667,0.006371
48165,Gaines County,,TX,1000,15707,16707,6,6,12,363,418,781,7,0.267218,0.27909,22.192112,0.000254,0.000253,136,0.000188,0,20,0.452381,0.002702
48167,Galveston County,,TX,21574,284665,306239,59,47,106,18213,15139,33352,6,0.366545,0.394903,1825.307161,0.022473,0.019712,136,0.000701,0,20,0.475198,0.164557
48169,Garza County,,TX,363,4433,4796,1,1,2,88,139,227,7,0.266801,0.277601,0,0.000138,0.000136,136,0.000067,0,20,0,0.001211
48171,Gillespie County,,TX,1485,23581,25066,5,5,10,726,477,1203,6,0.324704,0.341982,0.697924,0.002955,0.002577,136,0.000126,0,20,0.9,0.024892
48173,Glasscock County,,TX,119,1418,1537,0,0,0,0,0,0,0,0,0,0,0,0,140,0.00005,126,213,0,0
48175,Goliad County,,TX,487,6884,7371,2,1,3,212,189,401,7,0.249571,0.257816,0,0.000946,0.000049,136,0.000078,0,20,1,0.007719
48177,Gonzales County,,TX,1265,19188,20453,5,7,12,414,664,1078,6,0.324777,0.342325,14.0307,0.001379,0.002779,136,0.000139,0,20,0.785714,0.012972
48179,Gray County,,TX,1531,21357,22888,6,6,12,566,581,1147,6,0.314289,0.329679,385.079239,0.000927,0.001207,136,0.000184,0,20,0.595238,0.008623
48181,Grayson County,,TX,7376,118570,125946,23,17,40,5013,4461,9474,6,0.346387,0.368522,751.532729,0.008967,0.007927,136,0.000381,0,20,0.593846,0.070628
48183,Gregg County,,TX,10470,120499,130969,38,31,69,7425,7234,14659,6,0.348253,0.372434,3041.141274,0.011003,0.009406,136,0.000595,0,20,0.409408,0.082739
48185,Grimes County,,TX,2014,22542,24556,7,7,14,1380,1233,2613,6,0.320238,0.337222,2.092857,0.001333,0.001483,136,0.000178,0,20,0.785714,0.011801
48187,Guadalupe County,,TX,9608,113575,123183,40,20,60,10064,6084,16148,6,0.34738,0.369822,745.764939,0.017589,0.008643,136,0.000584,0,20,0.568525,0.132096
48189,Hale County,,TX,3103,36519,39622,10,12,22,1324,1648,2972,6,0.33087,0.349931,3032.110517,0.002511,0.004351,136,0.00024,0,20,0.487179,0.021714
48191,Hall County,,TX,312,3328,3640,0,0,0,0,0,0,0,0,0,0,0,0,141,0.00005,127,214,0,0
48193,Hamilton County,,TX,663,8258,8921,4,2,6,240,172,412,7,0.273831,0.285356,1.608027,0.000977,0.000201,136,0.000116,0,20,0.583333,0.008503
48195,Hansford County,,TX,417,5542,5959,0,0,0,0,0,0,0,0,0,0,0,0,142,0.00005,128,215,0,0
48197,Hardeman County,,TX,369,4251,4620,1,1,2,46,78,124,8,0.213782,0.219432,0,0.000001,0.000013,136,0.000083,0,20,0,0.000191
48199,Hardin County,,TX,4667,52936,57603,11,13,24,3226,2986,6212,6,0.326599,0.345344,23.892193,0.002872,0.004114,136,0.000161,0,20,0.643382,0.01512
48201,Harris County,,TX,198449,3800484,3998933,473,422,895,222170,179456,401626,5,0.470569,0.53004,497620.495521,0.123129,0.114149,136,0.005971,0,20,0.122312,0.879743
48203,Harrison County,,TX,4806,64331,69137,15,16,31,3146,3107,6253,6,0.32715,0.346191,98.206629,0.004536,0.004514,136,0.000278,0,20,0.621324,0.034656
48205,Hartley County,,TX,387,3790,4177,0,1,1,0,47,47,7,0.260492,0.26996,0,0,0.000095,136,0.00005,0,216,0,0
48207,Haskell County,,TX,522,5552,6074,1,3,4,45,178,223,7,0.267562,0.27868,2970,0.000001,0.000126,136,0.000077,0,20,0.333333,0.00014
48209,Hays County,,TX,12686,111863,124549,46,26,72,13276,9470,22746,6,0.352898,0.376432,486.98712,0.017009,0.011013,136,0.000631,0,20,0.604533,0.130222
48211,Hemphill County,,TX,354,3519,3873,0,1,1,0,42,42,7,0.260492,0.26996,0,0,0.000095,136,0.00005,0,217,0,0
48213,Henderson County,,TX,6453,70458,76911,15,18,33,4709,4325,9034,6,0.327187,0.346438,16.446009,0.004337,0.00582,136,0.00027,0,20,0.678947,0.039371
48215,Hidalgo County,,TX,22764,670378,693142,90,79,169,15908,13723,29631,6,0.382191,0.415046,33342.348579,0.033358,0.028033,136,0.001126,0,20,0.316597,0.250149
48217,Hill County,,TX,2918,33004,35922,9,10,19,1941,1733,3674,6,0.329745,0.34807,15.923448,0.002673,0.0044,136,0.000187,0,20,0.845455,0.023616
48219,Hockley County,,TX,2202,23908,26110,4,4,8,866,1164,2030,7,0.266948,0.278288,2971.833333,0.000175,0.000139,136,0.000139,0,20,0.45,0.001664
48221,Hood County,,TX,3909,46086,49995,17,10,27,3059,2262,5321,6,0.31964,0.336283,96.863261,0.006713,0.003914,136,0.00033,0,20,0.661765,0.057163
48223,Hopkins County,,TX,2424,33763,36187,14,14,28,1473,1366,2839,6,0.32627,0.344971,935.325198,0.00361,0.004285,136,0.000305,0,20,0.6,0.032894
48225,Houston County,,TX,1445,19756,21201,6,6,12,592,617,1209,6,0.320202,0.33705,1.64362,0.001245,0.001409,136,0.000142,0,20,0.733333,0.011131
48227,Howard County,,TX,2156,29444,31600,10,11,21,665,983,1648,6,0.325686,0.343471,3979.201709,0.002633,0.003014,136,0.000215,0,20,0.545455,0.022572
48229,Hudspeth County,,TX,302,3477,3779,1,1,2,86,110,196,6,0.292345,0.304559,0,0.000431,0.00043,6,0.000061,0,20,0,0.003277
48231,Hunt County,,TX,7449,79766,87215,22,22,44,5384,5135,10519,6,0.331889,0.352468,1770.56132,0.00714,0.006148,136,0.000406,0,20,0.527692,0.06245
48233,Hutchinson County,,TX,1864,24106,25970,6,7,13,626,868,1494,6,0.321582,0.33917,408.871876,0.001082,0.001284,136,0.000183,0,20,0.642857,0.009303
48235,Irion County,,TX,239,1902,2141,1,0,1,182,0,182,0,0,0,0,0.000154,0,136,0.000064,0,14,0,0.001021
48237,Jack County,,TX,691,7523,8214,4,5,9,254,389,643,6,0.313341,0.328087,0.45,0.000793,0.001027,136,0.000135,0,20,0.8,0.007776
48239,Jackson County,,TX,1089,15014,16103,4,4,8,410,533,943,6,0.320202,0.336821,0.4,0.000984,0.001025,136,0.000108,0,20,0.833333,0.008075
48241,Jasper County,,TX,3105,34316,37421,8,13,21,1536,1913,3449,6,0.32616,0.344685,473.439564,0.00115,0.003497,136,0.000158,0,20,0.660256,0.009595
48243,Jeff Davis County,,TX,193,2143,2336,0,0,0,0,0,0,0,0,0,0,0,0,143,0.00005,129,218,0,0
48245,Jefferson County,,TX,18682,242672,261354,39,44,83,8675,13733,22408,6,0.354921,0.381741,2481.144132,0.013646,0.015112,136,0.000477,0,20,0.450603,0.099727
48247,Jim Hogg County,,TX,294,5328,5622,1,0,1,46,0,46,0,0,0,0,0.000096,0,136,0.00006,0,6,0,0.000738
48249,Jim Wells County,,TX,2962,42465,45427,9,13,22,1572,2045,3617,6,0.326563,0.345172,594.276844,0.00271,0.003427,136,0.000189,0,20,0.653846,0.023714
48251,Johnson County,,TX,12488,143419,155907,31,26,57,9914,8961,18875,6,0.34842,0.372119,885.184496,0.010726,0.009347,136,0.000528,0,20,0.526891,0.08802
48253,Jones County,,TX,1628,15120,16748,3,3,6,751,801,1552,7,0.267586,0.278738,5945.253065,0.000914,0.000129,136,0.000096,0,20,0.416667,0.006938
48255,Karnes County,,TX,832,12364,13196,5,4,9,396,312,708,6,0.310135,0.324943,1.699735,0.000983,0.000889,136,0.000139,0,20,0.75,0.008944
48257,Kaufman County,,TX,8174,91517,99691,18,13,31,9466,6064,15530,6,0.326197,0.344742,47.67019,0.007916,0.004466,136,0.000281,0,20,0.687135,0.059703
48259,Kendall County,,TX,2466,30710,33176,12,7,19,2158,1430,3588,6,0.324777,0.342325,54.728603,0.005023,0.002679,136,0.000249,0,20,0.653846,0.044687
48261,Kenedy County,,TX,-2,-2,-4,0,0,0,0,0,0,0,0,0,0,0,0,144,0.00005,130,219,0,0
48263,Kent County,,TX,60,788,848,0,0,0,0,0,0,0,0,0,0,0,0,145,0.00005,131,220,0,0
48265,Kerr County,,TX,3494,46853,50347,17,11,28,1886,1537,3423,6,0.328368,0.347342,2998.826023,0.005262,0.004363,136,0.000352,0,20,0.627451,0.048233
48267,Kimble County,,TX,381,4626,5007,0,1,1,0,54,54,7,0.247261,0.255006,0,0,0.000041,136,0.00005,0,221,0,0
48269,King County,,TX,-2,-2,-4,0,0,0,0,0,0,0,0,0,0,0,0,146,0.00005,132,222,0,0
48271,Kinney County,,TX,265,3110,3375,1,1,2,71,46,117,7,0.258185,0.266925,0,0.000059,0.000031,136,0.000061,0,20,0,0.00035
48273,Kleberg County,,TX,3346,29651,32997,11,16,27,1382,1930,3312,6,0.344175,0.36555,529.198715,0.003646,0.006733,136,0.000176,0,20,0.590643,0.025223
48275,Knox County,,TX,326,3746,4072,1,0,1,43,0,43,0,0,0,0,0.000001,0,136,0.000072,0,17,0,0.000087
48277,Lamar County,,TX,2971,50736,53707,10,13,23,1281,1427,2708,6,0.32638,0.345,2137.295835,0.002546,0.004238,136,0.000245,0,20,0.564103,0.023413
48279,Lamb County,,TX,1408,14667,16075,5,6,11,475,742,1217,7,0.267512,0.279543,2222.564628,0.000177,0.000242,136,0.000148,0,20,0.433333,0.001761
48281,Lampasas County,,TX,1932,18738,20670,8,5,13,1400,800,2200,6,0.309048,0.323167,0,0.003828,0.00182,136,0.000151,0,20,1,0.033529
48283,La Salle County,,TX,438,5547,5985,2,3,5,112,196,308,6,0.309904,0.324427,0.666667,0.000782,0.000891,136,0.000073,0,20,0.666667,0.00677
48285,Lavaca County,,TX,1288,21421,22709,6,6,12,584,673,1257,6,0.320626,0.337709,16.177746,0.001026,0.001786,136,0.000144,0,20,0.547619,0.00854
48287,Lee County,,TX,1260,16493,17753,7,7,14,591,668,1259,6,0.320696,0.33791,1.790569,0.001832,0.002298,136,0.000167,0,20,0.767857,0.017034
48289,Leon County,,TX,1361,16090,17451,6,7,13,672,611,1283,6,0.320238,0.337222,5.971842,0.002064,0.001489,136,0.000133,0,20,0.678571,0.017144
48291,Liberty County,,TX,6522,67552,74074,11,12,23,4602,4526,9128,6,0.325358,0.343356,16.442076,0.002664,0.002789,136,0.000182,0,20,0.653846,0.01837
48293,Limestone County,,TX,1597,21293,22890,4,6,10,658,805,1463,6,0.326416,0.343889,0,0.001787,0.002801,136,0.000107,0,20,1,0.014441
48295,Lipscomb County,,TX,361,3025,3386,1,1,2,60,51,111,8,0.20882,0.213881,0,0.000001,0,136,0.000085,0,223,0,0.000086
48297,Live Oak County,,TX,805,8910,9715,2,4,6,155,311,466,6,0.3104,0.325258,0,0.00022,0.001132,136,0.000082,0,20,1,0.002145
48299,Llano County,,TX,1515,15246,16761,5,4,9,850,666,1516,6,0.314221,0.329175,0,0.002457,0.002005,136,0.000119,0,20,1,0.022251
48301,Loving County,,TX,-2,-2,-4,0,0,0,0,0,0,0,0,0,0,0,0,147,0.00005,133,224,0,0
48303,Lubbock County,,TX,17613,249446,267059,67,63,130,12166,11672,23838,6,0.363841,0.394015,68150.481253,0.017547,0.017779,136,0.001248,0,20,0.295359,0.138522
48305,Lynn County,,TX,659,6521,7180,2,1,3,342,342,684,7,0.266801,0.277601,0,0.00014,0.000136,136,0.000084,0,20,1,0.001317
48307,McCulloch County,,TX,623,8263,8886,2,2,4,87,114,201,7,0.266875,0.277761,0,0.000196,0.000156,136,0.000083,0,20,1,0.001475
48309,McLennan County,,TX,13938,220701,234639,58,44,102,8786,9026,17812,6,0.35767,0.384742,2425.270609,0.017212,0.014754,136,0.000855,0,20,0.426835,0.13487
48311,McMullen County,,TX,70,802,872,0,0,0,0,0,0,0,0,0,0,0,0,148,0.00005,134,225,0,0
48313,Madison County,,TX,935,10639,11574,6,4,10,561,404,965,6,0.320132,0.336707,0.2,0.001309,0.001101,136,0.000145,0,20,0.9,0.011477
48315,Marion County,,TX,896,9005,9901,4,4,8,422,450,872,6,0.314697,0.329313,0,0.000881,0.000922,136,0.000114,0,20,1,0.007195
48317,Martin County,,TX,403,4346,4749,1,2,3,147,210,357,7,0.259173,0.269027,0,0.000083,0.000109,136,0.000069,0,20,1,0.000876
48319,Mason County,,TX,242,3690,3932,0,0,0,0,0,0,0,0,0,0,0,0,149,0.00005,135,226,0,0
48321,Matagorda County,,TX,2750,37746,40496,8,9,17,1078,1504,2582,6,0.324886,0.342726,7.99348,0.002352,0.003331,136,0.000149,0,20,0.763636,0.015314
48323,Maverick County,,TX,2828,59298,62126,8,11,19,1097,1421,2518,6,0.333181,0.352228,174.157535,0.003823,0.005002,136,0.000176,0,20,0.654545,0.032271
48325,Medina County,,TX,3053,41206,44259,7,6,13,2411,1893,4304,6,0.324487,0.341781,128.076679,0.001631,0.001928,136,0.00025,0,20,0.446429,0.014431
48327,Menard County,,TX,191,2120,2311,0,0,0,0,0,0,0,0,0,0,0,0,150,0.00005,136,227,0,0
48329,Midland County,,TX,8402,129553,137955,43,39,82,6584,5327,11911,6,0.349634,0.375384,29185.72631,0.011432,0.010719,136,0.000854,0,20,0.346939,0.098142
48331,Milam County,,TX,1794,24752,26546,9,8,17,1040,1081,2121,6,0.321903,0.339548,16.106791,0.002443,0.002698,136,0.000207,0,20,0.652778,0.021835
48333,Mills County,,TX,384,4746,5130,1,1,2,45,50,95,7,0.247913,0.255857,0,0.000041,0.000041,136,0.000069,0,20,0,0.000454
48335,Mitchell County,,TX,583,6682,7265,2,5,7,129,273,402,7,0.271531,0.283864,0.45,0.000028,0.000288,136,0.00008,0,20,0.7,0.000382
48337,Montague County,,TX,1398,19445,20843,8,6,14,965,765,1730,6,0.315208,0.330172,435.671122,0.002673,0.001689,136,0.000181,0,20,0.75,0.023757
48339,Montgomery County,,TX,30072,368499,398571,114,76,190,36994,22563,59557,6,0.378168,0.409662,10631.862361,0.043405,0.028142,136,0.001353,0,20,0.370411,0.31427
48341,Moore County,,TX,1847,21460,23307,5,6,11,459,732,1191,6,0.293643,0.307027,5106.309967,0.000622,0.000618,136,0.000167,0,20,0.285714,0.005222
48343,Morris County,,TX,1269,13990,15259,7,6,13,773,745,1518,6,0.314765,0.329656,118.617885,0.001617,0.00093,136,0.000177,0,20,0.738095,0.014055
48345,Motley County,,TX,86,1187,1273,0,0,0,0,0,0,0,0,0,0,0,0,151,0.00005,137,228,0,0
48347,Nacogdoches County,,TX,4606,54458,59064,20,20,40,2483,2828,5311,6,0.330832,0.35051,940.96181,0.00586,0.006901,136,0.000337,0,20,0.548433,0.042718
48349,Navarro County,,TX,3384,46628,50012,14,12,26,2306,1989,4295,6,0.326673,0.344977,11.253311,0.003827,0.004426,136,0.000261,0,20,0.730769,0.034718
48351,Newton County,,TX,1111,10345,11456,4,4,8,490,575,1065,6,0.320132,0.336707,0,0.001077,0.001102,136,0.000091,0,20,1,0.008583
48353,Nolan County,,TX,1324,15014,16338,8,4,12,498,362,860,6,0.31514,0.330103,3161.455377,0.001206,0.001116,136,0.000179,0,20,0.444444,0.010454
48355,Nueces County,,TX,22972,330768,353740,82,75,157,14792,16147,30939,6,0.373652,0.405533,20491.753202,0.031136,0.025431,136,0.001093,0,20,0.35697,0.232553
48357,Ochiltree County,,TX,702,9948,10650,1,3,4,51,172,223,7,0.263912,0.274303,2911,0,0.000179,136,0.000122,0,223,0.333333,0.000086
48359,Oldham County,,TX,294,1956,2250,2,2,4,110,131,241,7,0.263802,0.273976,0,0.000181,0.000179,136,0.000091,0,20,1,0.001697
48361,Orange County,,TX,6760,87123,93883,13,20,33,3339,4371,7710,6,0.330532,0.350389,858.072627,0.004115,0.006075,136,0.000206,0,20,0.564286,0.029802
48363,Palo Pinto County,,TX,2114,26460,28574,10,8,18,1225,1169,2394,6,0.318939,0.334937,66.259537,0.003,0.001846,136,0.000239,0,20,0.636364,0.026788
48365,Panola County,,TX,1483,24039,25522,9,8,17,773,792,1565,6,0.324306,0.341936,15.295903,0.002046,0.002118,136,0.000192,0,20,0.733333,0.016627
48367,Parker County,,TX,8820,101177,109997,26,15,41,8385,6016,14401,6,0.327887,0.347153,459.084135,0.009982,0.0045,136,0.000452,0,20,0.57265,0.07812
48369,Parmer County,,TX,1131,10631,11762,3,5,8,298,443,741,7,0.269121,0.281249,774.359413,0.000084,0.000279,6,0.000096,0,20,0.5,0.000666
48371,Pecos County,,TX,1052,13522,14574,5,2,7,331,287,618,7,0.260846,0.271095,0,0.001423,0.000166,136,0.000125,0,20,1,0.01198
48373,Polk County,,TX,5629,52574,58203,17,24,41,2467,2637,5104,6,0.348336,0.370985,969.076427,0.005163,0.007982,136,0.000291,0,20,0.455385,0.045247
48375,Potter County,,TX,12940,110082,123022,33,34,67,9123,9702,18825,6,0.355485,0.381449,28677.560614,0.010887,0.01305,136,0.000654,0,20,0.369919,0.089426
48377,Presidio County,,TX,1118,10119,11237,3,4,7,236,582,818,6,0.293022,0.306163,0.958548,0.000156,0.000602,136,0.000109,0,20,0.833333,0.00179
48379,Rains County,,TX,861,8923,9784,6,6,12,604,491,1095,6,0.315003,0.330029,0.374573,0.001415,0.001642,136,0.000144,0,20,0.857143,0.012353
48381,Randall County,,TX,12263,113804,126067,41,31,72,10072,8676,18748,6,0.35213,0.377131,35964.622225,0.012206,0.010221,136,0.000897,0,20,0.30814,0.101516
48383,Reagan County,,TX,305,3548,3853,1,1,2,58,76,134,7,0.266703,0.277246,0,0.000154,0.000115,136,0.000064,0,20,0,0.001021
48385,Real County,,TX,295,3011,3306,0,1,1,0,45,45,7,0.238959,0.245438,0,0,0.000011,136,0.00005,0,229,0,0
48387,Red River County,,TX,956,13415,14371,2,2,4,301,406,707,7,0.250603,0.259288,0.710043,0.000797,0.000073,136,0.000077,0,20,0.666667,0.006076
48389,Reeves County,,TX,946,11137,12083,2,3,5,157,467,624,7,0.26087,0.271267,0,0.000152,0.000167,136,0.000087,0,20,1,0.00165
48391,Refugio County,,TX,578,8229,8807,3,3,6,206,185,391,7,0.272217,0.283821,0,0.000338,0.000317,136,0.000089,0,20,1,0.003035
48393,Roberts County,,TX,161,801,962,0,0,0,0,0,0,0,0,0,0,0,0,152,0.00005,138,230,0,0
48395,Robertson County,,TX,1422,16599,18021,4,4,8,752,775,1527,6,0.320732,0.337285,10.963715,0.001053,0.001213,136,0.000117,0,20,0.65,0.008586
48397,Rockwall County,,TX,5657,60990,66647,20,14,34,8302,3959,12261,6,0.330119,0.349072,118.266857,0.011063,0.005894,136,0.000287,0,20,0.71558,0.08269
48399,Runnels County,,TX,1122,11163,12285,2,2,4,210,421,631,7,0.272268,0.283898,0,0.000303,0.000234,136,0.000077,0,20,1,0.002067
48401,Rusk County,,TX,3499,46371,49870,10,11,21,2253,2301,4554,6,0.326087,0.344341,9.968228,0.002018,0.003585,136,0.000203,0,20,0.780303,0.01696
48403,Sabine County,,TX,736,9996,10732,5,5,10,335,294,629,7,0.24908,0.257996,1.271465,0.001123,0.000139,136,0.000106,0,20,0.714286,0.009046
48405,San Augustine County,,TX,568,8270,8838,5,4,9,339,285,624,6,0.320167,0.336764,161.251128,0.000994,0.00106,136,0.000139,0,20,0.7,0.008467
48407,San Jacinto County,,TX,2459,20681,23140,6,5,11,1708,1611,3319,6,0.321654,0.337967,0.142857,0.001515,0.001383,136,0.00013,0,20,0.9,0.013915
48409,San Patricio County,,TX,8224,71522,79746,22,26,48,4527,4850,9377,6,0.3468,0.369977,768.733361,0.009049,0.010324,136,0.000324,0,20,0.548942,0.068933
48411,San Saba County,,TX,456,5517,5973,0,0,0,0,0,0,0,0,0,0,0,0,153,0.00005,139,231,0,0
48413,Schleicher County,,TX,322,3013,3335,1,1,2,120,117,237,7,0.266703,0.277246,0,0.000154,0.000115,136,0.000064,0,20,0,0.001021
48415,Scurry County,,TX,1246,15744,16990,4,7,11,247,485,732,7,0.276013,0.289522,191.155008,0.000372,0.000546,136,0.000113,0,20,0.666667,0.003224
48417,Shackelford County,,TX,273,3376,3649,1,1,2,83,54,137,7,0.267439,0.278193,0,0.000149,0.000119,136,0.000064,0,20,0,0.001047
48419,Shelby County,,TX,1460,24217,25677,7,5,12,642,624,1266,6,0.320238,0.336993,182.978577,0.001785,0.001026,136,0.000171,0,20,0.452381,0.014264
48421,Sherman County,,TX,229,2662,2891,0,1,1,0,49,49,7,0.227049,0.233088,0,0,0.000005,136,0.00005,0,232,0,0
48423,Smith County,,TX,13460,197059,210519,58,43,101,10639,9143,19782,6,0.352941,0.379347,1671.941917,0.017278,0.011904,136,0.000834,0,20,0.396175,0.133136
48425,Somervell County,,TX,702,7325,8027,5,4,9,369,324,693,6,0.313274,0.327858,0.811111,0.000872,0.001032,136,0.000152,0,20,0.8,0.00843
48427,Starr County,,TX,2919,62362,65281,8,7,15,1333,1881,3214,6,0.333143,0.352234,39.789453,0.003494,0.003474,136,0.000143,0,20,0.722222,0.027275
48429,Stephens County,,TX,672,8517,9189,2,1,3,119,51,170,6,0.313173,0.327342,0,0.000743,0.000882,136,0.000085,0,20,1,0.006724
48431,Sterling County,,TX,139,1138,1277,0,0,0,0,0,0,0,0,0,0,0,0,154,0.00005,140,233,0,0
48433,Stonewall County,,TX,123,1410,1533,0,0,0,0,0,0,0,0,0,0,0,0,155,0.00005,141,234,0,0
48435,Sutton County,,TX,384,4942,5326,2,1,3,118,92,210,7,0.266703,0.277246,0,0.000214,0.000115,136,0.000075,0,20,1,0.001371
48437,Swisher County,,TX,694,7756,8450,3,4,7,300,395,695,7,0.268302,0.279966,0,0.000214,0.000335,136,0.000108,0,20,1,0.001957
48439,Tarrant County,,TX,110102,1708808,1818910,382,307,689,121536,95008,216544,5,0.455898,0.505825,234603.357419,0.11361,0.094586,136,0.004752,0,20,0.160606,0.8132
48441,Taylor County,,TX,13049,129276,142325,47,58,105,6411,7623,14034,6,0.365028,0.394914,32429.988488,0.015352,0.019175,136,0.000908,0,20,0.379466,0.12055
48443,Terrell County,,TX,133,900,1033,0,0,0,0,0,0,0,0,0,0,0,0,156,0.00005,142,235,0,0
48445,Terry County,,TX,1018,11832,12850,3,2,5,299,464,763,7,0.26685,0.27783,0.7,0.000141,0.000138,136,0.000123,0,20,0.666667,0.001429
48447,Throckmorton County,,TX,101,1647,1748,0,0,0,0,0,0,0,0,0,0,0,0,157,0.00005,143,236,0,0
48449,Titus County,,TX,1991,29791,31782,10,8,18,1084,1058,2142,6,0.318869,0.334822,244.909762,0.00213,0.001941,136,0.000233,0,20,0.609091,0.019359
48451,Tom Green County,,TX,10488,107362,117850,43,57,100,4940,6057,10997,6,0.363659,0.392938,47884.724332,0.014812,0.0199,136,0.000935,0,20,0.348958,0.118103
48453,Travis County,,TX,76024,842891,918915,266,201,467,79188,65946,145134,5,0.434978,0.476787,78114.752121,0.095075,0.075323,136,0.00318,0,20,0.252177,0.675617
48455,Trinity County,,TX,1317,12849,14166,6,6,12,692,748,1440,6,0.321689,0.338139,1.775334,0.001269,0.001417,136,0.000139,0,20,0.866667,0.011208
48457,Tyler County,,TX,1687,17448,19135,8,8,16,1036,976,2012,6,0.32176,0.338482,1.852928,0.001435,0.001547,136,0.000142,0,20,0.821429,0.012254
48459,Upshur County,,TX,3335,35962,39297,11,11,22,2121,2227,4348,6,0.319044,0.335452,333.71725,0.002663,0.002685,136,0.000239,0,20,0.615385,0.023059
48461,Upton County,,TX,289,3198,3487,0,0,0,0,0,0,0,0,0,0,0,0,158,0.00005,144,237,0,0
48463,Uvalde County,,TX,1891,28098,29989,8,5,13,624,743,1367,6,0.313882,0.328946,2927.663236,0.001396,0.00159,136,0.000251,0,20,0.375,0.012654
48465,Val Verde County,,TX,4406,50810,55216,10,17,27,1076,1630,2706,6,0.348003,0.370527,6673.037877,0.003986,0.007656,136,0.000223,0,20,0.536842,0.034071
48467,Van Zandt County,,TX,3777,48449,52226,11,13,24,2787,2530,5317,6,0.326489,0.345172,7.260898,0.002803,0.005063,136,0.00022,0,20,0.824176,0.0265
48469,Victoria County,,TX,6186,90760,96946,28,29,57,3625,4173,7798,6,0.332533,0.353809,4094.733502,0.006332,0.007815,136,0.00053,0,20,0.445076,0.051444
48471,Walker County,,TX,4719,44762,49481,18,18,36,2861,3180,6041,6,0.330682,0.350052,166.485281,0.003836,0.006013,136,0.000336,0,20,0.535714,0.033979
48473,Waller County,,TX,3342,32707,36049,9,8,17,2477,2351,4828,6,0.324126,0.341649,44.817756,0.003011,0.002653,136,0.000194,0,20,0.708333,0.026274
48475,Ward County,,TX,879,10812,11691,4,3,7,278,369,647,7,0.26087,0.271267,0.333333,0.000154,0.000167,136,0.000149,0,20,0.833333,0.001852
48477,Washington County,,TX,1963,32317,34280,11,10,21,1277,1153,2430,6,0.320696,0.338282,17.380858,0.002943,0.002225,136,0.000232,0,20,0.507576,0.021255
48479,Webb County,,TX,7410,242592,250002,22,26,48,3567,4654,8221,6,0.358507,0.383305,3943.672838,0.010526,0.012402,136,0.000315,0,20,0.566667,0.084204
48481,Wharton County,,TX,2624,44894,47518,7,11,18,1290,1747,3037,6,0.325249,0.343499,22.80563,0.001399,0.003423,136,0.000158,0,20,0.618182,0.012646
48483,Wheeler County,,TX,402,5130,5532,1,2,3,43,113,156,7,0.260496,0.27011,0,0.000101,0.000102,136,0.000067,0,20,1,0.000798
48485,Wichita County,,TX,13467,125145,138612,54,71,125,6147,8029,14176,6,0.372123,0.404032,28241.598521,0.018971,0.023804,136,0.000914,0,20,0.361305,0.143444
48487,Wilbarger County,,TX,1097,13867,14964,4,4,8,304,342,646,7,0.271886,0.283818,6119.701711,0.001683,0.000173,136,0.000156,0,20,0.366667,0.013678
48489,Willacy County,,TX,1364,19715,21079,4,4,8,571,821,1392,6,0.321689,0.33858,0,0.00203,0.00213,136,0.000098,0,20,1,0.016573
48491,Williamson County,,TX,33966,344649,378615,135,82,217,41415,26704,68119,6,0.38345,0.416231,11124.682167,0.054328,0.033157,136,0.001649,0,20,0.381801,0.404429
48493,Wilson County,,TX,2641,39404,42045,7,6,13,2393,1687,4080,6,0.324813,0.342268,61.114281,0.002474,0.002161,136,0.000203,0,20,0.714286,0.022337
48495,Winkler County,,TX,645,6934,7579,3,3,6,225,282,507,7,0.26087,0.271267,0,0.000153,0.000167,136,0.000129,0,20,1,0.001755
48497,Wise County,,TX,4832,54354,59186,12,10,22,3462,3100,6562,6,0.320838,0.337125,40.486232,0.003882,0.003359,136,0.000252,0,20,0.641026,0.033439
48499,Wood County,,TX,2821,36917,39738,16,13,29,2341,1667,4008,6,0.326197,0.344742,579.947279,0.00374,0.004283,136,0.000315,0,20,0.604167,0.034092
48501,Yoakum County,,TX,668,8134,8802,2,5,7,133,271,404,7,0.267291,0.279147,0.60989,0.00014,0.000329,136,0.000094,0,20,0.9,0.001325
48503,Young County,,TX,1266,17986,19252,7,7,14,563,472,1035,6,0.315174,0.330229,255.009709,0.001889,0.00122,136,0.000172,0,20,0.611111,0.015786
48505,Zapata County,,TX,651,12538,13189,3,4,7,199,277,476,6,0.321405,0.33815,0.542857,0.001009,0.001323,136,0.00009,0,20,0.833333,0.008247
48507,Zavala County,,TX,699,11171,11870,4,3,7,328,299,627,6,0.309838,0.324313,1.5,0.000743,0.00082,136,0.000149,0,20,0.75,0.006688
49001,Beaver County,,UT,529,6669,7198,3,3,6,212,244,456,6,0.296576,0.309548,0,0.001001,0.000682,6,0.000112,0,20,1,0.008834
49003,Box Elder County,,UT,3506,52169,55675,10,8,18,2592,2318,4910,6,0.33299,0.351323,3920.076408,0.003243,0.002377,6,0.000203,0,20,0.8,0.026993
49005,Cache County,,UT,10239,103617,113856,27,34,61,5072,6747,11819,6,0.354748,0.379914,3781.429311,0.00827,0.011379,6,0.000497,0,20,0.4367,0.066557
49007,Carbon County,,UT,1472,20853,22325,4,7,11,623,776,1399,6,0.299506,0.313276,3.869876,0.000926,0.001047,6,0.000109,0,20,0.666667,0.006966
49009,Daggett County,,UT,110,893,1003,0,0,0,0,0,0,0,0,0,0,0,0,159,0.00005,145,238,0,0
49011,Davis County,,UT,26161,298064,324225,75,58,133,24155,19726,43881,6,0.36416,0.393643,4905.046483,0.028921,0.023307,6,0.000978,0,20,0.451681,0.220265
49013,Duchesne County,,UT,1174,16334,17508,6,3,9,795,566,1361,6,0.299044,0.312102,0.828571,0.001112,0.000801,6,0.000148,0,20,0.833333,0.009476
49015,Emery County,,UT,880,11440,12320,3,3,6,270,454,724,6,0.299014,0.312045,0,0.00084,0.000791,6,0.000086,0,20,1,0.006354
49017,Garfield County,,UT,486,4569,5055,3,2,5,154,214,368,7,0.256908,0.265854,0,0.000613,0.000172,6,0.000113,0,20,1,0.00541
49019,Grand County,,UT,781,8860,9641,2,4,6,134,261,395,6,0.299598,0.313018,2.723153,0.000595,0.000901,6,0.000085,0,20,0.75,0.004932
49021,Iron County,,UT,3836,36673,40509,21,10,31,3800,2337,6137,6,0.33456,0.353505,1416.16393,0.007977,0.003266,6,0.000381,0,20,0.542857,0.059726
49023,Juab County,,UT,736,9313,10049,3,3,6,501,399,900,6,0.299014,0.312045,0,0.000847,0.000799,6,0.00009,0,20,1,0.00643
49025,Kane County,,UT,561,6089,6650,4,3,7,317,198,515,7,0.261385,0.271421,0.090909,0.001591,0.000274,6,0.000102,0,20,0.9,0.01308
49027,Millard County,,UT,932,12773,13705,3,4,7,300,521,821,6,0.299075,0.312274,0,0.000913,0.000956,6,0.000091,0,20,1,0.007143
49029,Morgan County,,UT,847,8967,9814,6,3,9,790,530,1320,6,0.297637,0.310647,0,0.00127,0.00086,6,0.000125,0,20,0.966667,0.010186
49031,Piute County,,UT,117,1329,1446,0,0,0,0,0,0,0,0,0,0,0,0,160,0.00005,146,239,0,0
49033,Rich County,,UT,224,2013,2237,0,0,0,0,0,0,0,0,0,0,0,0,161,0.00005,147,240,0,0
49035,Salt Lake County,,UT,58409,1043891,1102300,181,178,359,48238,48848,97086,5,0.421373,0.462285,88554.34123,0.065672,0.065171,6,0.002388,0,20,0.297596,0.491013
49037,San Juan County,,UT,1196,9088,10284,5,4,9,510,503,1013,6,0.299629,0.313047,5.89743,0.000676,0.000885,6,0.000127,0,20,0.52381,0.005872
49039,Sanpete County,,UT,1870,22487,24357,7,8,15,1025,1253,2278,6,0.321831,0.338723,48.326822,0.00201,0.002028,6,0.000163,0,20,0.777778,0.016636
49041,Sevier County,,UT,1362,20151,21513,6,6,12,804,778,1582,6,0.32176,0.338379,0.166667,0.001849,0.001958,6,0.000152,0,20,0.966667,0.015265
49043,Summit County,,UT,4117,35424,39541,12,12,24,1903,2451,4354,6,0.343606,0.363877,198.382208,0.006756,0.006159,6,0.000192,0,20,0.824176,0.052072
49045,Tooele County,,UT,4969,53667,58636,13,9,22,4266,3150,7416,6,0.321938,0.339009,28.624865,0.004999,0.002407,6,0.000222,0,20,0.747253,0.039108
49047,Uintah County,,UT,1900,27697,29597,9,9,18,1074,1041,2115,6,0.300031,0.314307,521.228904,0.002268,0.001161,6,0.000204,0,20,0.55303,0.018821
49049,Utah County,,UT,33102,432286,465388,104,114,218,28361,25770,54131,6,0.38935,0.426168,21840.54006,0.035319,0.04198,6,0.001442,0,20,0.352302,0.280865
49051,Wasatch County,,UT,2136,19074,21210,9,6,15,2026,1361,3387,6,0.300248,0.313774,33.65179,0.003286,0.001179,6,0.000162,0,20,0.844444,0.025916
49053,Washington County,,UT,9533,113780,123313,42,31,73,11024,6526,17550,6,0.345647,0.368849,7883.924585,0.014174,0.010516,6,0.000678,0,20,0.451691,0.107025
49055,Wayne County,,UT,217,2517,2734,1,1,2,46,49,95,7,0.256908,0.26574,0,0.000506,0.00011,6,0.000062,0,20,1,0.003924
49057,Weber County,,UT,17867,230781,248648,37,38,75,12489,13430,25919,6,0.352258,0.378013,1845.729541,0.016176,0.015636,6,0.000532,0,20,0.536078,0.125942
50001,Addison County,,VT,2409,41666,44075,7,6,13,1163,1163,2326,6,0.303441,0.318087,137.760116,0.000958,0.00095,44,0.000151,0,20,0.535714,0.006813
50003,Bennington County,,VT,2302,41968,44270,7,7,14,766,904,1670,7,0.268104,0.279906,19.862141,0.001142,0.000367,97,0.00012,0,20,0.458333,0.006003
50005,Caledonia County,,VT,1847,34956,36803,8,8,16,1028,876,1904,7,0.266997,0.278239,582.419136,0.000265,0.000258,44,0.000188,0,20,0.5,0.002219
50007,Chittenden County,,VT,11590,174267,185857,45,56,101,6268,6869,13137,6,0.363523,0.391312,34960.933765,0.017776,0.023362,44,0.000509,0,20,0.483173,0.113294
50009,Essex County,,VT,668,7153,7821,3,3,6,316,351,667,8,0.219507,0.226637,2.635703,0.000011,0.000015,44,0.000103,0,20,0.5,0.000386
50011,Franklin County,,VT,2712,54650,57362,7,7,14,1597,1426,3023,7,0.291496,0.305782,152.087347,0.000211,0.000768,44,0.000191,0,20,0.375,0.00178
50013,Grand Isle County,,VT,778,8558,9336,2,2,4,460,429,889,7,0.266654,0.27675,0,0.000187,0.00014,44,0.000081,0,20,1,0.001086
50015,Lamoille County,,VT,2059,27910,29969,5,5,10,904,1017,1921,7,0.266752,0.277323,1.35,0.000202,0.000151,44,0.000139,0,20,0.85,0.001463
50017,Orange County,,VT,2398,33106,35504,6,6,12,1571,1449,3020,7,0.266948,0.277896,4.378121,0.00028,0.00027,44,0.00013,0,20,0.733333,0.002281
50019,Orleans County,,VT,1460,31312,32772,6,6,12,584,661,1245,7,0.266801,0.277552,463.614042,0.000217,0.000151,44,0.000159,0,20,0.595238,0.001778
50021,Rutland County,,VT,3515,73887,77402,10,9,19,1349,1255,2604,6,0.306994,0.322938,136.213735,0.001734,0.001729,44,0.000168,0,20,0.435897,0.010058
50023,Washington County,,VT,4232,70091,74323,10,12,22,1961,2143,4104,6,0.3024,0.31854,634.108406,0.000956,0.001532,44,0.000223,0,20,0.469697,0.007111
50025,Windham County,,VT,3292,51039,54331,13,11,24,1390,1388,2778,6,0.301961,0.317921,104.003268,0.004117,0.001597,44,0.000158,0,20,0.595833,0.025581
50027,Windsor County,,VT,4905,67338,72243,18,16,34,2534,2630,5164,6,0.302778,0.319628,857.091727,0.004976,0.002658,44,0.000235,0,20,0.480237,0.031304
51001,Accomack County,,VA,1983,37016,38999,6,6,12,527,760,1287,7,0.297333,0.312369,3072.712049,0.001686,0.001053,43,0.000169,0,20,0.404762,0.011377
51003,Albemarle County,,VA,10482,91790,102272,44,36,80,6600,6157,12757,6,0.360238,0.385263,25428.007463,0.017416,0.014932,43,0.000687,0,20,0.467755,0.124215
51005,Alleghany County,,VA,759,18674,19433,3,3,6,222,275,497,7,0.242885,0.251605,5878,0.000042,0.000027,164,0.000196,0,20,0.333333,0.00052
51007,Amelia County,,VA,965,14506,15471,6,5,11,871,583,1454,7,0.277937,0.290295,1.584524,0.000845,0.000594,164,0.000168,0,20,0.833333,0.007501
51009,Amherst County,,VA,1921,33986,35907,5,5,10,1163,1185,2348,7,0.242318,0.251336,32.692118,0.000038,0.000036,164,0.000209,0,20,0.55,0.00077
51011,Appomattox County,,VA,849,15734,16583,6,3,9,521,422,943,7,0.241815,0.250168,24.3218,0.000045,0.000016,164,0.000211,0,20,0.466667,0.000909
51013,Arlington County,,VA,43883,198063,241946,132,103,235,29410,36656,66066,5,0.397595,0.432251,7456.152945,0.067408,0.05351,43,0.001216,0,20,0.512787,0.456084
51015,Augusta County,,VA,4179,80054,84233,12,9,21,3155,2443,5598,6,0.31153,0.327663,15370.297794,0.001264,0.001074,43,0.000343,0,20,0.346154,0.011244
51017,Bath County,,VA,390,5806,6196,0,0,0,0,0,0,0,0,0,0,0,0,162,0.00005,148,241,0,0
51019,Bedford County,,VA,4825,73147,77972,14,13,27,3824,3200,7024,7,0.279593,0.293549,8948.61156,0.002425,0.000483,164,0.000347,0,20,0.383333,0.01833
51021,Bland County,,VA,411,6749,7160,2,3,5,117,229,346,7,0.233848,0.241652,65.590246,0.000008,0.000002,130,0.000117,0,20,0.333333,0.000211
51023,Botetourt County,,VA,2579,36989,39568,8,7,15,1905,1600,3505,7,0.256976,0.267166,473.624491,0.000154,0.000118,164,0.000286,0,20,0.553571,0.001766
51025,Brunswick County,,VA,965,16758,17723,5,4,9,430,375,805,7,0.277275,0.289287,5999.013416,0.000032,0.00038,164,0.000202,0,20,0.232143,0.000777
51027,Buchanan County,,VA,999,22482,23481,3,4,7,225,474,699,8,0.207902,0.213937,119.221814,0.000001,0.000001,130,0.000158,0,20,0.666667,0.000296
51029,Buckingham County,,VA,805,14491,15296,6,3,9,410,272,682,7,0.265172,0.274946,15.478881,0.000192,0.000148,43,0.000183,0,20,0.4,0.001956
51031,Campbell County,,VA,3990,58135,62125,7,7,14,2538,2518,5056,7,0.242439,0.25192,56.808024,0.000042,0.000036,164,0.000255,0,20,0.5,0.000962
51033,Caroline County,,VA,2859,28360,31219,13,12,25,3233,1810,5043,7,0.290826,0.30683,42.503655,0.00316,0.001913,43,0.000218,0,20,0.661905,0.023961
51035,Carroll County,,VA,1301,30619,31920,5,4,9,570,551,1121,7,0.23538,0.24306,6339.418923,0.000023,0.000011,99,0.000274,0,20,0.2,0.000586
51036,Charles City County,,VA,628,8278,8906,6,4,10,465,310,775,7,0.280455,0.292804,0,0.001122,0.000697,164,0.000137,0,20,0.904762,0.009167
51037,Charlotte County,,VA,725,13545,14270,3,4,7,252,319,571,7,0.232243,0.240068,15.402795,0.000022,0.000015,164,0.000118,0,20,0.25,0.000419
51041,Chesterfield County,,VA,25745,333377,359122,113,90,203,24813,18738,43551,6,0.383096,0.416478,63290.26267,0.047127,0.036512,164,0.001488,0,20,0.387434,0.33021
51043,Clarke County,,VA,1259,14395,15654,4,5,9,1116,735,1851,7,0.283267,0.296212,0,0.001271,0.000572,43,0.00011,0,20,0.966667,0.009711
51045,Craig County,,VA,298,5617,5915,3,2,5,144,88,232,7,0.255779,0.264709,0,0.000077,0.000071,164,0.000115,0,20,1,0.000784
51047,Culpeper County,,VA,3707,45123,48830,16,12,28,4249,2067,6316,6,0.311763,0.32807,1011.22383,0.0036,0.002047,43,0.000254,0,20,0.517544,0.027566
51049,Cumberland County,,VA,695,9674,10369,6,5,11,451,328,779,7,0.283543,0.296429,81.94461,0.000842,0.000793,164,0.000192,0,20,0.666667,0.00746
51051,Dickenson County,,VA,665,14645,15310,3,3,6,246,284,530,8,0.194026,0.198775,25.717803,0,0,130,0.000155,0,20,0.666667,0.000292
51053,Dinwiddie County,,VA,2369,28338,30707,10,9,19,1932,1579,3511,7,0.28418,0.297793,54.184928,0.000899,0.001078,164,0.000281,0,20,0.611111,0.008418
51057,Essex County,,VA,798,11787,12585,7,5,12,420,277,697,7,0.280455,0.292947,950.277975,0.000533,0.000468,43,0.000207,0,20,0.404762,0.004992
51059,Fairfax County,,VA,133212,1125717,1258929,316,312,628,93024,119600,212624,5,0.449699,0.501317,212080.96639,0.110205,0.10574,43,0.003355,0,20,0.199033,0.762203
51061,Fauquier County,,VA,6568,67886,74454,15,19,34,5355,3891,9246,6,0.314119,0.331907,1487.319851,0.00414,0.003946,43,0.000224,0,20,0.474026,0.03188
51063,Floyd County,,VA,875,15812,16687,5,5,10,439,454,893,7,0.256908,0.266679,139.811512,0.000149,0.000098,164,0.000175,0,20,0.5,0.001319
51065,Fluvanna County,,VA,2290,25526,27816,6,6,12,1143,1128,2271,7,0.280807,0.29364,138.812847,0.001356,0.000609,43,0.000139,0,20,0.571429,0.010735
51067,Franklin County,,VA,2744,56283,59027,8,8,16,1532,1488,3020,7,0.257067,0.267481,255.387918,0.000097,0.000121,164,0.000247,0,20,0.513889,0.001467
51069,Frederick County,,VA,7071,79958,87029,19,12,31,6562,4334,10896,6,0.313747,0.330475,1198.361984,0.004596,0.002391,43,0.000338,0,20,0.471053,0.032543
51071,Giles County,,VA,789,18952,19741,4,3,7,536,362,898,7,0.255824,0.264909,1479.90793,0.000079,0.000042,164,0.000177,0,20,0.416667,0.000746
51073,Gloucester County,,VA,2832,41046,43878,8,7,15,1765,1226,2991,7,0.288662,0.302535,4824.548893,0.001377,0.001023,164,0.000205,0,20,0.555556,0.009631
51075,Goochland County,,VA,1412,20464,21876,7,5,12,1633,857,2490,7,0.283543,0.296429,0.534483,0.001707,0.001041,164,0.000161,0,20,0.880952,0.013882
51077,Grayson County,,VA,816,16490,17306,5,4,9,311,369,680,8,0.204843,0.210651,153.08063,0.000001,0.000001,99,0.000284,0,20,0.3,0.000475
51079,Greene County,,VA,1587,19090,20677,6,7,13,932,847,1779,7,0.265487,0.275994,7.555465,0.00071,0.000247,43,0.000147,0,20,0.527778,0.005485
51081,Greensville County,,VA,610,9054,9664,2,2,4,130,126,256,8,0.217164,0.223016,113.534808,0.000003,0,164,0.000155,0,20,0.333333,0.000213
51083,Halifax County,,VA,1383,38760,40143,6,7,13,533,518,1051,7,0.242338,0.25196,88.706527,0.00005,0.000037,164,0.000175,0,20,0.238095,0.000771
51085,Hanover County,,VA,7657,110626,118283,18,16,34,5998,5082,11080,6,0.319991,0.339473,476.175694,0.00422,0.004244,164,0.000318,0,20,0.489177,0.031375
51087,Henrico County,,VA,31141,319545,350686,123,105,228,25972,25043,51015,6,0.389298,0.424473,68017.583496,0.053189,0.043864,164,0.00156,0,20,0.404739,0.3609
51089,Henry County,,VA,2817,61040,63857,7,8,15,1405,1514,2919,6,0.284569,0.297984,4104.084383,0.000422,0.000915,99,0.000214,0,20,0.347222,0.004544
51091,Highland County,,VA,128,2671,2799,0,0,0,0,0,0,0,0,0,0,0,0,163,0.00005,149,242,0,0
51093,Isle of Wight County,,VA,2818,37597,40415,11,12,23,2708,1593,4301,7,0.298891,0.314906,528.608617,0.002975,0.002044,164,0.0002,0,20,0.634615,0.020411
51095,James City County,,VA,5634,64997,70631,24,14,38,4265,2530,6795,6,0.313848,0.331632,390.02238,0.008441,0.003451,164,0.000328,0,20,0.539855,0.054942
51097,King and Queen County,,VA,515,6893,7408,3,3,6,206,233,439,7,0.280347,0.292489,1.238462,0.000353,0.000427,164,0.000123,0,20,0.666667,0.003187
51099,King George County,,VA,2592,22767,25359,13,10,23,2362,1139,3501,6,0.334637,0.35315,358.898186,0.005538,0.002829,43,0.000184,0,20,0.666667,0.03935
51101,King William County,,VA,1234,17233,18467,9,7,16,1254,801,2055,7,0.283653,0.296859,19.690327,0.001265,0.001098,164,0.000208,0,20,0.666667,0.010664
51103,Lancaster County,,VA,740,13289,14029,3,3,6,216,153,369,7,0.280428,0.292632,596.524781,0.001161,0.000427,43,0.000117,0,20,0.416667,0.009093
51105,Lee County,,VA,888,21104,21992,3,5,8,253,385,638,7,0.240794,0.249327,84.249281,0.000023,0.000026,130,0.000147,0,20,0.35,0.000532
51107,Loudoun County,,VA,32297,288355,320652,113,116,229,33252,23282,56534,6,0.392978,0.429771,17219.977784,0.056604,0.054179,43,0.001132,0,20,0.449213,0.39253
51109,Louisa County,,VA,2491,31792,34283,17,12,29,2477,1350,3827,6,0.312601,0.329376,216.282065,0.002763,0.002689,43,0.000296,0,20,0.551471,0.022169
51111,Lunenburg County,,VA,720,11688,12408,3,4,7,200,291,491,7,0.232076,0.239707,215.187074,0.000302,0.000021,164,0.000112,0,20,0.55,0.002953
51113,Madison County,,VA,904,13438,14342,5,4,9,612,447,1059,7,0.265124,0.275061,20.27441,0.000884,0.000191,43,0.000123,0,20,0.7,0.007115
51115,Mathews County,,VA,634,9685,10319,1,2,3,159,204,363,8,0.227237,0.23397,0,0.000008,0.000019,164,0.000075,0,20,1,0.000166
51117,Mecklenburg County,,VA,1928,33176,35104,7,9,16,664,810,1474,6,0.301742,0.317635,8915.804835,0.000968,0.001823,164,0.000209,0,20,0.255556,0.009118
51119,Middlesex County,,VA,766,10947,11713,7,3,10,437,214,651,7,0.283488,0.296057,1096.370961,0.001022,0.000789,164,0.000191,0,20,0.404762,0.008463
51121,Montgomery County,,VA,8068,72012,80080,26,27,53,3319,3816,7135,6,0.343322,0.365928,54673.898151,0.005267,0.009237,164,0.000641,0,20,0.330492,0.043484
51125,Nelson County,,VA,1165,16012,17177,5,6,11,535,624,1159,7,0.265948,0.276355,177.666016,0.000182,0.000177,43,0.000178,0,20,0.433333,0.001773
51127,New Kent County,,VA,1275,18074,19349,9,7,16,1457,779,2236,7,0.283653,0.296859,4.529308,0.001362,0.001103,164,0.000198,0,20,0.75,0.011188
51131,Northampton County,,VA,727,13724,14451,2,1,3,316,200,516,8,0.229206,0.23584,0,0.000639,0.000013,43,0.000082,0,20,1,0.00443
51133,Northumberland County,,VA,859,13206,14065,4,3,7,274,298,572,7,0.229026,0.236206,914.288429,0.000835,0.000028,43,0.000158,0,20,0.333333,0.006553
51135,Nottoway County,,VA,1065,15578,16643,7,6,13,591,494,1085,7,0.278017,0.290553,348.647826,0.000846,0.000596,164,0.000195,0,20,0.642857,0.007622
51137,Orange County,,VA,2856,33578,36434,15,12,27,3038,1503,4541,6,0.311864,0.32827,298.122842,0.002935,0.001905,43,0.000246,0,20,0.516667,0.021561
51139,Page County,,VA,1178,26713,27891,5,5,10,639,565,1204,7,0.239546,0.247579,4.764563,0.001358,0.00008,43,0.000139,0,20,0.714286,0.010201
51141,Patrick County,,VA,856,19224,20080,2,2,4,305,355,660,7,0.235095,0.242401,6.889838,0.000029,0.000014,99,0.000092,0,20,0,0.000325
51143,Pittsylvania County,,VA,3597,70040,73637,8,10,18,1986,2246,4232,6,0.283074,0.29673,517.670569,0.000091,0.000578,99,0.000218,0,20,0.336364,0.001333
51145,Powhatan County,,VA,1785,27843,29628,6,6,12,1990,1079,3069,7,0.28357,0.296601,4.897244,0.000869,0.001013,164,0.000168,0,20,0.714286,0.00768
51147,Prince Edward County,,VA,1452,15949,17401,9,9,18,649,654,1303,7,0.283792,0.297403,2921.305193,0.000842,0.001008,164,0.000279,0,20,0.322222,0.007804
51149,Prince George County,,VA,5237,32468,37705,15,15,30,2565,2656,5221,6,0.325722,0.344542,989.289352,0.003594,0.00451,164,0.000281,0,20,0.539216,0.027087
51153,Prince William County,,VA,54700,385027,439727,134,159,293,48448,44006,92454,6,0.401989,0.44358,32990.349374,0.062399,0.065192,43,0.001332,0,20,0.34814,0.431226
51155,Pulaski County,,VA,1983,36575,38558,6,5,11,1166,1056,2222,7,0.255869,0.26531,40.0151,0.000075,0.000044,164,0.00024,0,20,0.366667,0.000946
51157,Rappahannock County,,VA,753,8026,8779,4,3,7,355,274,629,7,0.239684,0.24747,0.271429,0.000568,0.000076,43,0.000102,0,20,0.916667,0.00426
51159,Richmond County,,VA,602,8121,8723,3,3,6,348,262,610,7,0.229008,0.236217,1.625,0.000014,0.00003,43,0.000153,0,20,0.666667,0.000501
51161,Roanoke County,,VA,8607,102476,111083,17,17,34,6162,5796,11958,6,0.319114,0.338877,10493.266918,0.003927,0.004535,164,0.000411,0,20,0.459559,0.03352
51163,Rockbridge County,,VA,1361,23145,24506,4,5,9,490,517,1007,7,0.238076,0.245921,11760.04829,0.00001,0.000016,43,0.000272,0,20,0.15,0.000493
51165,Rockingham County,,VA,4669,84112,88781,15,8,23,3178,2685,5863,6,0.310731,0.326552,3788.936886,0.002834,0.00105,43,0.000328,0,20,0.390476,0.021964
51167,Russell County,,VA,1149,26422,27571,6,6,12,701,657,1358,7,0.240337,0.248659,1797.534306,0.000002,0.000022,130,0.000284,0,20,0.452381,0.000592
51169,Scott County,,VA,987,23278,24265,5,3,8,598,541,1139,7,0.238995,0.246744,608.723839,0.000024,0.000024,130,0.000225,0,20,0.566667,0.000745
51171,Shenandoah County,,VA,2596,45527,48123,11,9,20,2170,1352,3522,6,0.311897,0.327755,456.808307,0.002577,0.001025,43,0.000229,0,20,0.544872,0.019199
51173,Smyth County,,VA,1291,34878,36169,3,3,6,567,529,1096,7,0.239802,0.247717,106.440439,0.000002,0.000021,130,0.000155,0,20,0.416667,0.00031
51175,Southampton County,,VA,1060,18059,19119,9,4,13,1000,422,1422,7,0.253617,0.262681,68.541819,0.001708,0.000112,164,0.000219,0,20,0.652778,0.011607
51177,Spotsylvania County,,VA,14071,125506,139577,40,38,78,12102,9033,21135,6,0.35277,0.377532,2105.243467,0.015446,0.015957,43,0.00048,0,20,0.513469,0.111488
51179,Stafford County,,VA,18172,124452,142624,48,54,102,13903,11956,25859,6,0.361895,0.389662,3323.484318,0.022097,0.024669,43,0.000521,0,20,0.50625,0.158345
51181,Surry County,,VA,471,7268,7739,2,3,5,153,193,346,7,0.281922,0.294264,7.329082,0.00037,0.000337,164,0.000071,0,20,0.333333,0.002446
51183,Sussex County,,VA,740,10831,11571,7,6,13,501,307,808,7,0.277831,0.29025,6055.223402,0.000342,0.000446,164,0.000263,0,20,0.25,0.003804
51185,Tazewell County,,VA,2155,43387,45542,7,10,17,1065,961,2026,7,0.262257,0.273815,8649.802933,0.00008,0.000119,130,0.000282,0,20,0.190909,0.001041
51187,Warren County,,VA,3442,39452,42894,13,13,26,2800,2143,4943,6,0.312937,0.32933,1591.54733,0.002076,0.00201,43,0.000248,0,20,0.459559,0.016169
51191,Washington County,,VA,3217,54812,58029,7,7,14,1662,1902,3564,7,0.242804,0.251929,1934.553256,0.000022,0.000077,130,0.000307,0,20,0.347222,0.000893
51193,Westmoreland County,,VA,1576,17638,19214,12,10,22,985,810,1795,6,0.296848,0.312468,6405.938012,0.002471,0.001346,43,0.000265,0,20,0.538462,0.017564
51195,Wise County,,VA,1786,38444,40230,6,8,14,754,959,1713,7,0.239388,0.248061,11005.363852,0.000022,0.000024,130,0.000294,0,20,0.25,0.000789
51197,Wythe County,,VA,1636,31421,33057,6,6,12,704,617,1321,7,0.256388,0.266232,6730.728388,0.000072,0.000042,130,0.000307,0,20,0.133333,0.00092
51199,York County,,VA,10523,69455,79978,32,37,69,6159,6233,12392,6,0.348503,0.373328,2996.78335,0.011777,0.014025,164,0.000416,0,20,0.466667,0.085908
51510,Alexandria city,,VA,33484,130944,164428,89,67,156,21782,27187,48969,6,0.38109,0.411976,2457.96691,0.049683,0.037911,43,0.000853,0,20,0.628586,0.346795
51515,Bedford city,,VA,612,6657,7269,3,4,7,258,369,627,7,0.243047,0.252121,4.003422,0.000036,0.00006,164,0.000124,0,20,0.833333,0.000562
51520,Bristol city,,VA,1865,16371,18236,3,3,6,1339,1260,2599,7,0.241996,0.250191,44.502446,0.000039,0.000076,130,0.000161,0,20,0.833333,0.000961
51530,Buena Vista city,,VA,588,6635,7223,2,1,3,276,201,477,8,0.192308,0.196295,0,0,0,43,0.000137,0,20,1,0.000181
51540,Charlottesville city,,VA,6075,33877,39952,14,19,33,2901,3784,6685,6,0.34842,0.370069,4465.506942,0.00369,0.00726,43,0.000276,0,20,0.502632,0.029935
51550,Chesapeake city,,VA,27003,232154,259157,64,76,140,20864,19500,40364,6,0.380193,0.411816,9671.18676,0.028379,0.034037,164,0.000668,0,20,0.45903,0.191152
51570,Colonial Heights city,,VA,2556,19387,21943,8,7,15,1736,1700,3436,7,0.284069,0.297334,15.021185,0.001606,0.001063,164,0.000186,0,20,0.839286,0.013506
51580,Covington city,,VA,441,6965,7406,1,1,2,135,135,270,8,0.195433,0.199881,0,0,0,164,0.000106,0,20,0,0.000093
51590,Danville city,,VA,3389,46493,49882,5,9,14,1614,2015,3629,6,0.302338,0.318007,987.149562,0.000412,0.001936,99,0.000143,0,20,0.472222,0.004438
51595,Emporia city,,VA,491,6064,6555,2,2,4,126,140,266,8,0.217489,0.223457,9.754386,0.000003,0.000003,164,0.000159,0,20,0.333333,0.000188
51600,Fairfax city,,VA,4442,23948,28390,7,11,18,3344,3130,6474,6,0.31378,0.330344,1.034773,0.003704,0.004668,43,0.000113,0,20,0.854545,0.028092
51610,Falls Church city,,VA,1919,11455,13374,6,6,12,932,1085,2017,6,0.311697,0.327239,0,0.003198,0.003326,43,0.000106,0,20,1,0.024697
51620,Franklin city,,VA,822,9119,9941,5,2,7,537,302,839,7,0.253396,0.261937,0,0.000965,0.000092,164,0.000143,0,20,0.9,0.006883
51630,Fredericksburg city,,VA,4857,17775,22632,12,12,24,3531,3360,6891,6,0.312399,0.329089,42.827081,0.003134,0.002422,43,0.000199,0,20,0.67033,0.023704
51640,Galax city,,VA,521,7544,8065,2,2,4,253,189,442,8,0.19067,0.194845,0,0,0,99,0.000169,0,20,1,0.000194
51650,Hampton city,,VA,21325,140228,161553,54,61,115,13112,14153,27265,6,0.372647,0.402509,6842.086969,0.025974,0.031498,164,0.000621,0,20,0.559474,0.186032
51660,Harrisonburg city,,VA,4359,31074,35433,8,10,18,2000,2221,4221,6,0.31153,0.32803,1177.201874,0.001594,0.002424,43,0.000227,0,20,0.515152,0.012373
51670,Hopewell city,,VA,2882,22930,25812,8,7,15,1994,1795,3789,7,0.284069,0.297334,11.670513,0.001318,0.001065,164,0.000187,0,20,0.857143,0.011357
51678,Lexington city,,VA,628,5446,6074,1,2,3,89,141,230,8,0.19232,0.196467,0,0,0,43,0.000096,0,20,1,0.000095
51680,Lynchburg city,,VA,6078,62675,68753,13,15,28,3464,3633,7097,6,0.31866,0.338104,17126.108695,0.001949,0.004183,164,0.000356,0,20,0.4375,0.015179
51683,Manassas city,,VA,8622,38138,46760,13,15,28,5216,6441,11657,6,0.328257,0.347973,128.214871,0.005107,0.004652,43,0.000173,0,20,0.647059,0.037356
51685,Manassas Park city,,VA,3439,12063,15502,7,9,16,2402,2471,4873,6,0.311597,0.327468,0.861143,0.002265,0.002089,43,0.000113,0,20,0.772727,0.017122
51690,Martinsville city,,VA,1182,14968,16150,3,3,6,642,612,1254,6,0.282497,0.294851,31.993083,0.000013,0.000535,99,0.000118,0,20,0.666667,0.000348
51700,Newport News city,,VA,29526,183538,213064,83,104,187,17616,20166,37782,6,0.391919,0.42732,20735.905057,0.040159,0.045627,164,0.000853,0,20,0.450758,0.274655
51710,Norfolk city,,VA,37657,212843,250500,91,108,199,22432,26702,49134,6,0.396242,0.432131,10194.552241,0.044459,0.051942,164,0.0009,0,20,0.500339,0.304165
51720,Norton city,,VA,407,3866,4273,1,1,2,202,235,437,8,0.193163,0.197431,0,0,0,130,0.000081,0,20,0,0.000101
51730,Petersburg city,,VA,4065,31683,35748,13,10,23,2353,2565,4918,7,0.298584,0.31411,4453.933561,0.004081,0.00149,164,0.000255,0,20,0.527473,0.030338
51735,Poquoson city,,VA,1189,13845,15034,3,3,6,709,520,1229,7,0.282716,0.295124,0,0.000707,0.000605,164,0.000075,0,20,1,0.004473
51740,Portsmouth city,,VA,13116,99834,112950,26,28,54,9849,8899,18748,6,0.344991,0.368259,566.859765,0.012316,0.011817,164,0.000297,0,20,0.593093,0.080819
51750,Radford city,,VA,1602,10111,11713,3,5,8,614,851,1465,7,0.25675,0.266393,4.744882,0.000107,0.000099,164,0.000132,0,20,0.8,0.000901
51760,Richmond city,,VA,24085,174397,198482,73,64,137,17115,19741,36856,6,0.366545,0.395521,15920.047536,0.026806,0.025936,164,0.000984,0,20,0.411774,0.184495
51770,Roanoke city,,VA,10192,95751,105943,20,20,40,6185,7139,13324,6,0.320661,0.341455,21449.349267,0.003295,0.005255,164,0.00049,0,20,0.32971,0.027885
51775,Salem city,,VA,2624,25949,28573,6,7,13,1885,1741,3626,7,0.256954,0.267108,10.613451,0.000153,0.000118,164,0.000195,0,20,0.785714,0.001583
51790,Staunton city,,VA,2292,24635,26927,6,6,12,1301,1345,2646,7,0.265487,0.275708,2963.070536,0.000668,0.000181,43,0.000222,0,20,0.595238,0.005105
51800,Suffolk city,,VA,8631,82747,91378,26,20,46,7361,5153,12514,6,0.3392,0.360613,8039.982419,0.010091,0.006896,164,0.000404,0,20,0.603448,0.071169
51810,Virginia Beach city,,VA,60915,473527,534442,191,213,404,39790,45782,85572,6,0.422045,0.467944,85448.911289,0.07875,0.081323,164,0.001909,0,20,0.290341,0.538244
51820,Waynesboro city,,VA,2387,22498,24885,7,6,13,1425,1278,2703,7,0.265753,0.276011,10.350627,0.00021,0.000202,43,0.000222,0,20,0.642857,0.002253
51830,Williamsburg city,,VA,1823,8311,10134,4,5,9,688,795,1483,7,0.282799,0.295524,0,0.001121,0.000681,164,0.000094,0,20,0.966667,0.007724
51840,Winchester city,,VA,4338,25484,29822,10,10,20,2631,2972,5603,6,0.311897,0.327898,519.753012,0.001854,0.001481,43,0.000218,0,20,0.583333,0.014478
53001,Adams County,,WA,1523,17808,19331,4,6,10,490,867,1357,6,0.30964,0.32445,0,0.000432,0.001384,6,0.000104,0,20,1,0.003995
53003,Asotin County,,WA,2170,20884,23054,8,7,15,1356,1213,2569,6,0.309805,0.324822,61.270359,0.001172,0.001366,6,0.000192,0,20,0.680556,0.010585
53005,Benton County,,WA,14160,169290,183450,45,42,87,9666,9915,19581,6,0.354532,0.381506,5912.813933,0.014532,0.013845,6,0.00066,0,20,0.506639,0.117515
53007,Chelan County,,WA,5891,73698,79589,18,17,35,4147,4227,8374,6,0.34312,0.364044,125.878029,0.006029,0.006421,6,0.000277,0,20,0.842105,0.049716
53009,Clallam County,,WA,4105,73406,77511,23,17,40,2560,2073,4633,6,0.34316,0.364101,80.851926,0.0105,0.006734,6,0.000297,0,20,0.778462,0.081435
53011,Clark County,,WA,26821,427283,454104,106,89,195,25300,20830,46130,6,0.3699,0.403253,10994.822721,0.034161,0.02912,6,0.001385,0,20,0.382163,0.266316
53013,Columbia County,,WA,465,3990,4455,1,1,2,109,157,266,7,0.251187,0.258895,0,0.000034,0.00004,6,0.00007,0,20,0,0.000425
53015,Cowlitz County,,WA,5915,102222,108137,28,23,51,6027,3807,9834,6,0.344419,0.366254,5608.736677,0.010176,0.008519,6,0.000404,0,20,0.721675,0.082494
53017,Douglas County,,WA,3436,34112,37548,10,9,19,3086,2559,5645,6,0.313206,0.328683,6.943617,0.003139,0.002277,6,0.000176,0,20,0.911111,0.025497
53019,Ferry County,,WA,590,6349,6939,3,3,6,202,214,416,7,0.270698,0.283013,0.416667,0.000263,0.000292,6,0.00011,0,20,0.666667,0.002655
53021,Franklin County,,WA,5810,63811,69621,17,15,32,6031,4289,10320,6,0.343079,0.363706,271.532809,0.005963,0.00587,6,0.000242,0,20,0.739474,0.044807
53023,Garfield County,,WA,184,2332,2516,0,0,0,0,0,0,0,0,0,0,0,0,165,0.00005,150,243,0,0
53025,Grant County,,WA,5228,82417,87645,24,24,48,3349,3289,6638,6,0.344297,0.366271,888.383665,0.007883,0.006641,6,0.00036,0,20,0.611111,0.063458
53027,Grays Harbor County,,WA,4214,68942,73156,17,17,34,3040,2714,5754,6,0.33564,0.355493,39.341354,0.005949,0.004915,6,0.000272,0,20,0.845029,0.049263
53029,Island County,,WA,11021,81361,92382,32,31,63,6403,6087,12490,6,0.35688,0.380893,338.171259,0.014798,0.014402,6,0.000374,0,20,0.618065,0.111369
53031,Jefferson County,,WA,2187,30659,32846,9,8,17,1291,1116,2407,6,0.313476,0.328929,0.439661,0.004504,0.002516,6,0.000152,0,20,0.918182,0.036453
53033,King County,,WA,124685,1985211,2109896,338,275,613,116826,111111,227937,5,0.44584,0.493975,181360.102946,0.108129,0.093735,6,0.004044,0,20,0.206729,0.767379
53035,Kitsap County,,WA,22994,262179,285173,77,79,156,16312,15904,32216,6,0.373029,0.405441,2820.683373,0.03114,0.030562,6,0.000853,0,20,0.453639,0.235409
53037,Kittitas County,,WA,3515,32658,36173,15,14,29,2531,2219,4750,6,0.335176,0.35449,16.953258,0.002838,0.004077,6,0.000245,0,20,0.808824,0.02566
53039,Klickitat County,,WA,1480,19437,20917,9,9,18,935,741,1676,6,0.3104,0.325762,152.612519,0.001976,0.002062,6,0.00021,0,20,0.672727,0.017932
53041,Lewis County,,WA,4799,74604,79403,20,19,39,3904,3284,7188,6,0.335795,0.355951,61.690883,0.007763,0.00534,6,0.000299,0,20,0.798419,0.063534
53043,Lincoln County,,WA,935,10759,11694,3,3,6,470,452,922,6,0.309476,0.32382,0,0.001006,0.001128,6,0.000089,0,20,1,0.008703
53045,Mason County,,WA,4369,55477,59846,13,8,21,4361,2971,7332,6,0.334752,0.353173,13.382584,0.005514,0.003433,6,0.000203,0,20,0.897436,0.044847
53047,Okanogan County,,WA,2568,39639,42207,12,11,23,1418,1279,2697,6,0.313375,0.329198,207.404682,0.002529,0.002539,6,0.000225,0,20,0.725275,0.022579
53049,Pacific County,,WA,1512,20847,22359,11,9,20,951,695,1646,6,0.313072,0.328511,405.69615,0.002559,0.002502,6,0.000211,0,20,0.736364,0.023598
53051,Pend Oreille County,,WA,1070,12076,13146,5,3,8,693,565,1258,7,0.270723,0.283071,0.366667,0.001085,0.000327,6,0.000149,0,20,0.9,0.010171
53053,Pierce County,,WA,62051,801839,863890,208,186,394,56905,49230,106135,5,0.423027,0.465538,48612.906372,0.071778,0.067003,6,0.002485,0,20,0.270485,0.531207
53055,San Juan County,,WA,1162,15732,16894,3,5,8,367,500,867,6,0.308884,0.323528,0,0.001191,0.001577,6,0.000089,0,20,1,0.010474
53057,Skagit County,,WA,7599,118389,125988,25,20,45,6095,4662,10757,6,0.343931,0.365252,190.241481,0.010723,0.007391,6,0.000326,0,20,0.669951,0.083576
53059,Skamania County,,WA,750,10018,10768,4,2,6,512,304,816,7,0.270095,0.281813,0,0.000627,0.00028,6,0.000113,0,20,0.916667,0.006334
53061,Snohomish County,,WA,49035,716934,765969,136,123,259,49746,39853,89599,5,0.392025,0.429198,13967.663367,0.052331,0.046574,6,0.001674,0,20,0.382327,0.396354
53063,Spokane County,,WA,26075,473073,499148,107,98,205,22680,18519,41199,6,0.371031,0.406002,32721.023193,0.029302,0.029261,6,0.001606,0,20,0.321419,0.232124
53065,Stevens County,,WA,3323,42409,45732,12,7,19,2189,1954,4143,6,0.313173,0.328482,639.397225,0.005802,0.002027,6,0.000239,0,20,0.719697,0.045543
53067,Thurston County,,WA,19412,250862,270274,76,60,136,18435,13768,32203,6,0.361985,0.391088,2239.503133,0.027524,0.022575,6,0.000935,0,20,0.47305,0.216442
53069,Wahkiakum County,,WA,229,4000,4229,1,2,3,76,107,183,7,0.256252,0.26484,0,0.000066,0.000099,6,0.000065,0,20,1,0.000734
53071,Walla Walla County,,WA,4141,56294,60435,18,14,32,2200,2343,4543,6,0.335408,0.354805,5980.373717,0.00514,0.004388,6,0.000323,0,20,0.661905,0.042736
53073,Whatcom County,,WA,11981,194278,206259,49,37,86,8294,7684,15978,6,0.347131,0.371426,749.502942,0.017274,0.013143,6,0.000628,0,20,0.54717,0.135183
53075,Whitman County,,WA,4969,33560,38529,15,21,36,2109,2832,4941,6,0.343566,0.365137,234.561043,0.002941,0.006551,6,0.000269,0,20,0.718615,0.02643
53077,Yakima County,,WA,10585,244054,254639,41,45,86,6110,7409,13519,6,0.350518,0.376609,691.105322,0.012583,0.014199,6,0.000533,0,20,0.552036,0.098957
54001,Barbour County,,WV,766,15755,16521,5,4,9,448,356,804,8,0.204282,0.210467,5139.049506,0.000038,0.000007,113,0.000244,0,20,0.55,0.00073
54003,Berkeley County,,WV,6627,103506,110133,28,18,46,7974,3373,11347,6,0.316511,0.334651,12549.886121,0.006267,0.003701,43,0.000507,0,20,0.355172,0.045462
54005,Boone County,,WV,1286,24551,25837,4,5,9,585,848,1433,7,0.247744,0.257602,2.259524,0.000066,0.000029,113,0.000159,0,20,0.7,0.000652
54007,Braxton County,,WV,726,12668,13394,3,3,6,158,183,341,7,0.247723,0.257315,5718.499284,0.000059,0.000026,113,0.000146,0,20,0.25,0.000512
54009,Brooke County,,WV,1418,27566,28984,5,5,10,603,766,1369,6,0.298339,0.31327,1.332102,0.000789,0.000703,113,0.000117,0,20,0.8,0.005352
54011,Cabell County,,WV,6200,93997,100197,15,16,31,3342,3480,6822,6,0.316408,0.335641,6216.5097,0.000862,0.002269,113,0.000451,0,20,0.269006,0.007064
54013,Calhoun County,,WV,336,7012,7348,1,1,2,40,45,85,8,0.198526,0.2033,0,0,0,113,0.000108,0,20,0,0.000093
54015,Clay County,,WV,533,9305,9838,2,2,4,165,212,377,7,0.24766,0.257029,0,0.000059,0.000026,113,0.000127,0,20,1,0.000435
54017,Doddridge County,,WV,372,5110,5482,1,2,3,114,178,292,8,0.204254,0.210095,0,0,0.000006,113,0.00009,0,20,0.5,0.000148
54019,Fayette County,,WV,2265,44022,46287,4,5,9,972,1137,2109,7,0.249272,0.259458,16.807841,0.000067,0.000034,113,0.000186,0,20,0.7,0.000653
54021,Gilmer County,,WV,457,5908,6365,1,2,3,90,101,191,8,0.198838,0.20413,2.2,0,0,113,0.000092,0,20,0.5,0.000093
54023,Grant County,,WV,628,13110,13738,3,2,5,317,254,571,8,0.202097,0.207509,30.112691,0.000002,0,43,0.000145,0,20,0.166667,0.000278
54025,Greenbrier County,,WV,1711,36074,37785,6,7,13,536,541,1077,7,0.256908,0.26845,3845.932753,0.000066,0.000051,113,0.000237,0,20,0.375,0.000815
54027,Hampshire County,,WV,1279,23881,25160,9,7,16,935,659,1594,7,0.241694,0.250718,3470.451083,0.001173,0.000137,43,0.000237,0,20,0.388889,0.008872
54029,Hancock County,,WV,1896,37254,39150,6,7,13,1058,1051,2109,6,0.298952,0.314364,16.83573,0.000864,0.000756,113,0.000119,0,20,0.547619,0.005637
54031,Hardy County,,WV,856,15003,15859,3,3,6,331,298,629,7,0.240556,0.248375,722.690907,0.000002,0.000058,43,0.000167,0,20,0.666667,0.000356
54033,Harrison County,,WV,3647,75472,79119,11,9,20,1625,1538,3163,7,0.256523,0.268209,17132.552349,0.0008,0.000051,113,0.000425,0,20,0.272727,0.006026
54035,Jackson County,,WV,1443,30431,31874,5,5,10,788,645,1433,7,0.247913,0.258031,24.76105,0.000073,0.000035,113,0.000233,0,20,0.5,0.0008
54037,Jefferson County,,WV,4461,53494,57955,15,8,23,3780,2447,6227,6,0.312903,0.328849,50.537743,0.004443,0.002363,43,0.000229,0,20,0.629167,0.031014
54039,Kanawha County,,WV,10474,213939,224413,28,33,61,5270,5764,11034,6,0.329074,0.352721,100217.375329,0.003306,0.007607,113,0.000877,0,20,0.180672,0.027269
54041,Lewis County,,WV,884,19018,19902,3,4,7,379,425,804,7,0.231154,0.239008,244.337989,0.000001,0.000007,113,0.000162,0,20,0.35,0.000329
54043,Lincoln County,,WV,1253,21099,22352,5,6,11,705,852,1557,7,0.249272,0.259503,8.141654,0.000084,0.000035,113,0.000186,0,20,0.7,0.000808
54045,Logan County,,WV,1359,35618,36977,6,6,12,550,705,1255,7,0.249293,0.259561,84.782135,0.000077,0.000035,113,0.000209,0,20,0.5,0.000885
54047,McDowell County,,WV,1040,17087,18127,4,3,7,284,515,799,7,0.233716,0.241406,2461.230962,0.000068,0.000001,130,0.000158,0,20,0.333333,0.001852
54049,Marion County,,WV,2931,59851,62782,9,7,16,1415,1341,2756,6,0.29926,0.314937,4187.126382,0.000074,0.000678,113,0.000358,0,20,0.3,0.001537
54051,Marshall County,,WV,1714,36793,38507,3,3,6,728,868,1596,7,0.236894,0.244661,23.150861,0.000022,0.00002,113,0.000129,0,20,0.333333,0.000423
54053,Mason County,,WV,1107,26396,27503,6,6,12,617,613,1230,7,0.249357,0.259773,50.160661,0.000095,0.000045,113,0.000211,0,20,0.433333,0.000976
54055,Mercer County,,WV,3034,60998,64032,9,13,22,1288,1237,2525,6,0.304171,0.320544,14866.858623,0.000067,0.000949,130,0.000351,0,20,0.21978,0.001129
54057,Mineral County,,WV,1554,30854,32408,5,7,12,819,900,1719,7,0.253242,0.264102,5319.194323,0.00005,0.000122,43,0.000214,0,20,0.309524,0.001163
54059,Mingo County,,WV,1167,24575,25742,4,6,10,415,667,1082,7,0.24955,0.260053,375.947612,0.000067,0.000039,113,0.000159,0,20,0.366667,0.000679
54061,Monongalia County,,WV,6387,77246,83633,25,21,46,2825,2736,5561,6,0.337274,0.360493,47812.750863,0.00304,0.004817,113,0.000682,0,20,0.2,0.022796
54063,Monroe County,,WV,679,12880,13559,3,3,6,286,322,608,7,0.233341,0.240713,35.073302,0.000008,0.000002,113,0.000152,0,20,0.333333,0.000308
54065,Morgan County,,WV,1103,17900,19003,9,4,13,886,469,1355,7,0.25641,0.265467,220.163848,0.001675,0.000139,43,0.000203,0,20,0.533333,0.012211
54067,Nicholas County,,WV,1129,26921,28050,6,5,11,469,441,910,7,0.247765,0.257659,5885.833333,0.000067,0.000028,113,0.000319,0,20,0.333333,0.000818
54069,Ohio County,,WV,2824,50702,53526,8,8,16,1439,1563,3002,6,0.309937,0.326781,3410.008424,0.001542,0.001419,113,0.000198,0,20,0.482143,0.010718
54071,Pendleton County,,WV,572,8803,9375,0,2,2,0,105,105,7,0.237574,0.244614,0,0,0.000022,43,0.00005,0,244,0,0
54073,Pleasants County,,WV,462,8061,8523,3,3,6,222,261,483,7,0.235857,0.243281,5.135714,0.000012,0.000013,113,0.000221,0,20,0.666667,0.0004
54075,Pocahontas County,,WV,464,9237,9701,0,2,2,0,134,134,8,0.204597,0.210578,0,0,0.000001,113,0.00005,0,245,0,0
54077,Preston County,,WV,1367,33138,34505,4,5,9,766,709,1475,7,0.252495,0.262424,70.6294,0.000043,0.000049,113,0.000196,0,20,0.4,0.000702
54079,Putnam County,,WV,4277,60192,64469,9,8,17,2963,2443,5406,6,0.302967,0.318305,973.55936,0.000121,0.000889,113,0.000305,0,20,0.436364,0.0014
54081,Raleigh County,,WV,3908,77079,80987,11,11,22,1598,1534,3132,6,0.303346,0.319181,5752.80252,0.000129,0.000889,113,0.000396,0,20,0.325758,0.001595
54083,Randolph County,,WV,1378,30868,32246,4,4,8,408,443,851,7,0.252407,0.262109,7249.084726,0,0.000024,113,0.000242,0,20,0.15,0.000364
54085,Ritchie County,,WV,644,11872,12516,4,2,6,298,239,537,7,0.235761,0.24288,176.161583,0.000007,0.000007,113,0.000231,0,20,0.416667,0.000486
54087,Roane County,,WV,711,15068,15779,3,3,6,338,328,666,7,0.247681,0.257201,5878,0.000059,0.000026,113,0.000204,0,20,0.333333,0.000519
54089,Summers County,,WV,611,11291,11902,3,3,6,328,288,616,7,0.233472,0.240959,2.354126,0.000015,0.000002,113,0.000133,0,20,0.833333,0.000328
54091,Taylor County,,WV,825,16845,17670,5,5,10,593,468,1061,7,0.252473,0.262396,572.567293,0.000043,0.000031,113,0.000246,0,20,0.65,0.00075
54093,Tucker County,,WV,455,7722,8177,1,1,2,87,82,169,8,0.201551,0.206375,0,0,0,113,0.000102,0,20,0,0.000094
54095,Tyler County,,WV,575,9714,10289,1,2,3,192,209,401,7,0.235876,0.243166,1.724242,0,0.000007,113,0.000084,0,20,0,0.000098
54097,Upshur County,,WV,1237,23629,24866,4,6,10,365,494,859,7,0.248103,0.258478,1601.721877,0.000001,0.000033,113,0.000228,0,20,0.366667,0.000433
54099,Wayne County,,WV,2237,40871,43108,8,8,16,1316,1474,2790,6,0.308034,0.32378,3725.765627,0.000094,0.000745,113,0.000263,0,20,0.355556,0.001177
54101,Webster County,,WV,380,8798,9178,1,1,2,87,109,196,8,0.198581,0.203472,0,0,0.000001,113,0.000105,0,20,0,0.000101
54103,Wetzel County,,WV,1100,18941,20041,5,6,11,358,510,868,7,0.25256,0.262739,3277.296626,0.000043,0.000031,113,0.00024,0,20,0.2,0.000681
54105,Wirt County,,WV,310,5358,5668,1,1,2,151,150,301,7,0.235742,0.242708,0,0.000006,0.000007,113,0.00009,0,20,0,0.000159
54107,Wood County,,WV,4584,96873,101457,13,12,25,1910,1808,3718,6,0.308426,0.324954,17938.742018,0.000869,0.000783,113,0.000563,0,20,0.208791,0.00686
54109,Wyoming County,,WV,1040,21873,22913,4,4,8,343,499,842,7,0.233622,0.241417,31.010628,0.000015,0.000003,113,0.000171,0,20,0.3,0.000427
55001,Adams County,,WI,1516,21327,22843,10,7,17,1015,804,1819,6,0.288376,0.30126,71.026016,0.00209,0.000451,166,0.000204,0,20,0.7,0.015197
55003,Ashland County,,WI,1149,18333,19482,2,3,5,285,300,585,7,0.252123,0.260496,7.707674,0.000004,0.000008,24,0.000095,0,20,0.333333,0.000184
55005,Barron County,,WI,2922,54461,57383,13,14,27,1561,1652,3213,6,0.305416,0.320888,549.770347,0.001301,0.001026,24,0.000304,0,20,0.509524,0.010005
55007,Bayfield County,,WI,961,17683,18644,2,3,5,252,383,635,7,0.260356,0.269969,377.867149,0.000019,0.000055,24,0.000092,0,20,0.5,0.000245
55009,Brown County,,WI,14183,290665,304848,46,42,88,9150,9403,18553,6,0.354878,0.380355,34762.433834,0.009476,0.008665,166,0.000823,0,20,0.283588,0.072492
55011,Buffalo County,,WI,1027,16843,17870,4,5,9,364,548,912,7,0.257591,0.267019,9.501204,0.000049,0.000061,24,0.000137,0,20,0.4,0.000852
55013,Burnett County,,WI,1147,18109,19256,8,5,13,596,466,1062,6,0.304584,0.318425,3.922161,0.001298,0.000627,24,0.000177,0,20,0.696429,0.009398
55015,Calumet County,,WI,3973,54010,57983,9,9,18,2824,2951,5775,6,0.297637,0.311489,0.797258,0.000913,0.001031,166,0.000175,0,20,0.911111,0.006985
55017,Chippewa County,,WI,3890,69989,73879,12,12,24,2678,2493,5171,6,0.30638,0.322291,1651.439153,0.001563,0.001534,24,0.000257,0,20,0.547619,0.012267
55019,Clark County,,WI,2215,39528,41743,6,9,15,936,1391,2327,6,0.297698,0.311661,118.610784,0.0001,0.000905,166,0.000159,0,20,0.638889,0.001477
55021,Columbia County,,WI,4996,67762,72758,15,14,29,3872,3472,7344,6,0.329409,0.347589,413.244633,0.002186,0.002094,166,0.000277,0,20,0.569853,0.016805
55023,Crawford County,,WI,1089,19338,20427,5,6,11,544,578,1122,6,0.28892,0.301867,2439.799276,0.000413,0.000427,166,0.000153,0,20,0.433333,0.003685
55025,Dane County,,WI,31714,541384,573098,145,127,272,24825,23892,48717,5,0.404616,0.441317,94338.162562,0.048804,0.047282,166,0.001948,0,20,0.291635,0.350566
55027,Dodge County,,WI,6036,102285,108321,14,14,28,5220,4299,9519,6,0.298186,0.312835,187.060741,0.003248,0.001324,166,0.000221,0,20,0.754167,0.025393
55029,Door County,,WI,1705,35028,36733,7,6,13,725,751,1476,6,0.297637,0.311117,474.782868,0.001888,0.001065,166,0.000157,0,20,0.805556,0.014284
55031,Douglas County,,WI,2754,48837,51591,8,12,20,1266,1361,2627,6,0.336533,0.356243,6755.513332,0.000994,0.002465,24,0.000214,0,20,0.429487,0.00775
55033,Dunn County,,WI,3233,43264,46497,12,15,27,1918,1996,3914,6,0.308721,0.325281,900.429879,0.001669,0.002086,24,0.000266,0,20,0.657143,0.012869
55035,Eau Claire County,,WI,7519,103569,111088,36,29,65,5398,4939,10337,6,0.34647,0.369278,18603.739175,0.004901,0.004515,24,0.000657,0,20,0.336508,0.038658
55037,Florence County,,WI,356,5553,5909,2,1,3,145,115,260,8,0.208632,0.213857,0,0.000068,0.000001,166,0.000099,0,20,1,0.00081
55039,Fond du Lac County,,WI,5816,121716,127532,19,21,40,4032,3864,7896,6,0.342716,0.363958,1089.674051,0.003113,0.003466,166,0.000305,0,20,0.521538,0.023934
55041,Forest County,,WI,553,10499,11052,2,3,5,104,168,272,7,0.262021,0.271739,0.248538,0.000084,0.000098,166,0.000083,0,20,0.666667,0.000937
55043,Grant County,,WI,3116,56659,59775,10,12,22,1494,1839,3333,6,0.298156,0.312554,290.698687,0.000457,0.000915,166,0.000269,0,20,0.410256,0.004599
55045,Green County,,WI,2382,43535,45917,7,6,13,1942,1359,3301,6,0.288662,0.30146,29.247522,0.001054,0.000455,166,0.000152,0,20,0.517857,0.007759
55047,Green Lake County,,WI,1456,22965,24421,7,8,15,764,953,1717,6,0.28849,0.301575,26.504971,0.000571,0.000557,166,0.000158,0,20,0.763889,0.004719
55049,Iowa County,,WI,1892,28133,30025,6,5,11,1351,1196,2547,6,0.288233,0.300745,2.333333,0.0004,0.000405,166,0.000174,0,20,0.7,0.003629
55051,Iron County,,WI,490,7196,7686,1,1,2,115,87,202,8,0.19937,0.20341,0,0,0,166,0.000126,0,78,0,0.000089
55053,Jackson County,,WI,1262,22117,23379,6,6,12,670,712,1382,6,0.288576,0.301546,128.501628,0.000552,0.000462,24,0.000159,0,20,0.642857,0.004303
55055,Jefferson County,,WI,6563,92717,99280,11,12,23,4950,4574,9524,6,0.297973,0.312262,3.858965,0.002276,0.001229,166,0.000163,0,20,0.738095,0.016707
55057,Juneau County,,WI,2018,29038,31056,13,8,21,1499,1169,2668,6,0.28849,0.301604,9.945813,0.001255,0.000489,166,0.000266,0,20,0.583333,0.009943
55059,Kenosha County,,WI,11328,183258,194586,15,21,36,8288,7032,15320,6,0.356793,0.380057,109.456115,0.006509,0.009641,166,0.000187,0,20,0.731602,0.045387
55061,Kewaunee County,,WI,1197,25442,26639,3,3,6,760,812,1572,7,0.261997,0.271681,0.166667,0.000084,0.000106,166,0.000103,0,20,0.833333,0.001133
55063,La Crosse County,,WI,7060,122349,129409,32,25,57,4183,4073,8256,6,0.346305,0.368591,7459.810075,0.004665,0.004365,24,0.000591,0,20,0.35322,0.036794
55065,Lafayette County,,WI,1189,20356,21545,5,5,10,680,723,1403,6,0.288719,0.301449,71.662345,0.000381,0.000422,166,0.000164,0,20,0.633333,0.003456
55067,Langlade County,,WI,1256,23870,25126,7,6,13,537,551,1088,6,0.288862,0.301907,4.907687,0.000212,0.000516,166,0.000171,0,20,0.803571,0.002553
55069,Lincoln County,,WI,1826,35597,37423,4,6,10,670,882,1552,6,0.288834,0.301947,24.240682,0.000521,0.000631,166,0.000115,0,20,0.857143,0.003856
55071,Manitowoc County,,WI,3865,100979,104844,12,13,25,2017,2240,4257,6,0.29779,0.312234,567.515878,0.002253,0.00108,166,0.000218,0,20,0.658333,0.016938
55073,Marathon County,,WI,6822,158422,165244,32,29,61,4853,4274,9127,6,0.346305,0.369078,12760.907491,0.004729,0.004474,166,0.000531,0,20,0.384874,0.037255
55075,Marinette County,,WI,2845,49850,52695,9,9,18,1538,1501,3039,6,0.297912,0.311919,867.670759,0.000854,0.001121,166,0.000229,0,20,0.611111,0.006554
55077,Marquette County,,WI,1471,17843,19314,9,8,17,941,933,1874,6,0.28849,0.301575,33.78718,0.001157,0.000511,166,0.000191,0,20,0.627273,0.008811
55078,Menominee County,,WI,327,4531,4858,2,1,3,175,151,326,7,0.229477,0.23561,0,0.000075,0.000005,166,0.000092,0,20,1,0.000848
55079,Milwaukee County,,WI,54363,1023327,1077690,128,152,280,32655,45093,77748,5,0.41955,0.457629,71449.211311,0.053432,0.059966,166,0.001553,0,20,0.331123,0.385629
55081,Monroe County,,WI,2925,49189,52114,8,6,14,1410,1238,2648,6,0.297364,0.310716,21.597858,0.000933,0.000851,24,0.00019,0,20,0.678571,0.00747
55083,Oconto County,,WI,2506,45431,47937,9,5,14,1931,1632,3563,6,0.296033,0.308792,69.933725,0.000866,0.00055,166,0.000198,0,20,0.694444,0.006589
55085,Oneida County,,WI,2935,45856,48791,14,14,28,1495,1349,2844,6,0.329895,0.348305,1376.816325,0.002239,0.002138,166,0.000269,0,20,0.558333,0.017033
55087,Outagamie County,,WI,13549,211585,225134,34,29,63,10660,9851,20511,6,0.346305,0.369078,4024.155015,0.00642,0.004317,166,0.000557,0,20,0.400794,0.048765
55089,Ozaukee County,,WI,7125,104224,111349,16,15,31,5043,4617,9660,6,0.345278,0.366071,155.939125,0.005341,0.003878,166,0.000228,0,20,0.777778,0.039885
55091,Pepin County,,WI,555,8626,9181,4,4,8,268,281,549,7,0.257499,0.266744,2.208556,0.000061,0.000063,24,0.00013,0,20,0.666667,0.000926
55093,Pierce County,,WI,2780,44023,46803,12,10,22,2005,1769,3774,6,0.305063,0.319828,614.731582,0.001445,0.00121,24,0.000255,0,20,0.712121,0.010959
55095,Polk County,,WI,2827,51916,54743,11,12,23,2155,1788,3943,6,0.305095,0.320115,8.874073,0.001423,0.001295,24,0.000235,0,20,0.742424,0.010588
55097,Portage County,,WI,4348,76425,80773,14,18,32,2255,2457,4712,6,0.345811,0.367131,987.040975,0.001323,0.004129,166,0.000265,0,20,0.614286,0.010755
55099,Price County,,WI,1053,18015,19068,3,5,8,195,292,487,6,0.288547,0.301317,2907.043388,0.000036,0.000433,166,0.000112,0,20,0.4,0.000611
55101,Racine County,,WI,12009,229041,241050,21,25,46,8413,7321,15734,6,0.350181,0.373265,485.360564,0.008421,0.007321,166,0.000257,0,20,0.555419,0.061203
55103,Richland County,,WI,1283,20278,21561,5,7,12,662,788,1450,6,0.288404,0.301317,2.533333,0.000396,0.000455,166,0.000158,0,20,0.738095,0.003515
55105,Rock County,,WI,8277,186678,194955,24,30,54,5939,5013,10952,6,0.34842,0.371747,1224.863401,0.006288,0.005478,166,0.00032,0,20,0.435714,0.043629
55107,Rusk County,,WI,1003,17186,18189,4,4,8,315,387,702,7,0.257545,0.26683,0.625,0.00006,0.000065,24,0.000135,0,20,0.833333,0.000952
55109,St. Croix County,,WI,5647,92927,98574,18,13,31,5785,3540,9325,6,0.336611,0.356501,129.527216,0.001983,0.002729,24,0.000333,0,20,0.602339,0.015792
55111,Sauk County,,WI,4355,72587,76942,16,12,28,3023,2605,5628,6,0.329223,0.347102,729.20489,0.002149,0.002013,166,0.000325,0,20,0.4875,0.016607
55113,Sawyer County,,WI,1246,19508,20754,6,5,11,335,367,702,6,0.304776,0.318769,329.668506,0.000671,0.000643,24,0.000167,0,20,0.7,0.005435
55115,Shawano County,,WI,2680,47723,50403,10,10,20,1829,1782,3611,6,0.29779,0.311861,3017.329205,0.000696,0.001009,166,0.000291,0,20,0.645455,0.00587
55117,Sheboygan County,,WI,5988,142382,148370,15,15,30,3313,3451,6764,6,0.345442,0.366271,284.305419,0.003304,0.003847,166,0.000243,0,20,0.8125,0.026159
55119,Taylor County,,WI,1196,23188,24384,5,6,11,439,617,1056,7,0.25791,0.267947,11.842399,0.000071,0.000097,166,0.000133,0,20,0.633333,0.001011
55121,Trempealeau County,,WI,1955,34446,36401,5,7,12,1110,1135,2245,6,0.288719,0.301879,91.430962,0.000082,0.000485,24,0.000157,0,20,0.52381,0.001292
55123,Vernon County,,WI,1754,32685,34439,9,8,17,983,1097,2080,6,0.288576,0.301678,25.295349,0.000933,0.000458,24,0.000216,0,20,0.622222,0.007523
55125,Vilas County,,WI,1661,25036,26697,8,5,13,800,555,1355,6,0.297637,0.311002,0,0.002155,0.000921,166,0.000146,0,20,0.964286,0.015699
55127,Walworth County,,WI,7120,111612,118732,17,19,36,5868,4545,10413,6,0.342514,0.363471,108.13436,0.005062,0.004991,166,0.000209,0,20,0.689474,0.035204
55129,Washburn County,,WI,1225,18792,20017,5,6,11,493,514,1007,6,0.304872,0.319026,4.656083,0.00064,0.00066,24,0.000156,0,20,0.7,0.00507
55131,Washington County,,WI,9152,157312,166464,17,22,39,8208,6589,14797,6,0.345811,0.367589,239.581393,0.004036,0.004063,166,0.000245,0,20,0.61413,0.03071
55133,Waukesha County,,WI,29071,472548,501619,54,75,129,22677,22676,45353,6,0.380392,0.411856,9475.406153,0.020652,0.029271,166,0.000673,0,20,0.395869,0.147748
55135,Waupaca County,,WI,3225,60738,63963,13,10,23,2316,2026,4342,6,0.29779,0.311861,73.309707,0.001331,0.00103,166,0.000245,0,20,0.762821,0.010452
55137,Waushara County,,WI,1581,26398,27979,11,8,19,1188,867,2055,7,0.260823,0.271137,112.839859,0.002161,0.000154,166,0.000202,0,20,0.689394,0.015892
55139,Winnebago County,,WI,11757,186625,198382,33,31,64,9130,8482,17612,6,0.351959,0.37563,4498.408088,0.004738,0.006045,166,0.000528,0,20,0.376518,0.037644
55141,Wood County,,WI,4819,91665,96484,16,18,34,2175,2859,5034,6,0.309081,0.326168,820.43062,0.001231,0.001742,166,0.000313,0,20,0.469048,0.010888
56001,Albany County,,WY,4665,29490,34155,13,20,33,1313,1933,3246,6,0.336261,0.356879,1789.5842,0.000809,0.004364,8,0.000338,0,20,0.417749,0.008064
56003,Big Horn County,,WY,942,11562,12504,2,4,6,240,324,564,7,0.263015,0.27407,19.415977,0.000003,0.000164,8,0.000096,0,20,0.65,0.000266
56005,Campbell County,,WY,3241,43146,46387,20,14,34,1741,1288,3029,6,0.334868,0.354204,13726.215743,0.001976,0.001544,8,0.000639,0,20,0.285714,0.017742
56007,Carbon County,,WY,1575,16034,17609,5,6,11,403,520,923,7,0.275177,0.287586,0.215534,0.000209,0.000445,8,0.000142,0,20,0.9,0.001839
56009,Converse County,,WY,1278,14212,15490,3,3,6,472,454,926,7,0.257203,0.266481,1.60119,0.00006,0.000092,8,0.000134,0,20,0.666667,0.000878
56011,Crook County,,WY,618,6893,7511,2,2,4,190,198,388,7,0.250905,0.258743,6.241999,0.000013,0.000015,8,0.000119,0,20,0.666667,0.000428
56013,Fremont County,,WY,2403,39951,42354,9,10,19,739,747,1486,6,0.333028,0.351581,4766.864537,0.000212,0.001539,8,0.000232,0,20,0.378205,0.002429
56015,Goshen County,,WY,961,12573,13534,3,5,8,220,363,583,7,0.264521,0.275221,12.034804,0.000104,0.000131,8,0.000113,0,20,0.65,0.000928
56017,Hot Springs County,,WY,466,4921,5387,1,1,2,48,53,101,8,0.209548,0.215243,0,0.000012,0.000009,8,0.00007,0,20,1,0.000118
56019,Johnson County,,WY,681,7949,8630,2,3,5,171,199,370,7,0.257181,0.266424,0,0.000049,0.000074,8,0.000106,0,20,1,0.000714
56021,Laramie County,,WY,8159,97834,105993,31,33,64,3227,3370,6597,6,0.35128,0.375533,18177.760338,0.009136,0.011138,8,0.000601,0,20,0.371977,0.075319
56023,Lincoln County,,WY,1546,17687,19233,9,8,17,759,474,1233,6,0.297242,0.311208,274.921318,0.001724,0.000761,8,0.000203,0,20,0.454545,0.014526
56025,Natrona County,,WY,5287,77831,83118,28,27,55,2434,2603,5037,6,0.345976,0.369124,21616.301459,0.006267,0.006024,8,0.000617,0,20,0.332661,0.052752
56027,Niobrara County,,WY,225,2481,2706,0,0,0,0,0,0,0,0,0,0,0,0,167,0.00005,151,246,0,0
56029,Park County,,WY,2388,30352,32740,9,8,17,642,601,1243,7,0.265051,0.277128,6347.578423,0.001192,0.000286,8,0.0003,0,20,0.455556,0.010689
56031,Platte County,,WY,747,9539,10286,4,4,8,242,305,547,7,0.26273,0.273027,9.731565,0.000168,0.000121,8,0.000119,0,20,0.6,0.001474
56033,Sheridan County,,WY,2244,30520,32764,10,7,17,790,729,1519,7,0.265051,0.277025,677.693232,0.001297,0.000242,8,0.000296,0,20,0.555556,0.011605
56035,Sublette County,,WY,737,7573,8310,3,3,6,218,142,360,7,0.255824,0.264743,0.405556,0.000085,0.000043,8,0.000106,0,20,0.6,0.001104
56037,Sweetwater County,,WY,3831,44424,48255,20,16,36,1634,1530,3164,6,0.342958,0.364238,5815.079231,0.003621,0.003836,8,0.000424,0,20,0.367965,0.030536
56039,Teton County,,WY,2644,21403,24047,5,8,13,367,783,1150,6,0.298339,0.312927,2577.367318,0.002459,0.001145,8,0.000128,0,20,0.344444,0.019406
56041,Uinta County,,WY,1928,21913,23841,8,9,17,606,724,1330,6,0.301648,0.316014,66.240007,0.002184,0.001234,6,0.000175,0,20,0.6,0.018095
56043,Washakie County,,WY,700,9385,10085,0,3,3,0,146,146,7,0.257201,0.266447,0,0,0.00005,8,0.00005,0,247,0.5,0
56045,Weston County,,WY,542,7337,7879,2,1,3,139,55,194,7,0.250884,0.258571,0,0.000012,0.000015,8,0.000139,0,20,1,0.000344
2275,Wrangell Petersburg,,AK,608,6607,7215,1,4,5,56,194,250,7,0.284513,0.297644,0,0.000027,0.000349,6,0.000071,0,20,0.833333,0.000182
2230,Skagway Hoonah Ango,,AK,328,3436,3764,1,1,2,47,57,104,7,0.251404,0.259102,0,0.000027,0.00001,6,0.000071,0,20,0,0.000182
2198,Prince Of Wales Oute,,AK,450,4797,5247,2,1,3,113,74,187,7,0.238603,0.244955,0,0.000036,0.000008,6,0.000116,0,20,1,0.000342
