Id,Label,timeset,state,totalmig,totalnonmig,population,indegree,outdegree,Degree,weighted indegree,weighted outdegree,Weighted Degree,Eccentricity,closnesscentrality,harmonicclosnesscentrality,betweenesscentrality,Authority,Hub,modularity_class,pageranks,componentnumber,strongcompnum,clustering,eigencentrality
1001,Autauga County,,AL,3871,60496,64367,7,6,13,2587,2288,4875,8,0.263324,0.27787,127.194382,0.002466,0.000621,33,0.00018,0,29,0.75,0.015935
1003,Baldwin County,,AL,9528,221228,230756,22,19,41,5346,4336,9682,7,0.325207,0.351106,4728.167915,0.007788,0.008165,33,0.000518,0,29,0.411667,0.050819
1005,Barbour County,,AL,1304,25014,26318,4,4,8,415,473,888,8,0.243453,0.254122,5412,0.000049,0.000044,33,0.000246,0,29,0.5,0.000821
1007,Bibb County,,AL,1030,21040,22070,4,3,7,720,670,1390,8,0.262779,0.276496,2.383333,0.000641,0.000457,33,0.000142,0,29,0.833333,0.003692
1009,Blount County,,AL,2911,59765,62676,6,7,13,2176,2131,4307,8,0.262728,0.276964,4.113934,0.00057,0.000493,33,0.000202,0,29,0.666667,0.004076
1011,Bullock County,,AL,577,9587,10164,1,2,3,88,180,268,8,0.250211,0.261969,0,0.000169,0.000087,33,0.000071,0,29,1,0.000717
1013,Butler County,,AL,941,20882,21823,2,3,5,214,261,475,8,0.250234,0.262156,0.75,0.00017,0.000089,33,0.000122,0,29,0.666667,0.000853
1015,Calhoun County,,AL,5737,122104,127841,13,16,29,2683,3152,5835,7,0.319444,0.343335,13348.342257,0.004599,0.00412,33,0.000369,0,29,0.338235,0.030767
1017,Chambers County,,AL,2192,36067,38259,4,4,8,1326,1387,2713,8,0.256687,0.270215,70.954532,0.000169,0.000375,33,0.000166,0,29,0.45,0.001508
1019,Cherokee County,,AL,1113,24092,25205,4,5,9,648,629,1277,8,0.243275,0.254554,31.999023,0.000104,0.000124,33,0.000149,0,29,0.3,0.001367
1021,Chilton County,,AL,2157,45800,47957,4,6,10,1195,1332,2527,8,0.263246,0.277683,2.059524,0.000716,0.000567,33,0.000135,0,29,0.766667,0.004136
1023,Choctaw County,,AL,546,13608,14154,1,0,1,75,0,75,0,0,0,0,0.000027,0,130,0.000078,0,15,0,0.000329
1025,Clarke County,,AL,1155,26891,28046,4,7,11,425,685,1110,8,0.252389,0.265398,5473.564242,0.00024,0.000287,33,0.000224,0,29,0.333333,0.00159
1027,Clay County,,AL,677,14625,15302,3,4,7,261,388,649,8,0.242722,0.253448,5.708354,0.000053,0.000068,33,0.000135,0,29,0.5,0.000806
1029,Cleburne County,,AL,754,15259,16013,3,3,6,365,404,769,8,0.242965,0.25371,6.821651,0.000123,0.000133,33,0.000135,0,29,0.5,0.001313
1031,Coffee County,,AL,4180,52773,56953,7,10,17,1804,1819,3623,8,0.291298,0.310309,1961.652476,0.001242,0.002778,33,0.000263,0,29,0.287879,0.008595
1033,Colbert County,,AL,2963,59882,62845,5,5,10,1883,1653,3536,8,0.260115,0.273219,2367.994766,0.000742,0.00024,33,0.000161,0,29,0.7,0.004508
1035,Conecuh County,,AL,690,12453,13143,2,3,5,207,300,507,9,0.20998,0.217717,4.103892,0.000012,0.00002,33,0.000122,0,29,0.333333,0.000353
1037,Coosa County,,AL,897,9716,10613,2,2,4,459,495,954,9,0.208862,0.216496,0,0.000013,0.000016,33,0.000106,0,29,1,0.00039
1039,Covington County,,AL,1466,38612,40078,5,4,9,545,466,1011,8,0.258703,0.272066,932.815401,0.000497,0.000444,33,0.000215,0,29,0.1,0.003489
1041,Crenshaw County,,AL,800,14507,15307,4,3,7,436,397,833,8,0.250305,0.262312,14.907349,0.000176,0.000093,33,0.000191,0,29,0.333333,0.001165
1043,Cullman County,,AL,3101,87492,90593,8,8,16,2069,1802,3871,8,0.264972,0.279646,26.804391,0.000904,0.000707,33,0.000251,0,29,0.553571,0.005814
1045,Dale County,,AL,5167,49921,55088,8,9,17,2296,2403,4699,8,0.271525,0.288833,2718.811966,0.000604,0.001058,33,0.00031,0,29,0.277778,0.004638
1047,Dallas County,,AL,1924,43238,45162,4,7,11,485,905,1390,7,0.318567,0.340848,1508.009318,0.002302,0.00231,33,0.000128,0,29,0.482143,0.014588
1049,DeKalb County,,AL,3143,72358,75501,8,7,15,2134,1742,3876,8,0.266241,0.281389,359.14868,0.001007,0.000849,33,0.00025,0,29,0.517857,0.006781
1051,Elmore County,,AL,4935,88435,93370,8,9,17,3454,3095,6549,8,0.264578,0.279956,668.122367,0.002432,0.000871,33,0.000219,0,29,0.583333,0.016104
1053,Escambia County,,AL,1664,36959,38623,6,6,12,912,919,1831,8,0.260955,0.275325,3670.165986,0.001028,0.000893,33,0.000202,0,29,0.6,0.006541
1055,Etowah County,,AL,4117,108193,112310,10,11,21,2219,2431,4650,8,0.265261,0.280708,259.528558,0.000926,0.000849,33,0.000293,0,29,0.509091,0.00647
1057,Fayette County,,AL,733,16760,17493,3,2,5,387,420,807,8,0.245717,0.256521,202.129764,0.000103,0.000034,33,0.000146,0,29,0.333333,0.000713
1059,Franklin County,,AL,1913,33435,35348,7,8,15,910,1158,2068,8,0.246512,0.258995,1912.080438,0.00003,0.000064,33,0.000294,0,29,0.222222,0.001063
1061,Geneva County,,AL,1449,26169,27618,4,4,8,874,846,1720,8,0.245153,0.256202,11.452445,0.000086,0.00006,33,0.000163,0,29,0.5,0.000951
1063,Greene County,,AL,455,8622,9077,1,1,2,182,211,393,8,0.245469,0.25589,0,0.000094,0.000034,33,0.000084,0,29,0,0.000407
1065,Hale County,,AL,1001,16135,17136,2,2,4,540,683,1223,8,0.245537,0.256171,0,0.000098,0.000035,33,0.000124,0,29,1,0.000543
1067,Henry County,,AL,1064,17863,18927,3,3,6,674,639,1313,8,0.243431,0.253935,0,0.000049,0.000044,33,0.000162,0,29,1,0.000708
1069,Houston County,,AL,6321,112005,118326,14,16,30,3193,3378,6571,7,0.320134,0.34424,23183.594338,0.003369,0.003433,33,0.000505,0,29,0.264706,0.02181
1071,Jackson County,,AL,2205,55266,57471,6,7,13,1181,1343,2524,8,0.266214,0.281326,127.010427,0.000582,0.000848,33,0.000225,0,29,0.547619,0.004197
1073,Jefferson County,,AL,31408,733578,764986,66,67,133,19120,21585,40705,7,0.355828,0.391792,82959.42822,0.031254,0.038335,33,0.00154,0,29,0.276371,0.207626
1075,Lamar County,,AL,640,14391,15031,2,2,4,197,218,415,9,0.221668,0.230038,20.712443,0.000017,0.000001,306,0.000117,0,29,0,0.000293
1077,Lauderdale County,,AL,4008,96737,100745,8,10,18,1921,2204,4125,7,0.284526,0.300701,4314.958809,0.000784,0.001541,33,0.000258,0,29,0.377778,0.00502
1079,Lawrence County,,AL,1546,35479,37025,3,6,9,880,1262,2142,8,0.26014,0.273406,2.790144,0.000056,0.000256,33,0.000127,0,29,0.733333,0.000569
1081,Lee County,,AL,9668,150438,160106,22,21,43,6195,5495,11690,7,0.321136,0.346258,6492.115159,0.007389,0.007905,33,0.000585,0,29,0.38587,0.048676
1083,Limestone County,,AL,4455,99605,104060,7,5,12,3283,2611,5894,8,0.264945,0.279209,31.572367,0.000798,0.000591,33,0.000204,0,29,0.52381,0.004933
1085,Lowndes County,,AL,860,12222,13082,3,2,5,481,542,1023,8,0.250188,0.261906,0.833333,0.000195,0.000086,33,0.000121,0,29,0.666667,0.001125
1087,Macon County,,AL,1278,18445,19723,3,2,5,597,699,1296,8,0.250281,0.262125,0,0.000264,0.000165,33,0.000115,0,29,1,0.001702
1089,Madison County,,AL,16821,409037,425858,39,46,85,8519,8816,17335,7,0.350637,0.382872,31089.100895,0.020493,0.028148,33,0.000914,0,29,0.372449,0.137255
1091,Marengo County,,AL,1084,21720,22804,4,4,8,360,403,763,8,0.262961,0.276995,154.849881,0.000098,0.000377,33,0.000186,0,29,0.3,0.000797
1093,Marion County,,AL,1457,28185,29642,4,6,10,779,826,1605,8,0.262987,0.277245,662.25444,0.000005,0.000352,33,0.00023,0,29,0.3,0.000567
1095,Marshall County,,AL,5467,104563,110030,11,8,19,3084,3349,6433,8,0.264945,0.279615,478.360384,0.003399,0.000613,33,0.000294,0,29,0.381818,0.021166
1097,Mobile County,,AL,13955,442718,456673,33,35,68,6465,7461,13926,7,0.33602,0.365723,28972.219148,0.014808,0.02152,33,0.000791,0,29,0.422436,0.097107
1099,Monroe County,,AL,885,22005,22890,5,4,9,420,383,803,8,0.251817,0.264024,977.136027,0.000335,0.000257,33,0.000186,0,29,0.55,0.002373
1101,Montgomery County,,AL,12609,247075,259684,26,36,62,6845,7625,14470,7,0.333583,0.363212,30686.68996,0.007785,0.015545,33,0.000729,0,29,0.315079,0.051416
1103,Morgan County,,AL,6372,136584,142956,9,10,19,3418,3919,7337,7,0.320673,0.343634,3082.31863,0.000765,0.00341,33,0.000281,0,29,0.431818,0.005432
1105,Perry County,,AL,535,9665,10200,0,2,2,0,223,223,8,0.245629,0.256419,0,0,0.000059,33,0.000054,0,30,0.5,0
1107,Pickens County,,AL,839,19642,20481,2,2,4,438,430,868,8,0.247014,0.258086,0,0.000107,0.000036,33,0.000115,0,29,1,0.000566
1109,Pike County,,AL,1899,30554,32453,6,5,11,778,828,1606,8,0.252341,0.26531,41.562957,0.00025,0.000143,33,0.000234,0,29,0.433333,0.001776
1111,Randolph County,,AL,893,23083,23976,5,4,9,479,315,794,8,0.243275,0.254391,26.767259,0.000199,0.000123,33,0.000184,0,29,0.35,0.001847
1113,Russell County,,AL,6925,57608,64533,8,4,12,4003,3509,7512,8,0.265684,0.281127,317.209161,0.003761,0.00092,33,0.000211,0,29,0.527778,0.025443
1115,St. Clair County,,AL,4660,91053,95713,7,6,13,3664,3036,6700,8,0.262805,0.276995,15.829671,0.000701,0.000495,33,0.000212,0,29,0.738095,0.004569
1117,Shelby County,,AL,13155,235435,248590,25,28,53,9977,9088,19065,7,0.328936,0.356542,7841.535305,0.007648,0.011453,33,0.000619,0,29,0.377419,0.050508
1119,Sumter County,,AL,712,12591,13303,1,3,4,77,332,409,8,0.246672,0.258177,46.318385,0.000027,0.000064,33,0.000078,0,29,0.333333,0.000329
1121,Talladega County,,AL,4017,83216,87233,8,10,18,2561,2739,5300,8,0.263428,0.278776,2814.36123,0.000608,0.000614,33,0.000267,0,29,0.444444,0.004445
1123,Tallapoosa County,,AL,2496,43698,46194,9,8,17,1421,1489,2910,8,0.263454,0.278432,3097.335504,0.00085,0.000622,33,0.000277,0,29,0.388889,0.005646
1125,Tuscaloosa County,,AL,9246,201864,211110,22,20,42,4873,4318,9191,7,0.325287,0.351049,37166.844078,0.003156,0.008672,33,0.000725,0,29,0.218254,0.021046
1127,Walker County,,AL,2225,67019,69244,6,6,12,1252,1159,2411,8,0.262961,0.277245,189.699287,0.000561,0.000472,33,0.000209,0,29,0.482143,0.003788
1129,Washington County,,AL,793,17678,18471,2,2,4,425,464,889,8,0.251603,0.263412,0,0.000237,0.000163,33,0.0001,0,29,1,0.001344
1131,Wilcox County,,AL,545,11517,12062,1,1,2,99,77,176,9,0.201541,0.207896,0,0.000003,0.000003,33,0.000081,0,29,0,0.000143
1133,Winston County,,AL,1387,23401,24788,5,5,10,715,846,1561,8,0.262883,0.276933,3475.3855,0.000434,0.000356,33,0.000193,0,29,0.5,0.003067
2013,Aleutians East Borough,,AK,324,1914,2238,0,1,1,0,86,86,7,0.284815,0.300938,0,0,0.001416,11,0.000054,0,31,0,0
2016,Aleutians West Census Area,,AK,647,4932,5579,0,2,2,0,197,197,7,0.286066,0.302911,0,0,0.001762,11,0.000054,0,32,1,0
2020,Anchorage Municipality,,AK,24250,348681,372931,56,63,119,10363,12333,22696,7,0.349993,0.385769,61286.311599,0.031834,0.037948,11,0.001598,0,29,0.350796,0.220158
2050,Bethel Census Area,,AK,754,17679,18433,1,3,4,156,352,508,8,0.259331,0.272917,0,0.000412,0.000381,11,0.000075,0,29,0.666667,0.002485
2060,Bristol Bay Borough,,AK,133,977,1110,0,0,0,0,0,0,0,0,0,0,0,0,0,0.000054,1,33,0,0
2068,Denali Borough,,AK,252,2483,2735,0,0,0,0,0,0,0,0,0,0,0,0,1,0.000054,2,34,0,0
2070,Dillingham Census Area,,AK,274,5364,5638,1,1,2,56,95,151,8,0.259281,0.272542,0,0.000412,0.000346,11,0.000075,0,29,0,0.002485
2090,Fairbanks North Star Borough,,AK,9245,109083,118328,22,24,46,2574,3159,5733,7,0.327402,0.355134,5338.300122,0.01483,0.016285,11,0.00051,0,29,0.581197,0.102707
2100,Haines Borough,,AK,158,2882,3040,0,0,0,0,0,0,0,0,0,0,0,0,2,0.000054,3,35,0,0
2105,Hoonah-Angoon Census Area,,AK,93,2341,2434,0,1,1,0,60,60,8,0.222769,0.230735,0,0,0.000019,11,0.000054,0,36,0,0
2110,Juneau City and Borough,,AK,2026,38665,40691,7,3,10,535,374,909,7,0.286512,0.303899,8145.654826,0.001724,0.002616,11,0.000295,0,29,0.214286,0.012903
2122,Kenai Peninsula Borough,,AK,3550,66897,70447,5,5,10,1155,1216,2371,7,0.305368,0.325568,3.213749,0.0033,0.003115,11,0.000172,0,29,0.866667,0.023685
2130,Ketchikan Gateway Borough,,AK,1014,16237,17251,1,2,3,64,127,191,8,0.259353,0.272814,2669,0,0.000364,11,0.000099,0,37,0.333333,0.000113
2150,Kodiak Island Borough,,AK,1454,16930,18384,1,1,2,113,205,318,8,0.259281,0.272542,0,0.000412,0.000346,11,0.000075,0,29,0,0.002485
2164,Lake and Peninsula Borough,,AK,134,1594,1728,0,1,1,0,68,68,8,0.259328,0.272627,0,0,0.000346,11,0.000054,0,38,0,0
2170,Matanuska-Susitna Borough,,AK,6034,106646,112680,8,6,14,3902,2428,6330,7,0.305753,0.326256,560.090294,0.00283,0.003977,11,0.000243,0,29,0.477778,0.020395
2180,Nome Census Area,,AK,384,9428,9812,1,1,2,112,135,247,8,0.259281,0.272542,0,0.000412,0.000346,11,0.000075,0,29,0,0.002485
2185,North Slope Borough,,AK,439,7399,7838,1,1,2,79,158,237,8,0.259281,0.272542,0,0.000412,0.000346,11,0.000075,0,29,0,0.002485
2188,Northwest Arctic Borough,,AK,374,6615,6989,1,1,2,94,158,252,8,0.259281,0.272542,0,0.000412,0.000346,11,0.000075,0,29,0,0.002485
2195,Petersburg Census Area,,AK,257,4373,4630,0,1,1,0,64,64,8,0.222769,0.230735,0,0,0.000019,11,0.000054,0,39,0,0
2198,Prince of Wales-Hyder Census Area,,AK,339,5272,5611,0,1,1,0,64,64,9,0.206003,0.212702,0,0,0,11,0.000054,0,40,0,0
2220,Sitka City and Borough,,AK,629,10411,11040,0,1,1,0,48,48,8,0.222769,0.230735,0,0,0.000019,11,0.000054,0,41,0,0
2230,Skagway Municipality,,AK,104,1467,1571,0,0,0,0,0,0,0,0,0,0,0,0,3,0.000054,4,42,0,0
2240,Southeast Fairbanks Census Area,,AK,465,8321,8786,2,3,5,144,305,449,8,0.259508,0.273198,0,0.000589,0.000537,11,0.000093,0,29,1,0.003694
2261,Valdez-Cordova Census Area,,AK,845,11302,12147,1,2,3,114,274,388,8,0.259306,0.272729,0,0.000412,0.000376,11,0.000075,0,29,1,0.002485
2275,Wrangell City and Borough,,AK,-2,2413,2411,0,0,0,0,0,0,0,0,0,0,0,0,4,0.000054,5,43,0,0
2282,Yakutat City and Borough,,AK,-2,579,577,0,0,0,0,0,0,0,0,0,0,0,0,5,0.000054,6,44,0,0
2290,Yukon-Koyukuk Census Area,,AK,269,5801,6070,1,2,3,135,201,336,8,0.259483,0.27301,0,0.000177,0.000507,11,0.000072,0,29,1,0.001209
4001,Apache County,,AZ,6471,63179,69650,10,9,19,4918,5172,10090,7,0.305228,0.325587,1185.781986,0.0035,0.00348,227,0.000282,0,29,0.6,0.023971
4003,Cochise County,,AZ,8909,134269,143178,16,19,35,3207,4469,7676,7,0.32102,0.346301,131.693677,0.013599,0.015194,11,0.000366,0,29,0.730994,0.094017
4005,Coconino County,,AZ,10126,137331,147457,18,23,41,5788,6601,12389,7,0.331017,0.357736,4818.354011,0.012008,0.017003,11,0.000386,0,29,0.588333,0.078703
4007,Gila County,,AZ,2762,53648,56410,7,6,13,1663,1787,3450,7,0.303907,0.323382,1.908333,0.002986,0.003065,11,0.000197,0,29,0.833333,0.021009
4009,Graham County,,AZ,1648,32120,33768,6,5,11,805,881,1686,7,0.304011,0.323307,2.317063,0.002756,0.002713,11,0.000195,0,29,0.733333,0.019738
4011,Greenlee County,,AZ,562,9227,9789,3,3,6,310,302,612,7,0.303769,0.322757,0,0.002313,0.002538,11,0.000126,0,29,1,0.016312
4012,La Paz County,,AZ,1352,15846,17198,4,4,8,438,618,1056,7,0.304288,0.323632,0,0.003522,0.003517,11,0.000118,0,29,1,0.022671
4013,Maricopa County,,AZ,135845,4492528,4628373,404,331,735,135064,111330,246394,6,0.43609,0.499719,667675.538334,0.158773,0.141535,11,0.008282,0,29,0.098752,0.959582
4015,Mohave County,,AZ,10547,188664,199211,21,20,41,6588,5717,12305,7,0.329545,0.3555,183.394613,0.015878,0.016268,11,0.000416,0,29,0.745238,0.103962
4017,Navajo County,,AZ,7304,100976,108280,9,13,22,4818,5064,9882,7,0.306139,0.327524,121.132301,0.003058,0.004549,11,0.000246,0,29,0.583333,0.021714
4019,Pima County,,AZ,36870,1077575,1114445,105,97,202,22991,23977,46968,7,0.37299,0.41342,15699.257355,0.072229,0.06873,11,0.002063,0,29,0.396036,0.470236
4021,Pinal County,,AZ,25106,344218,369324,38,29,67,19847,16702,36549,7,0.338278,0.367494,1367.888785,0.027598,0.022801,11,0.000744,0,29,0.582927,0.179409
4023,Santa Cruz County,,AZ,2707,55274,57981,3,2,5,1546,1903,3449,7,0.303734,0.32257,0,0.003999,0.002508,11,0.000108,0,29,1,0.027327
4025,Yavapai County,,AZ,11582,239302,250884,22,19,41,8281,6239,14520,7,0.331923,0.358517,297.876921,0.017856,0.017674,11,0.000428,0,29,0.73913,0.117685
4027,Yuma County,,AZ,11743,228107,239850,16,22,38,4677,6660,11337,7,0.332213,0.359529,56.677382,0.014633,0.019606,11,0.000314,0,29,0.785,0.096887
5001,Arkansas County,,AR,849,20335,21184,3,2,5,297,265,562,8,0.260267,0.273027,1.75,0.000357,0.0002,138,0.000144,0,29,0.666667,0.001883
5003,Ashley County,,AR,833,22096,22929,3,3,6,183,211,394,8,0.260369,0.273371,5834.407954,0.0003,0.000196,138,0.000163,0,29,0.333333,0.001827
5005,Baxter County,,AR,1817,43639,45456,3,5,8,488,455,943,8,0.261646,0.275329,5724.6723,0,0.000359,138,0.000204,0,29,0.15,0.000375
5007,Benton County,,AR,13626,277045,290671,34,30,64,9200,7542,16742,7,0.345551,0.375213,38502.06205,0.017868,0.018,138,0.001018,0,29,0.357143,0.119923
5009,Boone County,,AR,1913,39255,41168,7,6,13,885,802,1687,8,0.257678,0.270419,12370.695322,0.000364,0.000369,138,0.000376,0,29,0.166667,0.00342
5011,Bradley County,,AR,505,11314,11819,1,1,2,100,73,173,9,0.206629,0.213073,0,0.000002,0,138,0.000102,0,29,0,0.000128
5013,Calhoun County,,AR,218,4938,5156,1,0,1,84,0,84,0,0,0,0,0.000002,0,138,0.00009,0,14,0,0.000143
5015,Carroll County,,AR,1638,30358,31996,4,3,7,603,621,1224,8,0.257479,0.269607,1.666667,0.00036,0.000361,138,0.000202,0,29,0.833333,0.003049
5017,Chicot County,,AR,602,10511,11113,2,3,5,138,226,364,8,0.260369,0.273371,2557.54581,0.000059,0.000199,138,0.000117,0,29,0.25,0.000456
5019,Clark County,,AR,1123,20595,21718,4,5,9,375,517,892,8,0.260394,0.273683,402.46631,0.000333,0.000246,138,0.00021,0,29,0.7,0.002178
5021,Clay County,,AR,821,15300,16121,2,2,4,367,334,701,10,0.184241,0.189663,0,0.000001,0.000009,306,0.000186,0,29,1,0.000351
5023,Cleburne County,,AR,1723,26722,28445,4,5,9,640,794,1434,8,0.26042,0.273746,627.231708,0.000362,0.000213,138,0.00017,0,29,0.65,0.002099
5025,Cleveland County,,AR,344,8434,8778,1,1,2,106,112,218,8,0.234405,0.243973,0,0.000059,0.000004,138,0.000081,0,29,0,0.000176
5027,Columbia County,,AR,1069,23310,24379,4,4,8,303,317,620,8,0.260394,0.273558,3169.928947,0.000007,0.000202,138,0.000204,0,29,0.3,0.000558
5029,Conway County,,AR,1060,21721,22781,4,3,7,634,592,1226,8,0.260293,0.273246,1,0.000366,0.000211,138,0.000167,0,29,0.833333,0.002132
5031,Craighead County,,AR,5094,104849,109943,18,14,32,3698,2782,6480,8,0.283951,0.301652,30205.9212,0.002995,0.001053,306,0.000838,0,29,0.196078,0.020729
5033,Crawford County,,AR,3435,61970,65405,6,6,12,2226,2163,4389,8,0.257728,0.270619,300.365514,0.000419,0.000421,138,0.000258,0,29,0.466667,0.003727
5035,Crittenden County,,AR,3332,53833,57165,8,8,16,1594,1865,3459,8,0.282657,0.298994,2459.815218,0.001163,0.000945,306,0.000381,0,29,0.482143,0.007416
5037,Cross County,,AR,997,18939,19936,4,3,7,518,378,896,9,0.221246,0.229525,0.666667,0.000032,0.000057,306,0.000234,0,29,0.833333,0.00094
5039,Dallas County,,AR,468,7367,7835,0,0,0,0,0,0,0,0,0,0,0,0,6,0.000054,7,45,0,0
5041,Desha County,,AR,735,12802,13537,3,4,7,262,333,595,8,0.26042,0.273621,135.447868,0.000004,0.000201,138,0.000186,0,29,0.3,0.000377
5043,Drew County,,AR,925,18455,19380,3,4,7,270,366,636,8,0.26042,0.273621,5507.88669,0.000004,0.000199,138,0.000226,0,29,0.25,0.000389
5045,Faulkner County,,AR,7487,122324,129811,15,17,32,3872,3957,7829,7,0.32359,0.348707,7903.555007,0.000833,0.005581,138,0.000517,0,29,0.320261,0.006803
5047,Franklin County,,AR,937,17556,18493,4,4,8,514,622,1136,8,0.233135,0.243561,227.630313,0.000054,0.000057,138,0.000201,0,29,0.5,0.000952
5049,Fulton County,,AR,686,11121,11807,2,3,5,257,260,517,9,0.207675,0.2149,4.1,0.000004,0,138,0.000143,0,29,0.5,0.000256
5051,Garland County,,AR,5223,105282,110505,11,12,23,2155,2205,4360,7,0.295067,0.314843,12246.097408,0.002093,0.003117,138,0.00043,0,29,0.37619,0.015557
5053,Grant County,,AR,1003,19148,20151,3,4,7,420,607,1027,8,0.260318,0.273402,0.7,0.000377,0.000228,138,0.000139,0,29,0.833333,0.002054
5055,Greene County,,AR,2321,44541,46862,7,5,12,1525,1138,2663,9,0.221595,0.230505,4309.500226,0.000806,0.00006,306,0.000417,0,29,0.404762,0.005431
5057,Hempstead County,,AR,1133,22676,23809,4,4,8,460,496,956,8,0.232283,0.242299,7599.211998,0.000081,0.000096,350,0.000274,0,29,0.333333,0.001209
5059,Hot Spring County,,AR,1734,31814,33548,5,4,9,1131,1087,2218,8,0.260318,0.273402,1.916667,0.000357,0.000246,138,0.000207,0,29,0.75,0.002487
5061,Howard County,,AR,893,14163,15056,3,5,8,285,517,802,8,0.232384,0.242661,248.567621,0.000001,0.000097,350,0.000206,0,29,0.3,0.000397
5063,Independence County,,AR,1886,38787,40673,7,6,13,913,701,1614,8,0.260776,0.274589,10812.93495,0.000316,0.000232,138,0.000337,0,29,0.380952,0.002666
5065,Izard County,,AR,714,11758,12472,3,3,6,213,246,459,9,0.207707,0.215024,1089.735497,0.000006,0.000003,138,0.000176,0,29,0.5,0.000417
5067,Jackson County,,AR,835,14710,15545,3,4,7,260,499,759,8,0.260649,0.274058,4.6,0.000017,0.000236,138,0.000184,0,29,0.916667,0.000719
5069,Jefferson County,,AR,3919,75212,79131,9,13,22,1300,2147,3447,7,0.306139,0.328726,12091.779914,0.00039,0.005404,138,0.00042,0,29,0.32381,0.002937
5071,Johnson County,,AR,1204,25734,26938,3,4,7,384,444,828,8,0.255287,0.267405,123.964233,0.000008,0.00017,138,0.000165,0,29,0.416667,0.000456
5073,Lafayette County,,AR,370,6664,7034,1,2,3,73,141,214,8,0.226909,0.23532,2.93777,0.000002,0.000017,138,0.000097,0,29,0,0.000133
5075,Lawrence County,,AR,1025,15916,16941,3,3,6,402,523,925,9,0.221227,0.229462,0.833333,0.000013,0.000041,306,0.000223,0,29,0.833333,0.000707
5077,Lee County,,AR,500,7613,8113,1,1,2,72,64,136,9,0.220332,0.227661,0,0.000009,0.000012,306,0.000102,0,29,0,0.000201
5079,Lincoln County,,AR,659,10729,11388,2,2,4,173,269,442,8,0.234529,0.244366,113.486486,0.000061,0.000004,138,0.000121,0,29,0.5,0.000303
5081,Little River County,,AR,694,12466,13160,3,3,6,359,388,747,8,0.232283,0.242099,2946.282764,0.00008,0.000096,350,0.000184,0,29,0.333333,0.001085
5083,Logan County,,AR,956,22138,23094,4,4,8,430,476,906,8,0.233196,0.243748,225.464586,0.00005,0.000059,138,0.000185,0,29,0.5,0.0009
5085,Lonoke County,,AR,5273,77433,82706,6,7,13,3071,2939,6010,8,0.261671,0.275673,5423.246865,0.000415,0.000399,138,0.000273,0,29,0.571429,0.002711
5087,Madison County,,AR,887,16385,17272,2,3,5,570,693,1263,8,0.257355,0.26937,0,0.000352,0.000361,138,0.000116,0,29,1,0.002729
5089,Marion County,,AR,1053,15640,16693,2,2,4,354,429,783,9,0.20795,0.215118,1690.00867,0.000008,0.000004,138,0.000142,0,29,0,0.0003
5091,Miller County,,AR,3204,43032,46236,8,6,14,2457,2073,4530,7,0.293155,0.311158,6714.11882,0.001569,0.001692,350,0.000361,0,29,0.285714,0.011793
5093,Mississippi County,,AR,2351,45117,47468,7,7,14,859,1146,2005,8,0.281286,0.296852,11222.075663,0.002525,0.000684,306,0.000352,0,29,0.392857,0.016602
5095,Monroe County,,AR,548,7696,8244,1,2,3,52,153,205,8,0.260191,0.272871,0,0.000296,0.0002,138,0.000081,0,29,1,0.001574
5097,Montgomery County,,AR,453,8027,8480,1,2,3,80,176,256,8,0.227956,0.236801,0,0.000034,0.000023,138,0.000084,0,29,1,0.000313
5099,Nevada County,,AR,539,8667,9206,1,1,2,167,174,341,9,0.188511,0.193738,0,0.000001,0.000001,350,0.000112,0,29,0,0.000139
5101,Newton County,,AR,335,7624,7959,1,1,2,171,169,340,9,0.2049,0.211121,0,0.000004,0.000004,138,0.000107,0,29,0,0.000172
5103,Ouachita County,,AR,1125,24739,25864,3,4,7,282,385,667,8,0.260394,0.273558,4604.899862,0.0003,0.000199,138,0.000172,0,29,0.416667,0.001855
5105,Perry County,,AR,584,10283,10867,2,3,5,234,359,593,8,0.260242,0.273121,0,0.000357,0.000209,138,0.000107,0,29,1,0.00181
5107,Phillips County,,AR,1131,19241,20372,1,2,3,89,274,363,8,0.260496,0.273496,0,0.000296,0.000228,138,0.000081,0,29,1,0.001574
5109,Pike County,,AR,627,10661,11288,4,3,7,368,297,665,8,0.228132,0.237363,573.101601,0.000038,0.000026,138,0.00019,0,29,0.333333,0.000711
5111,Poinsett County,,AR,1249,23164,24413,3,4,7,680,779,1459,9,0.221264,0.229712,0.583333,0.000029,0.000073,306,0.000188,0,29,0.833333,0.000913
5113,Polk County,,AR,762,20297,21059,0,0,0,0,0,0,0,0,0,0,0,0,7,0.000054,8,46,0,0
5115,Pope County,,AR,3029,64675,67704,8,9,17,1434,1544,2978,8,0.262443,0.27711,5471.22833,0.00054,0.000641,138,0.00031,0,29,0.422222,0.003933
5117,Prairie County,,AR,328,8445,8773,1,1,2,99,92,191,9,0.207417,0.214119,0,0.000004,0.000005,138,0.000087,0,29,0,0.000163
5119,Pulaski County,,AR,25914,438932,464846,52,53,105,13331,14353,27684,7,0.351608,0.385149,154523.621519,0.018022,0.027259,138,0.001734,0,29,0.206504,0.127182
5121,Randolph County,,AR,770,17517,18287,2,3,5,307,341,648,9,0.221227,0.229462,0,0.000012,0.000041,306,0.000168,0,29,1,0.00052
5123,St. Francis County,,AR,1554,22857,24411,6,6,12,595,891,1486,8,0.282567,0.298557,6546.990272,0.001104,0.000871,306,0.000344,0,29,0.533333,0.006629
5125,Saline County,,AR,6528,127899,134427,11,11,22,5151,4211,9362,7,0.293833,0.312938,3019.046554,0.002187,0.002019,138,0.000384,0,29,0.423077,0.014609
5127,Scott County,,AR,597,10673,11270,1,1,2,147,204,351,8,0.233013,0.242842,0,0.000047,0.000052,138,0.00009,0,29,0,0.000515
5129,Searcy County,,AR,511,7480,7991,0,2,2,0,177,177,9,0.21323,0.220505,0,0,0.000008,306,0.000054,0,47,0,0
5131,Sebastian County,,AR,7315,134545,141860,17,14,31,4503,4456,8959,7,0.303769,0.326925,18825.511674,0.004793,0.004332,138,0.000594,0,29,0.333333,0.033453
5133,Sevier County,,AR,775,16889,17664,2,3,5,175,235,410,9,0.208911,0.216734,19.344304,0.000002,0.000001,350,0.000141,0,29,0,0.000263
5135,Sharp County,,AR,1070,15854,16924,3,3,6,338,448,786,9,0.221356,0.229806,2830.998398,0.000003,0.000036,138,0.000192,0,29,0.416667,0.000417
5137,Stone County,,AR,491,12024,12515,0,0,0,0,0,0,0,0,0,0,0,0,8,0.000054,9,48,0,0
5139,Union County,,AR,1741,45369,47110,4,4,8,497,428,925,8,0.260649,0.273921,2057.559906,0.000301,0.000201,138,0.000222,0,29,0.416667,0.001989
5141,Van Buren County,,AR,947,16587,17534,2,3,5,287,408,695,8,0.260242,0.273121,0,0.000063,0.000209,138,0.000108,0,29,1,0.000386
5143,Washington County,,AR,12575,229866,242441,33,26,59,7932,7643,15575,7,0.342359,0.371482,39040.565583,0.014989,0.014385,138,0.00103,0,29,0.28254,0.104305
5145,White County,,AR,3932,79536,83468,7,8,15,1813,1915,3728,8,0.260802,0.274933,2791.737915,0.000368,0.000273,138,0.000302,0,29,0.388889,0.002534
5147,Woodruff County,,AR,392,6701,7093,0,1,1,0,130,130,9,0.206915,0.213724,0,0,0.000004,138,0.000054,0,49,0,0
5149,Yell County,,AR,1489,21836,23325,1,4,5,550,848,1398,8,0.245921,0.257427,0.658333,0.000007,0.000068,138,0.000083,0,29,0.666667,0.000182
6001,Alameda County,,CA,86765,1874582,1961347,147,132,279,80916,77266,158182,7,0.379462,0.42386,16719.89537,0.102809,0.09036,11,0.002411,0,29,0.356447,0.623881
6003,Alpine County,,CA,-2,984,982,0,0,0,0,0,0,0,0,0,0,0,0,9,0.000054,10,50,0,0
6005,Amador County,,CA,1667,39342,41009,8,6,14,1268,900,2168,8,0.276391,0.292809,0.459524,0.004285,0.003035,11,0.000177,0,29,0.928571,0.028221
6007,Butte County,,CA,8227,221842,230069,40,37,77,6352,5540,11892,7,0.328491,0.35689,5512.56231,0.019091,0.021133,11,0.000707,0,29,0.604123,0.123296
6009,Calaveras County,,CA,2438,47777,50215,9,8,17,1611,1414,3025,8,0.278381,0.295345,1.579844,0.004717,0.00428,11,0.000201,0,29,0.888889,0.031387
6011,Colusa County,,CA,1075,28240,29315,4,3,7,463,416,879,8,0.264893,0.279787,0.666667,0.000979,0.000973,11,0.000125,0,29,0.583333,0.006825
6013,Contra Costa County,,CA,53668,1336067,1389735,84,91,175,50900,45643,96543,7,0.358843,0.398246,5581.02019,0.061195,0.063579,11,0.00143,0,29,0.461393,0.395694
6015,Del Norte County,,CA,1244,23390,24634,4,5,9,285,401,686,8,0.265156,0.280662,90.923826,0.002514,0.001184,11,0.000134,0,29,0.633333,0.016542
6017,El Dorado County,,CA,10449,213266,223715,31,30,61,8453,7452,15905,7,0.315255,0.340376,216.154759,0.018561,0.018762,11,0.000573,0,29,0.754032,0.122467
6019,Fresno County,,CA,30565,1053623,1084188,49,68,117,20949,23314,44263,7,0.351515,0.38768,2796.677963,0.034912,0.045895,11,0.000817,0,29,0.518584,0.230117
6021,Glenn County,,CA,1480,32397,33877,2,4,6,593,840,1433,8,0.264972,0.2801,0.95,0.000244,0.000945,11,0.000098,0,29,0.666667,0.001836
6023,Humboldt County,,CA,4786,131810,136596,22,22,44,2315,2164,4479,7,0.312193,0.336151,2186.999833,0.012943,0.015069,11,0.000397,0,29,0.702381,0.082652
6025,Imperial County,,CA,9954,220771,230725,12,13,25,5212,6477,11689,7,0.314697,0.337084,6329.487362,0.011202,0.011163,11,0.000221,0,29,0.820513,0.070515
6027,Inyo County,,CA,1026,20290,21316,2,2,4,246,176,422,7,0.30755,0.326893,0,0.001696,0.001794,11,0.000098,0,29,1,0.011138
6029,Kern County,,CA,29093,931805,960898,42,58,100,20662,20660,41322,7,0.343726,0.377692,849.040828,0.03108,0.040388,11,0.000732,0,29,0.617475,0.208875
6031,Kings County,,CA,8394,150626,159020,18,17,35,4667,4919,9586,7,0.312229,0.335064,15.186247,0.014238,0.013563,11,0.000316,0,29,0.821637,0.090137
6033,Lake County,,CA,2897,60181,63078,11,11,22,1686,1461,3147,7,0.310521,0.331997,0.731888,0.005891,0.007124,11,0.000223,0,29,0.928571,0.040955
6035,Lassen County,,CA,1321,24532,25853,3,5,8,258,520,778,8,0.265314,0.280943,10.951031,0.001378,0.001489,11,0.000103,0,29,0.8,0.00877
6037,Los Angeles County,,CA,311796,11438056,11749852,356,369,725,236456,288129,524585,6,0.444001,0.51062,456591.964468,0.160823,0.151561,11,0.006508,0,29,0.108187,0.961275
6039,Madera County,,CA,7003,164575,171578,18,18,36,4817,4966,9783,7,0.311391,0.333908,156.654713,0.011978,0.01132,11,0.000296,0,29,0.885965,0.074415
6041,Marin County,,CA,14086,315100,329186,33,37,70,10214,10707,20921,7,0.336741,0.366263,376.593195,0.026945,0.027978,11,0.000581,0,29,0.721951,0.179596
6043,Mariposa County,,CA,1161,18085,19246,5,5,10,390,458,848,8,0.260267,0.274288,0.211111,0.002832,0.001009,11,0.000116,0,29,0.833333,0.01715
6045,Mendocino County,,CA,3481,94559,98040,12,12,24,1658,1629,3287,7,0.311173,0.333183,8.536829,0.007401,0.009634,11,0.000239,0,29,0.917582,0.050525
6047,Merced County,,CA,11160,280846,292006,22,28,50,8698,8309,17007,7,0.328612,0.355281,620.844152,0.015692,0.019953,11,0.000373,0,29,0.792328,0.10145
6049,Modoc County,,CA,435,8466,8901,0,0,0,0,0,0,0,0,0,0,0,0,10,0.000054,11,51,0,0
6051,Mono County,,CA,1164,15208,16372,4,4,8,394,395,789,7,0.309908,0.33006,13.20445,0.004417,0.004665,11,0.000139,0,29,0.666667,0.028602
6053,Monterey County,,CA,22246,540032,562278,47,57,104,14390,15692,30082,7,0.345954,0.379241,1420.144518,0.032268,0.038617,11,0.000794,0,29,0.570339,0.216242
6055,Napa County,,CA,7368,174248,181616,22,19,41,5084,5006,10090,7,0.314586,0.33794,38.95337,0.016226,0.014748,11,0.000387,0,29,0.922925,0.108041
6057,Nevada County,,CA,5783,114557,120340,19,23,42,3912,3755,7667,7,0.315889,0.340532,71.302952,0.011638,0.016479,11,0.000347,0,29,0.851449,0.077656
6059,Orange County,,CA,134072,3769556,3903628,178,187,365,110234,119343,229577,6,0.398387,0.448744,37284.07806,0.114444,0.111417,11,0.003054,0,29,0.270158,0.698416
6061,Placer County,,CA,21876,437890,459766,41,46,87,19322,17093,36415,7,0.335513,0.366722,1181.974472,0.024998,0.030864,11,0.000688,0,29,0.665391,0.164008
6063,Plumas County,,CA,1087,20346,21433,3,2,5,298,250,548,8,0.256292,0.269816,0,0.00071,0.000598,11,0.000106,0,29,0.833333,0.00441
6065,Riverside County,,CA,107200,2489652,2596852,121,137,258,105849,92504,198353,6,0.386107,0.430891,18472.727196,0.080463,0.086938,11,0.00221,0,29,0.348639,0.52556
6067,Sacramento County,,CA,58573,1659834,1718407,105,107,212,54822,49084,103906,7,0.3602,0.401717,28024.798776,0.063084,0.064461,11,0.001979,0,29,0.346212,0.420806
6069,San Benito County,,CA,3544,70935,74479,5,7,12,2717,2275,4992,7,0.308439,0.328848,0,0.002377,0.005403,11,0.000116,0,29,0.982143,0.01473
6071,San Bernardino County,,CA,109296,2269673,2378969,100,128,228,96266,93680,189946,7,0.36999,0.414796,10773.242471,0.06883,0.079634,11,0.001821,0,29,0.343812,0.451991
6073,San Diego County,,CA,139371,3830135,3969506,311,311,622,113706,113296,227002,6,0.42956,0.491704,256083.520138,0.152682,0.142024,11,0.005526,0,29,0.135425,0.914732
6075,San Francisco County,,CA,62489,1000709,1063198,132,87,219,55685,55559,111244,7,0.364282,0.402551,5690.439689,0.097071,0.067515,11,0.002019,0,29,0.41359,0.574857
6077,San Joaquin County,,CA,28337,800195,828532,43,48,91,26786,22686,49472,7,0.335936,0.367353,1191.164973,0.02912,0.032858,11,0.000743,0,29,0.662745,0.194082
6079,San Luis Obispo County,,CA,11998,313006,325004,34,35,69,9882,8225,18107,7,0.330402,0.358673,124.534398,0.023726,0.02412,11,0.000552,0,29,0.816501,0.154551
6081,San Mateo County,,CA,47035,936652,983687,75,67,142,38365,40779,79144,7,0.349443,0.384607,2002.83913,0.060717,0.051005,11,0.001212,0,29,0.538936,0.382841
6083,Santa Barbara County,,CA,18951,511668,530619,39,46,85,12307,13345,25652,7,0.342798,0.374606,7447.161766,0.031658,0.039153,11,0.000666,0,29,0.705128,0.211652
6085,Santa Clara County,,CA,91113,2324329,2415442,151,136,287,66175,79310,145485,7,0.379408,0.424664,22158.380006,0.103314,0.089437,11,0.002497,0,29,0.329733,0.624379
6087,Santa Cruz County,,CA,13158,320407,333565,36,38,74,10344,10058,20402,7,0.330607,0.35936,364.063174,0.025388,0.025046,11,0.000587,0,29,0.752613,0.165529
6089,Shasta County,,CA,7824,186654,194478,29,30,59,4322,4588,8910,7,0.316451,0.342282,4515.976242,0.018329,0.01969,11,0.000555,0,29,0.69697,0.122745
6091,Sierra County,,CA,178,2938,3116,0,0,0,0,0,0,0,0,0,0,0,0,12,0.000054,12,52,0,0
6093,Siskiyou County,,CA,1986,45610,47596,6,5,11,596,646,1242,8,0.265209,0.280787,40.941072,0.002992,0.001355,11,0.000166,0,29,0.633333,0.020286
6095,Solano County,,CA,23805,494812,518617,43,44,87,19798,17539,37337,7,0.334965,0.365741,735.972243,0.030117,0.031499,11,0.000736,0,29,0.68898,0.201633
6097,Sonoma County,,CA,17806,601846,619652,43,49,92,13762,12979,26741,7,0.339311,0.37097,676.418478,0.029714,0.032373,11,0.000723,0,29,0.661569,0.196701
6099,Stanislaus County,,CA,19850,586129,605979,37,43,80,16975,15324,32299,7,0.339009,0.370124,1346.326721,0.023861,0.032093,11,0.000625,0,29,0.732828,0.157944
6101,Sutter County,,CA,5464,105472,110936,12,12,24,3570,3738,7308,7,0.310702,0.332371,266.22191,0.00633,0.006788,11,0.000255,0,29,0.795238,0.041503
6103,Tehama County,,CA,3163,63417,66580,7,5,12,1752,1610,3362,8,0.265024,0.28035,500.182991,0.003841,0.001365,11,0.000163,0,29,0.803571,0.024818
6105,Trinity County,,CA,567,11029,11596,2,2,4,186,243,429,8,0.24049,0.251179,0,0.000377,0.00034,11,0.000085,0,29,1,0.002412
6107,Tulare County,,CA,15040,500327,515367,24,27,51,10262,10645,20907,7,0.329708,0.35629,45.947993,0.018278,0.021173,11,0.000389,0,29,0.895503,0.116448
6109,Tuolumne County,,CA,2342,56285,58627,11,9,20,1532,1042,2574,7,0.310377,0.331497,164.414214,0.006521,0.007618,11,0.000222,0,29,0.818182,0.043061
6111,Ventura County,,CA,37071,1049812,1086883,54,75,129,25585,28508,54093,7,0.35184,0.388555,1022.074525,0.040787,0.054615,11,0.000965,0,29,0.542208,0.276602
6113,Yolo County,,CA,11580,217345,228925,32,28,60,9000,8645,17645,7,0.315927,0.341113,832.98708,0.020164,0.018009,11,0.000553,0,29,0.775401,0.132112
6115,Yuba County,,CA,5993,72640,78633,7,7,14,3545,3287,6832,7,0.301299,0.321131,0.090909,0.00283,0.003236,11,0.000159,0,29,0.930556,0.018396
8001,Adams County,,CO,41200,543267,584467,45,35,80,37055,33086,70141,7,0.34122,0.371476,3349.618958,0.030127,0.028407,227,0.001114,0,29,0.539116,0.208559
8003,Alamosa County,,CO,1108,15716,16824,3,4,7,343,425,768,8,0.279753,0.295435,16228,0.000855,0.001135,227,0.000279,0,29,0.166667,0.006998
8005,Arapahoe County,,CO,57672,713670,771342,93,83,176,49567,47430,96997,7,0.371691,0.410016,24928.073053,0.067884,0.065545,227,0.002064,0,29,0.440399,0.443098
8007,Archuleta County,,CO,830,13625,14455,1,1,2,69,107,176,8,0.23954,0.248992,0,0.000084,0.000082,227,0.000078,0,29,0,0.000706
8009,Baca County,,CO,74,3938,4012,0,0,0,0,0,0,0,0,0,0,0,0,13,0.000054,13,53,0,0
8011,Bent County,,CO,131,4017,4148,1,0,1,68,0,68,0,0,0,0,0.000012,0,227,0.000093,0,25,0,0.000129
8013,Boulder County,,CO,21335,357572,378907,67,45,112,14823,14808,29631,7,0.347713,0.380103,8487.849255,0.052396,0.03732,227,0.001407,0,29,0.529607,0.339667
8014,Broomfield County,,CO,7002,72129,79131,12,10,22,6264,5292,11556,7,0.306702,0.327418,0,0.008987,0.006993,227,0.000352,0,29,1,0.066444
8015,Chaffee County,,CO,1086,20288,21374,5,3,8,341,228,569,8,0.279753,0.295342,0.658986,0.002806,0.001608,227,0.000199,0,29,0.9,0.022481
8017,Cheyenne County,,CO,75,2115,2190,0,0,0,0,0,0,0,0,0,0,0,0,14,0.000054,14,54,0,0
8019,Clear Creek County,,CO,827,10076,10903,3,2,5,336,321,657,8,0.277772,0.291818,0,0.001926,0.001664,227,0.000132,0,29,1,0.015366
8021,Conejos County,,CO,467,8000,8467,1,1,2,78,134,212,9,0.218617,0.225935,0,0.000012,0.000009,227,0.000113,0,29,0,0.000192
8023,Costilla County,,CO,129,3134,3263,0,0,0,0,0,0,0,0,0,0,0,0,15,0.000054,15,55,0,0
8025,Crowley County,,CO,168,2759,2927,0,1,1,0,78,78,9,0.218591,0.225894,0,0,0.000001,227,0.000054,0,56,0,0
8027,Custer County,,CO,213,4522,4735,1,0,1,73,0,73,0,0,0,0,0.000025,0,227,0.000096,0,22,0,0.00036
8029,Delta County,,CO,1771,32050,33821,2,2,4,538,613,1151,8,0.24036,0.250307,0,0.00017,0.000124,227,0.000114,0,29,1,0.001156
8031,Denver County,,CO,70658,730427,801085,167,100,267,66610,61067,127677,7,0.383719,0.423461,83018.775834,0.104123,0.073295,227,0.003465,0,29,0.300507,0.643471
8033,Dolores County,,CO,67,1950,2017,0,0,0,0,0,0,0,0,0,0,0,0,16,0.000054,16,57,0,0
8035,Douglas County,,CO,23086,379904,402990,44,35,79,18529,16135,34664,7,0.340436,0.370583,2210.569282,0.035925,0.031633,227,0.001011,0,29,0.647109,0.242098
8037,Eagle County,,CO,4476,64542,69018,15,14,29,1832,1996,3828,7,0.305403,0.326568,4066.036226,0.008713,0.006039,227,0.000475,0,29,0.653595,0.063367
8039,Elbert County,,CO,2016,27747,29763,6,5,11,1671,1193,2864,8,0.285775,0.301791,0,0.003433,0.003834,227,0.000208,0,29,1,0.027113
8041,El Paso County,,CO,46051,753368,799419,170,129,299,30647,25614,56261,7,0.387734,0.432161,115289.116002,0.096068,0.078698,227,0.003631,0,29,0.241863,0.618734
8043,Fremont County,,CO,2088,41855,43943,6,5,11,793,843,1636,8,0.285806,0.301822,2753.92655,0.002891,0.002296,227,0.000252,0,29,0.619048,0.023277
8045,Garfield County,,CO,3675,65031,68706,12,11,23,1864,1566,3430,7,0.305298,0.326006,97.253985,0.006447,0.005805,227,0.000396,0,29,0.840909,0.049054
8047,Gilpin County,,CO,526,5732,6258,2,2,4,178,180,358,8,0.260369,0.273607,0,0.000824,0.001102,227,0.000108,0,29,1,0.007272
8049,Grand County,,CO,1445,15604,17049,5,6,11,356,457,813,8,0.279313,0.294179,0,0.002675,0.003633,227,0.000183,0,29,1,0.021701
8051,Gunnison County,,CO,1138,16655,17793,1,3,4,50,175,225,8,0.277599,0.291818,0,0.000419,0.001822,227,0.000082,0,29,1,0.003592
8053,Hinsdale County,,CO,79,852,931,0,0,0,0,0,0,0,0,0,0,0,0,17,0.000054,17,58,0,0
8055,Huerfano County,,CO,292,6075,6367,1,1,2,70,97,167,8,0.235918,0.245086,0,0.000093,0.000091,227,0.000093,0,29,0,0.000807
8057,Jackson County,,CO,147,1517,1664,0,0,0,0,0,0,0,0,0,0,0,0,18,0.000054,18,59,0,0
8059,Jefferson County,,CO,43349,666546,709895,73,55,128,36596,34301,70897,7,0.350039,0.384185,18651.476579,0.049118,0.038557,227,0.001811,0,29,0.423216,0.327398
8061,Kiowa County,,CO,64,1505,1569,0,0,0,0,0,0,0,0,0,0,0,0,19,0.000054,19,60,0,0
8063,Kit Carson County,,CO,428,8453,8881,0,0,0,0,0,0,0,0,0,0,0,0,20,0.000054,20,61,0,0
8065,Lake County,,CO,606,7231,7837,2,2,4,179,126,305,8,0.234983,0.24431,0,0.000118,0.00014,227,0.000114,0,29,1,0.001274
8067,La Plata County,,CO,3529,60215,63744,13,14,27,1331,1443,2774,7,0.314957,0.337628,8388.683611,0.007511,0.007738,227,0.000402,0,29,0.606618,0.055525
8069,Larimer County,,CO,18649,372403,391052,49,36,85,12931,11195,24126,7,0.342227,0.37251,8262.43335,0.030974,0.025335,227,0.001272,0,29,0.465309,0.210637
8071,Las Animas County,,CO,748,14119,14867,1,1,2,99,105,204,8,0.235918,0.245086,0,0.000093,0.000091,227,0.000093,0,29,0,0.000807
8073,Lincoln County,,CO,295,5067,5362,1,0,1,50,0,50,0,0,0,0,0.000854,0,227,0.000078,0,26,0,0.006756
8075,Logan County,,CO,1034,20846,21880,2,2,4,169,158,327,8,0.255043,0.266924,0.2,0.000176,0.000539,227,0.000123,0,29,0.833333,0.001863
8077,Mesa County,,CO,6872,165464,172336,23,18,41,3200,3042,6242,7,0.316301,0.339926,19386.860538,0.011277,0.011076,227,0.000715,0,29,0.482213,0.083164
8079,Mineral County,,CO,-2,938,936,0,0,0,0,0,0,0,0,0,0,0,0,21,0.000054,21,62,0,0
8081,Moffat County,,CO,847,14365,15212,1,2,3,105,192,297,8,0.240404,0.250401,1,0.000028,0.000147,227,0.000093,0,29,0,0.000314
8083,Montezuma County,,CO,1637,27485,29122,2,3,5,427,440,867,8,0.241645,0.252468,1.605392,0.000136,0.000235,227,0.000096,0,29,0.5,0.001056
8085,Montrose County,,CO,2165,45404,47569,4,7,11,788,842,1630,7,0.306737,0.327074,6213.29672,0.00014,0.004556,227,0.000219,0,29,0.410714,0.001379
8087,Morgan County,,CO,1866,32849,34715,5,5,10,549,705,1254,8,0.278875,0.293398,179.213518,0.002241,0.0024,227,0.000198,0,29,0.766667,0.018039
8089,Otero County,,CO,899,19270,20169,2,3,5,255,305,560,8,0.279635,0.295092,5413,0.000093,0.001135,227,0.000138,0,29,0.166667,0.00092
8091,Ouray County,,CO,443,5509,5952,1,1,2,81,189,270,8,0.234756,0.243529,0,0.000049,0.000002,227,0.00008,0,29,0,0.000141
8093,Park County,,CO,1350,15982,17332,5,5,10,800,641,1441,8,0.285806,0.301853,0,0.002834,0.00349,227,0.000188,0,29,1,0.022605
8095,Phillips County,,CO,379,5125,5504,0,0,0,0,0,0,0,0,0,0,0,0,22,0.000054,22,63,0,0
8097,Pitkin County,,CO,1896,20555,22451,4,3,7,532,747,1279,8,0.277425,0.291474,0,0.00257,0.001295,227,0.000157,0,29,0.833333,0.019142
8099,Prowers County,,CO,600,12600,13200,0,1,1,0,65,65,8,0.235965,0.245181,0,0,0.000091,227,0.000054,0,64,0,0
8101,Pueblo County,,CO,6024,169978,176002,18,15,33,3132,2983,6115,7,0.308725,0.33051,19772.437446,0.008406,0.008529,227,0.00069,0,29,0.426316,0.063815
8103,Rio Blanco County,,CO,417,7314,7731,1,1,2,68,76,144,8,0.240317,0.250057,0,0.00012,0.000122,227,0.000087,0,29,0,0.001015
8105,Rio Grande County,,CO,923,14549,15472,2,2,4,240,217,457,9,0.218653,0.226185,5412,0.000012,0.000009,227,0.000248,0,29,0,0.00031
8107,Routt County,,CO,1849,28404,30253,6,5,11,404,451,855,8,0.277946,0.292568,2998.701711,0.002268,0.002569,227,0.00023,0,29,0.714286,0.018647
8109,Saguache County,,CO,334,4059,4393,1,1,2,72,74,146,10,0.179434,0.183623,0,0,0,227,0.000159,0,29,0,0.000123
8111,San Juan County,,CO,-2,695,693,0,0,0,0,0,0,0,0,0,0,0,0,23,0.000054,23,65,0,0
8113,San Miguel County,,CO,739,8892,9631,0,3,3,0,202,202,8,0.277616,0.291833,0,0,0.001701,227,0.000054,0,66,0.5,0
8115,Sedgwick County,,CO,68,2615,2683,0,0,0,0,0,0,0,0,0,0,0,0,24,0.000054,24,67,0,0
8117,Summit County,,CO,3292,35472,38764,11,10,21,1111,1335,2446,8,0.28599,0.302853,1595.658894,0.004218,0.004866,227,0.000374,0,29,0.727273,0.034436
8119,Teller County,,CO,2072,26777,28849,1,2,3,720,817,1537,8,0.279694,0.295092,0,0.000854,0.001576,227,0.000078,0,29,1,0.006756
8121,Washington County,,CO,186,5058,5244,0,0,0,0,0,0,0,0,0,0,0,0,25,0.000054,25,68,0,0
8123,Weld County,,CO,18024,310868,328892,29,19,48,14673,11370,26043,7,0.321446,0.346761,4259.529254,0.018688,0.013782,227,0.000811,0,29,0.571429,0.134981
8125,Yuma County,,CO,484,11690,12174,0,0,0,0,0,0,0,0,0,0,0,0,26,0.000054,26,69,0,0
9001,Fairfield County,,CT,40738,1110976,1151714,79,113,192,28213,32272,60485,7,0.36724,0.409728,5996.945724,0.066115,0.086826,271,0.001095,0,29,0.456751,0.386685
9003,Hartford County,,CT,34337,1075964,1110301,66,95,161,21577,26124,47701,7,0.363984,0.404268,6257.143938,0.05537,0.074637,271,0.000918,0,29,0.509689,0.319856
9005,Litchfield County,,CT,8505,227652,236157,12,19,31,5210,5310,10520,7,0.31403,0.338106,58.138155,0.008258,0.01519,271,0.000169,0,29,0.766082,0.041227
9007,Middlesex County,,CT,8688,198388,207076,10,16,26,6013,5706,11719,7,0.294221,0.315543,21.188866,0.005274,0.012089,271,0.000148,0,29,0.768382,0.024065
9009,New Haven County,,CT,33577,990412,1023989,63,94,157,21972,25866,47838,7,0.362451,0.402494,3995.304474,0.054606,0.077392,271,0.000893,0,29,0.528586,0.323663
9011,New London County,,CT,13515,321274,334789,32,43,75,6541,7712,14253,7,0.335766,0.366385,1106.880402,0.019992,0.036775,271,0.000446,0,29,0.556471,0.109574
9013,Tolland County,,CT,7628,166486,174114,10,13,23,5282,4889,10171,7,0.285837,0.305117,12.317794,0.005418,0.007176,271,0.000146,0,29,0.775641,0.024546
9015,Windham County,,CT,4887,132488,137375,9,9,18,2931,2898,5829,8,0.275279,0.29337,2.079647,0.003744,0.004299,271,0.000131,0,29,0.8,0.015251
10001,Kent County,,DE,8676,190529,199205,21,17,38,5360,4259,9619,7,0.323042,0.347573,3426.018528,0.014322,0.011021,271,0.000337,0,29,0.611667,0.077083
10003,New Castle County,,DE,21682,637809,659491,69,73,142,15933,15488,31421,7,0.355733,0.392324,5657.174207,0.057524,0.063241,271,0.000941,0,29,0.613429,0.325756
10005,Sussex County,,DE,8914,241035,249949,34,29,63,7002,5440,12442,7,0.324851,0.35099,2128.521961,0.017483,0.018452,271,0.000508,0,29,0.455128,0.089519
11001,District of Columbia,,DC,53302,682329,735631,149,117,266,44515,44389,88904,7,0.378011,0.420941,36722.959048,0.106961,0.088862,366,0.002341,0,29,0.38049,0.624311
12001,Alachua County,,FL,15445,248642,264087,45,48,93,9546,10138,19684,7,0.340915,0.372897,17414.167439,0.026707,0.038628,27,0.001073,0,29,0.523906,0.186215
12003,Baker County,,FL,1193,26250,27443,4,3,7,817,650,1467,8,0.276563,0.292243,1.482038,0.001335,0.001516,27,0.000157,0,29,0.666667,0.010325
12005,Bay County,,FL,11937,199190,211127,36,34,70,4960,4682,9642,7,0.336062,0.365714,27290.0941,0.022518,0.025476,33,0.00089,0,29,0.413131,0.149167
12007,Bradford County,,FL,1624,23864,25488,5,4,9,957,889,1846,8,0.276649,0.292555,95.325187,0.001723,0.001735,27,0.000177,0,29,0.7,0.011834
12009,Brevard County,,FL,23890,639912,663802,113,73,186,18648,13537,32185,7,0.357066,0.393921,3019.649579,0.083281,0.064574,27,0.001846,0,29,0.443097,0.498889
12011,Broward County,,FL,105571,2114081,2219652,196,196,392,98473,91477,189950,7,0.397142,0.448935,41631.596754,0.125052,0.12217,27,0.0032,0,29,0.268412,0.743803
12013,Calhoun County,,FL,747,12028,12775,3,3,6,361,385,746,8,0.251651,0.263617,2752.341437,0.000287,0.000253,33,0.00015,0,29,0.333333,0.002024
12015,Charlotte County,,FL,10160,177314,187474,29,16,45,6439,5423,11862,7,0.318491,0.34171,365.54011,0.023834,0.015678,27,0.000526,0,29,0.690524,0.143447
12017,Citrus County,,FL,8063,147850,155913,23,18,41,4114,3468,7582,7,0.318187,0.341923,112.718401,0.017798,0.015341,27,0.000525,0,29,0.867754,0.12139
12019,Clay County,,FL,15204,228877,244081,32,27,59,10941,9758,20699,7,0.32918,0.355453,1777.220378,0.025055,0.022678,27,0.000715,0,29,0.644385,0.16827
12021,Collier County,,FL,19814,408839,428653,102,50,152,17007,12048,29055,7,0.353659,0.386662,2331.210159,0.075422,0.046203,27,0.001489,0,29,0.446908,0.420493
12023,Columbia County,,FL,3848,64880,68728,10,12,22,1895,1903,3798,8,0.287655,0.306985,2571.017804,0.007057,0.006217,27,0.000321,0,29,0.495238,0.045338
12027,DeSoto County,,FL,1658,29540,31198,5,4,9,714,634,1348,8,0.271442,0.285943,3.998786,0.001706,0.002222,27,0.000184,0,29,0.6,0.014043
12029,Dixie County,,FL,703,12351,13054,3,3,6,322,298,620,8,0.254313,0.266796,0,0.000462,0.000324,27,0.000146,0,29,1,0.002558
12031,Duval County,,FL,51741,1018081,1069822,173,133,306,43791,38125,81916,7,0.381961,0.427128,74492.596648,0.107514,0.092227,27,0.003298,0,29,0.309805,0.661579
12033,Escambia County,,FL,21969,327942,349911,57,69,126,10657,12907,23564,7,0.35073,0.386208,12702.41737,0.043357,0.049577,33,0.001141,0,29,0.413449,0.286485
12035,Flagler County,,FL,6685,114725,121410,19,14,33,3607,3428,7035,7,0.293187,0.313388,20.958984,0.017009,0.011626,27,0.000391,0,29,0.888095,0.108886
12037,Franklin County,,FL,511,10160,10671,1,1,2,101,53,154,8,0.257107,0.269647,0,0.000479,0.000298,27,0.000075,0,29,0,0.002159
12039,Gadsden County,,FL,2833,49105,51938,5,5,10,1648,1819,3467,8,0.277339,0.293811,1702.103084,0.002209,0.001485,27,0.000205,0,29,0.380952,0.014006
12041,Gilchrist County,,FL,1001,15838,16839,4,3,7,773,560,1333,8,0.254313,0.266796,1.716667,0.000529,0.000323,27,0.000164,0,29,0.666667,0.003144
12043,Glades County,,FL,781,8645,9426,4,3,7,548,435,983,8,0.271414,0.285755,3.314303,0.002168,0.001265,27,0.000143,0,29,0.666667,0.015297
12045,Gulf County,,FL,727,13220,13947,1,1,2,271,267,538,8,0.251556,0.263118,0,0.000277,0.000244,33,0.000076,0,29,0,0.001719
12047,Hamilton County,,FL,820,11576,12396,3,3,6,210,371,581,8,0.244322,0.255715,17.310805,0.000237,0.000234,27,0.000144,0,29,0.333333,0.001852
12049,Hardee County,,FL,1539,26380,27919,5,5,10,861,929,1790,8,0.282717,0.299064,17.965918,0.002299,0.002947,27,0.000187,0,29,0.65,0.017856
12051,Hendry County,,FL,3027,39403,42430,8,10,18,2123,1948,4071,7,0.318263,0.340586,316.231717,0.008098,0.01064,27,0.000221,0,29,0.822222,0.054463
12053,Hernando County,,FL,9726,180399,190125,17,18,35,6304,5682,11986,7,0.319292,0.343147,23.654595,0.014945,0.016026,27,0.000368,0,29,0.911905,0.09553
12055,Highlands County,,FL,4740,97950,102690,17,16,33,2569,2153,4722,7,0.318491,0.34171,362.097161,0.012396,0.014689,27,0.000417,0,29,0.692105,0.086646
12057,Hillsborough County,,FL,72183,1458808,1530991,213,155,368,68753,56741,125494,7,0.393743,0.441183,49500.182286,0.12807,0.108294,27,0.003621,0,29,0.255605,0.751575
12059,Holmes County,,FL,1223,16635,17858,5,6,11,621,873,1494,8,0.260496,0.274471,151.374154,0.000304,0.000686,33,0.000215,0,29,0.4,0.002572
12061,Indian River County,,FL,7847,165517,173364,25,19,44,5272,3888,9160,7,0.319368,0.343397,6.238689,0.021597,0.017681,27,0.000446,0,29,0.831281,0.132626
12063,Jackson County,,FL,2227,45341,47568,7,7,14,972,1034,2006,8,0.259938,0.274569,130.873206,0.000822,0.000612,33,0.000271,0,29,0.357143,0.004981
12065,Jefferson County,,FL,664,14206,14870,1,1,2,311,286,597,8,0.257107,0.269647,0,0.000479,0.000298,27,0.000075,0,29,0,0.002159
12067,Lafayette County,,FL,386,6376,6762,1,1,2,124,124,248,9,0.21677,0.22427,0,0.000017,0.000049,27,0.000099,0,29,0,0.000428
12069,Lake County,,FL,21083,356226,377309,45,33,78,17818,14107,31925,7,0.337252,0.366332,333.529281,0.036821,0.030138,27,0.000886,0,29,0.718779,0.239136
12071,Lee County,,FL,32695,745272,777967,176,97,273,34784,20224,55008,7,0.372314,0.412321,21687.668586,0.105098,0.074625,27,0.002754,0,29,0.274088,0.597859
12073,Leon County,,FL,16861,280607,297468,50,56,106,10537,11408,21945,7,0.346044,0.379572,58003.911894,0.027431,0.044118,27,0.001407,0,29,0.42623,0.191086
12075,Levy County,,FL,2701,39500,42201,6,7,13,1467,1657,3124,8,0.286051,0.303799,739.769064,0.002609,0.003587,27,0.000222,0,29,0.642857,0.017372
12077,Liberty County,,FL,288,6724,7012,1,2,3,104,126,230,8,0.257206,0.26999,11.169418,0.000003,0.000301,33,0.000096,0,29,0,0.000144
12079,Madison County,,FL,839,17809,18648,2,3,5,151,249,400,8,0.258527,0.272227,10.037947,0.000632,0.000411,27,0.000097,0,29,0.5,0.002987
12081,Manatee County,,FL,19464,387340,406804,73,33,106,16836,11547,28383,7,0.339656,0.369068,1590.766093,0.060493,0.032537,27,0.001224,0,29,0.606847,0.360314
12083,Marion County,,FL,16528,363219,379747,43,34,77,11204,9355,20559,7,0.335597,0.364239,685.50739,0.031811,0.027658,27,0.000861,0,29,0.673913,0.204326
12085,Martin County,,FL,9931,171482,181413,21,17,38,7436,6061,13497,7,0.319751,0.343666,188.137137,0.019822,0.015874,27,0.00038,0,29,0.806159,0.119424
12086,Miami-Dade County,,FL,114444,2925547,3039991,179,201,380,79624,99703,179327,6,0.403326,0.455816,89765.714329,0.120364,0.122971,27,0.00305,0,29,0.258252,0.723052
12087,Monroe County,,FL,7606,93442,101048,18,19,37,2795,3206,6001,7,0.323669,0.348207,19.607363,0.016765,0.01902,27,0.000377,0,29,0.836957,0.111308
12089,Nassau County,,FL,4890,90189,95079,10,6,16,2822,2281,5103,8,0.276591,0.29268,223.742913,0.008206,0.001868,27,0.000259,0,29,0.590909,0.054573
12091,Okaloosa County,,FL,17450,231404,248854,51,50,101,7664,8492,16156,7,0.348212,0.381571,16771.276289,0.03552,0.041316,33,0.001106,0,29,0.481823,0.234925
12093,Okeechobee County,,FL,2073,36715,38788,6,5,11,832,761,1593,7,0.282059,0.298614,16.793109,0.003275,0.002123,27,0.000182,0,29,0.6,0.020972
12095,Orange County,,FL,90998,1388767,1479765,199,167,366,82827,76281,159108,7,0.392526,0.441264,39624.850369,0.124955,0.11222,27,0.003346,0,29,0.275131,0.736674
12097,Osceola County,,FL,28820,340086,368906,56,39,95,24482,21780,46262,7,0.340089,0.370492,266.335436,0.048743,0.037861,27,0.000858,0,29,0.704802,0.285737
12099,Palm Beach County,,FL,67527,1591185,1658712,202,172,374,69061,54688,123749,6,0.392468,0.441236,47058.49834,0.120877,0.112288,27,0.003216,0,29,0.254767,0.707941
12101,Pasco County,,FL,29219,512194,541413,64,46,110,26029,19831,45860,7,0.343195,0.375203,825.922506,0.054248,0.043703,27,0.001102,0,29,0.624218,0.328681
12103,Pinellas County,,FL,46606,1043681,1090287,183,115,298,41558,32406,73964,7,0.382783,0.424754,20626.710772,0.11892,0.090695,27,0.003,0,29,0.314171,0.693004
12105,Polk County,,FL,32950,674126,707076,89,62,151,27430,21255,48685,7,0.351284,0.386281,3040.374449,0.068735,0.054037,27,0.001535,0,29,0.526424,0.417041
12107,Putnam County,,FL,3923,68241,72164,9,9,18,2359,2190,4549,8,0.285073,0.303,52.984309,0.00589,0.004791,27,0.000241,0,29,0.844444,0.041022
12109,St. Johns County,,FL,13705,254271,267976,39,26,65,10773,8347,19120,7,0.333292,0.360298,693.788217,0.033648,0.024485,27,0.000753,0,29,0.744872,0.2135
12111,St. Lucie County,,FL,16967,316926,333893,48,38,86,14429,11012,25441,7,0.335766,0.365657,724.172447,0.040222,0.035374,27,0.000758,0,29,0.682698,0.235439
12113,Santa Rosa County,,FL,11407,177084,188491,21,22,43,6443,5968,12411,7,0.327885,0.354263,2059.81282,0.01597,0.015115,33,0.000465,0,29,0.583077,0.10456
12115,Sarasota County,,FL,23534,453235,476769,98,52,150,19437,15091,34528,7,0.351237,0.384854,3595.357263,0.073438,0.049143,27,0.001509,0,29,0.464059,0.417629
12117,Seminole County,,FL,34938,501048,535986,68,53,121,28729,27184,55913,7,0.347758,0.381296,937.703986,0.059651,0.051732,27,0.001187,0,29,0.661142,0.367006
12119,Sumter County,,FL,6071,122537,128608,29,12,41,4492,3348,7840,7,0.289685,0.308759,28.494087,0.024966,0.009936,27,0.000546,0,29,0.82266,0.154691
12121,Suwannee County,,FL,2495,39749,42244,7,5,12,1069,1035,2104,8,0.276735,0.292867,6115.55541,0.004543,0.001537,27,0.00027,0,29,0.47619,0.029233
12123,Taylor County,,FL,769,20175,20944,2,1,3,142,99,241,8,0.257107,0.269647,0,0.000483,0.000298,27,0.000102,0,29,1,0.002309
12125,Union County,,FL,734,11376,12110,3,3,6,357,351,708,8,0.254362,0.266921,1,0.000506,0.000385,27,0.000133,0,29,0.666667,0.002931
12127,Volusia County,,FL,25443,554420,579863,95,61,156,21146,15873,37019,7,0.354269,0.389346,2465.113404,0.072816,0.054921,27,0.001617,0,29,0.521565,0.438371
12129,Wakulla County,,FL,1668,31462,33130,2,1,3,955,843,1798,8,0.257107,0.269647,0,0.000495,0.000298,27,0.00011,0,29,1,0.002434
12131,Walton County,,FL,4695,64497,69192,9,7,16,2644,2078,4722,8,0.26763,0.283564,396.516724,0.00393,0.001581,33,0.000263,0,29,0.555556,0.024703
12133,Washington County,,FL,1419,22165,23584,3,3,6,926,837,1763,8,0.251651,0.263617,0,0.000291,0.000257,33,0.000139,0,29,1,0.002062
13001,Appling County,,GA,829,18534,19363,2,1,3,173,153,326,11,0.151513,0.154469,0.5,0,0,27,0.000343,0,29,0,0.000251
13003,Atkinson County,,GA,516,8289,8805,1,1,2,224,235,459,10,0.178533,0.183162,0,0.000001,0.00002,27,0.000166,0,29,0,0.000273
13005,Bacon County,,GA,564,10872,11436,2,2,4,162,197,359,10,0.178557,0.183412,1946.987592,0.000014,0.00002,27,0.000223,0,29,0.333333,0.000619
13007,Baker County,,GA,170,2973,3143,0,0,0,0,0,0,0,0,0,0,0,0,28,0.000054,27,70,0,0
13009,Baldwin County,,GA,2424,40939,43363,6,9,15,882,1250,2132,7,0.290158,0.308053,14482.912164,0.000084,0.003386,33,0.00041,0,29,0.277778,0.00134
13011,Banks County,,GA,1361,17746,19107,3,3,6,968,843,1811,8,0.243408,0.253991,1.944444,0.000136,0.000133,33,0.000156,0,29,0.666667,0.00129
13013,Barrow County,,GA,5184,80134,85318,12,10,22,4879,3458,8337,7,0.289811,0.307753,432.035868,0.004381,0.004632,33,0.000365,0,29,0.674242,0.030277
13015,Bartow County,,GA,5905,109319,115224,13,11,24,4074,3508,7582,7,0.289905,0.308066,173.169247,0.006123,0.004608,33,0.000347,0,29,0.666667,0.041771
13017,Ben Hill County,,GA,1054,17249,18303,4,3,7,429,392,821,8,0.241382,0.251311,2107.909109,0.001739,0.000041,33,0.000305,0,29,0.416667,0.012032
13019,Berrien County,,GA,1277,17053,18330,5,4,9,762,679,1441,8,0.244255,0.25564,1027.318122,0.001894,0.000132,33,0.000246,0,29,0.6,0.012737
13021,Bibb County,,GA,8890,162682,171572,18,18,36,4816,5165,9981,7,0.320288,0.344696,20742.191971,0.007258,0.007426,33,0.000596,0,29,0.371345,0.048312
13023,Bleckley County,,GA,625,12293,12918,3,3,6,339,302,641,8,0.249649,0.260953,141.080989,0.000273,0.000105,33,0.000154,0,29,0.416667,0.001645
13025,Brantley County,,GA,908,16636,17544,3,3,6,504,469,973,8,0.226121,0.235061,64.482204,0.000078,0.000127,27,0.000219,0,29,0.666667,0.001197
13027,Brooks County,,GA,1158,15462,16620,4,2,6,727,617,1344,8,0.244166,0.255141,0,0.001897,0.000135,33,0.000151,0,29,0.916667,0.012756
13029,Bryan County,,GA,3631,41107,44738,4,4,8,1749,1461,3210,8,0.26216,0.275848,0,0.000755,0.000694,33,0.000156,0,29,1,0.005091
13031,Bulloch County,,GA,4317,61242,65559,15,16,31,2251,2091,4342,7,0.291776,0.311252,24312.3619,0.005705,0.005067,33,0.00058,0,29,0.286765,0.038111
13033,Burke County,,GA,1505,23564,25069,4,3,7,778,795,1573,8,0.250047,0.262276,758.458588,0.002086,0.000363,234,0.000152,0,29,0.2,0.014074
13035,Butts County,,GA,1641,22999,24640,6,6,12,905,975,1880,8,0.259659,0.273042,112.502378,0.000719,0.000804,33,0.000242,0,29,0.5,0.005785
13037,Calhoun County,,GA,275,5028,5303,0,0,0,0,0,0,0,0,0,0,0,0,29,0.000054,28,71,0,0
13039,Camden County,,GA,4664,53948,58612,8,11,19,1449,1640,3089,7,0.30709,0.328461,256.053608,0.003404,0.005924,27,0.000257,0,29,0.44697,0.023862
13043,Candler County,,GA,617,10482,11099,2,1,3,248,164,412,8,0.225891,0.234349,0,0.000056,0.000062,33,0.000133,0,29,1,0.000684
13045,Carroll County,,GA,7136,118455,125591,18,16,34,4449,4548,8997,7,0.318986,0.342585,8332.38766,0.006498,0.006874,33,0.000497,0,29,0.457516,0.045198
13047,Catoosa County,,GA,4320,66868,71188,5,5,10,3132,2959,6091,8,0.254483,0.267331,5.052229,0.000327,0.000315,306,0.000227,0,29,0.633333,0.002738
13049,Charlton County,,GA,641,8849,9490,3,3,6,300,308,608,8,0.276505,0.292118,0,0.001086,0.001293,27,0.000131,0,29,1,0.008227
13051,Chatham County,,GA,19391,293074,312465,63,55,118,10707,10916,21623,7,0.35249,0.386356,34584.830634,0.040578,0.041972,33,0.001465,0,29,0.405158,0.274411
13053,Chattahoochee County,,GA,3191,6571,9762,1,7,8,308,1254,1562,8,0.291648,0.311552,0,0.000291,0.004377,33,0.000072,0,29,0.809524,0.001725
13055,Chattooga County,,GA,1073,24002,25075,3,2,5,518,468,986,8,0.223957,0.232583,4.655977,0.000045,0.000056,306,0.000149,0,29,0.333333,0.000779
13057,Cherokee County,,GA,14234,266946,281180,22,22,44,11202,9076,20278,7,0.323237,0.349375,1991.503814,0.013207,0.014857,33,0.00055,0,29,0.5,0.087131
13059,Clarke County,,GA,8567,101882,110449,24,21,45,5148,5128,10276,7,0.326201,0.351818,25672.520686,0.008794,0.008773,33,0.00076,0,29,0.358696,0.060282
13061,Clay County,,GA,230,3016,3246,0,0,0,0,0,0,0,0,0,0,0,0,30,0.000054,29,72,0,0
13063,Clayton County,,GA,31394,281475,312869,55,43,98,26656,24661,51317,7,0.349672,0.381714,9827.16868,0.036895,0.032874,33,0.001126,0,29,0.449153,0.232179
13065,Clinch County,,GA,223,6730,6953,0,0,0,0,0,0,0,0,0,0,0,0,31,0.000054,30,73,0,0
13067,Cobb County,,GA,59681,829444,889125,145,122,267,49380,47772,97152,7,0.384383,0.42769,74028.082979,0.090787,0.080712,33,0.002844,0,29,0.304805,0.549284
13069,Coffee County,,GA,1720,41470,43190,7,5,12,798,552,1350,9,0.217317,0.225963,18891.90775,0.001884,0.000051,27,0.000664,0,29,0.142857,0.013144
13071,Colquitt County,,GA,2256,46344,48600,7,9,16,855,997,1852,7,0.317619,0.33983,2532.865391,0.001996,0.002056,33,0.000264,0,29,0.458333,0.013694
13073,Columbia County,,GA,9837,156855,166692,21,17,38,6739,5206,11945,7,0.30642,0.330276,5726.098058,0.011698,0.010117,234,0.000526,0,29,0.465,0.079383
13075,Cook County,,GA,1118,16496,17614,4,3,7,533,514,1047,8,0.244233,0.255453,0.392857,0.000199,0.000149,33,0.000197,0,29,0.833333,0.001656
13077,Coweta County,,GA,9495,158361,167856,21,16,37,6181,5380,11561,7,0.319712,0.343647,2649.994427,0.010084,0.007741,33,0.000509,0,29,0.54329,0.066666
13079,Crawford County,,GA,850,12619,13469,3,3,6,544,500,1044,8,0.249743,0.261121,0,0.000274,0.000185,33,0.000174,0,29,1,0.001661
13081,Crisp County,,GA,1247,21115,22362,4,2,6,440,263,703,8,0.249509,0.260559,3265.212491,0.001909,0.000105,33,0.000225,0,29,0.333333,0.012453
13083,Dade County,,GA,839,15203,16042,3,5,8,426,519,945,8,0.25441,0.267144,4.307407,0.000268,0.000257,306,0.000155,0,29,0.6,0.002048
13085,Dawson County,,GA,1661,23939,25600,5,6,11,1327,1106,2433,7,0.287191,0.304458,11.567141,0.002293,0.002574,33,0.000172,0,29,0.866667,0.015386
13087,Decatur County,,GA,1372,28952,30324,5,5,10,422,561,983,8,0.257305,0.270615,13231.091931,0.000499,0.000327,27,0.000253,0,29,0.35,0.002835
13089,DeKalb County,,GA,74855,770416,845271,150,132,282,65582,64237,129819,7,0.394733,0.438359,77854.668961,0.093587,0.088006,33,0.002935,0,29,0.304381,0.571224
13091,Dodge County,,GA,912,18845,19757,3,4,7,366,423,789,8,0.249836,0.26144,8159.495238,0.000003,0.000128,33,0.000184,0,29,0.333333,0.00053
13093,Dooly County,,GA,679,10241,10920,2,2,4,211,305,516,8,0.249509,0.260559,0,0.000192,0.000124,33,0.000182,0,29,1,0.001116
13095,Dougherty County,,GA,6619,92374,98993,15,21,36,3048,3831,6879,7,0.321098,0.346321,23617.305157,0.00544,0.008914,33,0.000543,0,29,0.341897,0.03696
13097,Douglas County,,GA,12851,146466,159317,20,16,36,9649,8879,18528,7,0.320635,0.344578,1568.07083,0.014483,0.008823,33,0.000444,0,29,0.65,0.093304
13099,Early County,,GA,512,11073,11585,1,1,2,67,71,138,8,0.24259,0.252542,331.206147,0,0.000037,33,0.000098,0,29,0,0.000123
13101,Echols County,,GA,234,3661,3895,1,1,2,130,114,244,8,0.243987,0.254653,0,0.000153,0.000108,33,0.000075,0,29,0,0.000828
13103,Effingham County,,GA,3520,61710,65230,6,6,12,2422,1966,4388,8,0.262624,0.276973,374.845672,0.00111,0.001105,33,0.000239,0,29,0.566667,0.007789
13105,Elbert County,,GA,873,21218,22091,4,3,7,427,399,826,8,0.246194,0.256965,1.266503,0.000102,0.000108,33,0.000194,0,29,0.75,0.001296
13107,Emanuel County,,GA,1186,23259,24445,4,4,8,399,374,773,8,0.226236,0.235395,97.789518,0.000066,0.000063,33,0.00023,0,29,0.166667,0.001224
13109,Evans County,,GA,808,10786,11594,3,3,6,328,360,688,8,0.260904,0.274005,20.049772,0.000518,0.000506,33,0.00014,0,29,0.833333,0.003741
13111,Fannin County,,GA,1064,24180,25244,5,3,8,466,374,840,9,0.217707,0.225495,12754.19053,0.002024,0.000024,33,0.000344,0,29,0.25,0.014065
13113,Fayette County,,GA,10254,131152,141406,11,15,26,4614,5041,9655,7,0.321368,0.345758,102.320264,0.008055,0.009019,33,0.00028,0,29,0.708333,0.054276
13115,Floyd County,,GA,4533,102485,107018,10,12,22,2267,2518,4785,7,0.288432,0.307263,7231.612046,0.004798,0.003769,33,0.000319,0,29,0.49359,0.032634
13117,Forsyth County,,GA,11867,239737,251604,19,17,36,11481,7264,18745,7,0.328531,0.353938,3261.706856,0.014788,0.012527,33,0.00046,0,29,0.511858,0.099269
13119,Franklin County,,GA,1638,22714,24352,5,7,12,845,1073,1918,8,0.24761,0.259651,36.149818,0.000123,0.000233,33,0.000269,0,29,0.452381,0.001665
13121,Fulton County,,GA,100405,1015491,1115896,197,175,372,86382,87520,173902,6,0.398328,0.447851,134645.101276,0.113724,0.104462,33,0.003825,0,29,0.233971,0.689632
13123,Gilmer County,,GA,1564,29948,31512,5,4,9,651,534,1185,8,0.277859,0.293099,7818.089486,0.002198,0.001176,33,0.000251,0,29,0.7,0.015137
13125,Glascock County,,GA,125,2817,2942,0,0,0,0,0,0,0,0,0,0,0,0,32,0.000054,31,74,0,0
13127,Glynn County,,GA,4664,88199,92863,14,11,25,2096,1687,3783,7,0.29184,0.310995,11127.37993,0.008717,0.005856,27,0.00047,0,29,0.423077,0.057274
13129,Gordon County,,GA,2991,60296,63287,7,7,14,1920,1653,3573,8,0.278875,0.295185,796.170931,0.001276,0.001535,33,0.000251,0,29,0.5,0.009537
13131,Grady County,,GA,1375,26553,27928,4,4,8,711,688,1399,8,0.257579,0.270915,53.080573,0.000489,0.000354,33,0.000182,0,29,0.5,0.002755
13133,Greene County,,GA,1063,18243,19306,3,3,6,189,323,512,8,0.246216,0.256984,98.925497,0.001231,0.000109,33,0.000134,0,29,0.416667,0.008516
13135,Gwinnett County,,GA,66611,998635,1065246,140,132,272,53507,50393,103900,7,0.385884,0.430363,78438.736836,0.086392,0.084386,33,0.002754,0,29,0.289481,0.527734
13137,Habersham County,,GA,2248,45580,47828,6,7,13,1130,1263,2393,8,0.284921,0.301503,6216.646958,0.001012,0.002053,33,0.00028,0,29,0.309524,0.007053
13139,Hall County,,GA,10790,218742,229532,20,18,38,7527,6623,14150,7,0.321446,0.346227,12172.909075,0.007736,0.008276,33,0.000594,0,29,0.397619,0.051933
13141,Hancock County,,GA,374,7608,7982,1,1,2,156,164,320,8,0.22492,0.232884,0,0.000037,0.000001,33,0.000092,0,29,0,0.000148
13143,Haralson County,,GA,1713,28470,30183,6,5,11,1340,1148,2488,8,0.243164,0.253985,163.16171,0.001134,0.000327,33,0.00021,0,29,0.666667,0.008776
13145,Harris County,,GA,2164,35593,37757,5,5,10,1607,1318,2925,8,0.256637,0.270247,4.177793,0.00048,0.000432,33,0.000194,0,29,0.7,0.003529
13147,Hart County,,GA,1291,26053,27344,5,4,9,717,650,1367,8,0.247725,0.259395,336.645463,0.001066,0.000148,33,0.000219,0,29,0.45,0.007342
13149,Heard County,,GA,781,10513,11294,3,3,6,584,489,1073,8,0.242612,0.253173,0,0.000234,0.000231,33,0.000128,0,29,1,0.001952
13151,Henry County,,GA,17469,235483,252952,35,34,69,13960,11957,25917,7,0.334545,0.363377,12799.755628,0.020994,0.019367,33,0.000802,0,29,0.399225,0.132462
13153,Houston County,,GA,10622,171910,182532,28,28,56,5186,4894,10080,7,0.332378,0.359948,53508.252153,0.009501,0.017589,33,0.001089,0,29,0.268067,0.065759
13155,Irwin County,,GA,631,9067,9698,2,2,4,339,289,628,8,0.241208,0.25078,0,0.000023,0.000039,33,0.000185,0,29,1,0.000538
13157,Jackson County,,GA,4475,69532,74007,12,8,20,3703,2883,6586,8,0.285012,0.301847,2224.934605,0.00346,0.002186,33,0.000384,0,29,0.545455,0.023872
13159,Jasper County,,GA,915,14069,14984,2,2,4,429,311,740,8,0.241974,0.251924,0,0.000285,0.000106,33,0.000103,0,29,1,0.002297
13161,Jeff Davis County,,GA,796,14853,15649,2,2,4,221,205,426,10,0.178557,0.183412,3464.012408,0.000001,0.00002,27,0.000458,0,29,0,0.000396
13163,Jefferson County,,GA,932,18007,18939,1,1,2,164,230,394,8,0.249813,0.261539,0,0.000259,0.000235,234,0.000075,0,29,0,0.001644
13165,Jenkins County,,GA,531,7702,8233,1,2,3,87,205,292,8,0.225949,0.234662,2.67619,0.000055,0.000085,33,0.000084,0,29,0,0.000545
13167,Johnson County,,GA,384,7694,8078,2,2,4,200,236,436,9,0.200255,0.206565,2758.187581,0.000003,0.000022,33,0.00015,0,29,0.166667,0.000411
13169,Jones County,,GA,1733,30258,31991,4,4,8,1030,1102,2132,8,0.24986,0.261527,40.338557,0.00031,0.000184,33,0.000188,0,29,0.666667,0.001792
13171,Lamar County,,GA,1174,17438,18612,6,6,12,820,716,1536,8,0.259609,0.272918,111.131444,0.000299,0.00073,33,0.00028,0,29,0.571429,0.002919
13173,Lanier County,,GA,907,8302,9209,2,2,4,470,419,889,8,0.24401,0.254841,0,0.000155,0.000128,33,0.000128,0,29,1,0.001091
13175,Laurens County,,GA,2187,51701,53888,6,5,11,560,467,1027,8,0.250211,0.262283,19317.239409,0.001989,0.000183,33,0.000278,0,29,0.190476,0.01323
13177,Lee County,,GA,2245,34947,37192,3,3,6,1314,1090,2404,8,0.243164,0.253791,2.931818,0.000113,0.00008,33,0.000137,0,29,0.5,0.000922
13179,Liberty County,,GA,12441,63317,75758,28,35,63,3968,5830,9798,7,0.331387,0.361781,9474.808065,0.016488,0.021379,33,0.000641,0,29,0.491667,0.109864
13181,Lincoln County,,GA,392,7844,8236,2,2,4,156,140,296,8,0.249836,0.261726,0,0.000369,0.000362,234,0.000101,0,29,1,0.002604
13183,Long County,,GA,1863,12857,14720,4,4,8,1159,754,1913,8,0.262031,0.275611,49.079068,0.000709,0.000626,33,0.000164,0,29,0.5,0.004636
13185,Lowndes County,,GA,8215,109759,117974,20,27,47,3037,3734,6771,7,0.32269,0.349294,24168.369549,0.009931,0.014097,33,0.000693,0,29,0.327957,0.06545
13187,Lumpkin County,,GA,1923,28079,30002,5,5,10,999,955,1954,7,0.285195,0.302053,89.340757,0.001173,0.001516,33,0.000182,0,29,0.8,0.008117
13189,McDuffie County,,GA,1241,23760,25001,3,3,6,513,591,1104,8,0.249883,0.261976,5412,0.000369,0.000362,234,0.000193,0,29,0.333333,0.002723
13191,McIntosh County,,GA,847,11555,12402,1,1,2,282,328,610,8,0.225929,0.234356,0,0.000064,0.000095,27,0.00009,0,29,0,0.000726
13193,Macon County,,GA,781,11557,12338,2,2,4,200,327,527,8,0.249509,0.260559,1,0.000206,0.000106,33,0.000106,0,29,0.5,0.000987
13195,Madison County,,GA,1721,29787,31508,5,6,11,998,1065,2063,8,0.246148,0.257383,6.003968,0.000148,0.000195,33,0.000218,0,29,0.52381,0.001676
13197,Marion County,,GA,487,7300,7787,1,1,2,152,134,286,8,0.255899,0.268348,0,0.000291,0.000241,33,0.000072,0,29,0,0.001725
13199,Meriwether County,,GA,1760,21985,23745,7,6,13,1000,979,1979,7,0.286882,0.304127,313.640019,0.00169,0.001645,33,0.000232,0,29,0.52381,0.011587
13201,Miller County,,GA,426,5713,6139,2,2,4,170,176,346,9,0.204821,0.211557,0,0.000004,0.000005,27,0.000141,0,29,1,0.000282
13205,Mitchell County,,GA,1375,22024,23399,3,4,7,464,699,1163,8,0.243364,0.254372,4.643517,0.000125,0.000113,33,0.000136,0,29,0.666667,0.001115
13207,Monroe County,,GA,1668,28469,30137,5,4,9,923,726,1649,8,0.279109,0.294916,61.109158,0.000499,0.001028,33,0.000209,0,29,0.566667,0.003409
13209,Montgomery County,,GA,628,7812,8440,1,1,2,268,280,548,9,0.206982,0.213462,0,0.000005,0.000001,33,0.000108,0,29,0,0.000137
13211,Morgan County,,GA,1078,20648,21726,7,3,10,660,323,983,8,0.246216,0.257102,10.479524,0.000303,0.000261,33,0.000263,0,29,0.428571,0.003459
13213,Murray County,,GA,2353,40147,42500,2,3,5,1411,1515,2926,8,0.228366,0.237328,0.67619,0.000066,0.000079,306,0.000114,0,29,0.666667,0.00073
13215,Muscogee County,,GA,17973,212014,229987,42,46,88,9279,10693,19972,7,0.343859,0.376598,25905.094623,0.02219,0.026798,33,0.001005,0,29,0.361635,0.148335
13217,Newton County,,GA,8209,109728,117937,16,14,30,6149,5658,11807,7,0.319024,0.342398,7498.861377,0.009033,0.006922,33,0.000479,0,29,0.496324,0.059629
13219,Oconee County,,GA,2490,41041,43531,6,7,13,1587,1412,2999,7,0.287345,0.304896,689.707265,0.001116,0.002358,33,0.000224,0,29,0.569444,0.007866
13221,Oglethorpe County,,GA,843,14581,15424,2,3,5,495,483,978,8,0.246035,0.256696,0,0.000097,0.000109,33,0.000115,0,29,1,0.000945
13223,Paulding County,,GA,11073,161122,172195,15,14,29,8370,7765,16135,7,0.290063,0.308753,554.231142,0.007946,0.005427,33,0.000382,0,29,0.666667,0.053307
13225,Peach County,,GA,2450,27395,29845,4,3,7,1460,1549,3009,8,0.249743,0.261121,2.63287,0.000275,0.000185,33,0.000209,0,29,0.666667,0.001787
13227,Pickens County,,GA,1878,34526,36404,5,4,9,1197,980,2177,7,0.285592,0.30226,34.15524,0.002321,0.002388,33,0.00019,0,29,0.85,0.016037
13229,Pierce County,,GA,1169,19637,20806,2,2,4,542,585,1127,9,0.216928,0.224688,0,0.000015,0.000033,27,0.000172,0,29,1,0.000481
13231,Pike County,,GA,1161,19355,20516,4,4,8,764,690,1454,8,0.250799,0.262577,25.489782,0.000283,0.000324,33,0.000199,0,29,0.833333,0.002574
13233,Polk County,,GA,2174,42805,44979,6,7,13,1461,1391,2852,7,0.285837,0.303134,174.158925,0.001104,0.002508,33,0.000208,0,29,0.785714,0.008581
13235,Pulaski County,,GA,605,9179,9784,2,1,3,181,216,397,8,0.249486,0.260372,0,0.000192,0.000103,33,0.00013,0,29,1,0.001001
13237,Putnam County,,GA,1324,22341,23665,3,4,7,475,424,899,8,0.242413,0.252992,677.119707,0.000954,0.000116,33,0.000148,0,29,0.3,0.006122
13239,Quitman County,,GA,118,2020,2138,1,1,2,70,69,139,9,0.195802,0.201244,0,0,0.000001,33,0.000106,0,29,0,0.000136
13241,Rabun County,,GA,698,17691,18389,2,2,4,179,158,337,9,0.222612,0.230662,61.890353,0.000026,0.000011,234,0.000139,0,29,0,0.000327
13243,Randolph County,,GA,382,6815,7197,0,1,1,0,66,66,8,0.243123,0.253415,0,0,0.000059,33,0.000054,0,75,0,0
13245,Richmond County,,GA,16398,201521,217919,35,36,71,8902,10396,19298,7,0.332959,0.363027,24751.312364,0.02164,0.02387,234,0.000888,0,29,0.467073,0.143478
13247,Rockdale County,,GA,8564,91523,100087,11,9,20,6380,5615,11995,7,0.28978,0.307566,639.319736,0.008936,0.004972,33,0.000269,0,29,0.772727,0.058433
13249,Schley County,,GA,217,4690,4907,1,1,2,145,119,264,8,0.222556,0.230418,0,0.000015,0.000001,33,0.000073,0,29,0,0.000127
13251,Screven County,,GA,704,14045,14749,3,2,5,336,326,662,8,0.226044,0.234762,0,0.000523,0.000074,33,0.000141,0,29,1,0.003797
13253,Seminole County,,GA,558,8812,9370,2,3,5,207,266,473,9,0.205247,0.212387,2756.179779,0.000004,0.000005,27,0.000156,0,29,0.333333,0.000282
13255,Spalding County,,GA,4481,65368,69849,13,12,25,3221,2981,6202,7,0.318491,0.341304,4917.863007,0.006369,0.005897,33,0.000402,0,29,0.576923,0.043336
13257,Stephens County,,GA,1216,25570,26786,3,3,6,526,430,956,8,0.243453,0.254116,6.724254,0.000115,0.000096,33,0.000148,0,29,0.5,0.001048
13259,Stewart County,,GA,235,4128,4363,0,1,1,0,100,100,8,0.255946,0.268434,0,0,0.000241,33,0.000054,0,76,0,0
13261,Sumter County,,GA,1680,31839,33519,2,6,8,214,544,758,7,0.286235,0.30359,5417.320842,0.000097,0.001401,33,0.000138,0,29,0.3,0.000652
13263,Talbot County,,GA,528,6446,6974,2,2,4,254,224,478,8,0.255923,0.268535,0,0.000309,0.000259,33,0.000105,0,29,1,0.001977
13265,Taliaferro County,,GA,85,1555,1640,0,0,0,0,0,0,0,0,0,0,0,0,34,0.000054,32,77,0,0
13267,Tattnall County,,GA,1296,20525,21821,5,6,11,712,679,1391,8,0.262237,0.276286,89.716094,0.000304,0.000696,33,0.000229,0,29,0.533333,0.002309
13269,Taylor County,,GA,463,8341,8804,0,1,1,0,74,74,8,0.249533,0.260461,0,0,0.000103,33,0.000054,0,78,0,0
13271,Telfair County,,GA,709,10158,10867,1,2,3,84,229,313,9,0.19994,0.205971,2746,0.000001,0,33,0.000093,0,29,0,0.000129
13273,Terrell County,,GA,696,10093,10789,2,1,3,319,274,593,8,0.243076,0.253323,0,0.000098,0.000059,33,0.000115,0,29,1,0.000667
13275,Thomas County,,GA,2479,47954,50433,8,7,15,1227,1157,2384,8,0.259155,0.273845,1092.507692,0.002474,0.000514,33,0.000291,0,29,0.464286,0.015697
13277,Tift County,,GA,2645,43034,45679,9,10,19,1268,1271,2539,7,0.317619,0.339955,12298.377555,0.001897,0.002066,33,0.000528,0,29,0.311111,0.013741
13279,Toombs County,,GA,1544,28630,30174,4,4,8,555,617,1172,8,0.26098,0.274287,5589.604438,0.000063,0.000445,33,0.000258,0,29,0.35,0.000956
13281,Towns County,,GA,724,11561,12285,1,1,2,136,180,316,11,0.151703,0.154461,0,0,0,33,0.000184,0,29,0,0.000124
13283,Treutlen County,,GA,261,6248,6509,0,1,1,0,66,66,9,0.200195,0.20625,0,0,0.000022,33,0.000054,0,79,0,0
13285,Troup County,,GA,4331,74974,79305,12,15,27,2263,2729,4992,7,0.319368,0.34296,4641.51021,0.004727,0.006904,33,0.000362,0,29,0.504762,0.032284
13287,Turner County,,GA,494,8863,9357,2,1,3,173,137,310,8,0.241077,0.250418,0,0.001738,0.000021,33,0.000114,0,29,1,0.011633
13289,Twiggs County,,GA,789,8835,9624,2,3,5,397,424,821,8,0.249743,0.261121,0,0.000083,0.000185,33,0.000122,0,29,1,0.000801
13291,Union County,,GA,1186,23043,24229,2,2,4,296,213,509,10,0.17882,0.183312,5412,0,0.000022,33,0.000308,0,29,0,0.000387
13293,Upson County,,GA,1042,26804,27846,5,3,8,447,328,775,8,0.241645,0.251499,567.287471,0.002148,0.000075,33,0.000202,0,29,0.65,0.014844
13295,Walker County,,GA,4006,64576,68582,6,5,11,2597,2786,5383,8,0.25441,0.267144,292.730148,0.000328,0.000294,306,0.000281,0,29,0.5,0.002866
13297,Walton County,,GA,5316,94939,100255,12,12,24,4257,3533,7790,7,0.289937,0.308253,950.26115,0.006176,0.00465,33,0.000383,0,29,0.653846,0.042016
13299,Ware County,,GA,2008,34245,36253,7,6,13,1043,936,1979,8,0.276965,0.293367,21878.924365,0.002936,0.001284,27,0.000396,0,29,0.303571,0.020601
13301,Warren County,,GA,322,5625,5947,1,1,2,143,110,253,9,0.19994,0.206017,0,0.000004,0.000004,234,0.000108,0,29,0,0.00015
13303,Washington County,,GA,638,20921,21559,1,1,2,69,94,163,8,0.224977,0.232996,197.112552,0,0.000001,33,0.000117,0,29,0,0.000125
13305,Wayne County,,GA,1231,28478,29709,3,3,6,354,290,644,8,0.276677,0.292418,23.087898,0.000303,0.00127,27,0.00014,0,29,0.583333,0.002193
13307,Webster County,,GA,147,2400,2547,0,0,0,0,0,0,0,0,0,0,0,0,35,0.000054,33,80,0,0
13309,Wheeler County,,GA,309,4613,4922,1,0,1,69,0,69,0,0,0,0,0,0,33,0.000093,0,3,0,0.000118
13311,White County,,GA,1612,27130,28742,4,4,8,871,744,1615,8,0.247587,0.258614,2.675379,0.001045,0.000268,33,0.000164,0,29,0.75,0.006877
13313,Whitfield County,,GA,5245,116165,121410,12,11,23,2964,3175,6139,7,0.290663,0.309121,5665.623027,0.00503,0.004505,306,0.000392,0,29,0.461538,0.034306
13315,Wilcox County,,GA,445,7134,7579,0,1,1,0,75,75,9,0.199746,0.205432,0,0,0.000021,33,0.000054,0,81,0,0
13317,Wilkes County,,GA,398,10565,10963,0,0,0,0,0,0,0,0,0,0,0,0,36,0.000054,34,82,0,0
13319,Wilkinson County,,GA,601,10253,10854,1,1,2,140,156,296,8,0.22492,0.232884,0,0.000037,0.000001,33,0.000092,0,29,0,0.000148
13321,Worth County,,GA,1463,21577,23040,5,4,9,744,803,1547,8,0.24332,0.254354,857.074165,0.001858,0.000103,33,0.0002,0,29,0.65,0.01258
15001,Hawaii County,,HI,7475,206555,214030,18,20,38,3759,3775,7534,7,0.317317,0.341759,15.602252,0.015898,0.018492,11,0.00038,0,29,0.857143,0.109275
15003,Honolulu County,,HI,51383,1172573,1223956,161,154,315,34007,34983,68990,7,0.38796,0.435408,48299.406837,0.099795,0.093662,11,0.002937,0,29,0.278508,0.63318
15005,Kalawao County,,HI,0,0,0,0,0,0,0,0,0,0,0,0,0,0,0,37,0.000054,35,83,0,0
15007,Kauai County,,HI,2965,83281,86246,9,8,17,1251,1144,2395,7,0.312852,0.334229,0,0.009781,0.009003,11,0.000213,0,29,1,0.066696
15009,Maui County,,HI,6918,187807,194725,17,17,34,3065,3402,6467,7,0.329953,0.355459,38.374499,0.0168,0.018504,11,0.000357,0,29,0.913158,0.115194
16001,Ada County,,ID,21125,491251,512376,67,55,122,14780,12602,27382,7,0.339052,0.372538,61728.406661,0.031998,0.031202,11,0.001789,0,29,0.342136,0.221802
16003,Adams County,,ID,274,3994,4268,0,0,0,0,0,0,0,0,0,0,0,0,38,0.000054,36,84,0,0
16005,Bannock County,,ID,4192,88363,92555,9,12,21,1629,2041,3670,7,0.307373,0.328973,8326.906138,0.00157,0.005091,11,0.000346,0,29,0.510989,0.011368
16007,Bear Lake County,,ID,284,6854,7138,0,0,0,0,0,0,0,0,0,0,0,0,39,0.000054,37,85,0,0
16009,Benewah County,,ID,521,9716,10237,1,2,3,138,291,429,8,0.252723,0.265612,0,0.000147,0.000426,11,0.000079,0,29,1,0.001017
16011,Bingham County,,ID,2883,51991,54874,2,6,8,991,1630,2621,8,0.271111,0.287002,84.999743,0.00011,0.001131,11,0.000106,0,29,0.7,0.000856
16013,Blaine County,,ID,1183,28476,29659,2,2,4,199,262,461,8,0.253419,0.266474,0,0.000388,0.00041,11,0.000114,0,29,1,0.003112
16015,Boise County,,ID,403,7169,7572,2,1,3,353,213,566,8,0.253227,0.265881,0,0.000443,0.000347,11,0.000109,0,29,1,0.00358
16017,Bonner County,,ID,2449,45431,47880,4,6,10,905,1141,2046,7,0.285959,0.303549,334.786371,0.000466,0.002195,11,0.0002,0,29,0.533333,0.00355
16019,Bonneville County,,ID,5759,126325,132084,15,14,29,3715,3120,6835,7,0.307444,0.329348,12021.805568,0.006166,0.005076,11,0.000455,0,29,0.441176,0.043293
16021,Boundary County,,ID,521,12484,13005,2,2,4,145,195,340,8,0.240794,0.251098,0,0.000171,0.000137,11,0.000108,0,29,1,0.00118
16023,Butte County,,ID,151,2703,2854,0,0,0,0,0,0,0,0,0,0,0,0,40,0.000054,38,86,0,0
16025,Camas County,,ID,-2,1106,1104,0,0,0,0,0,0,0,0,0,0,0,0,41,0.000054,39,87,0,0
16027,Canyon County,,ID,11200,219288,230488,22,20,42,8128,7008,15136,7,0.316865,0.341501,9090.990862,0.012528,0.009628,11,0.000658,0,29,0.398462,0.086288
16029,Caribou County,,ID,419,7847,8266,0,1,1,0,87,87,8,0.235175,0.244392,0,0,0.000017,11,0.000054,0,88,0,0
16031,Cassia County,,ID,1739,27327,29066,2,3,5,728,988,1716,8,0.253444,0.266662,0,0.000054,0.000411,11,0.00012,0,29,0.833333,0.000706
16033,Clark County,,ID,-2,956,954,0,0,0,0,0,0,0,0,0,0,0,0,42,0.000054,40,89,0,0
16035,Clearwater County,,ID,400,8529,8929,1,1,2,86,108,194,9,0.20289,0.210084,0,0.000009,0.000009,11,0.000095,0,29,0,0.000207
16037,Custer County,,ID,349,4635,4984,0,0,0,0,0,0,0,0,0,0,0,0,43,0.000054,41,90,0,0
16039,Elmore County,,ID,2786,28386,31172,2,2,4,406,669,1075,8,0.253251,0.266068,0,0.000443,0.000483,11,0.000109,0,29,1,0.00358
16041,Franklin County,,ID,613,15115,15728,1,1,2,263,217,480,8,0.234591,0.243428,0,0.00005,0.000068,11,0.000095,0,29,0,0.000596
16043,Fremont County,,ID,844,14728,15572,2,2,4,285,398,683,8,0.235211,0.244671,0,0.000093,0.0001,11,0.000105,0,29,1,0.000957
16045,Gem County,,ID,1152,18396,19548,2,3,5,530,697,1227,8,0.253275,0.266256,0,0.000443,0.000488,11,0.000109,0,29,1,0.00358
16047,Gooding County,,ID,1058,17524,18582,2,2,4,539,585,1124,8,0.23517,0.244608,0,0.000054,0.000063,11,0.000115,0,29,1,0.000706
16049,Idaho County,,ID,679,16172,16851,2,2,4,220,218,438,9,0.202905,0.210272,0,0.000009,0.000009,11,0.000166,0,29,1,0.000331
16051,Jefferson County,,ID,1842,30841,32683,2,2,4,945,1040,1985,8,0.235211,0.244671,0,0.000093,0.0001,11,0.000105,0,29,1,0.000957
16053,Jerome County,,ID,1979,26528,28507,2,4,6,906,1165,2071,8,0.253468,0.266849,99.259239,0.00005,0.000411,11,0.000135,0,29,0.5,0.000706
16055,Kootenai County,,ID,7634,171936,179570,20,20,40,4449,4066,8515,7,0.317053,0.341676,18479.074756,0.012167,0.013568,11,0.000603,0,29,0.495671,0.083885
16057,Latah County,,ID,2382,36948,39330,7,7,14,863,1084,1947,7,0.286082,0.303924,480.518496,0.001984,0.002234,11,0.000278,0,29,0.666667,0.01528
16059,Lemhi County,,ID,360,8533,8893,0,0,0,0,0,0,0,0,0,0,0,0,44,0.000054,42,91,0,0
16061,Lewis County,,ID,415,4355,4770,2,2,4,148,226,374,9,0.202905,0.210272,0,0.000009,0.000009,11,0.000166,0,29,1,0.000331
16063,Lincoln County,,ID,441,5617,6058,2,1,3,172,97,269,8,0.235149,0.244421,0,0.000054,0.000063,11,0.000115,0,29,1,0.000706
16065,Madison County,,ID,4132,32018,36150,8,10,18,1095,1978,3073,7,0.305543,0.326537,4076.8509,0.003022,0.003446,11,0.000276,0,29,0.527273,0.021348
16067,Minidoka County,,ID,1483,24133,25616,2,3,5,776,769,1545,8,0.253444,0.266662,0,0.000054,0.000411,11,0.00012,0,29,0.833333,0.000706
16069,Nez Perce County,,ID,2284,44384,46668,8,9,17,1407,1447,2854,8,0.254507,0.26961,16247.733351,0.000828,0.00083,11,0.000443,0,29,0.319444,0.006622
16071,Oneida County,,ID,205,4780,4985,0,0,0,0,0,0,0,0,0,0,0,0,45,0.000054,43,92,0,0
16073,Owyhee County,,ID,945,12096,13041,2,2,4,542,583,1125,8,0.253251,0.266068,0,0.000443,0.000483,11,0.000109,0,29,1,0.00358
16075,Payette County,,ID,1710,25433,27143,5,4,9,984,995,1979,8,0.253299,0.266443,1.5,0.000459,0.000492,11,0.000219,0,29,0.7,0.004049
16077,Power County,,ID,544,9078,9622,2,1,3,331,192,523,8,0.235128,0.244296,0,0.000068,0.000017,11,0.000093,0,29,1,0.000386
16079,Shoshone County,,ID,624,12631,13255,1,1,2,230,231,461,8,0.240751,0.250848,0,0.000147,0.000132,11,0.000079,0,29,0,0.001017
16081,Teton County,,ID,735,11547,12282,1,2,3,242,248,490,8,0.23596,0.245733,13.4704,0.000012,0.000075,227,0.000095,0,29,0,0.00017
16083,Twin Falls County,,ID,4828,92485,97313,15,15,30,2711,2599,5310,7,0.307409,0.32941,20942.261018,0.005789,0.004565,11,0.000571,0,29,0.308333,0.040965
16085,Valley County,,ID,750,11504,12254,2,2,4,331,288,619,8,0.253251,0.266068,0,0.000443,0.000483,11,0.000109,0,29,1,0.00358
16087,Washington County,,ID,613,10687,11300,3,3,6,279,325,604,8,0.253275,0.266256,0,0.000349,0.000488,11,0.000161,0,29,1,0.002865
17001,Adams County,,IL,2044,81283,83327,7,7,14,618,636,1254,7,0.306385,0.326183,27436.156787,0.001521,0.002223,47,0.000451,0,29,0.166667,0.010292
17003,Alexander County,,IL,532,6713,7245,1,1,2,71,96,167,9,0.21921,0.226117,0,0.000012,0.000013,147,0.000129,0,29,0,0.000234
17005,Bond County,,IL,800,17677,18477,1,4,5,188,454,642,8,0.253275,0.265152,1550.416369,0.000089,0.000149,147,0.000072,0,29,0.5,0.000471
17007,Boone County,,IL,3462,67407,70869,6,7,13,2519,2220,4739,7,0.304601,0.323772,0.614827,0.00301,0.002528,47,0.000124,0,29,0.833333,0.015843
17009,Brown County,,IL,220,5831,6051,0,1,1,0,60,60,8,0.234596,0.243179,0,0,0.000017,47,0.000054,0,93,0,0
17011,Bureau County,,IL,1652,42053,43705,2,4,6,500,693,1193,7,0.304671,0.323522,722.013875,0.00005,0.001651,47,0.000098,0,29,0.5,0.000457
17013,Calhoun County,,IL,147,5773,5920,0,0,0,0,0,0,0,0,0,0,0,0,46,0.000054,44,94,0,0
17015,Carroll County,,IL,751,18857,19608,2,3,5,148,304,452,8,0.235439,0.244828,2.668347,0.000041,0.000038,47,0.000095,0,29,0.333333,0.000394
17017,Cass County,,IL,768,16372,17140,3,2,5,282,227,509,8,0.24332,0.253804,95.348482,0.000094,0.000087,47,0.000143,0,29,0.333333,0.000927
17019,Champaign County,,IL,9214,207040,216254,25,27,52,4097,4127,8224,7,0.341395,0.370114,22314.344039,0.009384,0.01648,47,0.000602,0,29,0.339718,0.054225
17021,Christian County,,IL,1359,39209,40568,4,4,8,651,699,1350,8,0.243697,0.254779,109.972568,0.000122,0.000111,47,0.000195,0,29,0.5,0.001253
17023,Clark County,,IL,642,19290,19932,3,3,6,237,274,511,8,0.235814,0.245631,43.094772,0.000031,0.000029,47,0.000148,0,29,0.666667,0.000611
17025,Clay County,,IL,520,16110,16630,3,1,4,215,76,291,9,0.189853,0.194801,121.220963,0,0,147,0.000196,0,29,0,0.000376
17027,Clinton County,,IL,1586,44416,46002,5,4,9,990,860,1850,8,0.253203,0.265059,1191.933994,0.000253,0.000148,147,0.000188,0,29,0.5,0.001623
17029,Coles County,,IL,2296,51696,53992,10,10,20,1064,1128,2192,7,0.305438,0.325427,32793.954308,0.001714,0.001654,47,0.000448,0,29,0.266667,0.011436
17031,Cook County,,IL,202036,6288416,6490452,306,326,632,135911,177805,313716,6,0.437377,0.499581,667191.416745,0.140512,0.138483,47,0.005941,0,29,0.128259,0.844848
17033,Crawford County,,IL,592,22635,23227,1,1,2,74,53,127,10,0.178748,0.182839,0,0,0,306,0.000171,0,29,0,0.000128
17035,Cumberland County,,IL,561,12772,13333,2,3,5,265,331,596,8,0.234158,0.243245,0,0.000018,0.000019,47,0.000169,0,29,1,0.000409
17037,DeKalb County,,IL,5979,114020,119999,12,13,25,4020,3947,7967,7,0.314178,0.335925,58.145817,0.004223,0.004977,47,0.000211,0,29,0.653846,0.02122
17039,De Witt County,,IL,695,19468,20163,3,4,7,346,413,759,8,0.256391,0.268601,4.124283,0.000348,0.000186,47,0.000115,0,29,0.833333,0.001524
17041,Douglas County,,IL,1201,25923,27124,4,4,8,551,656,1207,8,0.254848,0.266808,108.613145,0.000199,0.000123,47,0.000195,0,29,0.5,0.001285
17043,DuPage County,,IL,57446,1194209,1251655,72,96,168,43461,47741,91202,6,0.377423,0.41666,16731.561203,0.053349,0.072514,47,0.001259,0,29,0.442795,0.331108
17045,Edgar County,,IL,751,20598,21349,4,5,9,356,428,784,8,0.255752,0.268407,171.452702,0.000056,0.000149,47,0.000188,0,29,0.4,0.00085
17047,Edwards County,,IL,335,7697,8032,0,1,1,0,76,76,10,0.161201,0.164444,0,0,0,306,0.000054,0,95,0,0
17049,Effingham County,,IL,1406,44351,45757,6,6,12,655,555,1210,8,0.234323,0.243982,11410.36048,0.000019,0.000019,47,0.000546,0,29,0.2,0.000911
17051,Fayette County,,IL,855,23760,24615,3,2,5,283,246,529,9,0.201953,0.208582,67.165278,0.000002,0,47,0.000193,0,29,0.166667,0.000412
17053,Ford County,,IL,690,16553,17243,3,3,6,341,337,678,8,0.254726,0.266446,1.703968,0.000341,0.000144,47,0.00011,0,29,0.5,0.001476
17055,Franklin County,,IL,1621,42800,44421,4,4,8,762,882,1644,8,0.234983,0.244463,33.022222,0.000059,0.000038,147,0.000254,0,29,0.583333,0.000799
17057,Fulton County,,IL,1344,40341,41685,5,5,10,633,696,1329,8,0.251485,0.263185,103.36109,0.000167,0.000125,47,0.000201,0,29,0.4,0.001449
17059,Gallatin County,,IL,196,5891,6087,1,1,2,77,83,160,9,0.189947,0.194563,0,0,0,147,0.000196,0,29,0,0.000129
17061,Greene County,,IL,611,15038,15649,3,3,6,231,311,542,8,0.250493,0.261414,31.639493,0.000097,0.000055,147,0.00015,0,29,0.333333,0.000741
17063,Grundy County,,IL,2942,63281,66223,7,7,14,2427,2097,4524,7,0.304636,0.323835,3.620635,0.002878,0.002413,47,0.00016,0,29,0.761905,0.015516
17065,Hamilton County,,IL,476,9394,9870,1,2,3,70,163,233,9,0.219446,0.226503,2669,0,0.000002,147,0.000155,0,96,0,0.000118
17067,Hancock County,,IL,948,22245,23193,4,3,7,415,395,810,8,0.235087,0.244314,61.969105,0.000042,0.000033,47,0.0002,0,29,0.166667,0.000711
17069,Hardin County,,IL,153,4078,4231,0,1,1,0,70,70,9,0.189991,0.194677,0,0,0,147,0.000054,0,97,0,0
17071,Henderson County,,IL,339,8283,8622,1,1,2,101,93,194,8,0.234632,0.243204,0,0.00002,0.000016,47,0.000082,0,29,0,0.000232
17073,Henry County,,IL,2268,62326,64594,8,7,15,1256,1224,2480,7,0.305019,0.324459,1832.364173,0.001647,0.001676,47,0.000262,0,29,0.361111,0.010895
17075,Iroquois County,,IL,1327,35463,36790,5,6,11,749,743,1492,7,0.30474,0.323866,477.798317,0.001757,0.001865,47,0.000165,0,29,0.566667,0.010864
17077,Jackson County,,IL,3750,53821,57571,8,10,18,1350,1726,3076,7,0.306631,0.326964,9723.700439,0.001718,0.002584,147,0.000347,0,29,0.409091,0.011377
17079,Jasper County,,IL,352,12214,12566,1,1,2,68,87,155,9,0.189853,0.194801,0,0,0,47,0.000131,0,29,0,0.000144
17081,Jefferson County,,IL,1759,42586,44345,6,6,12,645,627,1272,8,0.280931,0.295559,12254.174558,0.000163,0.00063,147,0.000316,0,29,0.196429,0.001403
17083,Jersey County,,IL,1066,25721,26787,3,4,7,684,656,1340,8,0.280547,0.294753,133.940057,0.000098,0.000666,147,0.000152,0,29,0.583333,0.00075
17085,Jo Daviess County,,IL,1058,29191,30249,4,4,8,420,450,870,7,0.304845,0.323803,331.897726,0.001574,0.001571,47,0.000157,0,29,0.5,0.01015
17087,Johnson County,,IL,570,12808,13378,1,1,2,151,160,311,8,0.234426,0.242896,0,0.000023,0.000017,147,0.000123,0,29,0,0.000253
17089,Kane County,,IL,29035,648178,677213,22,33,55,23127,21529,44656,7,0.3397,0.369389,1529.08327,0.014936,0.026959,47,0.000383,0,29,0.54902,0.091239
17091,Kankakee County,,IL,4401,130228,134629,6,8,14,2184,2075,4259,7,0.313845,0.334966,35.408573,0.003039,0.004325,47,0.000144,0,29,0.678571,0.015982
17093,Kendall County,,IL,8102,149569,157671,7,10,17,7278,5632,12910,7,0.318415,0.340891,35.61937,0.003114,0.006506,47,0.000148,0,29,0.8,0.016438
17095,Knox County,,IL,2022,57848,59870,5,6,11,646,731,1377,7,0.304775,0.323959,5882.680762,0.001634,0.001636,47,0.000254,0,29,0.433333,0.010564
17097,Lake County,,IL,35767,891533,927300,52,71,123,23490,25950,49440,7,0.364431,0.401111,6350.021863,0.043595,0.062042,47,0.000899,0,29,0.568421,0.275966
17099,LaSalle County,,IL,4742,135596,140338,13,16,29,3128,2683,5811,7,0.314363,0.336841,8774.37871,0.003335,0.00456,47,0.000291,0,29,0.404167,0.017767
17101,Lawrence County,,IL,612,16291,16903,3,2,5,189,202,391,9,0.217636,0.225018,7978.087861,0.000008,0,306,0.000277,0,29,0,0.000374
17103,Lee County,,IL,1687,40535,42222,5,6,11,737,911,1648,7,0.304671,0.323772,500.035573,0.001653,0.001733,47,0.000135,0,29,0.666667,0.010591
17105,Livingston County,,IL,1592,43203,44795,6,5,11,761,790,1551,7,0.304705,0.32371,218.302097,0.002123,0.001834,47,0.000158,0,29,0.633333,0.011946
17107,Logan County,,IL,1272,31507,32779,6,4,10,578,504,1082,8,0.254144,0.266396,28.591543,0.000285,0.000186,47,0.000199,0,29,0.5,0.001974
17109,McDonough County,,IL,1445,30037,31482,4,4,8,469,337,806,7,0.30474,0.323585,5522.50595,0.001506,0.001544,47,0.000175,0,29,0.25,0.009834
17111,McHenry County,,IL,15067,396819,411886,13,23,36,11004,10178,21182,7,0.33421,0.360794,283.836694,0.007847,0.01651,47,0.000231,0,29,0.628458,0.04482
17113,McLean County,,IL,8192,196962,205154,15,24,39,3167,4017,7184,7,0.337039,0.364329,8316.596942,0.005406,0.013043,47,0.000389,0,29,0.42029,0.031845
17115,Macon County,,IL,3913,123876,127789,12,13,25,1484,1533,3017,7,0.306949,0.32787,9222.54261,0.002053,0.002484,47,0.000432,0,29,0.333333,0.013073
17117,Macoupin County,,IL,2220,53532,55752,5,5,10,1155,1331,2486,8,0.28099,0.295628,433.365005,0.000191,0.000752,147,0.000217,0,29,0.5,0.001559
17119,Madison County,,IL,11468,311284,322752,14,20,34,6208,6353,12561,7,0.333917,0.360135,20606.840005,0.00486,0.008189,147,0.000438,0,29,0.339474,0.030428
17121,Marion County,,IL,1656,45103,46759,4,5,9,686,680,1366,8,0.252102,0.263894,2472.211862,0.00001,0.000117,147,0.000255,0,29,0.333333,0.000564
17123,Marshall County,,IL,678,14912,15590,3,3,6,306,384,690,8,0.251366,0.262804,4.896498,0.000162,0.00011,47,0.000126,0,29,0.5,0.001081
17125,Mason County,,IL,712,16219,16931,2,4,6,241,367,608,8,0.2512,0.262554,0.642857,0.000021,0.000095,47,0.000114,0,29,0.666667,0.000403
17127,Massac County,,IL,589,16560,17149,1,1,2,178,223,401,8,0.221411,0.228408,0,0.000016,0,306,0.000109,0,29,0,0.000147
17129,Menard County,,IL,676,15583,16259,1,1,2,341,392,733,8,0.243253,0.253492,0,0.000093,0.000086,47,0.000082,0,29,0,0.000676
17131,Mercer County,,IL,806,20198,21004,2,4,6,290,443,733,8,0.24049,0.250646,82.749978,0.000087,0.000076,47,0.000103,0,29,0.5,0.000686
17133,Monroe County,,IL,1542,43040,44582,6,5,11,1089,980,2069,8,0.280576,0.294928,162.409244,0.001424,0.000993,147,0.000193,0,29,0.766667,0.007464
17135,Montgomery County,,IL,1037,32585,33622,4,4,8,448,465,913,8,0.2512,0.262782,18.076348,0.000191,0.000142,147,0.000179,0,29,0.666667,0.001435
17137,Morgan County,,IL,1482,38962,40444,4,5,9,535,604,1139,8,0.243408,0.254429,5440.407783,0.000094,0.00009,47,0.00027,0,29,0.2,0.001059
17139,Moultrie County,,IL,773,17439,18212,4,4,8,454,432,886,8,0.235211,0.244863,3.02381,0.000047,0.000044,47,0.000208,0,29,0.666667,0.000841
17141,Ogle County,,IL,2615,65098,67713,8,8,16,1433,1414,2847,7,0.304671,0.324022,717.691646,0.002891,0.002444,47,0.000176,0,29,0.589286,0.015866
17143,Peoria County,,IL,9422,223080,232502,20,19,39,4786,4943,9729,7,0.335134,0.362009,19349.130553,0.00656,0.010221,47,0.000536,0,29,0.288043,0.040904
17145,Perry County,,IL,841,22521,23362,5,4,9,452,426,878,8,0.234942,0.24437,14.47619,0.000061,0.000038,147,0.000268,0,29,0.4,0.000927
17147,Piatt County,,IL,875,20441,21316,3,3,6,505,466,971,8,0.254726,0.266433,1.071429,0.000207,0.000126,47,0.000142,0,29,0.666667,0.001177
17149,Pike County,,IL,484,18068,18552,1,1,2,106,82,188,8,0.234549,0.243083,0,0.000024,0.000017,47,0.000108,0,29,0,0.000242
17151,Pope County,,IL,110,4181,4291,0,0,0,0,0,0,0,0,0,0,0,0,48,0.000054,45,98,0,0
17153,Pulaski County,,IL,316,6216,6532,0,0,0,0,0,0,0,0,0,0,0,0,49,0.000054,46,99,0,0
17155,Putnam County,,IL,313,7281,7594,1,2,3,81,184,265,8,0.23924,0.248776,0,0.00005,0.000037,47,0.000069,0,29,1,0.000336
17157,Randolph County,,IL,1392,35199,36591,4,6,10,626,719,1345,8,0.280753,0.295322,527.412325,0.0002,0.000739,147,0.000196,0,29,0.333333,0.001363
17159,Richland County,,IL,692,19157,19849,0,2,2,0,154,154,10,0.179308,0.18397,0,0,0,147,0.000054,0,100,0,0
17161,Rock Island County,,IL,7043,176910,183953,7,12,19,3071,3896,6967,7,0.315889,0.338084,3304.322571,0.001604,0.004274,47,0.000241,0,29,0.416667,0.010805
17163,St. Clair County,,IL,13448,300373,313821,19,20,39,6268,7307,13575,7,0.336274,0.363383,26790.424856,0.008616,0.01479,147,0.000532,0,29,0.381538,0.057079
17165,Saline County,,IL,872,27016,27888,3,2,5,308,266,574,8,0.234467,0.243145,8079,0.000023,0.000017,147,0.000335,0,29,0,0.000485
17167,Sangamon County,,IL,7611,246618,254229,23,22,45,3833,3538,7371,7,0.321407,0.346654,34016.230051,0.00789,0.008548,47,0.000736,0,29,0.291667,0.047363
17169,Schuyler County,,IL,450,7997,8447,0,3,3,0,244,244,8,0.23402,0.242892,0,0,0.000018,47,0.000054,0,101,0.333333,0
17171,Scott County,,IL,215,6235,6450,1,1,2,80,104,184,9,0.195773,0.201339,0,0.000001,0.000001,47,0.0001,0,29,0,0.000138
17173,Shelby County,,IL,1151,26120,27271,6,6,12,670,682,1352,8,0.235419,0.2456,913.284189,0.000047,0.000043,47,0.000331,0,29,0.380952,0.001101
17175,Stark County,,IL,301,6861,7162,2,2,4,130,140,270,8,0.251177,0.262211,0.939733,0.000129,0.000089,47,0.000109,0,29,0.5,0.000854
17177,Stephenson County,,IL,1967,55982,57949,6,7,13,875,1041,1916,7,0.305648,0.325234,3923.117556,0.001745,0.002021,47,0.000193,0,29,0.333333,0.01093
17179,Tazewell County,,IL,6220,164898,171118,8,9,17,3533,3593,7126,7,0.305193,0.325053,4475.137727,0.00178,0.001851,47,0.000276,0,29,0.444444,0.011337
17181,Union County,,IL,686,19868,20554,1,3,4,119,275,394,8,0.235253,0.244801,4.472222,0.000028,0.000048,147,0.000083,0,29,0.333333,0.000257
17183,Vermilion County,,IL,2798,87539,90337,6,6,12,1042,1034,2076,7,0.30635,0.326227,4350.525194,0.001706,0.002359,47,0.000217,0,29,0.285714,0.010834
17185,Wabash County,,IL,460,13760,14220,2,1,3,131,86,217,9,0.192108,0.197376,2668,0.000001,0.000001,306,0.000158,0,29,0,0.000255
17187,Warren County,,IL,943,20525,21468,2,1,3,230,213,443,8,0.233605,0.241927,1.11039,0.000019,0.000018,47,0.000111,0,29,0,0.000366
17189,Washington County,,IL,847,17892,18739,4,5,9,456,515,971,8,0.252031,0.263738,846.54652,0.00017,0.000099,147,0.000204,0,29,0.4,0.001187
17191,Wayne County,,IL,582,19766,20348,1,2,3,76,145,221,9,0.219625,0.226742,165.294189,0.000007,0.000002,147,0.000098,0,29,0,0.000149
17193,White County,,IL,598,16696,17294,1,1,2,84,70,154,10,0.179968,0.183878,0,0,0,147,0.00012,0,96,0,0.000118
17195,Whiteside County,,IL,2004,71251,73255,6,9,15,971,1074,2045,7,0.304949,0.324584,827.780085,0.000131,0.001762,47,0.000195,0,29,0.416667,0.001405
17197,Will County,,IL,35154,852306,887460,28,46,74,28484,26955,55439,7,0.347622,0.380184,3210.837084,0.016804,0.036843,47,0.00051,0,29,0.512855,0.103069
17199,Williamson County,,IL,3317,75054,78371,9,7,16,1889,1415,3304,7,0.306174,0.325809,25534.245955,0.001542,0.002157,147,0.000568,0,29,0.2,0.010624
17201,Winnebago County,,IL,11147,344867,356014,18,25,43,6001,6285,12286,7,0.335851,0.36308,1445.283963,0.008544,0.01781,47,0.000334,0,29,0.504274,0.049261
17203,Woodford County,,IL,1933,48342,50275,4,4,8,1263,1138,2401,8,0.254047,0.265877,7.222483,0.000274,0.000151,47,0.000153,0,29,0.666667,0.001482
18001,Adams County,,IN,1098,42929,44027,3,3,6,520,555,1075,8,0.256341,0.268745,600.567342,0.000225,0.000145,47,0.000169,0,29,0.333333,0.001343
18003,Allen County,,IN,12475,442923,455398,35,37,72,6930,6445,13375,7,0.344391,0.375484,62824.715486,0.013134,0.020589,47,0.000903,0,29,0.253775,0.081876
18005,Bartholomew County,,IN,4272,101004,105276,9,9,18,2481,2230,4711,8,0.277512,0.293289,1888.187636,0.001105,0.001005,47,0.000288,0,29,0.466667,0.006935
18007,Benton County,,IN,561,10352,10913,1,1,2,191,277,468,8,0.25196,0.263123,0,0.000138,0.000074,47,0.000074,0,29,0,0.000636
18009,Blackford County,,IN,559,14554,15113,3,4,7,283,313,596,9,0.21792,0.226287,6.443254,0.000025,0.000029,47,0.000144,0,29,0.333333,0.000582
18011,Boone County,,IN,3543,76762,80305,7,8,15,2734,2113,4847,7,0.306315,0.326414,299.3778,0.002786,0.002568,47,0.000219,0,29,0.660714,0.016791
18013,Brown County,,IN,1055,18276,19331,5,5,10,661,738,1399,8,0.277195,0.292133,0.767857,0.000952,0.000804,47,0.000172,0,29,0.9,0.005806
18015,Carroll County,,IN,1134,24339,25473,5,5,10,917,822,1739,8,0.252198,0.264185,3.229167,0.000183,0.000115,47,0.000178,0,29,0.7,0.001416
18017,Cass County,,IN,2107,47232,49339,7,9,16,894,1145,2039,8,0.27809,0.294351,2363.871886,0.000985,0.001129,47,0.000234,0,29,0.430556,0.006061
18019,Clark County,,IN,7022,136522,143544,9,9,18,5145,4665,9810,8,0.279167,0.2958,1826.054909,0.001498,0.001259,306,0.000313,0,29,0.402778,0.00923
18021,Clay County,,IN,1303,30714,32017,5,5,10,848,774,1622,8,0.277252,0.292289,2371.292512,0.000844,0.000739,47,0.000201,0,29,0.6,0.005362
18023,Clinton County,,IN,1599,40245,41844,6,6,12,863,1030,1893,8,0.277397,0.292695,230.270573,0.00129,0.001014,47,0.000197,0,29,0.733333,0.007267
18025,Crawford County,,IN,563,11829,12392,1,2,3,110,206,316,9,0.218617,0.226645,2.283333,0.000006,0.000015,306,0.000089,0,29,0,0.000172
18027,Daviess County,,IN,1126,38944,40070,6,4,10,569,430,999,8,0.237747,0.247832,4046.092178,0.001404,0.00006,306,0.000304,0,29,0.166667,0.008912
18029,Dearborn County,,IN,2478,61727,64205,8,10,18,1755,1692,3447,8,0.279284,0.295694,10802.136716,0.000942,0.0014,257,0.000335,0,29,0.4,0.005136
18031,Decatur County,,IN,1478,32597,34075,7,7,14,786,915,1701,8,0.277397,0.292789,2105.176198,0.000865,0.000759,47,0.000256,0,29,0.357143,0.005713
18033,DeKalb County,,IN,2346,51118,53464,4,3,7,1358,1455,2813,8,0.256292,0.268651,0,0.00023,0.000149,47,0.000168,0,29,1,0.00154
18035,Delaware County,,IN,5082,117432,122514,10,11,21,2336,2668,5004,8,0.278352,0.295131,9530.311458,0.001383,0.001161,47,0.000318,0,29,0.409091,0.008274
18037,Dubois County,,IN,1661,55641,57302,9,7,16,746,672,1418,8,0.27809,0.293757,11345.962842,0.000678,0.000779,306,0.000463,0,29,0.172727,0.004837
18039,Elkhart County,,IN,8336,251136,259472,13,13,26,5182,4752,9934,7,0.316414,0.339402,4879.104529,0.004598,0.005469,47,0.000325,0,29,0.419048,0.029266
18041,Fayette County,,IN,981,25440,26421,3,4,7,341,467,808,9,0.21876,0.227236,14.619798,0.00002,0.000026,47,0.000142,0,29,0.166667,0.000527
18043,Floyd County,,IN,5083,90814,95897,6,6,12,4063,3838,7901,8,0.278992,0.295081,122.799435,0.001478,0.001243,306,0.000225,0,29,0.733333,0.008764
18045,Fountain County,,IN,1080,20110,21190,4,5,9,524,695,1219,8,0.252436,0.264622,318.495883,0.000174,0.000105,47,0.000179,0,29,0.25,0.001207
18047,Franklin County,,IN,1192,28364,29556,6,6,12,793,723,1516,8,0.272774,0.286911,1735.116198,0.000907,0.000632,257,0.000206,0,29,0.4,0.004677
18049,Fulton County,,IN,1168,24847,26015,4,5,9,457,533,990,8,0.253516,0.265928,243.062788,0.000042,0.000121,47,0.00015,0,29,0.266667,0.000695
18051,Gibson County,,IN,1544,40505,42049,5,6,11,748,873,1621,8,0.237768,0.248145,8300.633429,0.000053,0.000054,306,0.000412,0,29,0.233333,0.001025
18053,Grant County,,IN,2867,74355,77222,9,10,19,1101,1370,2471,8,0.277975,0.294257,3545.202579,0.001086,0.001087,47,0.000303,0,29,0.422222,0.006955
18055,Greene County,,IN,1540,36736,38276,6,7,13,824,905,1729,8,0.277627,0.293182,2406.97125,0.000946,0.000804,47,0.000224,0,29,0.333333,0.005818
18057,Hamilton County,,IN,16782,377720,394502,38,35,73,13002,10972,23974,7,0.349215,0.380612,21025.852213,0.016899,0.027346,47,0.000882,0,29,0.340136,0.106097
18059,Hancock County,,IN,4381,87721,92102,8,8,16,3681,3037,6718,8,0.277281,0.292726,849.126261,0.001178,0.000978,47,0.000259,0,29,0.589286,0.007309
18061,Harrison County,,IN,1828,46684,48512,5,5,10,1283,1238,2521,8,0.27395,0.287851,3890.591695,0.000665,0.000535,306,0.000209,0,29,0.6,0.004125
18063,Hendricks County,,IN,10362,189977,200339,14,10,24,7406,5911,13317,8,0.27757,0.293538,329.878643,0.003262,0.001113,47,0.000372,0,29,0.467033,0.019463
18065,Henry County,,IN,2359,54630,56989,7,8,15,1446,1524,2970,8,0.277483,0.293132,1944.506792,0.000871,0.000951,47,0.000238,0,29,0.535714,0.005801
18067,Howard County,,IN,3359,99424,102783,10,9,19,1922,1654,3576,8,0.277599,0.293507,1281.300989,0.001317,0.00101,47,0.000303,0,29,0.466667,0.007866
18069,Huntington County,,IN,1613,44860,46473,5,5,10,826,954,1780,8,0.256366,0.269089,7.447619,0.000241,0.000163,47,0.000223,0,29,0.5,0.001718
18071,Jackson County,,IN,2507,56938,59445,7,8,15,1156,1551,2707,8,0.277483,0.29307,1886.632682,0.000949,0.00081,47,0.000251,0,29,0.339286,0.005996
18073,Jasper County,,IN,1719,40139,41858,6,7,13,1042,1042,2084,8,0.277627,0.293289,3324.452328,0.002027,0.000996,47,0.000164,0,29,0.5,0.011855
18075,Jay County,,IN,942,25328,26270,4,4,8,435,463,898,9,0.21792,0.226193,14.368547,0.000015,0.000018,47,0.00019,0,29,0.333333,0.000642
18077,Jefferson County,,IN,1452,37093,38545,4,7,11,375,643,1018,8,0.274288,0.288757,638.104993,0.000025,0.000543,306,0.000183,0,29,0.190476,0.000716
18079,Jennings County,,IN,1634,32300,33934,4,4,8,896,951,1847,9,0.218635,0.227288,22.530683,0.000034,0.000032,47,0.000161,0,29,0.333333,0.000744
18081,Johnson County,,IN,9446,178681,188127,12,12,24,7277,6307,13584,8,0.278148,0.29485,113.452706,0.001326,0.001209,47,0.000357,0,29,0.417582,0.008555
18083,Knox County,,IN,1428,41289,42717,5,6,11,562,611,1173,8,0.27809,0.293601,15373.335875,0.000045,0.000778,306,0.000389,0,29,0.2,0.001113
18085,Kosciusko County,,IN,3910,98285,102195,9,10,19,2009,2237,4246,7,0.306808,0.327476,3100.941027,0.001266,0.002534,47,0.000279,0,29,0.411111,0.007634
18087,LaGrange County,,IN,1961,47235,49196,5,6,11,1182,1361,2543,8,0.256835,0.270013,21.144247,0.000294,0.000205,47,0.000183,0,29,0.6,0.002006
18089,Lake County,,IN,23321,568884,592205,25,37,62,15346,16832,32178,7,0.344525,0.375724,10269.834695,0.01483,0.02777,47,0.000496,0,29,0.481508,0.091185
18091,LaPorte County,,IN,4555,127815,132370,8,8,16,2656,2511,5167,7,0.30635,0.326477,571.685989,0.002962,0.002676,47,0.000191,0,29,0.652778,0.017239
18093,Lawrence County,,IN,1773,53276,55049,4,5,9,770,873,1643,8,0.277425,0.29257,1138.23236,0.00012,0.000788,47,0.000178,0,29,0.5,0.001037
18095,Madison County,,IN,5988,146565,152553,9,10,19,3338,3489,6827,8,0.278004,0.294319,98.510235,0.001404,0.001138,47,0.00027,0,29,0.509091,0.008259
18097,Marion County,,IN,52234,1093651,1145885,121,117,238,36254,38830,75084,7,0.383058,0.424966,209247.00375,0.065384,0.075027,47,0.002643,0,29,0.270462,0.414844
18099,Marshall County,,IN,2399,57443,59842,5,6,11,1205,1459,2664,8,0.253371,0.265803,199.269218,0.000251,0.000195,47,0.000162,0,29,0.533333,0.001717
18101,Martin County,,IN,436,11802,12238,1,2,3,97,221,318,9,0.217707,0.225205,0,0.000001,0.000023,306,0.000118,0,29,1,0.000221
18103,Miami County,,IN,1826,39051,40877,5,5,10,931,1022,1953,8,0.277339,0.292477,109.754665,0.000038,0.00075,47,0.000189,0,29,0.466667,0.000928
18105,Monroe County,,IN,6974,128701,135675,20,21,41,3144,3480,6624,7,0.324337,0.350446,7257.616742,0.0053,0.009426,47,0.000533,0,29,0.333333,0.03269
18107,Montgomery County,,IN,1779,46222,48001,6,6,12,948,807,1755,8,0.277397,0.292695,229.290253,0.001003,0.000861,47,0.000209,0,29,0.6,0.006272
18109,Morgan County,,IN,4166,83775,87941,7,8,15,2976,2950,5926,8,0.277281,0.292695,5.731944,0.000968,0.001031,47,0.000241,0,29,0.642857,0.00633
18111,Newton County,,IN,987,16618,17605,2,3,5,449,555,1004,8,0.25686,0.269725,0,0.000312,0.000257,47,0.000085,0,29,1,0.001375
18113,Noble County,,IN,2437,57821,60258,7,7,14,1776,1809,3585,8,0.256514,0.269713,17.507107,0.000318,0.000218,47,0.000265,0,29,0.547619,0.002345
18115,Ohio County,,IN,352,6834,7186,2,2,4,215,220,435,9,0.218348,0.225961,0,0.000015,0.00001,257,0.000154,0,29,1,0.000321
18117,Orange County,,IN,891,21830,22721,3,3,6,298,282,580,9,0.218742,0.227145,26.180132,0.000023,0.000016,47,0.000174,0,29,0,0.000515
18119,Owen County,,IN,1357,23903,25260,6,6,12,840,947,1787,8,0.27731,0.292477,6.495238,0.000954,0.000807,47,0.000211,0,29,0.6,0.005924
18121,Parke County,,IN,750,17862,18612,3,3,6,327,401,728,9,0.218009,0.226017,1.709524,0.00002,0.000019,47,0.000155,0,29,0.666667,0.000523
18123,Perry County,,IN,687,21835,22522,2,4,6,185,334,519,9,0.219878,0.228828,19.157024,0.000001,0.000024,306,0.000165,0,29,0.5,0.000269
18125,Pike County,,IN,598,14620,15218,2,3,5,224,301,525,8,0.237663,0.247489,5.733333,0.000009,0.00006,306,0.000168,0,29,0.666667,0.000335
18127,Porter County,,IN,7922,202324,210246,11,14,25,6192,5108,11300,7,0.316226,0.339246,694.805235,0.004255,0.006492,47,0.000236,0,29,0.542857,0.022805
18129,Posey County,,IN,1232,31449,32681,2,1,3,653,704,1357,8,0.237557,0.246927,0,0.000044,0.000052,306,0.000161,0,29,1,0.000634
18131,Pulaski County,,IN,658,15185,15843,2,3,5,195,254,449,9,0.217636,0.225644,27.214922,0.000014,0.000008,47,0.000097,0,29,0.166667,0.000418
18133,Putnam County,,IN,2018,39242,41260,7,7,14,1247,1204,2451,8,0.277339,0.292726,16.124603,0.000876,0.000796,47,0.000248,0,29,0.547619,0.005978
18135,Randolph County,,IN,1368,30156,31524,5,5,10,810,840,1650,9,0.218492,0.227524,49.645404,0.000038,0.000043,47,0.000195,0,29,0.4,0.000935
18137,Ripley County,,IN,1608,33863,35471,6,5,11,959,916,1875,8,0.278963,0.294488,136.812029,0.001524,0.001251,257,0.000198,0,29,0.433333,0.008634
18139,Rush County,,IN,912,19955,20867,5,5,10,596,497,1093,8,0.277224,0.292227,644.256921,0.00004,0.000751,47,0.000194,0,29,0.466667,0.000928
18141,St. Joseph County,,IN,11250,308783,320033,19,24,43,6274,6219,12493,7,0.338622,0.367213,11622.508695,0.008568,0.014685,47,0.000421,0,29,0.418333,0.054736
18143,Scott County,,IN,1085,26015,27100,6,6,12,763,677,1440,8,0.274175,0.288445,656.27125,0.00068,0.000545,306,0.00022,0,29,0.566667,0.004339
18145,Shelby County,,IN,2671,53886,56557,6,7,13,1477,1759,3236,8,0.277281,0.292601,631.558729,0.000866,0.000942,47,0.000217,0,29,0.619048,0.00564
18147,Spencer County,,IN,904,24943,25847,5,5,10,553,555,1108,8,0.23879,0.249322,2473.122084,0.00006,0.000076,306,0.000315,0,29,0.45,0.001219
18149,Starke County,,IN,1224,25993,27217,6,6,12,717,751,1468,8,0.257529,0.27095,830.822954,0.000563,0.000335,47,0.000165,0,29,0.5,0.002828
18151,Steuben County,,IN,1939,39302,41241,7,6,13,1125,1013,2138,8,0.256514,0.269557,90.548811,0.000255,0.000157,47,0.000254,0,29,0.380952,0.002022
18153,Sullivan County,,IN,839,22399,23238,3,3,6,461,436,897,9,0.21817,0.226411,30.959524,0.000029,0.00002,47,0.00016,0,29,0.333333,0.000545
18155,Switzerland County,,IN,557,10415,10972,3,2,5,239,142,381,9,0.218348,0.225961,8.902652,0.000021,0.00001,257,0.00017,0,29,0.333333,0.000451
18157,Tippecanoe County,,IN,9028,179283,188311,23,26,49,4460,4589,9049,7,0.336784,0.365101,28094.974031,0.006799,0.012722,47,0.000633,0,29,0.267196,0.043348
18159,Tipton County,,IN,925,19034,19959,3,4,7,514,588,1102,8,0.277166,0.291977,0.326923,0.00032,0.000923,47,0.000127,0,29,0.916667,0.001776
18161,Union County,,IN,433,8295,8728,3,3,6,262,266,528,8,0.257877,0.269763,267.398318,0.000209,0.000097,47,0.000123,0,29,0.333333,0.000981
18163,Vanderburgh County,,IN,8255,205732,213987,17,15,32,4246,4323,8569,7,0.311537,0.333973,56549.909637,0.004812,0.003966,306,0.000866,0,29,0.210526,0.031301
18165,Vermillion County,,IN,876,18444,19320,3,3,6,444,452,896,8,0.23546,0.244994,49.946496,0.000013,0.000028,47,0.000152,0,29,0.333333,0.000479
18167,Vigo County,,IN,4532,112983,117515,10,14,24,1768,2227,3995,8,0.278584,0.295438,10593.612391,0.000856,0.001084,47,0.000396,0,29,0.247253,0.006104
18169,Wabash County,,IN,1303,38152,39455,5,5,10,589,753,1342,8,0.25644,0.269276,149.445182,0.000273,0.000171,47,0.000194,0,29,0.5,0.001793
18171,Warren County,,IN,507,10254,10761,2,2,4,280,272,552,8,0.252079,0.263498,0,0.000139,0.000076,47,0.000105,0,29,1,0.000776
18173,Warrick County,,IN,3177,75178,78355,5,4,9,2147,1750,3897,8,0.237726,0.247801,23.02619,0.000054,0.000054,306,0.000343,0,29,0.5,0.001119
18175,Washington County,,IN,1243,31528,32771,7,7,14,719,852,1571,8,0.274147,0.288538,2028.19628,0.00068,0.000552,306,0.00028,0,29,0.47619,0.004501
18177,Wayne County,,IN,2723,76561,79284,8,9,17,1096,1261,2357,8,0.278294,0.294694,4913.393043,0.001236,0.001137,47,0.000258,0,29,0.305556,0.007132
18179,Wells County,,IN,1427,34010,35437,4,3,7,811,684,1495,8,0.256267,0.268589,189.012539,0.000227,0.000148,47,0.000191,0,29,0.333333,0.001483
18181,White County,,IN,1597,30226,31823,5,6,11,836,953,1789,8,0.277627,0.293164,1906.559202,0.000163,0.000979,47,0.000174,0,29,0.47619,0.001361
18183,Whitley County,,IN,1706,41936,43642,4,4,8,1113,1097,2210,8,0.256317,0.268839,2.614286,0.000255,0.000162,47,0.000168,0,29,0.666667,0.001599
19001,Adair County,,IA,350,8745,9095,0,2,2,0,115,115,8,0.262047,0.274555,0,0,0.000234,47,0.000054,0,103,0.5,0
19003,Adams County,,IA,158,4735,4893,0,0,0,0,0,0,0,0,0,0,0,0,50,0.000054,47,104,0,0
19005,Allamakee County,,IA,679,17722,18401,1,2,3,65,224,289,9,0.195472,0.201356,5332.833333,0,0,47,0.000202,0,29,0,0.000128
19007,Appanoose County,,IA,513,14157,14670,0,1,1,0,54,54,8,0.261975,0.274283,0,0,0.000234,47,0.000054,0,105,0,0
19009,Audubon County,,IA,175,7149,7324,0,0,0,0,0,0,0,0,0,0,0,0,51,0.000054,48,106,0,0
19011,Benton County,,IA,1255,31755,33010,4,3,7,703,674,1377,8,0.242369,0.252864,6.973052,0.000186,0.00009,47,0.000223,0,29,0.833333,0.001621
19013,Black Hawk County,,IA,5379,148150,153529,17,19,36,2278,2457,4735,7,0.319444,0.34365,46649.453924,0.001971,0.004544,47,0.000804,0,29,0.230952,0.01437
19015,Boone County,,IA,1323,31969,33292,4,3,7,708,646,1354,8,0.262031,0.274698,0.666667,0.000311,0.000261,47,0.000228,0,29,0.75,0.00239
19017,Bremer County,,IA,1184,29068,30252,4,5,9,630,625,1255,8,0.242523,0.253488,2484.118946,0.00005,0.00009,47,0.000238,0,29,0.35,0.000704
19019,Buchanan County,,IA,947,25116,26063,3,3,6,434,512,946,8,0.242435,0.252989,288.32804,0.000098,0.000089,47,0.000172,0,29,0.666667,0.001083
19021,Buena Vista County,,IA,1537,25262,26799,2,5,7,128,398,526,8,0.262311,0.275453,10687,0,0.000239,47,0.000189,0,109,0,0.000236
19023,Butler County,,IA,649,18310,18959,3,2,5,288,255,543,8,0.242171,0.25227,1,0.000051,0.000022,47,0.000168,0,29,0.666667,0.000576
19025,Calhoun County,,IA,385,11735,12120,1,1,2,96,134,230,9,0.207772,0.214141,0,0.000003,0.000003,47,0.000097,0,29,0,0.000149
19027,Carroll County,,IA,886,26354,27240,3,3,6,227,236,463,8,0.262031,0.274698,2798.614029,0.000253,0.000239,47,0.000218,0,29,0.166667,0.002029
19029,Cass County,,IA,520,16350,16870,1,1,2,73,79,152,9,0.210643,0.217616,0,0.000006,0.000008,209,0.000117,0,29,0,0.000191
19031,Cedar County,,IA,970,22537,23507,5,4,9,595,612,1207,8,0.243497,0.254657,4.72895,0.000178,0.000169,47,0.00024,0,29,0.7,0.001888
19033,Cerro Gordo County,,IA,1951,51082,53033,8,7,15,815,689,1504,8,0.262598,0.276391,26187.206158,0.000297,0.000261,47,0.000508,0,29,0.138889,0.002809
19035,Cherokee County,,IA,493,14735,15228,0,1,1,0,70,70,9,0.207864,0.21431,0,0,0,47,0.000054,0,110,0,0
19037,Chickasaw County,,IA,533,15242,15775,2,3,5,145,211,356,8,0.242215,0.25252,2.5,0.000001,0.000022,47,0.000138,0,29,0.5,0.000259
19039,Clarke County,,IA,454,10972,11426,3,1,4,225,121,346,8,0.261928,0.274198,0,0.000253,0.000234,47,0.00015,0,29,0.333333,0.001994
19041,Clay County,,IA,852,20769,21621,2,2,4,154,154,308,9,0.207883,0.214546,5348,0.000003,0,47,0.000212,0,109,0,0.000245
19043,Clayton County,,IA,759,21724,22483,4,4,8,363,286,649,8,0.242678,0.253513,8160.575568,0.000045,0.000089,47,0.000258,0,29,0.3,0.000673
19045,Clinton County,,IA,2108,57098,59206,6,7,13,1054,1107,2161,7,0.30642,0.326202,2795.801762,0.00161,0.001888,47,0.000225,0,29,0.428571,0.010534
19047,Crawford County,,IA,1010,21331,22341,3,2,5,226,192,418,8,0.262547,0.275494,164.580886,0.000417,0.000293,47,0.000176,0,29,0,0.002392
19049,Dallas County,,IA,5758,95515,101273,10,9,19,4308,3675,7983,7,0.308868,0.330279,1822.184843,0.001977,0.002868,47,0.000503,0,29,0.462121,0.01349
19051,Davis County,,IA,227,10109,10336,1,1,2,118,116,234,9,0.207788,0.214179,0,0.000003,0.000003,47,0.000138,0,29,0,0.000159
19053,Decatur County,,IA,324,8047,8371,0,2,2,0,133,133,8,0.262001,0.27447,0,0,0.000237,47,0.000054,0,111,1,0
19055,Delaware County,,IA,777,22040,22817,3,3,6,341,328,669,8,0.242545,0.253107,75.068499,0.000094,0.000089,47,0.000183,0,29,0.833333,0.001057
19057,Des Moines County,,IA,1915,47922,49837,5,8,13,542,814,1356,7,0.306526,0.326483,17698.303521,0.001506,0.00186,47,0.000263,0,29,0.267857,0.009946
19059,Dickinson County,,IA,849,21717,22566,2,2,4,172,137,309,10,0.172139,0.176161,2676,0,0,47,0.000296,0,109,0,0.000241
19061,Dubuque County,,IA,3357,119312,122669,11,14,25,1489,1547,3036,7,0.317317,0.340145,14415.841696,0.001914,0.004046,47,0.000494,0,29,0.32967,0.013532
19063,Emmet County,,IA,391,11611,12002,1,1,2,52,76,128,11,0.146867,0.14939,0,0,0,47,0.000179,0,109,0,0.000123
19065,Fayette County,,IA,936,23095,24031,3,4,7,289,349,638,8,0.242325,0.252895,8230.333333,0.000051,0.000023,47,0.000179,0,29,0.333333,0.000591
19067,Floyd County,,IA,692,19040,19732,2,3,5,186,306,492,8,0.242303,0.252739,276.747721,0.000003,0.000025,47,0.000154,0,29,0.5,0.000294
19069,Franklin County,,IA,483,12419,12902,1,2,3,64,150,214,9,0.208031,0.21486,2.833333,0.000003,0.000004,47,0.000115,0,29,0,0.00017
19071,Fremont County,,IA,400,8189,8589,0,2,2,0,175,175,9,0.208165,0.215001,0,0,0.000005,209,0.000054,0,114,0,0
19073,Greene County,,IA,481,10884,11365,1,2,3,57,146,203,8,0.262005,0.274511,0,0.000003,0.000237,47,0.000116,0,29,1,0.000145
19075,Grundy County,,IA,482,15531,16013,1,2,3,188,208,396,8,0.242149,0.252208,0,0.000049,0.000022,47,0.00009,0,29,1,0.00032
19077,Guthrie County,,IA,544,13086,13630,2,2,4,202,335,537,8,0.261954,0.274386,0,0.000279,0.000256,47,0.000142,0,29,1,0.002049
19079,Hamilton County,,IA,779,18378,19157,3,4,7,302,340,642,8,0.26216,0.27506,2661.32381,0.000033,0.000246,47,0.000169,0,29,0.45,0.000475
19081,Hancock County,,IA,497,13693,14190,3,2,5,274,213,487,9,0.208031,0.21486,2753.17619,0.000003,0.000003,47,0.000174,0,29,0.166667,0.000402
19083,Hardin County,,IA,724,20089,20813,2,2,4,144,149,293,8,0.262005,0.274511,1228.890663,0.00003,0.00024,47,0.000153,0,29,0.333333,0.000331
19085,Harrison County,,IA,525,17214,17739,2,2,4,230,292,522,8,0.262521,0.275463,0,0.000418,0.000299,209,0.000146,0,29,1,0.002316
19087,Henry County,,IA,1028,22738,23766,4,5,9,364,408,772,8,0.243697,0.255175,1195.074528,0.000022,0.000144,47,0.0002,0,29,0.333333,0.000626
19089,Howard County,,IA,431,11953,12384,1,1,2,71,79,150,11,0.140562,0.142896,0,0,0,47,0.000202,0,29,0,0.000128
19091,Humboldt County,,IA,424,11966,12390,1,2,3,70,132,202,9,0.207837,0.214485,5492,0.000003,0.000003,47,0.000097,0,29,0,0.000149
19093,Ida County,,IA,284,8704,8988,0,0,0,0,0,0,0,0,0,0,0,0,52,0.000054,49,115,0,0
19095,Iowa County,,IA,794,20835,21629,3,3,6,312,369,681,8,0.243275,0.254001,2.760364,0.000136,0.000128,47,0.000194,0,29,0.833333,0.001307
19097,Jackson County,,IA,867,24132,24999,3,2,5,519,406,925,8,0.241034,0.250802,3.012121,0.000105,0.000038,47,0.000143,0,29,0.666667,0.00097
19099,Jasper County,,IA,1793,42791,44584,4,5,9,910,990,1900,8,0.262108,0.275135,6.233333,0.000255,0.000249,47,0.000248,0,29,0.5,0.002212
19101,Jefferson County,,IA,1018,18017,19035,2,4,6,122,308,430,9,0.208226,0.215659,2817.045807,0.000004,0.000003,47,0.000172,0,29,0.083333,0.000293
19103,Johnson County,,IA,7241,149125,156366,19,18,37,3616,3438,7054,7,0.321175,0.346211,18646.332543,0.005415,0.007957,47,0.000706,0,29,0.297101,0.034546
19105,Jones County,,IA,795,23482,24277,2,3,5,353,426,779,8,0.242501,0.253014,0.968347,0.000093,0.00009,47,0.000128,0,29,0.666667,0.000923
19107,Keokuk County,,IA,413,12089,12502,2,3,5,136,216,352,9,0.208129,0.215297,6.75,0.000001,0.000007,47,0.000133,0,29,0.333333,0.000266
19109,Kossuth County,,IA,542,19376,19918,1,1,2,54,83,137,1,1,1,2747,0,0,47,0.000095,0,6,0,0.000119
19111,Lee County,,IA,1425,39823,41248,3,4,7,458,494,952,8,0.243653,0.254807,2756.046335,0.000021,0.000076,47,0.000184,0,29,0.2,0.00048
19113,Linn County,,IA,7913,264267,272180,23,18,41,4235,3599,7834,7,0.319177,0.343181,37189.524027,0.006202,0.004498,47,0.000942,0,29,0.208333,0.042613
19115,Louisa County,,IA,566,13512,14078,2,2,4,289,278,567,8,0.234818,0.243767,5.146825,0.000022,0.000019,47,0.000122,0,29,0,0.000389
19117,Lucas County,,IA,328,10150,10478,1,2,3,66,141,207,8,0.261954,0.274386,0,0.000247,0.000237,47,0.000094,0,29,1,0.001762
19119,Lyon County,,IA,403,14875,15278,2,2,4,128,148,276,8,0.252293,0.263647,8536.55662,0.000125,0.000127,209,0.000255,0,29,0,0.001163
19121,Madison County,,IA,838,18556,19394,3,3,6,559,538,1097,8,0.26198,0.274573,0,0.000281,0.000259,47,0.000192,0,29,1,0.002201
19123,Mahaska County,,IA,1077,25282,26359,5,3,8,470,381,851,8,0.262134,0.274854,1101.269617,0.000255,0.00024,47,0.000324,0,29,0.35,0.002335
19125,Marion County,,IA,1347,39548,40895,4,3,7,548,584,1132,8,0.26198,0.274573,2.166667,0.000256,0.00024,47,0.000279,0,29,0.5,0.002219
19127,Marshall County,,IA,1787,48130,49917,5,5,10,539,686,1225,8,0.262366,0.27561,287.773069,0.000331,0.000264,47,0.000269,0,29,0.55,0.002576
19129,Mills County,,IA,675,17312,17987,4,3,7,397,363,760,8,0.262547,0.27565,2668,0.000486,0.00034,209,0.000203,0,29,0.5,0.002838
19131,Mitchell County,,IA,358,12780,13138,0,1,1,0,48,48,9,0.208044,0.214717,0,0,0.000003,47,0.000054,0,116,0,0
19133,Monona County,,IA,362,10364,10726,1,1,2,116,136,252,9,0.211461,0.218878,0,0.000008,0.000009,209,0.000097,0,29,0,0.000193
19135,Monroe County,,IA,360,8898,9258,1,1,2,66,75,141,9,0.207788,0.214179,0,0.000003,0.000003,47,0.000138,0,29,0,0.000159
19137,Montgomery County,,IA,467,11991,12458,1,2,3,61,130,191,9,0.210796,0.21812,2669,0,0.000008,209,0.000105,0,113,0,0.000123
19139,Muscatine County,,IA,2253,53230,55483,6,6,12,996,1101,2097,8,0.243742,0.255406,365.122608,0.000224,0.000187,47,0.000284,0,29,0.5,0.002124
19141,O'Brien County,,IA,584,17493,18077,2,1,3,218,98,316,10,0.167788,0.171361,2668,0,0,209,0.000246,0,29,0,0.000247
19143,Osceola County,,IA,340,8019,8359,0,1,1,0,63,63,11,0.143726,0.146141,0,0,0,209,0.000054,0,117,0,0
19145,Page County,,IA,592,16670,17262,2,2,4,179,124,303,10,0.174131,0.178472,3,0,0,209,0.000121,0,113,0,0.000232
19147,Palo Alto County,,IA,385,10750,11135,1,0,1,83,0,83,0,0,0,0,0,0,47,0.000134,0,5,0,0.000118
19149,Plymouth County,,IA,1253,31750,33003,2,2,4,623,527,1150,9,0.211511,0.21919,290.297335,0.000008,0.000009,209,0.000243,0,29,0.5,0.000326
19151,Pocahontas County,,IA,326,8706,9032,1,0,1,70,0,70,0,0,0,0,0.000003,0,47,0.000086,0,107,0,0.000123
19153,Polk County,,IA,23516,554460,577976,58,47,105,13037,11736,24773,7,0.354834,0.387568,206767.204885,0.021555,0.022783,47,0.002257,0,29,0.177419,0.143516
19155,Pottawattamie County,,IA,4336,106497,110833,8,7,15,2605,2501,5106,8,0.266827,0.281528,16309.400263,0.000734,0.000576,209,0.000521,0,29,0.178571,0.004952
19157,Poweshiek County,,IA,889,20741,21630,2,4,6,241,369,610,8,0.262031,0.274823,213.506662,0.00025,0.00024,47,0.000137,0,29,0.333333,0.001913
19159,Ringgold County,,IA,138,5561,5699,0,0,0,0,0,0,0,0,0,0,0,0,53,0.000054,50,118,0,0
19161,Sac County,,IA,373,12486,12859,1,0,1,83,0,83,0,0,0,0,0.000003,0,47,0.000086,0,108,0,0.000123
19163,Scott County,,IA,8437,205079,213516,16,14,30,4204,3675,7879,7,0.316114,0.338677,8290.530068,0.003756,0.003695,47,0.000535,0,29,0.320261,0.026029
19165,Shelby County,,IA,516,14988,15504,1,1,2,86,105,191,9,0.210643,0.217616,0,0.000006,0.000008,209,0.000117,0,29,0,0.000191
19167,Sioux County,,IA,1196,41785,42981,4,3,7,339,325,664,9,0.201602,0.207861,8081.25,0.000009,0.000001,209,0.000517,0,29,0.166667,0.000573
19169,Story County,,IA,4731,86197,90928,13,11,24,1730,2234,3964,7,0.310196,0.331587,8043.497554,0.000522,0.00277,47,0.000646,0,29,0.328571,0.005004
19171,Tama County,,IA,709,21192,21901,3,3,6,332,337,669,8,0.242391,0.252926,9.839322,0.000055,0.000092,47,0.000164,0,29,0.333333,0.000619
19173,Taylor County,,IA,236,7255,7491,1,0,1,63,0,63,0,0,0,0,0,0,209,0.000105,0,112,0,0.000123
19175,Union County,,IA,610,14149,14759,1,2,3,60,151,211,8,0.262001,0.27447,0.5,0.000003,0.000237,47,0.000076,0,102,0.5,0.000113
19177,Van Buren County,,IA,238,8532,8770,1,0,1,71,0,71,0,0,0,0,0,0,47,0.00009,0,4,0,0.000124
19179,Wapello County,,IA,1574,40009,41583,6,5,11,609,545,1154,8,0.262263,0.275416,18941.680722,0.00025,0.000237,47,0.000495,0,29,0.133333,0.002402
19181,Warren County,,IA,2540,57668,60208,4,4,8,1926,1623,3549,8,0.262005,0.27476,2.5,0.000284,0.000261,47,0.000237,0,29,0.5,0.002332
19183,Washington County,,IA,1014,27490,28504,4,4,8,516,466,982,8,0.243586,0.254769,3389.979656,0.000137,0.000126,47,0.000203,0,29,0.333333,0.001419
19185,Wayne County,,IA,200,7275,7475,0,0,0,0,0,0,0,0,0,0,0,0,54,0.000054,51,119,0,0
19187,Webster County,,IA,1659,41248,42907,4,5,9,425,498,923,8,0.262237,0.275341,17297.16335,0.00025,0.00024,47,0.000254,0,29,0.25,0.002128
19189,Winnebago County,,IA,512,12996,13508,1,3,4,87,217,304,9,0.208047,0.215047,1,0,0.000003,47,0.000128,0,29,0.666667,0.000128
19191,Winneshiek County,,IA,688,24245,24933,3,2,5,213,136,349,10,0.163541,0.167203,8156.833333,0,0,47,0.000349,0,29,0,0.000367
19193,Woodbury County,,IA,4930,118655,123585,7,9,16,1787,2174,3961,8,0.268141,0.284021,18720.080291,0.000789,0.000695,209,0.000455,0,29,0.194444,0.005421
19195,Worth County,,IA,447,9133,9580,2,1,3,179,170,349,9,0.207999,0.21461,0,0.000003,0.000003,47,0.000151,0,29,0.5,0.000289
19197,Wright County,,IA,607,15492,16099,0,2,2,0,126,126,9,0.207947,0.214704,0,0,0,47,0.000054,0,120,0,0
20001,Allen County,,KS,636,14808,15444,1,2,3,75,148,223,10,0.174516,0.178854,2747.601681,0,0,138,0.000134,0,29,0,0.000128
20003,Anderson County,,KS,319,9244,9563,1,1,2,51,59,110,9,0.210859,0.217451,2581.979713,0,0.000006,138,0.000111,0,29,0,0.000118
20005,Atchison County,,KS,723,17701,18424,2,1,3,160,106,266,9,0.215474,0.222939,0.777778,0.000043,0.000014,138,0.000119,0,29,0,0.000454
20007,Barber County,,KS,193,5800,5993,0,0,0,0,0,0,0,0,0,0,0,0,55,0.000054,52,121,0,0
20009,Barton County,,KS,1165,32399,33564,2,2,4,138,181,319,8,0.258552,0.271165,5412,0.000285,0.000247,138,0.000198,0,29,0,0.001988
20011,Bourbon County,,KS,643,16453,17096,1,1,2,55,103,158,9,0.214332,0.221577,2.833333,0.000004,0.000009,138,0.000087,0,29,0,0.000147
20013,Brown County,,KS,427,11439,11866,0,1,1,0,57,57,1,1,1,0,0,0,81,0.000054,53,123,0,0
20015,Butler County,,KS,3767,74722,78489,3,4,7,1962,2094,4056,8,0.267791,0.281925,33.640625,0.000291,0.000611,138,0.000165,0,29,0.5,0.002177
20017,Chase County,,KS,135,3057,3192,0,0,0,0,0,0,0,0,0,0,0,0,56,0.000054,54,124,0,0
20019,Chautauqua County,,KS,211,3677,3888,0,0,0,0,0,0,0,0,0,0,0,0,57,0.000054,55,125,0,0
20021,Cherokee County,,KS,1111,22046,23157,4,4,8,559,672,1231,9,0.216928,0.225738,8.988141,0.000038,0.000041,138,0.000229,0,29,0.666667,0.000864
20023,Cheyenne County,,KS,-2,3248,3246,0,0,0,0,0,0,0,0,0,0,0,0,58,0.000054,56,126,0,0
20025,Clark County,,KS,101,2434,2535,0,0,0,0,0,0,0,0,0,0,0,0,59,0.000054,57,127,0,0
20027,Clay County,,KS,445,10341,10786,0,2,2,0,142,142,8,0.246286,0.257425,0,0,0.000175,138,0.000054,0,128,1,0
20029,Cloud County,,KS,398,10683,11081,0,0,0,0,0,0,0,0,0,0,0,0,60,0.000054,58,129,0,0
20031,Coffey County,,KS,417,10358,10775,1,1,2,67,76,143,9,0.21136,0.218266,0,0.000007,0.000009,138,0.000089,0,29,0,0.000175
20033,Comanche County,,KS,97,2165,2262,0,0,0,0,0,0,0,0,0,0,0,0,61,0.000054,59,130,0,0
20035,Cowley County,,KS,1820,40339,42159,4,4,8,692,654,1346,8,0.258728,0.27179,9.159524,0.000306,0.000267,138,0.000205,0,29,0.5,0.002387
20037,Crawford County,,KS,1896,40464,42360,7,6,13,668,701,1369,8,0.272718,0.288103,12922.735645,0.000805,0.001055,138,0.000345,0,29,0.303571,0.005255
20039,Decatur County,,KS,75,3518,3593,0,0,0,0,0,0,0,0,0,0,0,0,62,0.000054,60,131,0,0
20041,Dickinson County,,KS,1237,23067,24304,3,3,6,452,428,880,8,0.246398,0.257834,6.222644,0.000215,0.00018,138,0.000135,0,29,0.666667,0.001595
20043,Doniphan County,,KS,485,8638,9123,1,1,2,213,191,404,9,0.215474,0.222939,0,0.000014,0.000014,138,0.000098,0,29,0,0.000234
20045,Douglas County,,KS,6077,115446,121523,14,13,27,3210,3020,6230,7,0.329017,0.354163,7868.373082,0.003152,0.00652,138,0.000473,0,29,0.398693,0.020844
20047,Edwards County,,KS,123,3760,3883,0,0,0,0,0,0,0,0,0,0,0,0,63,0.000054,61,132,0,0
20049,Elk County,,KS,125,2946,3071,0,0,0,0,0,0,0,0,0,0,0,0,64,0.000054,62,133,0,0
20051,Ellis County,,KS,1508,32975,34483,3,5,8,187,333,520,8,0.267952,0.282425,8157,0.000293,0.000609,138,0.000187,0,29,0.25,0.002165
20053,Ellsworth County,,KS,287,6809,7096,1,1,2,82,47,129,9,0.211628,0.218866,0,0.000008,0.000005,138,0.000087,0,29,0,0.000177
20055,Finney County,,KS,2394,47280,49674,4,3,7,497,366,863,8,0.258678,0.27154,6006.661625,0.000288,0.00025,138,0.000339,0,29,0.333333,0.002278
20057,Ford County,,KS,2749,44052,46801,4,4,8,432,562,994,8,0.258753,0.271852,6203.4139,0.000288,0.000252,138,0.000342,0,29,0.25,0.002278
20059,Franklin County,,KS,1421,29609,31030,5,4,9,692,661,1353,8,0.26704,0.280607,5924.477284,0.000574,0.000405,138,0.000282,0,29,0.25,0.003342
20061,Geary County,,KS,9117,44385,53502,20,19,39,3071,3281,6352,7,0.326361,0.353038,9328.176137,0.010215,0.012142,138,0.000448,0,29,0.497355,0.068212
20063,Gove County,,KS,106,3483,3589,0,0,0,0,0,0,0,0,0,0,0,0,65,0.000054,63,134,0,0
20065,Graham County,,KS,102,3233,3335,0,0,0,0,0,0,0,0,0,0,0,0,66,0.000054,64,135,0,0
20067,Grant County,,KS,437,9527,9964,0,0,0,0,0,0,0,0,0,0,0,0,67,0.000054,65,136,0,0
20069,Gray County,,KS,427,7367,7794,1,1,2,109,94,203,9,0.205579,0.211998,0,0.000003,0.000003,138,0.000126,0,29,0,0.00015
20071,Greeley County,,KS,-2,1667,1665,0,0,0,0,0,0,0,0,0,0,0,0,68,0.000054,66,137,0,0
20073,Greenwood County,,KS,235,7183,7418,0,1,1,0,65,65,8,0.258549,0.271001,0,0,0.000247,138,0.000054,0,138,0,0
20075,Hamilton County,,KS,117,2984,3101,0,0,0,0,0,0,0,0,0,0,0,0,69,0.000054,67,139,0,0
20077,Harper County,,KS,294,7004,7298,1,1,2,78,54,132,8,0.258502,0.270915,0,0.000285,0.000247,138,0.000081,0,29,0,0.00187
20079,Harvey County,,KS,1683,41006,42689,5,5,10,899,931,1830,8,0.258627,0.271727,7,0.000304,0.00026,138,0.00024,0,29,0.5,0.002463
20081,Haskell County,,KS,243,4834,5077,0,0,0,0,0,0,0,0,0,0,0,0,70,0.000054,68,140,0,0
20083,Hodgeman County,,KS,84,2276,2360,0,0,0,0,0,0,0,0,0,0,0,0,71,0.000054,69,141,0,0
20085,Jackson County,,KS,634,16114,16748,1,1,2,253,312,565,8,0.23894,0.248575,0,0.000062,0.000019,138,0.000081,0,29,0,0.000275
20087,Jefferson County,,KS,1058,22008,23066,3,4,7,594,647,1241,8,0.267576,0.281369,0,0.000162,0.000426,138,0.000133,0,29,1,0.00087
20089,Jewell County,,KS,102,3746,3848,0,0,0,0,0,0,0,0,0,0,0,0,72,0.000054,70,142,0,0
20091,Johnson County,,KS,30502,712988,743490,60,66,126,20102,19928,40030,7,0.364033,0.399883,86103.589727,0.032886,0.045476,138,0.001676,0,29,0.351333,0.220557
20093,Kearny County,,KS,254,4967,5221,1,1,2,77,110,187,9,0.205531,0.211873,0,0.000003,0.000003,138,0.00015,0,29,0,0.00015
20095,Kingman County,,KS,360,9206,9566,1,2,3,114,228,342,8,0.258552,0.271165,0,0.000285,0.00025,138,0.000081,0,29,1,0.00187
20097,Kiowa County,,KS,114,2916,3030,0,0,0,0,0,0,0,0,0,0,0,0,73,0.000054,71,143,0,0
20099,Labette County,,KS,1062,24235,25297,3,4,7,269,388,657,9,0.217069,0.2261,9384.384252,0.000018,0.000035,138,0.00021,0,29,0.25,0.000474
20101,Lane County,,KS,56,2226,2282,0,0,0,0,0,0,0,0,0,0,0,0,74,0.000054,72,144,0,0
20103,Leavenworth County,,KS,5314,83146,88460,8,11,19,2627,2208,4835,8,0.289308,0.308274,1809.25069,0.001415,0.002679,138,0.000268,0,29,0.409091,0.007821
20105,Lincoln County,,KS,137,3763,3900,0,0,0,0,0,0,0,0,0,0,0,0,75,0.000054,73,145,0,0
20107,Linn County,,KS,558,10747,11305,2,3,5,233,259,492,8,0.266987,0.280357,2745,0.000503,0.00037,138,0.000117,0,29,0.333333,0.002724
20109,Logan County,,KS,148,3459,3607,0,0,0,0,0,0,0,0,0,0,0,0,76,0.000054,74,146,0,0
20111,Lyon County,,KS,1656,36109,37765,4,5,9,323,502,825,8,0.267979,0.282487,5412,0.000841,0.000658,138,0.000205,0,29,0.6,0.004787
20113,McPherson County,,KS,1604,35503,37107,4,4,8,422,563,985,8,0.258678,0.271727,6.5,0.000303,0.000258,138,0.000188,0,29,0.75,0.002358
20115,Marion County,,KS,574,14069,14643,2,2,4,139,205,344,8,0.258527,0.271102,0,0.000288,0.000251,138,0.000122,0,29,1,0.002026
20117,Marshall County,,KS,394,13245,13639,0,1,1,0,63,63,8,0.240472,0.250231,0,0,0.000064,138,0.000054,0,147,0,0
20119,Meade County,,KS,214,5162,5376,0,0,0,0,0,0,0,0,0,0,0,0,77,0.000054,75,148,0,0
20121,Miami County,,KS,1801,38333,40134,6,5,11,1183,1072,2255,8,0.271497,0.285861,60.214933,0.001152,0.000812,138,0.000247,0,29,0.5,0.006639
20123,Mitchell County,,KS,233,7820,8053,0,0,0,0,0,0,0,0,0,0,0,0,78,0.000054,76,149,0,0
20125,Montgomery County,,KS,2005,36482,38487,5,7,12,431,664,1095,8,0.264342,0.279498,10222.23501,0.000317,0.000626,138,0.00022,0,29,0.285714,0.002479
20127,Morris County,,KS,262,6733,6995,0,0,0,0,0,0,0,0,0,0,0,0,79,0.000054,77,150,0,0
20129,Morton County,,KS,226,3722,3948,0,0,0,0,0,0,0,0,0,0,0,0,80,0.000054,78,151,0,0
20131,Nemaha County,,KS,339,13215,13554,1,0,1,57,0,57,0,0,0,0,0,0,81,0.000099,53,122,0,0.000113
20133,Neosho County,,KS,689,18364,19053,3,2,5,265,145,410,10,0.178438,0.183574,5577.38546,0,0,138,0.000189,0,29,0,0.000366
20135,Ness County,,KS,124,3767,3891,0,0,0,0,0,0,0,0,0,0,0,0,82,0.000054,79,152,0,0
20137,Norton County,,KS,155,5949,6104,0,0,0,0,0,0,0,0,0,0,0,0,83,0.000054,80,153,0,0
20139,Osage County,,KS,793,18709,19502,2,3,5,424,465,889,8,0.250258,0.261334,4.858824,0.000066,0.000059,138,0.000141,0,29,0.666667,0.000439
20141,Osborne County,,KS,137,4651,4788,0,0,0,0,0,0,0,0,0,0,0,0,84,0.000054,81,154,0,0
20143,Ottawa County,,KS,263,7292,7555,1,1,2,114,109,223,9,0.211628,0.218866,0,0.000008,0.000005,138,0.000087,0,29,0,0.000177
20145,Pawnee County,,KS,310,7126,7436,1,1,2,83,70,153,9,0.205452,0.211711,0,0.000003,0.000003,138,0.000138,0,29,0,0.00014
20147,Phillips County,,KS,237,6815,7052,0,0,0,0,0,0,0,0,0,0,0,0,85,0.000054,82,155,0,0
20149,Pottawatomie County,,KS,1559,27886,29445,4,2,6,870,682,1552,8,0.244614,0.25532,10.806416,0.000269,0.000083,138,0.000164,0,29,0.583333,0.001814
20151,Pratt County,,KS,529,11417,11946,0,1,1,0,69,69,8,0.258549,0.271001,0,0,0.000247,138,0.000054,0,156,0,0
20153,Rawlins County,,KS,98,3143,3241,0,0,0,0,0,0,0,0,0,0,0,0,86,0.000054,83,157,0,0
20155,Reno County,,KS,2555,72972,75527,5,7,12,795,1099,1894,8,0.268006,0.2828,5467.569812,0.000293,0.00065,138,0.000269,0,29,0.357143,0.002431
20157,Republic County,,KS,136,6000,6136,0,0,0,0,0,0,0,0,0,0,0,0,87,0.000054,84,158,0,0
20159,Rice County,,KS,437,11258,11695,1,1,2,68,93,161,9,0.211377,0.21836,0,0.000007,0.000003,138,0.000086,0,29,0,0.000155
20161,Riley County,,KS,7799,59361,67160,14,14,28,2950,2975,5925,7,0.316489,0.339879,9120.136946,0.005913,0.006945,138,0.000463,0,29,0.385965,0.040054
20163,Rooks County,,KS,178,6197,6375,1,0,1,57,0,57,0,0,0,0,0.000007,0,138,0.000085,0,20,0,0.000146
20165,Rush County,,KS,161,3806,3967,0,0,0,0,0,0,0,0,0,0,0,0,88,0.000054,85,159,0,0
20167,Russell County,,KS,236,8145,8381,1,1,2,58,61,119,9,0.211343,0.218235,0,0.000007,0.000003,138,0.000085,0,29,0,0.000146
20169,Saline County,,KS,2647,66663,69310,8,10,18,850,979,1829,8,0.26841,0.283974,11004.319272,0.000435,0.000731,138,0.000391,0,29,0.295455,0.003554
20171,Scott County,,KS,238,6385,6623,0,0,0,0,0,0,0,0,0,0,0,0,89,0.000054,86,160,0,0
20173,Sedgwick County,,KS,21357,596025,617382,47,50,97,9262,9819,19081,7,0.348576,0.381577,130754.055963,0.022774,0.026252,138,0.001602,0,29,0.274351,0.159026
20175,Seward County,,KS,2193,29580,31773,4,4,8,571,522,1093,8,0.227412,0.23653,6485.383303,0.000143,0.000006,138,0.000273,0,29,0.1,0.001245
20177,Shawnee County,,KS,7359,210413,217772,15,17,32,2936,3447,6383,7,0.313919,0.337149,16552.67181,0.001746,0.005695,138,0.000556,0,29,0.307018,0.01097
20179,Sheridan County,,KS,68,3351,3419,0,0,0,0,0,0,0,0,0,0,0,0,90,0.000054,87,161,0,0
20181,Sherman County,,KS,316,6861,7177,0,0,0,0,0,0,0,0,0,0,0,0,91,0.000054,88,162,0,0
20183,Smith County,,KS,95,4835,4930,0,0,0,0,0,0,0,0,0,0,0,0,92,0.000054,89,163,0,0
20185,Stafford County,,KS,186,5038,5224,0,0,0,0,0,0,0,0,0,0,0,0,93,0.000054,90,164,0,0
20187,Stanton County,,KS,77,2771,2848,0,0,0,0,0,0,0,0,0,0,0,0,94,0.000054,91,165,0,0
20189,Stevens County,,KS,383,6726,7109,0,0,0,0,0,0,0,0,0,0,0,0,95,0.000054,92,166,0,0
20191,Sumner County,,KS,1331,27008,28339,2,2,4,680,759,1439,8,0.258527,0.271102,0,0.000288,0.000251,138,0.000124,0,29,1,0.002021
20193,Thomas County,,KS,374,9374,9748,0,0,0,0,0,0,0,0,0,0,0,0,96,0.000054,93,167,0,0
20195,Trego County,,KS,132,3795,3927,0,0,0,0,0,0,0,0,0,0,0,0,97,0.000054,94,168,0,0
20197,Wabaunsee County,,KS,363,8334,8697,1,2,3,105,186,291,8,0.238961,0.248763,0,0.000062,0.000022,138,0.000081,0,29,1,0.000275
20199,Wallace County,,KS,-2,1865,1863,0,0,0,0,0,0,0,0,0,0,0,0,98,0.000054,95,169,0,0
20201,Washington County,,KS,178,7359,7537,0,0,0,0,0,0,0,0,0,0,0,0,99,0.000054,96,170,0,0
20203,Wichita County,,KS,70,2860,2930,0,0,0,0,0,0,0,0,0,0,0,0,100,0.000054,97,171,0,0
20205,Wilson County,,KS,404,10255,10659,1,2,3,73,143,216,9,0.209189,0.216656,1599.933892,0.000007,0.000003,138,0.00008,0,29,0,0.000156
20207,Woodson County,,KS,100,3636,3736,0,0,0,0,0,0,0,0,0,0,0,0,101,0.000054,98,172,0,0
20209,Wyandotte County,,KS,11803,172151,183954,13,15,28,7742,8980,16722,7,0.324298,0.349159,3355.276633,0.006639,0.006731,138,0.00039,0,29,0.519608,0.042944
21001,Adair County,,KY,826,17941,18767,2,2,4,216,328,544,9,0.21591,0.223012,45.127735,0.000007,0.000007,306,0.000182,0,29,0,0.000293
21003,Allen County,,KY,920,20056,20976,4,4,8,554,556,1110,8,0.22821,0.237835,20.590225,0.000061,0.000079,306,0.000239,0,29,0.666667,0.001135
21005,Anderson County,,KY,1207,26637,27844,4,5,9,588,733,1321,8,0.260853,0.273631,5.636905,0.000262,0.000199,306,0.000247,0,29,0.6,0.001834
21007,Ballard County,,KY,419,8901,9320,1,1,2,186,230,416,8,0.221411,0.228408,0,0.000016,0,306,0.000109,0,29,0,0.000147
21009,Barren County,,KY,1983,47498,49481,7,6,13,1367,1136,2503,8,0.274147,0.288413,9616.187891,0.000656,0.000524,306,0.000435,0,29,0.190476,0.004339
21011,Bath County,,KY,581,11891,12472,2,2,4,340,320,660,9,0.207207,0.21382,2841.259654,0.000004,0.000003,306,0.000179,0,29,0,0.000283
21013,Bell County,,KY,1126,23551,24677,2,2,4,322,438,760,9,0.209897,0.216504,59.292167,0.000004,0.000004,306,0.000152,0,29,0,0.000277
21015,Boone County,,KY,9655,148590,158245,12,12,24,6169,5882,12051,8,0.284162,0.303334,4434.425912,0.001972,0.002347,257,0.000373,0,29,0.525641,0.010645
21017,Bourbon County,,KY,1210,22405,23615,5,5,10,737,749,1486,8,0.260802,0.273507,5413.916667,0.000262,0.00019,306,0.000318,0,29,0.45,0.001962
21019,Boyd County,,KY,2585,49637,52222,6,7,13,1392,1507,2899,8,0.262237,0.275734,7256.531007,0.000013,0.000186,372,0.000356,0,29,0.309524,0.000889
21021,Boyle County,,KY,1646,30002,31648,5,5,10,915,902,1817,8,0.260776,0.273444,5.666667,0.000264,0.000185,306,0.000283,0,29,0.6,0.001949
21023,Bracken County,,KY,560,9307,9867,2,3,5,165,362,527,9,0.221448,0.230407,5233.145546,0.000026,0.000022,257,0.000142,0,29,0.333333,0.00039
21025,Breathitt County,,KY,374,12237,12611,1,1,2,87,79,166,9,0.206966,0.213151,0,0.000002,0,306,0.000097,0,29,0,0.000127
21027,Breckinridge County,,KY,931,20966,21897,4,4,8,578,533,1111,8,0.276019,0.290059,0.833333,0.000772,0.000538,306,0.000138,0,29,0.833333,0.004005
21029,Bullitt County,,KY,4467,91459,95926,6,5,11,3658,3290,6948,8,0.276162,0.290434,18.034314,0.000758,0.000554,306,0.000224,0,29,0.533333,0.004451
21031,Butler County,,KY,624,13843,14467,2,2,4,264,311,575,8,0.223114,0.231192,0,0.000023,0.000021,306,0.000142,0,29,1,0.000446
21033,Caldwell County,,KY,555,13906,14461,2,2,4,157,169,326,1,1,1,5481.6,0.000002,0,306,0.000201,0,21,0,0.00026
21035,Calloway County,,KY,1727,36147,37874,4,4,8,617,625,1242,8,0.221687,0.229445,16480.966765,0.000016,0.000001,306,0.00029,0,29,0.5,0.000542
21037,Campbell County,,KY,5690,102646,108336,12,12,24,4257,4340,8597,8,0.284132,0.30324,12500.184794,0.001971,0.002393,257,0.000383,0,29,0.519231,0.010639
21039,Carlisle County,,KY,194,5622,5816,0,1,1,0,56,56,8,0.221457,0.22851,0,0,0,306,0.000054,0,173,0,0
21041,Carroll County,,KY,839,11873,12712,2,3,5,172,278,450,8,0.273781,0.28732,272.285908,0.000006,0.000496,306,0.000117,0,29,0.25,0.000297
21043,Carter County,,KY,1030,27977,29007,3,3,6,358,459,817,9,0.208015,0.215119,317.374277,0.000006,0,372,0.000199,0,29,0.333333,0.00041
21045,Casey County,,KY,726,15362,16088,2,2,4,223,230,453,9,0.207046,0.21362,3.842857,0.000002,0.000003,306,0.000182,0,29,0,0.00028
21047,Christian County,,KY,10505,73826,84331,16,15,31,2833,4455,7288,7,0.314697,0.339218,21690.427641,0.010457,0.009368,306,0.000433,0,29,0.492105,0.072827
21049,Clark County,,KY,1927,39564,41491,5,6,11,940,1017,1957,8,0.261006,0.274013,1418.341776,0.000264,0.000199,306,0.000309,0,29,0.466667,0.00199
21051,Clay County,,KY,543,17394,17937,2,1,3,271,281,552,9,0.207143,0.213564,0,0.000002,0.000003,306,0.00017,0,29,1,0.000291
21053,Clinton County,,KY,360,9971,10331,1,1,2,110,89,199,10,0.177689,0.18169,0,0,0,306,0.000169,0,29,0,0.000123
21055,Crittenden County,,KY,280,9546,9826,2,0,2,130,0,130,0,0,0,0,0,0,306,0.000187,0,17,0,0.000247
21057,Cumberland County,,KY,206,6561,6767,0,0,0,0,0,0,0,0,0,0,0,0,102,0.000054,99,174,0,0
21059,Daviess County,,KY,3432,114972,118404,12,11,23,1661,1640,3301,8,0.276391,0.292505,21362.535297,0.001455,0.000745,306,0.000622,0,29,0.211538,0.01126
21061,Edmonson County,,KY,702,12171,12873,2,3,5,392,448,840,8,0.223189,0.231567,4.209524,0.000028,0.000035,306,0.000152,0,29,0.5,0.000491
21063,Elliott County,,KY,203,5878,6081,0,0,0,0,0,0,0,0,0,0,0,0,103,0.000054,100,175,0,0
21065,Estill County,,KY,461,14252,14713,1,1,2,138,191,329,9,0.216032,0.223094,0,0.000007,0.00001,306,0.000112,0,29,0,0.000219
21067,Fayette County,,KY,16698,334562,351260,51,43,94,9567,9469,19036,7,0.352444,0.384132,223195.662929,0.016024,0.023041,306,0.001939,0,29,0.174859,0.104684
21069,Fleming County,,KY,529,16154,16683,2,2,4,226,171,397,9,0.207288,0.213932,48.625815,0.000002,0,306,0.00018,0,29,0,0.00026
21071,Floyd County,,KY,1624,35178,36802,4,4,8,660,767,1427,8,0.261185,0.27395,29135.048468,0.000252,0.000174,306,0.000311,0,29,0.083333,0.001729
21073,Franklin County,,KY,2865,58319,61184,7,7,14,1450,1536,2986,8,0.27508,0.289731,4380.617381,0.000902,0.000695,306,0.000462,0,29,0.452381,0.005541
21075,Fulton County,,KY,415,5739,6154,1,1,2,100,123,223,9,0.182915,0.187148,0,0,0.000009,306,0.000113,0,29,0,0.000184
21077,Gallatin County,,KY,694,8785,9479,3,4,7,348,358,706,9,0.221429,0.230601,61.928634,0.000057,0.000047,257,0.000138,0,29,0.25,0.000667
21079,Garrard County,,KY,967,17298,18265,5,5,10,854,653,1507,8,0.260827,0.273569,6.067857,0.000269,0.000193,306,0.000289,0,29,0.7,0.002026
21081,Grant County,,KY,1858,26268,28126,5,6,11,1053,1268,2321,8,0.261133,0.274212,1522.637236,0.000752,0.000244,257,0.000199,0,29,0.619048,0.004255
21083,Graves County,,KY,1761,40440,42201,3,3,6,640,732,1372,8,0.221521,0.228939,0,0.000016,0,306,0.000231,0,29,1,0.000413
21085,Grayson County,,KY,1062,26996,28058,4,4,8,523,492,1015,8,0.276362,0.290715,486.350922,0.000729,0.000551,306,0.000163,0,29,0.6,0.003969
21087,Green County,,KY,552,11435,11987,1,1,2,164,132,296,9,0.21577,0.222525,0,0.000007,0.000007,306,0.000102,0,29,0,0.000165
21089,Greenup County,,KY,1780,39213,40993,4,5,9,1136,1016,2152,8,0.261517,0.2747,2383.592372,0.000024,0.000185,372,0.000216,0,29,0.35,0.000616
21091,Hancock County,,KY,448,10201,10649,2,2,4,253,316,569,9,0.216646,0.224249,355.346481,0.000008,0.000016,306,0.000137,0,29,0.5,0.000391
21093,Hardin County,,KY,9222,117462,126684,12,25,37,3119,4545,7664,7,0.310196,0.335729,8229.56714,0.002508,0.008361,306,0.000441,0,29,0.363077,0.015786
21095,Harlan County,,KY,934,25288,26222,0,1,1,0,69,69,8,0.26067,0.272655,0,0,0.000174,306,0.000054,0,176,0,0
21097,Harrison County,,KY,945,19764,20709,3,4,7,367,432,799,8,0.260776,0.273319,101.797906,0.00026,0.000188,306,0.000196,0,29,0.5,0.001701
21099,Hart County,,KY,955,19502,20457,4,2,6,477,468,945,8,0.236924,0.247773,13.507612,0.000666,0.000034,306,0.000201,0,29,0.65,0.003981
21101,Henderson County,,KY,1850,51457,53307,6,5,11,931,886,1817,8,0.238769,0.249259,7097.197304,0.000054,0.000069,306,0.000426,0,29,0.3,0.001287
21103,Henry County,,KY,975,16985,17960,4,4,8,681,702,1383,8,0.273838,0.287508,2.367399,0.000653,0.000519,306,0.000173,0,29,0.75,0.003891
21105,Hickman County,,KY,139,4841,4980,0,0,0,0,0,0,0,0,0,0,0,0,104,0.000054,101,177,0,0
21107,Hopkins County,,KY,1701,50295,51996,4,7,11,529,812,1341,8,0.248904,0.261473,12236.415785,0.00011,0.000183,306,0.000239,0,29,0.238095,0.001425
21109,Jackson County,,KY,494,12193,12687,2,3,5,198,353,551,9,0.21619,0.223756,37.883445,0.000009,0.000013,306,0.000178,0,29,0.666667,0.000385
21111,Jefferson County,,KY,36384,881432,917816,83,87,170,19091,21042,40133,7,0.376677,0.414228,221265.555671,0.04559,0.058221,306,0.002252,0,29,0.293341,0.298477
21113,Jessamine County,,KY,3126,54450,57576,6,7,13,2229,1838,4067,8,0.275137,0.289856,102.277816,0.000271,0.000698,306,0.000345,0,29,0.547619,0.002225
21115,Johnson County,,KY,844,21773,22617,4,3,7,471,344,815,9,0.207449,0.214326,8419.498155,0.000002,0.000003,306,0.000373,0,29,0,0.000506
21117,Kenton County,,KY,11045,187566,198611,13,13,26,8634,8363,16997,8,0.284193,0.303521,4840.993294,0.002364,0.002399,257,0.000386,0,29,0.516484,0.012134
21119,Knott County,,KY,625,13159,13784,2,3,5,269,300,569,9,0.207207,0.213945,8233.333333,0.000004,0.000003,306,0.000163,0,29,0.166667,0.000273
21121,Knox County,,KY,1565,29146,30711,3,3,6,1100,1047,2147,9,0.207562,0.214576,140.470852,0.000004,0.000003,306,0.00022,0,29,0.333333,0.000418
21123,Larue County,,KY,822,15545,16367,2,3,5,497,473,970,8,0.27599,0.289872,1.607419,0.000099,0.000529,306,0.000097,0,29,0.666667,0.000489
21125,Laurel County,,KY,3146,60602,63748,8,7,15,1784,1732,3516,8,0.261236,0.274587,12997.788093,0.000267,0.000187,306,0.00054,0,29,0.232143,0.00235
21127,Lawrence County,,KY,700,15210,15910,3,3,6,276,278,554,9,0.207966,0.214963,137.529625,0.000002,0,372,0.000256,0,29,0.333333,0.000411
21129,Lee County,,KY,202,5691,5893,0,0,0,0,0,0,0,0,0,0,0,0,105,0.000054,102,178,0,0
21131,Leslie County,,KY,378,9830,10208,0,2,2,0,201,201,9,0.20743,0.214352,0,0,0.000003,306,0.000054,0,179,0,0
21133,Letcher County,,KY,736,21017,21753,2,1,3,153,83,236,9,0.207062,0.21332,9.5,0.000002,0,306,0.000143,0,29,0.333333,0.000251
21135,Lewis County,,KY,454,13496,13950,0,1,1,0,105,105,10,0.176767,0.180849,0,0,0,257,0.000054,0,180,0,0
21137,Lincoln County,,KY,1343,24756,26099,5,6,11,662,892,1554,8,0.260929,0.273881,5877.181853,0.000262,0.000183,306,0.00034,0,29,0.3,0.00194
21139,Livingston County,,KY,559,9988,10547,2,3,5,285,375,660,8,0.221466,0.228845,12.4,0.000016,0,306,0.000169,0,29,0.333333,0.00028
21141,Logan County,,KY,1252,29671,30923,4,3,7,545,573,1118,8,0.223901,0.23241,24.960664,0.000044,0.000026,306,0.000214,0,29,0.166667,0.000843
21143,Lyon County,,KY,417,7867,8284,1,1,2,100,84,184,2,0.666667,0.75,0,0,0,306,0.000139,0,21,0,0.000123
21145,McCracken County,,KY,3387,74019,77406,7,8,15,1551,1593,3144,7,0.284344,0.299803,25476.713083,0,0.001448,306,0.00052,0,29,0.138889,0.000869
21147,McCreary County,,KY,465,13495,13960,2,1,3,165,137,302,9,0.216032,0.223031,2668.2625,0.000007,0.000003,306,0.0002,0,29,0,0.000285
21149,McLean County,,KY,425,10492,10917,1,1,2,186,218,404,9,0.216558,0.223874,0,0.000008,0.000016,306,0.000102,0,29,0,0.000268
21151,Madison County,,KY,4391,86155,90546,12,10,22,2358,2005,4363,8,0.275534,0.290968,14075.024795,0.000914,0.000684,306,0.000688,0,29,0.234848,0.006207
21153,Magoffin County,,KY,287,11156,11443,1,1,2,74,80,154,10,0.171819,0.175681,0,0,0,306,0.000159,0,29,0,0.000132
21155,Marion County,,KY,653,21063,21716,4,4,8,401,386,787,8,0.273866,0.287601,2356.973198,0.000647,0.00051,306,0.000205,0,29,0.5,0.00383
21157,Marshall County,,KY,1455,35294,36749,4,4,8,885,717,1602,8,0.221558,0.229189,1376.616667,0.000016,0.000001,306,0.000284,0,29,0.666667,0.000532
21159,Martin County,,KY,455,9101,9556,0,1,1,0,75,75,10,0.171861,0.175802,0,0,0,306,0.000054,0,181,0,0
21161,Mason County,,KY,806,18605,19411,3,3,6,349,298,647,9,0.214642,0.221917,5104.718794,0,0.00001,257,0.000216,0,29,0,0.000361
21163,Meade County,,KY,3541,31416,34957,3,8,11,1080,1666,2746,7,0.294579,0.31369,100.469033,0.000729,0.003944,306,0.00012,0,29,0.589286,0.003843
21165,Menifee County,,KY,249,5827,6076,1,1,2,116,133,249,9,0.206966,0.213176,0,0.000002,0.000003,306,0.000114,0,29,0,0.00015
21167,Mercer County,,KY,1075,24536,25611,3,3,6,359,450,809,8,0.260674,0.272944,1,0.000254,0.00018,306,0.000182,0,29,0.666667,0.001644
21169,Metcalfe County,,KY,457,10377,10834,1,1,2,233,212,445,9,0.215179,0.221854,0,0.000006,0.000007,306,0.000115,0,29,0,0.000181
21171,Monroe County,,KY,469,11543,12012,0,1,1,0,148,148,9,0.215225,0.221958,0,0,0.000007,306,0.000054,0,182,0,0
21173,Montgomery County,,KY,1482,29113,30595,5,5,10,736,818,1554,8,0.260955,0.2737,13655.843509,0.000254,0.000177,306,0.000353,0,29,0.25,0.001863
21175,Morgan County,,KY,304,11436,11740,0,1,1,0,55,55,9,0.20714,0.213427,0,0,0,306,0.000054,0,183,0,0
21177,Muhlenberg County,,KY,938,32614,33552,4,4,8,338,310,648,8,0.223713,0.232679,50.079257,0.000033,0.000038,306,0.000219,0,29,0.666667,0.000855
21179,Nelson County,,KY,2033,54132,56165,6,8,14,1184,1369,2553,8,0.277425,0.292658,3628.613486,0.00074,0.00072,306,0.000264,0,29,0.375,0.004311
21181,Nicholas County,,KY,316,7708,8024,1,1,2,92,109,201,9,0.20687,0.213064,0,0.000002,0.000003,306,0.000108,0,29,0,0.000152
21183,Ohio County,,KY,971,26223,27194,4,4,8,688,591,1279,8,0.2236,0.232398,18.160104,0.000031,0.000037,306,0.000245,0,29,0.666667,0.000839
21185,Oldham County,,KY,3714,72076,75790,4,6,10,2462,2270,4732,8,0.275137,0.289669,25.444897,0.000659,0.000709,306,0.00018,0,29,0.533333,0.003961
21187,Owen County,,KY,525,11045,11570,4,1,5,282,70,352,9,0.215753,0.222556,3.708333,0.000016,0.00001,257,0.0002,0,29,0.166667,0.000622
21189,Owsley County,,KY,137,3536,3673,0,0,0,0,0,0,0,0,0,0,0,0,106,0.000054,103,184,0,0
21191,Pendleton County,,KY,714,15501,16215,6,4,10,773,486,1259,9,0.221448,0.230588,14.649023,0.000082,0.000077,257,0.000242,0,29,0.466667,0.001246
21193,Perry County,,KY,1188,27220,28408,3,4,7,365,440,805,8,0.260955,0.273588,8046.678191,0,0.000174,306,0.000205,0,29,0.05,0.000355
21195,Pike County,,KY,2220,55644,57864,3,4,7,614,849,1463,8,0.261057,0.273713,5604.091423,0.000002,0.000187,306,0.000313,0,29,0.2,0.000392
21197,Powell County,,KY,599,12809,13408,2,3,5,142,276,418,8,0.260827,0.2732,0,0.000004,0.00018,306,0.000157,0,29,1,0.000303
21199,Pulaski County,,KY,2514,66626,69140,8,8,16,944,905,1849,8,0.275534,0.290718,25754.440326,0.000262,0.000685,306,0.000697,0,29,0.208333,0.002382
21201,Robertson County,,KY,122,2072,2194,0,0,0,0,0,0,0,0,0,0,0,0,107,0.000054,104,185,0,0
21203,Rockcastle County,,KY,569,15860,16429,2,2,4,306,327,633,9,0.216172,0.223624,1.191667,0.000009,0.000013,306,0.00016,0,29,0.666667,0.00037
21205,Rowan County,,KY,1248,21050,22298,4,4,8,414,412,826,8,0.261159,0.273888,7898.001491,0,0.000174,306,0.000308,0,29,0,0.000488
21207,Russell County,,KY,899,18399,19298,3,3,6,401,370,771,9,0.216137,0.223624,82.519861,0.000008,0.000003,306,0.000282,0,29,0,0.000414
21209,Scott County,,KY,3101,58245,61346,9,8,17,1887,1551,3438,8,0.27525,0.290231,498.820858,0.000908,0.0007,306,0.000466,0,29,0.377778,0.005789
21211,Shelby County,,KY,2970,51901,54871,7,7,14,1916,1932,3848,8,0.27508,0.289731,128.119902,0.000911,0.000708,306,0.000312,0,29,0.410714,0.00555
21213,Simpson County,,KY,1036,20024,21060,4,4,8,679,708,1387,8,0.22821,0.237835,44.065452,0.000055,0.000073,306,0.000239,0,29,0.666667,0.001091
21215,Spencer County,,KY,1139,20708,21847,4,4,8,911,763,1674,8,0.273781,0.287445,2.111111,0.000654,0.000521,306,0.00018,0,29,0.75,0.003915
21217,Taylor County,,KY,1117,25913,27030,4,5,9,484,511,995,8,0.275108,0.289544,10828.671528,0.000638,0.000676,306,0.000283,0,29,0.2,0.003772
21219,Todd County,,KY,596,13288,13884,3,3,6,331,381,712,8,0.262728,0.275601,680.703271,0.000414,0.000424,306,0.000158,0,29,0.333333,0.003218
21221,Trigg County,,KY,645,15038,15683,1,1,2,222,196,418,8,0.23939,0.249552,0,0.000102,0.000114,306,0.000078,0,29,0,0.000897
21223,Trimble County,,KY,517,9324,9841,4,4,8,345,329,674,8,0.274006,0.287851,3311.285603,0.000651,0.000502,306,0.00016,0,29,0.4,0.003832
21225,Union County,,KY,618,15478,16096,1,1,2,129,151,280,9,0.192761,0.198095,0,0.000001,0.000001,306,0.000126,0,29,0,0.000148
21227,Warren County,,KY,6294,128573,134867,16,17,33,3150,3193,6343,7,0.287129,0.305267,23887.382049,0.001882,0.002077,306,0.000727,0,29,0.181287,0.013998
21229,Washington County,,KY,510,13216,13726,2,2,4,225,245,470,9,0.217264,0.224505,0,0.000013,0.000015,306,0.000125,0,29,1,0.000343
21231,Wayne County,,KY,704,20117,20821,2,2,4,308,302,610,9,0.216067,0.223281,5412,0.000007,0.000003,306,0.000271,0,29,0,0.000285
21233,Webster County,,KY,781,14317,15098,2,2,4,413,389,802,9,0.199357,0.2058,6.555556,0.000003,0.000002,306,0.000155,0,29,0.5,0.00029
21235,Whitley County,,KY,1996,35307,37303,3,5,8,1217,1348,2565,8,0.261569,0.2747,1478.332893,0.000006,0.000191,306,0.000213,0,29,0.4,0.000449
21237,Wolfe County,,KY,306,6352,6658,0,0,0,0,0,0,0,0,0,0,0,0,108,0.000054,105,186,0,0
21239,Woodford County,,KY,1664,30920,32584,5,5,10,904,926,1830,8,0.260751,0.273382,2.833333,0.000275,0.000199,306,0.000281,0,29,0.7,0.002049
22001,Acadia Parish,,LA,3247,66478,69725,7,8,15,2216,2476,4692,7,0.298501,0.318723,301.155236,0.000275,0.001914,130,0.000232,0,29,0.625,0.002593
22003,Allen Parish,,LA,1122,22979,24101,6,6,12,726,738,1464,8,0.250941,0.263679,29.383355,0.000276,0.000205,350,0.000221,0,29,0.533333,0.002277
22005,Ascension Parish,,LA,6530,131950,138480,15,14,29,5331,4325,9656,7,0.320827,0.344959,2007.671709,0.003081,0.004834,130,0.000401,0,29,0.5125,0.021836
22007,Assumption Parish,,LA,1306,25038,26344,5,5,10,805,880,1685,8,0.260369,0.273735,0.771825,0.000523,0.000363,130,0.000161,0,29,0.75,0.003246
22009,Avoyelles Parish,,LA,1374,42677,44051,3,5,8,520,724,1244,7,0.298936,0.319066,4.754331,0.000203,0.002108,130,0.000124,0,29,0.7,0.001852
22011,Beauregard Parish,,LA,2190,36528,38718,3,3,6,1292,1078,2370,8,0.250234,0.26208,0,0.000206,0.000135,350,0.000134,0,29,1,0.001381
22013,Bienville Parish,,LA,783,14807,15590,4,4,8,397,380,777,8,0.249509,0.261463,3.602882,0.000285,0.000226,130,0.000151,0,29,0.833333,0.00213
22015,Bossier Parish,,LA,10510,134421,144931,17,16,33,6105,5816,11921,7,0.304845,0.328237,7967.961387,0.008032,0.007819,130,0.000456,0,29,0.442105,0.056638
22017,Caddo Parish,,LA,13821,276086,289907,25,28,53,7947,9321,17268,7,0.332089,0.360638,22782.454776,0.012213,0.013287,130,0.000658,0,29,0.358065,0.085832
22019,Calcasieu Parish,,LA,7568,217048,224616,23,20,43,5018,4327,9345,7,0.322573,0.348195,15448.318122,0.007042,0.008183,350,0.000655,0,29,0.366667,0.050164
22021,Caldwell Parish,,LA,476,10043,10519,2,1,3,205,129,334,8,0.244345,0.254928,20.943662,0.000102,0.000071,130,0.000119,0,29,0,0.000789
22023,Cameron Parish,,LA,631,7517,8148,1,1,2,373,447,820,8,0.24392,0.254329,0,0.000089,0.000076,350,0.000081,0,29,0,0.000702
22025,Catahoula Parish,,LA,488,9893,10381,1,1,2,90,102,192,9,0.206613,0.213025,0,0.000003,0.000004,130,0.000107,0,29,0,0.000145
22027,Claiborne Parish,,LA,727,14007,14734,1,3,4,149,294,443,8,0.249486,0.261275,0.559524,0.000002,0.000139,130,0.00008,0,29,0.666667,0.000148
22029,Concordia Parish,,LA,1064,19497,20561,3,3,6,458,453,911,8,0.260394,0.273517,5412,0.000396,0.000244,130,0.000187,0,29,0.333333,0.002099
22031,De Soto Parish,,LA,1632,30220,31852,2,3,5,944,1001,1945,8,0.249416,0.261119,30.143655,0.000229,0.000221,130,0.000098,0,29,0.333333,0.001813
22033,East Baton Rouge Parish,,LA,25158,473175,498333,56,62,118,16098,18030,34128,7,0.351747,0.386164,73974.161681,0.022057,0.034419,130,0.00148,0,29,0.258341,0.152114
22035,East Carroll Parish,,LA,465,6957,7422,1,2,3,89,196,285,8,0.244389,0.255178,0,0.000001,0.000073,130,0.000089,0,29,1,0.000128
22037,East Feliciana Parish,,LA,1189,20460,21649,2,3,5,694,791,1485,8,0.260293,0.273298,0.5,0.000406,0.000273,130,0.000102,0,29,0.666667,0.002179
22039,Evangeline Parish,,LA,1524,34721,36245,6,6,12,844,1016,1860,8,0.248834,0.261306,7.961462,0.000314,0.000279,130,0.000207,0,29,0.7,0.002877
22041,Franklin Parish,,LA,793,21186,21979,2,2,4,306,351,657,8,0.244367,0.255116,0,0.000102,0.000073,130,0.000169,0,29,1,0.000799
22043,Grant Parish,,LA,1233,20255,21488,1,1,2,699,706,1405,8,0.232303,0.242205,0,0.000064,0.000064,130,0.000077,0,29,0,0.000603
22045,Iberia Parish,,LA,4180,84042,88222,6,6,12,2470,2774,5244,7,0.298835,0.319004,478.414159,0.001995,0.002071,130,0.000188,0,29,0.8,0.014127
22047,Iberville Parish,,LA,1937,33348,35285,4,5,9,1363,1500,2863,8,0.260343,0.273673,0.583333,0.000433,0.000312,130,0.000163,0,29,0.85,0.002536
22049,Jackson Parish,,LA,803,15746,16549,3,2,5,371,394,765,8,0.244389,0.255178,2667,0.000154,0.000075,130,0.00018,0,29,0.333333,0.000954
22051,Jefferson Parish,,LA,27363,479383,506746,46,49,95,18036,20898,38934,7,0.344525,0.376722,16596.210297,0.026858,0.032915,130,0.000999,0,29,0.391582,0.175659
22053,Jefferson Davis Parish,,LA,1803,34716,36519,4,5,9,954,1208,2162,8,0.248649,0.260744,5.082078,0.000226,0.000215,350,0.00016,0,29,0.7,0.001973
22055,Lafayette Parish,,LA,13943,260619,274562,30,28,58,10262,10021,20283,7,0.330035,0.358008,12578.470214,0.010129,0.010517,130,0.000747,0,29,0.349462,0.072376
22057,Lafourche Parish,,LA,4754,108091,112845,10,12,22,3262,3311,6573,7,0.299338,0.320584,188.899302,0.001556,0.003073,130,0.00027,0,29,0.660256,0.010138
22059,La Salle Parish,,LA,541,14583,15124,1,2,3,98,161,259,8,0.232343,0.242455,3.546162,0.000064,0.000065,130,0.000077,0,29,0,0.000603
22061,Lincoln Parish,,LA,2854,43290,46144,7,10,17,1201,1406,2607,7,0.301401,0.323039,3063.92318,0.000336,0.004889,130,0.000322,0,29,0.463636,0.003019
22063,Livingston Parish,,LA,7406,143444,150850,12,11,23,5569,4902,10471,7,0.299304,0.320397,1167.293655,0.002748,0.002997,130,0.000358,0,29,0.490476,0.0183
22065,Madison Parish,,LA,585,10649,11234,1,2,3,64,177,241,8,0.244412,0.255209,14.948761,0.000022,0.000073,130,0.000085,0,29,0.333333,0.000262
22067,Morehouse Parish,,LA,1481,28578,30059,2,2,4,553,656,1209,8,0.244479,0.255278,1.722222,0.000102,0.000073,130,0.000122,0,29,0.666667,0.000794
22069,Natchitoches Parish,,LA,1899,38911,40810,6,8,14,609,954,1563,7,0.299372,0.320147,7334.029416,0.001728,0.002216,130,0.000232,0,29,0.375,0.013387
22071,Orleans Parish,,LA,25810,349484,375294,62,57,119,19438,18502,37940,7,0.355971,0.390356,21788.485952,0.042748,0.045285,130,0.001323,0,29,0.439045,0.287228
22073,Ouachita Parish,,LA,7526,168834,176360,20,22,42,4000,4301,8301,7,0.323316,0.349494,46947.804108,0.006579,0.009305,130,0.000848,0,29,0.302536,0.047397
22075,Plaquemines Parish,,LA,2009,25504,27513,3,3,6,921,868,1789,8,0.26309,0.276514,0,0.000859,0.000858,130,0.000114,0,29,1,0.005382
22077,Pointe Coupee Parish,,LA,1138,24673,25811,4,4,8,587,668,1255,8,0.260318,0.273486,1.333333,0.000403,0.000279,130,0.000154,0,29,0.6,0.002293
22079,Rapides Parish,,LA,5930,146102,152032,18,19,37,3022,3230,6252,7,0.302563,0.3261,14464.328826,0.005929,0.005939,130,0.000532,0,29,0.380952,0.041843
22081,Red River Parish,,LA,483,8820,9303,1,2,3,99,203,302,8,0.249416,0.260994,0,0.000024,0.000151,130,0.000078,0,29,1,0.000272
22083,Richland Parish,,LA,1203,21465,22668,3,2,5,607,623,1230,8,0.244367,0.255116,1.166667,0.000103,0.000073,130,0.000194,0,29,0.5,0.000914
22085,Sabine Parish,,LA,792,23954,24746,3,2,5,315,184,499,8,0.243564,0.254704,9.412253,0.000142,0.000075,130,0.000127,0,29,0,0.000932
22087,St. Bernard Parish,,LA,2633,40482,43115,3,4,7,2024,1762,3786,8,0.263116,0.276702,0.333333,0.000964,0.000867,130,0.000112,0,29,0.916667,0.006039
22089,St. Charles Parish,,LA,3403,60245,63648,6,10,16,2018,2475,4493,7,0.299103,0.319897,1.628968,0.001061,0.002974,130,0.000175,0,29,0.855556,0.007108
22091,St. Helena Parish,,LA,1367,13633,15000,3,3,6,783,1061,1844,8,0.260394,0.273442,0,0.000458,0.000321,130,0.000127,0,29,1,0.002682
22093,St. James Parish,,LA,1085,25308,26393,4,4,8,686,674,1360,8,0.260343,0.273548,0.309524,0.000815,0.000323,130,0.000136,0,29,0.85,0.004588
22095,St. John the Baptist Parish,,LA,2805,47722,50527,8,9,17,1914,2196,4110,7,0.29907,0.31971,280.714501,0.003079,0.002893,130,0.00022,0,29,0.777778,0.019651
22097,St. Landry Parish,,LA,4714,94253,98967,9,10,19,3032,3345,6377,7,0.29917,0.320128,1613.586847,0.002078,0.002198,130,0.000276,0,29,0.536364,0.015012
22099,St. Martin Parish,,LA,3390,59451,62841,7,8,15,2866,2726,5592,7,0.298902,0.319379,44.333883,0.000607,0.002111,130,0.000216,0,29,0.714286,0.003976
22101,St. Mary Parish,,LA,3027,60589,63616,8,10,18,1360,1863,3223,7,0.299137,0.320066,371.405193,0.002035,0.002897,130,0.000239,0,29,0.666667,0.014854
22103,St. Tammany Parish,,LA,11814,275986,287800,25,24,49,8655,7272,15927,7,0.329261,0.356303,3880.261443,0.009392,0.010612,130,0.000594,0,29,0.39532,0.06314
22105,Tangipahoa Parish,,LA,6138,126652,132790,15,13,28,5195,4180,9375,7,0.32102,0.345084,11855.716164,0.004801,0.004806,130,0.000388,0,29,0.542857,0.032894
22107,Tensas Parish,,LA,258,4711,4969,0,0,0,0,0,0,0,0,0,0,0,0,109,0.000054,106,187,0,0
22109,Terrebonne Parish,,LA,5910,125716,131626,11,10,21,3256,3647,6903,7,0.299137,0.320066,643.537318,0.004702,0.002954,130,0.000275,0,29,0.718182,0.031802
22111,Union Parish,,LA,1342,22604,23946,4,3,7,784,831,1615,8,0.245333,0.256565,54.117823,0.000157,0.000078,130,0.000212,0,29,0.333333,0.001111
22113,Vermilion Parish,,LA,3015,65737,68752,5,6,11,1889,2013,3902,7,0.298301,0.318098,0.983333,0.000204,0.001854,130,0.000174,0,29,0.8,0.001874
22115,Vernon Parish,,LA,7259,52578,59837,14,16,30,1570,2245,3815,7,0.320557,0.346261,8216.72425,0.005159,0.01063,350,0.000394,0,29,0.494152,0.036545
22117,Washington Parish,,LA,1764,43318,45082,6,6,12,1035,1000,2035,8,0.264263,0.279007,2201.268135,0.000905,0.001157,130,0.000204,0,29,0.571429,0.005513
22119,Webster Parish,,LA,2050,41897,43947,4,5,9,1038,1202,2240,8,0.249579,0.261744,4504.240751,0.000233,0.000223,130,0.000152,0,29,0.35,0.002081
22121,West Baton Rouge Parish,,LA,1906,28443,30349,5,5,10,1577,1418,2995,8,0.260343,0.273673,1.416667,0.000465,0.000312,130,0.000186,0,29,0.8,0.002872
22123,West Carroll Parish,,LA,696,11485,12181,2,3,5,164,337,501,8,0.244412,0.255366,2745.5,0.000102,0.000073,130,0.000124,0,29,0.5,0.000784
22125,West Feliciana Parish,,LA,615,11575,12190,2,1,3,270,256,526,8,0.260242,0.272923,0,0.000377,0.000239,130,0.000103,0,29,1,0.001979
22127,Winn Parish,,LA,719,13381,14100,1,1,2,75,85,160,9,0.196451,0.202071,2.333333,0.000024,0.000002,130,0.000078,0,29,0,0.000272
23001,Androscoggin County,,ME,4802,117613,122415,8,8,16,2734,2932,5666,8,0.274401,0.29199,107.47884,0.000509,0.001469,110,0.000234,0,29,0.680556,0.003036
23003,Aroostook County,,ME,1969,76424,78393,3,4,7,385,618,1003,8,0.254677,0.267404,0,0.000478,0.000318,110,0.000112,0,29,1,0.0022
23005,Cumberland County,,ME,14074,346975,361049,40,47,87,9445,9153,18598,7,0.341395,0.373287,56543.738453,0.019683,0.032271,110,0.00076,0,29,0.412121,0.112482
23007,Franklin County,,ME,1413,31377,32790,7,7,14,779,880,1659,8,0.25475,0.267966,2.095455,0.000519,0.000333,110,0.000202,0,29,0.857143,0.002884
23009,Hancock County,,ME,2505,63676,66181,4,4,8,798,899,1697,8,0.254653,0.267342,242.106879,0.000372,0.000236,110,0.000157,0,29,0.75,0.001908
23011,Kennebec County,,ME,4836,138978,143814,12,13,25,3212,3006,6218,8,0.274599,0.29302,249.525477,0.00052,0.001673,110,0.000339,0,29,0.43956,0.003621
23013,Knox County,,ME,1611,46988,48599,5,5,10,678,687,1365,8,0.254677,0.267529,1.25,0.000391,0.000245,110,0.000168,0,29,0.85,0.002123
23015,Lincoln County,,ME,1812,41219,43031,4,6,10,737,988,1725,8,0.254726,0.267779,1.908333,0.000374,0.000327,110,0.00015,0,29,0.766667,0.001863
23017,Oxford County,,ME,2536,61124,63660,6,6,12,1518,1367,2885,8,0.254799,0.267935,3.279978,0.000526,0.000351,110,0.000174,0,29,0.8,0.002811
23019,Penobscot County,,ME,6155,163538,169693,14,13,27,2964,3007,5971,8,0.274542,0.292927,8526.661452,0.001622,0.001469,110,0.000441,0,29,0.362637,0.010295
23021,Piscataquis County,,ME,761,17749,18510,2,1,3,318,280,598,9,0.215422,0.223718,0,0.00002,0.000018,110,0.000101,0,29,1,0.000419
23023,Sagadahoc County,,ME,2204,42916,45120,5,4,9,1394,1295,2689,8,0.254604,0.267217,0.916667,0.000499,0.000229,110,0.000152,0,29,0.85,0.002448
23025,Somerset County,,ME,2534,53532,56066,5,8,13,1287,1675,2962,8,0.254775,0.268154,244.177713,0.000391,0.000333,110,0.000171,0,29,0.678571,0.002145
23027,Waldo County,,ME,1915,43247,45162,6,6,12,1055,1060,2115,8,0.254702,0.267717,2.5,0.000393,0.000249,110,0.000198,0,29,0.733333,0.002272
23029,Washington County,,ME,1014,34019,35033,2,3,5,243,375,618,8,0.254629,0.267154,0,0.000019,0.000235,110,0.000116,0,29,1,0.000412
23031,York County,,ME,9325,243244,252569,22,22,44,6154,5826,11980,7,0.312522,0.336782,4613.68275,0.007444,0.010254,110,0.000422,0,29,0.420635,0.039551
24001,Allegany County,,MD,2153,72517,74670,4,6,10,683,783,1466,8,0.27685,0.293129,9125.233401,0.000071,0.001184,366,0.000165,0,29,0.2,0.000895
24003,Anne Arundel County,,MD,36262,671076,707338,84,87,171,26884,26396,53280,7,0.35526,0.393761,23774.794657,0.059753,0.067349,366,0.001383,0,29,0.429722,0.36566
24005,Baltimore County,,MD,49197,972908,1022105,75,96,171,40498,41252,81750,7,0.362057,0.402226,12814.764087,0.056122,0.075125,366,0.001127,0,29,0.489435,0.330163
24009,Calvert County,,MD,5392,109824,115216,8,11,19,2660,2505,5165,7,0.284314,0.303068,0.25,0.005761,0.006768,366,0.000163,0,29,0.945455,0.033258
24011,Caroline County,,MD,1669,37067,38736,6,7,13,1167,1202,2369,8,0.262987,0.278034,4.078455,0.001095,0.001138,366,0.000179,0,29,0.690476,0.006851
24013,Carroll County,,MD,7522,210007,217529,11,14,25,5227,4929,10156,8,0.280842,0.299676,25.311144,0.005302,0.005318,366,0.000195,0,29,0.675824,0.027612
24015,Cecil County,,MD,5259,114918,120177,11,12,23,3263,3206,6469,8,0.276591,0.294756,291.596629,0.00583,0.004993,271,0.000182,0,29,0.727273,0.029172
24017,Charles County,,MD,9926,184075,194001,15,15,30,7626,6071,13697,7,0.284587,0.304024,12780.062457,0.009487,0.008192,366,0.000266,0,29,0.669118,0.054757
24019,Dorchester County,,MD,1688,36261,37949,6,6,12,957,916,1873,8,0.262961,0.277847,5.701713,0.001645,0.000977,366,0.000171,0,29,0.690476,0.009723
24021,Frederick County,,MD,13293,299568,312861,20,25,45,8439,7941,16380,7,0.331429,0.357876,1338.153798,0.010602,0.01646,366,0.00037,0,29,0.632308,0.061887
24023,Garrett County,,MD,1023,33991,35014,2,3,5,229,346,575,9,0.22066,0.229952,45.387591,0.000013,0.000013,366,0.000117,0,29,0.333333,0.000261
24025,Harford County,,MD,12267,308398,320665,21,25,46,7342,7802,15144,7,0.330362,0.356749,589.88416,0.013866,0.01781,366,0.000332,0,29,0.615079,0.077256
24027,Howard County,,MD,21367,374556,395923,37,46,83,15931,15468,31399,7,0.350776,0.383104,2223.271596,0.030956,0.043299,366,0.000561,0,29,0.650075,0.18531
24029,Kent County,,MD,979,21792,22771,3,3,6,362,394,756,8,0.26265,0.276457,0.900737,0.000199,0.000818,271,0.000106,0,29,0.583333,0.001697
24031,Montgomery County,,MD,62886,1252041,1314927,135,139,274,44864,51947,96811,7,0.380545,0.425472,53886.590796,0.096352,0.097081,366,0.002113,0,29,0.362821,0.568639
24033,Prince George's County,,MD,66078,1060744,1126822,93,109,202,49964,56908,106872,7,0.369529,0.410679,18403.166998,0.070694,0.07743,366,0.001429,0,29,0.434096,0.413541
24035,Queen Anne's County,,MD,2576,58248,60824,8,8,16,1609,1416,3025,8,0.267737,0.283863,322.039171,0.003481,0.00229,366,0.000211,0,29,0.572727,0.019069
24037,St. Mary's County,,MD,5955,129886,135841,13,13,26,2765,2430,5195,7,0.2906,0.310908,64.406575,0.01051,0.008897,366,0.000243,0,29,0.82381,0.064551
24039,Somerset County,,MD,1218,21128,22346,2,2,4,687,698,1385,9,0.218081,0.226199,0,0.000076,0.000114,366,0.000101,0,29,1,0.000864
24041,Talbot County,,MD,2028,45210,47238,6,4,10,921,786,1707,8,0.262263,0.276579,20.163611,0.002649,0.000716,366,0.000158,0,29,0.666667,0.014489
24043,Washington County,,MD,6894,169127,176021,15,17,32,4377,4169,8546,7,0.285256,0.305213,14081.416088,0.006411,0.00647,366,0.00031,0,29,0.464912,0.036143
24045,Wicomico County,,MD,4996,107842,112838,13,12,25,3061,2853,5914,8,0.278846,0.296562,3254.90276,0.005493,0.004299,366,0.000302,0,29,0.538462,0.030663
24047,Worcester County,,MD,3332,62235,65567,11,8,19,1882,1695,3577,8,0.277917,0.294569,2303.533524,0.005011,0.002719,366,0.000245,0,29,0.672727,0.026833
24510,Baltimore city,,MD,43434,590628,634062,76,73,149,32648,36973,69621,7,0.353284,0.389638,7930.815307,0.059317,0.059511,366,0.001062,0,29,0.531665,0.340081
25001,Barnstable County,,MA,10951,280002,290953,29,35,64,6284,6924,13208,7,0.336784,0.365448,3880.41436,0.022594,0.029577,110,0.000441,0,29,0.713371,0.129025
25003,Berkshire County,,MA,3831,151868,155699,12,17,29,1270,1571,2841,7,0.312559,0.335995,1626.835244,0.005148,0.010138,110,0.000219,0,29,0.581699,0.029813
25005,Bristol County,,MA,18662,643414,662076,26,38,64,14738,14112,28850,7,0.331882,0.360554,1186.162731,0.018152,0.030511,110,0.000367,0,29,0.673414,0.103462
25007,Dukes County,,MA,1111,23000,24111,3,4,7,183,364,547,7,0.284891,0.302506,0,0.002225,0.003597,110,0.000093,0,29,1,0.01329
25009,Essex County,,MA,30647,926442,957089,47,63,110,22849,24505,47354,7,0.347215,0.382083,3655.177184,0.036993,0.054028,110,0.000693,0,29,0.586957,0.217799
25011,Franklin County,,MA,3285,83519,86804,8,8,16,1897,1875,3772,8,0.274344,0.29179,7.283532,0.00315,0.002948,110,0.000162,0,29,0.696429,0.017603
25013,Hampden County,,MA,14014,527937,541951,29,39,68,7843,9115,16958,7,0.332834,0.36224,946.854706,0.022674,0.031431,110,0.000413,0,29,0.664344,0.130716
25015,Hampshire County,,MA,7635,167009,174644,13,16,29,4549,4960,9509,7,0.312595,0.33561,58.990791,0.008749,0.010688,110,0.000202,0,29,0.808824,0.046886
25017,Middlesex County,,MA,78058,1863727,1941785,160,150,310,63586,68196,131782,7,0.377049,0.424771,74887.222527,0.104524,0.101448,110,0.002475,0,29,0.31394,0.614955
25019,Nantucket County,,MA,902,15078,15980,1,2,3,87,171,258,8,0.268519,0.282923,0,0.000321,0.00115,110,0.000064,0,29,1,0.001474
25021,Norfolk County,,MA,40432,835336,875768,56,66,122,32913,33993,66906,7,0.351654,0.387127,4064.129366,0.047389,0.056009,110,0.000779,0,29,0.593484,0.275911
25023,Plymouth County,,MA,20954,617439,638393,25,35,60,17086,16430,33516,7,0.334587,0.363811,314.174122,0.019369,0.03005,110,0.000358,0,29,0.680654,0.11097
25025,Suffolk County,,MA,56736,773259,829995,116,95,211,45971,50232,96203,7,0.366786,0.406811,20611.397086,0.083296,0.073936,110,0.00164,0,29,0.422631,0.473909
25027,Worcester County,,MA,27342,961679,989021,54,77,131,19011,20466,39477,7,0.350591,0.387649,7703.843303,0.042767,0.058943,110,0.000763,0,29,0.497502,0.247102
26001,Alcona County,,MI,526,11679,12205,2,2,4,186,168,354,9,0.215683,0.223306,4566.964164,0.000011,0.000022,118,0.000208,0,29,0,0.000362
26003,Alger County,,MI,368,9881,10249,1,1,2,86,105,191,9,0.216541,0.224187,0,0.000008,0.00001,374,0.000102,0,29,0,0.000178
26005,Allegan County,,MI,6638,138455,145093,7,10,17,5118,4982,10100,7,0.306491,0.327108,174.733724,0.00224,0.0029,118,0.000182,0,29,0.744444,0.013801
26007,Alpena County,,MI,1109,34138,35247,3,2,5,237,213,450,10,0.177523,0.18211,14.035714,0.000001,0,118,0.000282,0,29,0,0.000366
26009,Antrim County,,MI,1526,27051,28577,5,4,9,756,770,1526,8,0.234942,0.244663,144.898891,0.000486,0.000079,118,0.000231,0,29,0.45,0.003111
26011,Arenac County,,MI,795,17590,18385,2,3,5,296,352,648,9,0.219012,0.227349,3.057576,0.000036,0.000043,118,0.000108,0,29,0.5,0.000472
26013,Baraga County,,MI,239,8576,8815,1,2,3,70,106,176,9,0.216576,0.224437,0,0,0.00001,374,0.000118,0,29,1,0.000123
26015,Barry County,,MI,3094,70093,73187,8,7,15,2269,2088,4357,8,0.264473,0.278786,3.933494,0.000971,0.000578,118,0.000192,0,29,0.75,0.005482
26017,Bay County,,MI,3850,130359,134209,10,12,22,2128,2221,4349,8,0.280105,0.29743,5525.1192,0.001664,0.002296,118,0.000274,0,29,0.448718,0.009042
26019,Benzie County,,MI,1153,21128,22281,4,3,7,563,535,1098,8,0.234859,0.24432,23.889715,0.000937,0.000069,118,0.000206,0,29,0.583333,0.005158
26021,Berrien County,,MI,7363,181127,188490,16,17,33,3425,3948,7373,7,0.333125,0.359017,1028.90411,0.007759,0.009855,47,0.000322,0,29,0.517544,0.044666
26023,Branch County,,MI,1834,48560,50394,5,5,10,973,899,1872,8,0.252508,0.264753,25.171481,0.000216,0.000168,118,0.000166,0,29,0.4,0.001697
26025,Calhoun County,,MI,6116,151097,157213,15,13,28,3262,3217,6479,7,0.324614,0.349047,2786.020239,0.004896,0.005398,118,0.00031,0,29,0.511029,0.02811
26027,Cass County,,MI,3122,57402,60524,7,6,13,2048,2177,4225,8,0.254702,0.267714,178.430487,0.002,0.000353,47,0.000175,0,29,0.666667,0.012431
26029,Charlevoix County,,MI,1523,31970,33493,4,6,10,687,734,1421,8,0.27525,0.291446,294.809354,0.000917,0.001073,118,0.000193,0,29,0.7,0.005002
26031,Cheboygan County,,MI,1350,29480,30830,3,3,6,445,448,893,9,0.218904,0.227005,6246.535836,0.0009,0.00004,118,0.000198,0,29,0.5,0.004725
26033,Chippewa County,,MI,1267,38882,40149,1,1,2,126,67,193,1,1,1,0,0,0,115,0.000357,107,188,0,0.000118
26035,Clare County,,MI,1626,32357,33983,6,6,12,680,575,1255,8,0.27946,0.295369,645.249505,0.002049,0.001546,118,0.000164,0,29,0.761905,0.010669
26037,Clinton County,,MI,4501,91041,95542,10,11,21,3314,3138,6452,8,0.280134,0.297368,232.791395,0.002759,0.002159,118,0.000209,0,29,0.659091,0.01414
26039,Crawford County,,MI,758,14327,15085,2,2,4,221,213,434,9,0.218527,0.226137,2.25,0.000031,0.000047,118,0.000158,0,29,0,0.000495
26041,Delta County,,MI,1223,44214,45437,2,2,4,233,236,469,9,0.216594,0.224499,36.959287,0.000009,0.00001,374,0.00017,0,29,0,0.000306
26043,Dickinson County,,MI,945,31903,32848,3,3,6,213,243,456,9,0.200813,0.206996,5431.032944,0.00001,0.000009,374,0.000252,0,29,0.166667,0.00047
26045,Eaton County,,MI,7711,129073,136784,13,14,27,5410,5659,11069,8,0.280547,0.298292,123.465773,0.00304,0.002572,118,0.000262,0,29,0.67033,0.015798
26047,Emmet County,,MI,2018,41324,43342,6,6,12,859,877,1736,8,0.275307,0.29154,2233.792163,0.001856,0.001067,118,0.00024,0,29,0.595238,0.01004
26049,Genesee County,,MI,15919,470013,485932,23,40,63,8053,9472,17525,7,0.346944,0.378363,10810.402338,0.010734,0.02394,118,0.000453,0,29,0.401923,0.066518
26051,Gladwin County,,MI,1276,28397,29673,4,3,7,447,430,877,9,0.218922,0.227174,0.908333,0.000951,0.000069,118,0.000129,0,29,0.833333,0.005123
26053,Gogebic County,,MI,623,16056,16679,1,1,2,55,62,117,1,1,1,0,0,0,111,0.000357,108,189,0,0.000118
26055,Grand Traverse County,,MI,4987,111565,116552,18,16,34,2845,2711,5556,7,0.306808,0.32842,14489.352228,0.004504,0.004114,118,0.000622,0,29,0.368421,0.025751
26057,Gratiot County,,MI,1807,43149,44956,6,6,12,933,932,1865,8,0.257206,0.270188,3.400869,0.000354,0.000287,118,0.000154,0,29,0.6,0.002486
26059,Hillsdale County,,MI,2104,50669,52773,6,7,13,1158,1147,2305,8,0.277888,0.293545,285.31026,0.001038,0.000858,118,0.000174,0,29,0.380952,0.006035
26061,Houghton County,,MI,1310,36214,37524,2,2,4,149,136,285,9,0.216576,0.224437,2745,0.000008,0.00001,374,0.000152,0,29,0.5,0.000296
26063,Huron County,,MI,1106,41064,42170,5,5,10,489,534,1023,8,0.274712,0.290228,1.645238,0.001387,0.00095,118,0.000136,0,29,0.8,0.006543
26065,Ingham County,,MI,16106,287224,303330,30,37,67,10603,11173,21776,7,0.344258,0.374953,11224.660167,0.010595,0.020056,118,0.000564,0,29,0.35061,0.065003
26067,Ionia County,,MI,3200,69599,72799,7,7,14,1993,2216,4209,8,0.26442,0.278723,3.328173,0.000771,0.000559,118,0.000182,0,29,0.690476,0.00451
26069,Iosco County,,MI,1340,28867,30207,6,6,12,583,482,1065,8,0.274853,0.290634,13074.84311,0.002045,0.001018,118,0.000245,0,29,0.333333,0.010274
26071,Iron County,,MI,374,13222,13596,0,0,0,0,0,0,0,0,0,0,0,0,112,0.000054,109,190,0,0
26073,Isabella County,,MI,3561,62513,66074,12,14,26,1486,2107,3593,8,0.280164,0.297805,337.196408,0.003246,0.002345,118,0.000253,0,29,0.527473,0.016079
26075,Jackson County,,MI,5783,176019,181802,13,13,26,3083,3217,6300,7,0.306772,0.327982,155.515444,0.003916,0.004157,118,0.000247,0,29,0.71978,0.018894
26077,Kalamazoo County,,MI,11538,287725,299263,24,26,50,7273,7012,14285,7,0.336529,0.364733,7673.159804,0.008904,0.012875,118,0.000462,0,29,0.432266,0.052957
26079,Kalkaska County,,MI,1124,19304,20428,2,2,4,488,447,935,8,0.23488,0.244226,0,0.000046,0.000054,118,0.000136,0,29,1,0.000597
26081,Kent County,,MI,25641,752988,778629,58,65,123,18040,18274,36314,7,0.358843,0.394755,64745.105158,0.027676,0.037993,118,0.00121,0,29,0.286581,0.182065
26083,Keweenaw County,,MI,96,2551,2647,0,0,0,0,0,0,0,0,0,0,0,0,113,0.000054,110,191,0,0
26085,Lake County,,MI,684,10584,11268,2,3,5,149,256,405,9,0.218904,0.227143,0.5,0.000416,0.000034,118,0.000104,0,29,0.666667,0.002297
26087,Lapeer County,,MI,4034,106424,110458,7,8,15,3069,2731,5800,8,0.279547,0.295837,8.875005,0.002563,0.001919,118,0.000151,0,29,0.767857,0.012099
26089,Leelanau County,,MI,1463,27610,29073,4,2,6,799,698,1497,8,0.234818,0.24407,1.320544,0.001346,0.000059,118,0.000174,0,29,0.75,0.007116
26091,Lenawee County,,MI,3880,114649,118529,9,9,18,2210,2219,4429,8,0.280576,0.297574,210.631621,0.002841,0.002086,118,0.000196,0,29,0.555556,0.014106
26093,Livingston County,,MI,9022,231332,240354,13,13,26,7330,5853,13183,7,0.315889,0.338615,269.319606,0.005241,0.005915,118,0.000235,0,29,0.733333,0.027417
26095,Luce County,,MI,157,6147,6304,0,0,0,0,0,0,0,0,0,0,0,0,114,0.000054,111,192,0,0
26097,Mackinac County,,MI,853,13540,14393,1,1,2,67,126,193,1,1,1,0,0,0,115,0.000357,107,188,0,0.000118
26099,Macomb County,,MI,35795,1057706,1093501,33,54,87,29014,28615,57629,7,0.350039,0.383873,10236.649869,0.020189,0.041008,118,0.000619,0,29,0.432957,0.127967
26101,Manistee County,,MI,1117,27331,28448,4,5,9,391,434,825,8,0.264315,0.278255,134.825239,0.000463,0.000369,118,0.000187,0,29,0.5,0.002901
26103,Marquette County,,MI,2346,74564,76910,5,6,11,393,434,827,8,0.276362,0.292883,24180.60768,0.000888,0.000759,374,0.000341,0,29,0.047619,0.004853
26105,Mason County,,MI,1351,34210,35561,4,5,9,453,499,952,8,0.264237,0.278067,454.512334,0.000422,0.000437,118,0.000154,0,29,0.466667,0.002593
26107,Mecosta County,,MI,2373,40926,43299,8,8,16,1192,1111,2303,8,0.279958,0.296618,2124.371783,0.002236,0.001819,118,0.000222,0,29,0.5,0.012139
26109,Menominee County,,MI,918,27210,28128,3,3,6,490,533,1023,8,0.251082,0.262248,2473.527647,0.000001,0.000089,374,0.000242,0,29,0.333333,0.000426
26111,Midland County,,MI,4334,100762,105096,10,10,20,2026,1965,3991,8,0.280017,0.296993,1063.682828,0.002619,0.001977,118,0.000229,0,29,0.651515,0.013069
26113,Missaukee County,,MI,726,16993,17719,2,1,3,360,226,586,9,0.209058,0.215731,0,0.000007,0.000005,118,0.000151,0,29,1,0.000323
26115,Monroe County,,MI,6395,182741,189136,7,8,15,4119,4058,8177,8,0.28037,0.297012,7.159325,0.003064,0.002229,118,0.000151,0,29,0.732143,0.014418
26117,Montcalm County,,MI,3311,68210,71521,8,8,16,2386,2197,4583,8,0.264473,0.278973,30.370994,0.000767,0.000556,118,0.000212,0,29,0.553571,0.004612
26119,Montmorency County,,MI,455,10320,10775,1,2,3,59,131,190,9,0.218681,0.226477,2669,0,0.00002,118,0.000099,0,193,0,0.000113
26121,Muskegon County,,MI,6017,191981,197998,12,12,24,3782,3693,7475,7,0.331182,0.355831,2331.237953,0.005896,0.007058,118,0.000267,0,29,0.589744,0.034825
26123,Newaygo County,,MI,2641,53693,56334,6,6,12,1599,1723,3322,8,0.264263,0.278255,3.552778,0.000597,0.000464,118,0.000179,0,29,0.666667,0.003754
26125,Oakland County,,MI,62688,1504166,1566854,97,122,219,48119,50264,98383,7,0.37844,0.421928,116111.218284,0.062499,0.081783,118,0.001892,0,29,0.346094,0.397628
26127,Oceana County,,MI,1554,30735,32289,4,5,9,792,907,1699,8,0.264211,0.278005,1.25,0.000499,0.000437,118,0.00014,0,29,0.8,0.002969
26129,Ogemaw County,,MI,1083,22941,24024,3,3,6,260,259,519,9,0.21903,0.227411,3.9,0.000271,0.000068,118,0.000128,0,29,0.45,0.001226
26131,Ontonagon County,,MI,233,6673,6906,0,0,0,0,0,0,0,0,0,0,0,0,116,0.000054,112,194,0,0
26133,Osceola County,,MI,1366,25316,26682,5,5,10,610,678,1288,8,0.264237,0.278067,1660.257878,0.000462,0.000334,118,0.000201,0,29,0.4,0.003015
26135,Oscoda County,,MI,328,8805,9133,0,1,1,0,59,59,10,0.179496,0.183855,0,0,0,118,0.000054,0,195,0,0
26137,Otsego County,,MI,1432,29161,30593,8,7,15,611,476,1087,8,0.279547,0.295681,11468.470785,0.001808,0.001486,118,0.000356,0,29,0.319444,0.010006
26139,Ottawa County,,MI,12927,332657,345584,23,19,42,9669,9066,18735,7,0.316601,0.340489,2212.971553,0.005692,0.007117,118,0.000474,0,29,0.4,0.031083
26141,Presque Isle County,,MI,628,15741,16369,2,2,4,208,222,430,10,0.179688,0.184418,849.07155,0,0.00001,118,0.000229,0,29,0,0.000297
26143,Roscommon County,,MI,1352,25828,27180,7,3,10,568,257,825,8,0.279284,0.29465,3587.123737,0.002549,0.001402,118,0.000217,0,29,0.5,0.012201
26145,Saginaw County,,MI,7201,222567,229768,15,18,33,3206,4078,7284,7,0.312266,0.335273,2318.717621,0.006463,0.00551,118,0.000295,0,29,0.481579,0.036915
26147,St. Clair County,,MI,5914,192004,197918,7,10,17,3819,3560,7379,7,0.306526,0.327967,66.728376,0.00294,0.004233,118,0.000149,0,29,0.8,0.013993
26149,St. Joseph County,,MI,2796,71846,74642,6,8,14,1251,1635,2886,8,0.26542,0.280491,104.222977,0.000367,0.000621,118,0.000184,0,29,0.392857,0.002497
26151,Sanilac County,,MI,1752,48644,50396,6,7,13,1069,1144,2213,8,0.279372,0.295338,9.588081,0.001421,0.001714,118,0.00015,0,29,0.738095,0.00683
26153,Schoolcraft County,,MI,174,9409,9583,0,0,0,0,0,0,0,0,0,0,0,0,117,0.000054,113,196,0,0
26155,Shiawassee County,,MI,3215,82364,85579,8,9,17,1877,2026,3903,8,0.279987,0.296806,0.980159,0.002436,0.002124,118,0.000164,0,29,0.902778,0.012341
26157,Tuscola County,,MI,2251,64786,67037,8,7,15,1416,1409,2825,8,0.274825,0.290728,6.040148,0.001728,0.000942,118,0.000177,0,29,0.696429,0.008177
26159,Van Buren County,,MI,4414,86970,91384,7,8,15,2580,2913,5493,7,0.305438,0.325334,123.943242,0.002276,0.002168,118,0.000178,0,29,0.732143,0.013975
26161,Washtenaw County,,MI,20566,382164,402730,40,49,89,12834,14251,27085,7,0.358602,0.392218,4889.791759,0.028853,0.043748,118,0.000714,0,29,0.55311,0.182663
26163,Wayne County,,MI,70535,1919184,1989719,99,121,220,48412,58397,106809,7,0.38383,0.426278,65149.262907,0.066591,0.08244,118,0.00185,0,29,0.353706,0.426223
26165,Wexford County,,MI,1865,37223,39088,5,4,9,818,788,1606,8,0.264289,0.278067,4077.130262,0.000465,0.000355,118,0.000297,0,29,0.45,0.003011
27001,Aitkin County,,MN,723,17391,18114,2,1,3,237,142,379,8,0.235149,0.244428,0,0.000948,0.00002,374,0.000101,0,29,1,0.005737
27003,Anoka County,,MN,19776,424967,444743,29,29,58,16266,15415,31681,7,0.336274,0.364321,11669.428191,0.008434,0.011723,374,0.000805,0,29,0.289773,0.057145
27005,Becker County,,MN,1643,39114,40757,5,6,11,829,847,1676,7,0.282627,0.298792,2761.321861,0.000999,0.000934,374,0.000244,0,29,0.466667,0.006726
27007,Beltrami County,,MN,2155,48362,50517,6,9,15,709,939,1648,7,0.282627,0.299166,4366.851685,0.000953,0.001266,374,0.000263,0,29,0.388889,0.006384
27009,Benton County,,MN,3290,46354,49644,7,8,15,2271,2507,4778,7,0.282418,0.298729,314.083443,0.001405,0.001263,374,0.000236,0,29,0.75,0.008663
27011,Big Stone County,,MN,228,6137,6365,0,0,0,0,0,0,0,0,0,0,0,0,119,0.000054,114,197,0,0
27013,Blue Earth County,,MN,3900,69423,73323,14,13,27,2162,2334,4496,7,0.282687,0.299916,13207.747776,0.0018,0.001433,374,0.000491,0,29,0.346154,0.011467
27015,Brown County,,MN,1012,32714,33726,4,4,8,389,304,693,7,0.282298,0.29798,1243.171596,0.000938,0.001107,374,0.000174,0,29,0.5,0.006067
27017,Carlton County,,MN,1556,40235,41791,4,5,9,892,832,1724,7,0.318453,0.340045,1739.413043,0.00099,0.001879,374,0.000158,0,29,0.433333,0.00634
27019,Carver County,,MN,5434,123162,128596,8,8,16,4056,3624,7680,7,0.282388,0.298667,1067.664542,0.00175,0.001376,374,0.00026,0,29,0.714286,0.010235
27021,Cass County,,MN,1983,34013,35996,5,7,12,859,984,1843,7,0.282388,0.298542,342.724074,0.000982,0.000925,374,0.000182,0,29,0.47619,0.006321
27023,Chippewa County,,MN,581,15274,15855,2,3,5,203,199,402,8,0.220459,0.228401,5495.491667,0.000014,0.000015,374,0.000123,0,29,0,0.00034
27025,Chisago County,,MN,2997,65412,68409,8,8,16,2294,2158,4452,7,0.282448,0.298698,2.6125,0.001826,0.001444,374,0.000247,0,29,0.821429,0.010682
27027,Clay County,,MN,3759,67788,71547,5,6,11,2271,2271,4542,7,0.282627,0.298792,284.724251,0.001117,0.000934,374,0.000242,0,29,0.52381,0.007334
27029,Clearwater County,,MN,368,9774,10142,1,2,3,109,170,279,8,0.220678,0.228529,0,0.000014,0.000021,374,0.000078,0,29,1,0.000198
27031,Cook County,,MN,184,6683,6867,0,0,0,0,0,0,0,0,0,0,0,0,120,0.000054,115,198,0,0
27033,Cottonwood County,,MN,568,14594,15162,1,1,2,73,52,125,10,0.167756,0.171252,0,0,0,209,0.00012,0,199,0,0.000118
27035,Crow Wing County,,MN,3043,75279,78322,11,13,24,1630,1571,3201,7,0.307409,0.329317,3209.274181,0.001814,0.003248,374,0.000392,0,29,0.472527,0.011268
27037,Dakota County,,MN,24977,525636,550613,36,38,74,17871,18475,36346,7,0.344881,0.375665,17328.948141,0.013772,0.021819,374,0.001014,0,29,0.294397,0.093414
27039,Dodge County,,MN,970,25484,26454,3,4,7,549,550,1099,8,0.235294,0.245388,1.131818,0.000065,0.000103,374,0.00013,0,29,0.583333,0.000981
27041,Douglas County,,MN,1799,46035,47834,7,7,14,733,870,1603,7,0.282777,0.299229,7459.27093,0.001099,0.000952,374,0.000292,0,29,0.392857,0.007313
27043,Faribault County,,MN,592,17503,18095,2,3,5,138,263,401,8,0.220496,0.228645,1,0.000025,0.000034,374,0.00012,0,29,0.333333,0.000404
27045,Fillmore County,,MN,933,25243,26176,4,3,7,469,462,931,8,0.235273,0.2452,4.672519,0.000063,0.000083,374,0.000184,0,29,0.5,0.00109
27047,Freeborn County,,MN,1328,38361,39689,6,4,10,519,411,930,7,0.282268,0.297917,862.249965,0.00136,0.001105,374,0.000223,0,29,0.6,0.0084
27049,Goodhue County,,MN,2409,58013,60422,8,9,17,1388,1442,2830,7,0.282388,0.298792,1188.748349,0.001602,0.001404,374,0.000261,0,29,0.541667,0.009839
27051,Grant County,,MN,293,7352,7645,1,2,3,64,163,227,8,0.220587,0.228438,0,0.00001,0.000023,374,0.000089,0,29,1,0.000212
27053,Hennepin County,,MN,69888,1480020,1549908,155,151,306,53573,55521,109094,6,0.392815,0.438574,344779.37473,0.076742,0.084025,374,0.003833,0,29,0.210099,0.489187
27055,Houston County,,MN,768,23936,24704,2,3,5,314,411,725,8,0.241361,0.25158,2.921611,0.000073,0.000056,374,0.000112,0,29,0.666667,0.000639
27057,Hubbard County,,MN,1287,23441,24728,4,5,9,490,580,1070,7,0.282298,0.298105,1297.439197,0.000946,0.000865,374,0.000157,0,29,0.4,0.006061
27059,Isanti County,,MN,2252,44970,47222,10,8,18,1861,1568,3429,7,0.282358,0.298604,164.773626,0.001853,0.00124,374,0.000289,0,29,0.7,0.011057
27061,Itasca County,,MN,1562,52221,53783,5,5,10,599,628,1227,7,0.282448,0.298292,6.042857,0.001023,0.001,374,0.000174,0,29,0.733333,0.00663
27063,Jackson County,,MN,520,13127,13647,1,2,3,52,158,210,9,0.201555,0.207593,2669,0,0.000001,209,0.000155,0,199,0,0.000118
27065,Kanabec County,,MN,889,17718,18607,4,5,9,332,510,842,7,0.282238,0.29798,0.642157,0.000168,0.000974,374,0.000155,0,29,0.9,0.001523
27067,Kandiyohi County,,MN,2119,53432,55551,7,8,15,764,946,1710,7,0.282627,0.299104,20940.993572,0.001343,0.001267,374,0.000301,0,29,0.267857,0.008261
27069,Kittson County,,MN,150,5542,5692,0,0,0,0,0,0,0,0,0,0,0,0,121,0.000054,116,200,0,0
27071,Koochiching County,,MN,356,14801,15157,1,0,1,54,0,54,0,0,0,0,0.000052,0,374,0.00008,0,11,0,0.000501
27073,Lac qui Parle County,,MN,291,8739,9030,1,0,1,62,0,62,0,0,0,0,0,0,374,0.000088,0,7,0,0.000124
27075,Lake County,,MN,490,12857,13347,1,1,2,167,174,341,8,0.240729,0.25029,0,0.000052,0.000054,374,0.00008,0,29,0,0.000501
27077,Lake of the Woods County,,MN,155,4840,4995,0,0,0,0,0,0,0,0,0,0,0,0,122,0.000054,117,201,0,0
27079,Le Sueur County,,MN,1658,34701,36359,7,8,15,1102,1130,2232,7,0.282418,0.298729,1621.941521,0.001235,0.001053,374,0.000246,0,29,0.517857,0.007802
27081,Lincoln County,,MN,247,7060,7307,0,0,0,0,0,0,0,0,0,0,0,0,123,0.000054,118,202,0,0
27083,Lyon County,,MN,1400,30582,31982,3,4,7,243,343,586,7,0.283709,0.299947,6836.227163,0.000913,0.001204,374,0.000146,0,29,0.25,0.005711
27085,McLeod County,,MN,1738,45844,47582,7,7,14,1015,913,1928,7,0.282358,0.298479,2220.506017,0.001366,0.000935,374,0.000241,0,29,0.486111,0.00823
27087,Mahnomen County,,MN,258,5712,5970,1,0,1,78,0,78,0,0,0,0,0.00001,0,374,0.000088,0,8,0,0.000199
27089,Marshall County,,MN,393,11604,11997,1,3,4,129,207,336,8,0.235247,0.244912,98.369097,0,0.000044,374,0.000101,0,203,0.5,0.000123
27091,Martin County,,MN,850,25845,26695,2,3,5,117,180,297,7,0.282238,0.29773,637.820447,0.000016,0.000853,374,0.00012,0,29,0.666667,0.000404
27093,Meeker County,,MN,1177,28192,29369,4,5,9,523,706,1229,7,0.282448,0.298354,5.795671,0.000094,0.000923,374,0.000171,0,29,0.75,0.001161
27095,Mille Lacs County,,MN,1571,29359,30930,8,9,17,982,1014,1996,7,0.282418,0.298854,402.869602,0.001165,0.001043,374,0.000262,0,29,0.597222,0.007877
27097,Morrison County,,MN,1338,40130,41468,5,5,10,680,695,1375,7,0.282298,0.298105,4.315873,0.000106,0.000908,374,0.000197,0,29,0.7,0.001301
27099,Mower County,,MN,2003,47781,49784,7,6,13,773,786,1559,7,0.282328,0.298292,1025.325073,0.001361,0.001163,374,0.000277,0,29,0.547619,0.008544
27101,Murray County,,MN,324,10746,11070,1,1,2,82,81,163,9,0.20145,0.207186,0,0.000001,0.000001,209,0.000136,0,29,0,0.000137
27103,Nicollet County,,MN,2266,38460,40726,5,5,10,1233,1405,2638,7,0.282328,0.298167,20.167317,0.000972,0.000898,374,0.000197,0,29,0.566667,0.006346
27105,Nobles County,,MN,1295,27195,28490,3,3,6,255,265,520,8,0.252245,0.263678,10746,0.000125,0.000128,209,0.00029,0,29,0.166667,0.001266
27107,Norman County,,MN,232,7960,8192,2,1,3,147,57,204,8,0.236714,0.247006,0,0.000065,0.000067,374,0.000146,0,29,1,0.000851
27109,Olmsted County,,MN,6765,189564,196329,17,16,33,3123,3356,6479,7,0.307409,0.329816,10784.21545,0.005314,0.00327,374,0.000514,0,29,0.371053,0.034312
27111,Otter Tail County,,MN,2516,70925,73441,9,7,16,1187,1169,2356,7,0.282777,0.299229,4933.507459,0.001008,0.001179,374,0.000413,0,29,0.3,0.007242
27113,Pennington County,,MN,660,17043,17703,2,3,5,156,253,409,8,0.220525,0.228325,2671,0,0.000011,374,0.000168,0,203,0.166667,0.000236
27115,Pine County,,MN,1445,30966,32411,8,10,18,798,901,1699,7,0.282567,0.299166,183.528757,0.001536,0.001497,374,0.000257,0,29,0.644444,0.009462
27117,Pipestone County,,MN,362,11563,11925,0,0,0,0,0,0,0,0,0,0,0,0,124,0.000054,119,204,0,0
27119,Polk County,,MN,1774,36628,38402,8,4,12,926,780,1706,7,0.282597,0.298448,6864.905312,0.001023,0.000944,374,0.00036,0,29,0.303571,0.00725
27121,Pope County,,MN,517,13906,14423,1,2,3,164,206,370,8,0.235481,0.245278,0,0.00001,0.000051,374,0.000089,0,29,1,0.000212
27123,Ramsey County,,MN,37012,615172,652184,59,61,120,28042,29892,57934,7,0.353331,0.388105,50523.090008,0.022451,0.035392,374,0.001614,0,29,0.242199,0.150978
27125,Red Lake County,,MN,187,4885,5072,1,1,2,77,70,147,9,0.180693,0.18494,0,0,0,374,0.000101,0,203,0,0.000123
27127,Redwood County,,MN,668,19176,19844,2,3,5,163,281,444,8,0.221356,0.229507,14.937649,0.000013,0.00002,374,0.000118,0,29,0,0.000305
27129,Renville County,,MN,842,18948,19790,2,3,5,156,273,429,8,0.220569,0.228745,15.117857,0.000014,0.00003,374,0.000119,0,29,0,0.000345
27131,Rice County,,MN,3005,73038,76043,7,10,17,1648,1834,3482,7,0.282597,0.299354,8.046012,0.001609,0.001461,374,0.00023,0,29,0.7,0.009478
27133,Rock County,,MN,360,11635,11995,2,1,3,202,117,319,8,0.252174,0.263241,0,0.000126,0.000127,209,0.000191,0,29,1,0.001167
27135,Roseau County,,MN,653,19952,20605,0,0,0,0,0,0,0,0,0,0,0,0,125,0.000054,120,205,0,0
27137,St. Louis County,,MN,7032,225042,232074,16,16,32,3388,3628,7016,7,0.317015,0.34017,19291.028553,0.004982,0.004761,374,0.00049,0,29,0.362745,0.032326
27139,Scott County,,MN,7861,174559,182420,15,11,26,6488,5381,11869,7,0.306949,0.328411,361.1304,0.001991,0.003204,374,0.000441,0,29,0.495833,0.012765
27141,Sherburne County,,MN,5722,108346,114068,10,11,21,4317,4155,8472,7,0.282687,0.299541,9.657814,0.001891,0.001552,374,0.000303,0,29,0.718182,0.011366
27143,Sibley County,,MN,712,18920,19632,3,4,7,242,348,590,7,0.282209,0.297792,0.875,0.000037,0.000889,374,0.000137,0,29,0.75,0.000685
27145,Stearns County,,MN,8902,178368,187270,21,17,38,5337,5337,10674,7,0.307834,0.330503,9399.928882,0.003611,0.003282,374,0.000649,0,29,0.35,0.024632
27147,Steele County,,MN,1737,46589,48326,7,9,16,818,920,1738,7,0.282418,0.298854,1443.427312,0.0012,0.001332,374,0.000261,0,29,0.5,0.007609
27149,Stevens County,,MN,491,11221,11712,0,0,0,0,0,0,0,0,0,0,0,0,126,0.000054,121,206,0,0
27151,Swift County,,MN,474,11712,12186,1,1,2,118,99,217,8,0.220368,0.227839,0,0.000014,0.000015,374,0.000086,0,29,0,0.000222
27153,Todd County,,MN,1324,28059,29383,5,6,11,615,750,1365,7,0.282388,0.298417,1164.024127,0.000066,0.000897,374,0.000247,0,29,0.428571,0.001123
27155,Traverse County,,MN,121,4156,4277,0,0,0,0,0,0,0,0,0,0,0,0,127,0.000054,122,207,0,0
27157,Wabasha County,,MN,1093,27200,28293,3,3,6,534,587,1121,8,0.235294,0.245263,0.825,0.000963,0.000086,374,0.000127,0,29,0.833333,0.006235
27159,Wadena County,,MN,907,15415,16322,3,2,5,412,293,705,8,0.220569,0.228376,2.299242,0.000032,0.000012,374,0.000165,0,29,0.166667,0.00055
27161,Waseca County,,MN,911,22701,23612,3,4,7,286,416,702,7,0.282328,0.298042,2.14899,0.000041,0.000879,374,0.000136,0,29,0.666667,0.000711
27163,Washington County,,MN,14526,313778,328304,18,20,38,11066,10845,21911,7,0.335134,0.361541,3298.890692,0.006632,0.011163,374,0.000524,0,29,0.432971,0.04409
27165,Watonwan County,,MN,395,13550,13945,1,1,2,77,69,146,8,0.220405,0.228082,0,0.000016,0.00002,374,0.000086,0,29,0,0.000279
27167,Wilkin County,,MN,382,8144,8526,1,3,4,91,260,351,8,0.236861,0.24763,1.6,0.000001,0.000079,374,0.000115,0,29,0.666667,0.000129
27169,Winona County,,MN,2071,54637,56708,8,9,17,768,1018,1786,7,0.282627,0.29926,4548.738122,0.00101,0.001332,374,0.000338,0,29,0.344444,0.007152
27171,Wright County,,MN,6811,160948,167759,12,13,25,4917,4615,9532,7,0.306949,0.328661,559.831651,0.001918,0.003193,374,0.000367,0,29,0.582418,0.011776
27173,Yellow Medicine County,,MN,477,12369,12846,1,2,3,70,225,295,8,0.221246,0.229101,15.537302,0,0.00001,374,0.000088,0,29,0,0.000124
28001,Adams County,,MS,1775,31103,32878,3,6,9,444,711,1155,7,0.300383,0.320859,8353.606395,0.000376,0.002058,130,0.000159,0,29,0.266667,0.002099
28003,Alcorn County,,MS,1576,36218,37794,5,6,11,774,761,1535,8,0.28102,0.296421,6326.601295,0.000008,0.00064,306,0.000316,0,29,0.285714,0.000707
28005,Amite County,,MS,830,12463,13293,1,2,3,255,363,618,9,0.208064,0.215432,2745,0.000002,0.000001,130,0.000077,0,29,0,0.000137
28007,Attala County,,MS,870,19931,20801,2,3,5,213,216,429,8,0.251746,0.263761,0.533333,0.000004,0.000173,130,0.000116,0,29,0.833333,0.000301
28009,Benton County,,MS,596,7919,8515,4,4,8,386,413,799,8,0.280547,0.295359,4150.32988,0.000793,0.000639,306,0.000206,0,29,0.333333,0.004652
28011,Bolivar County,,MS,1942,35529,37471,4,5,9,570,833,1403,8,0.281643,0.296902,0.333333,0.000904,0.00084,306,0.000143,0,29,0.9,0.005167
28013,Calhoun County,,MS,649,15553,16202,1,1,2,83,140,223,10,0.180307,0.18469,0,0,0,306,0.000102,0,29,0,0.000134
28015,Carroll County,,MS,711,10843,11554,2,2,4,336,318,654,8,0.242457,0.252083,3833.551327,0.000028,0.000029,306,0.000126,0,29,0.333333,0.000427
28017,Chickasaw County,,MS,1080,19182,20262,4,5,9,551,701,1252,9,0.219951,0.228186,5416.255556,0.000008,0.00001,306,0.000282,0,29,0.35,0.000624
28019,Choctaw County,,MS,498,8721,9219,2,2,4,177,153,330,9,0.221044,0.229001,1.2,0.000001,0.000033,306,0.000155,0,29,0.666667,0.000251
28021,Claiborne County,,MS,489,9014,9503,2,1,3,160,164,324,8,0.241121,0.250318,43.303602,0.000022,0.000021,130,0.000117,0,29,0,0.00038
28023,Clarke County,,MS,942,17431,18373,3,4,7,437,555,992,8,0.232202,0.242289,455.848268,0.000027,0.000032,130,0.000212,0,29,0.333333,0.000593
28025,Clay County,,MS,1001,21197,22198,4,4,8,440,520,960,9,0.2225,0.23173,132.784165,0.000024,0.000044,306,0.000218,0,29,0.7,0.000794
28027,Coahoma County,,MS,1385,26375,27760,3,4,7,273,534,807,8,0.280547,0.295284,1782.168933,0.000845,0.000687,306,0.000143,0,29,0.583333,0.004845
28029,Copiah County,,MS,1395,29999,31394,3,3,6,763,770,1533,8,0.252007,0.264129,4.090476,0.000251,0.000159,130,0.000148,0,29,0.833333,0.001587
28031,Covington County,,MS,1161,20444,21605,6,7,13,849,769,1618,8,0.24574,0.257536,50.221164,0.000035,0.000072,130,0.000246,0,29,0.595238,0.001146
28033,DeSoto County,,MS,11427,197382,208809,19,17,36,8494,6966,15460,7,0.308261,0.331015,6207.665421,0.004395,0.004784,306,0.000647,0,29,0.242424,0.029291
28035,Forrest County,,MS,6918,74279,81197,17,15,32,4106,4303,8409,7,0.301027,0.322927,26337.578053,0.002387,0.002138,130,0.000593,0,29,0.245614,0.016707
28037,Franklin County,,MS,445,8409,8854,1,1,2,80,99,179,9,0.20145,0.207735,5.166667,0.000022,0.000002,130,0.000076,0,29,0,0.000145
28039,George County,,MS,1058,23826,24884,3,3,6,647,588,1235,8,0.253131,0.265598,4911.085066,0.00034,0.000213,130,0.000145,0,29,0.333333,0.001818
28041,Greene County,,MS,601,11807,12408,2,2,4,195,236,431,9,0.202382,0.209176,13.091859,0.000003,0.000004,130,0.000132,0,29,0,0.000263
28043,Grenada County,,MS,1167,24098,25265,4,5,9,426,421,847,8,0.280665,0.295658,6794.827549,0.000008,0.000643,306,0.000268,0,29,0.233333,0.000507
28045,Hancock County,,MS,2733,43610,46343,6,5,11,1800,1401,3201,8,0.258979,0.272542,10.177163,0.001294,0.000599,130,0.000175,0,29,0.833333,0.007834
28047,Harrison County,,MS,18709,205856,224565,29,34,63,7552,7881,15433,7,0.33619,0.365745,20474.604284,0.01335,0.019999,130,0.000735,0,29,0.355769,0.089256
28049,Hinds County,,MS,15525,261655,277180,36,37,73,9400,10616,20016,7,0.336232,0.366209,55842.571827,0.011393,0.016975,130,0.001039,0,29,0.233838,0.078722
28051,Holmes County,,MS,1158,19440,20598,3,5,8,316,669,985,8,0.251888,0.264279,1269.902228,0.000235,0.000203,130,0.000152,0,29,0.5,0.001668
28053,Humphreys County,,MS,437,8833,9270,0,0,0,0,0,0,0,0,0,0,0,0,128,0.000054,123,208,0,0
28055,Issaquena County,,MS,68,1126,1194,0,0,0,0,0,0,0,0,0,0,0,0,129,0.000054,124,209,0,0
28057,Itawamba County,,MS,1330,24230,25560,4,5,9,899,912,1811,9,0.220751,0.229635,674.944588,0.000009,0.00001,306,0.000242,0,29,0.35,0.000652
28059,Jackson County,,MS,9479,151938,161417,13,20,33,4499,5390,9889,7,0.327643,0.35406,5556.565208,0.004823,0.009803,130,0.000378,0,29,0.435714,0.032628
28061,Jasper County,,MS,1123,17995,19118,4,2,6,678,626,1304,9,0.206198,0.213364,9.317978,0.000028,0.000003,130,0.000191,0,29,0.416667,0.000785
28063,Jefferson County,,MS,443,8197,8640,1,2,3,96,159,255,8,0.231096,0.240296,7.895148,0.000022,0.000004,130,0.000076,0,29,0,0.000145
28065,Jefferson Davis County,,MS,934,12360,13294,5,4,9,387,393,780,8,0.231577,0.241539,188.387411,0.000031,0.000033,130,0.000213,0,29,0.433333,0.000961
28067,Jones County,,MS,3225,73542,76767,8,10,18,1882,1817,3699,8,0.259508,0.273929,5860.158968,0.000247,0.000382,130,0.000374,0,29,0.4,0.002346
28069,Kemper County,,MS,671,9374,10045,1,2,3,135,359,494,8,0.232101,0.241664,0,0.000027,0.000029,130,0.000078,0,29,1,0.000329
28071,Lafayette County,,MS,2829,44957,47786,12,9,21,1429,970,2399,8,0.282209,0.298401,7963.165242,0.001166,0.000876,306,0.000568,0,29,0.287879,0.007737
28073,Lamar County,,MS,5395,59943,65338,12,11,23,3533,3227,6760,8,0.259634,0.274335,1335.05292,0.000613,0.000438,130,0.000412,0,29,0.371795,0.004456
28075,Lauderdale County,,MS,4260,81220,85480,10,12,22,1228,1375,2603,7,0.302049,0.323733,25141.583649,0.002628,0.002491,130,0.00035,0,29,0.225275,0.017734
28077,Lawrence County,,MS,627,12898,13525,1,2,3,126,141,267,9,0.201617,0.208348,2.592857,0.000002,0.000002,130,0.000096,0,29,0,0.000147
28079,Leake County,,MS,1173,22746,23919,6,6,12,767,758,1525,8,0.252079,0.264766,1757.905663,0.000303,0.000206,130,0.000258,0,29,0.466667,0.00234
28081,Lee County,,MS,5149,94309,99458,14,12,26,3058,3015,6073,8,0.281762,0.298363,32867.247083,0.000879,0.000725,306,0.000647,0,29,0.225275,0.00665
28083,Leflore County,,MS,1857,31397,33254,6,6,12,623,740,1363,7,0.319674,0.341656,9431.109059,0.002697,0.002608,306,0.000211,0,29,0.404762,0.017027
28085,Lincoln County,,MS,1501,37237,38738,5,5,10,642,677,1319,8,0.252174,0.264785,8122.183003,0.000188,0.00016,130,0.000248,0,29,0.233333,0.001554
28087,Lowndes County,,MS,3667,63694,67361,8,11,19,1045,1210,2255,8,0.284526,0.302311,12644.282477,0.000115,0.001171,306,0.000396,0,29,0.227273,0.001643
28089,Madison County,,MS,7098,119937,127035,16,12,28,5352,4142,9494,7,0.323042,0.347109,7652.695844,0.004268,0.004499,130,0.000541,0,29,0.341912,0.029997
28091,Marion County,,MS,1358,26055,27413,4,3,7,548,632,1180,8,0.231597,0.241402,955.013889,0.000028,0.000033,130,0.000202,0,29,0.5,0.000814
28093,Marshall County,,MS,2534,37192,39726,6,4,10,1640,1654,3294,8,0.280547,0.295315,6.074603,0.000869,0.000698,306,0.000261,0,29,0.533333,0.005431
28095,Monroe County,,MS,1730,38284,40014,5,5,10,827,919,1746,9,0.221926,0.231099,77.532489,0.000021,0.000011,306,0.000265,0,29,0.5,0.000795
28097,Montgomery County,,MS,698,10833,11531,1,2,3,110,238,348,9,0.219228,0.226443,2.333333,0.000007,0,306,0.000099,0,29,0.5,0.000133
28099,Neshoba County,,MS,1352,30493,31845,6,4,10,750,608,1358,8,0.232526,0.242651,72.636153,0.000033,0.000032,130,0.000268,0,29,0.266667,0.001021
28101,Newton County,,MS,1223,23433,24656,3,4,7,620,658,1278,8,0.245763,0.257087,39.18996,0.00003,0.000065,130,0.00016,0,29,0.5,0.000625
28103,Noxubee County,,MS,580,12342,12922,1,2,3,121,234,355,9,0.222204,0.230731,0,0.000013,0.000034,306,0.000084,0,29,1,0.000159
28105,Oktibbeha County,,MS,2933,42363,45296,13,11,24,1309,1183,2492,8,0.283619,0.300737,26002.317323,0.003039,0.001037,306,0.000521,0,29,0.263736,0.019592
28107,Panola County,,MS,2021,37429,39450,6,6,12,905,1282,2187,8,0.280635,0.295721,7004.155009,0.000861,0.000699,306,0.000296,0,29,0.333333,0.005328
28109,Pearl River County,,MS,2874,54538,57412,7,7,14,1406,1481,2887,8,0.259306,0.273417,53.077671,0.000737,0.000595,130,0.000234,0,29,0.52381,0.004927
28111,Perry County,,MS,717,12132,12849,1,2,3,272,328,600,8,0.231477,0.241102,325.018711,0.000023,0.000026,130,0.000087,0,29,0,0.000347
28113,Pike County,,MS,1903,42235,44138,4,7,11,717,876,1593,8,0.252532,0.265966,8857.187657,0.000054,0.00021,130,0.000192,0,29,0.190476,0.000892
28115,Pontotoc County,,MS,1874,34394,36268,4,4,8,1071,1097,2168,9,0.220678,0.229175,42.377133,0.000018,0.000022,306,0.000241,0,29,0.583333,0.000734
28117,Prentiss County,,MS,1206,25224,26430,4,3,7,778,652,1430,9,0.220096,0.228173,593.971218,0.000015,0.00001,306,0.000224,0,29,0.55,0.000638
28119,Quitman County,,MS,519,7269,7788,1,1,2,173,115,288,9,0.219156,0.226131,0,0.000008,0.000009,306,0.000096,0,29,0,0.000188
28121,Rankin County,,MS,8589,163973,172562,20,20,40,6252,5393,11645,7,0.324851,0.35052,19786.652577,0.003058,0.006009,130,0.000656,0,29,0.246667,0.021153
28123,Scott County,,MS,1818,32323,34141,5,7,12,874,1224,2098,8,0.252198,0.265172,264.045589,0.000253,0.000208,130,0.000203,0,29,0.452381,0.001873
28125,Sharkey County,,MS,295,4863,5158,0,0,0,0,0,0,0,0,0,0,0,0,131,0.000054,125,210,0,0
28127,Simpson County,,MS,1588,27271,28859,4,6,10,746,970,1716,8,0.25215,0.264922,228.517205,0.000251,0.000165,130,0.000162,0,29,0.566667,0.00173
28129,Smith County,,MS,942,16103,17045,5,6,11,525,639,1164,8,0.245559,0.257099,36.964076,0.000074,0.000042,130,0.000191,0,29,0.4,0.001012
28131,Stone County,,MS,1002,17274,18276,2,2,4,492,484,976,8,0.252007,0.264016,0,0.000324,0.000171,130,0.000088,0,29,1,0.001607
28133,Sunflower County,,MS,1549,25490,27039,5,7,12,622,835,1457,8,0.281821,0.297495,1780.785182,0.000887,0.00087,306,0.00017,0,29,0.595238,0.005123
28135,Tallahatchie County,,MS,827,13355,14182,3,5,8,273,432,705,8,0.280635,0.295596,819.437747,0.000024,0.000649,306,0.00015,0,29,0.333333,0.000486
28137,Tate County,,MS,1777,30042,31819,3,4,7,1230,1228,2458,8,0.280488,0.29519,0.5,0.000845,0.000696,306,0.000146,0,29,0.833333,0.004861
28139,Tippah County,,MS,903,23797,24700,4,5,9,402,513,915,9,0.220041,0.228436,24.371967,0.000022,0.000019,306,0.000228,0,29,0.45,0.000677
28141,Tishomingo County,,MS,878,19553,20431,4,3,7,440,370,810,9,0.220368,0.228548,42.851209,0.000008,0.000001,306,0.000234,0,29,0.416667,0.000557
28143,Tunica County,,MS,1112,12342,13454,3,3,6,465,604,1069,8,0.280429,0.29494,0,0.000845,0.000686,306,0.000135,0,29,1,0.004845
28145,Union County,,MS,1538,30554,32092,4,5,9,894,879,1773,9,0.220697,0.229332,14.796646,0.000015,0.000031,306,0.000233,0,29,0.5,0.000674
28147,Walthall County,,MS,869,14503,15372,2,3,5,254,468,722,9,0.210095,0.21823,20.08883,0.000003,0.000011,130,0.000134,0,29,0,0.000273
28149,Warren County,,MS,2432,54200,56632,4,6,10,660,861,1521,7,0.317695,0.339487,8192.190548,0.001966,0.002001,130,0.00022,0,29,0.4,0.012912
28151,Washington County,,MS,2964,52749,55713,6,9,15,708,1228,1936,7,0.32195,0.344948,5520.377249,0.002756,0.005279,306,0.000188,0,29,0.513889,0.017419
28153,Wayne County,,MS,1041,22299,23340,3,3,6,412,405,817,8,0.231497,0.24129,187.151616,0.000005,0.000029,130,0.000186,0,29,0.25,0.000419
28155,Webster County,,MS,624,10600,11224,1,2,3,118,269,387,9,0.221007,0.228907,1367.034749,0.000011,0.000033,306,0.000094,0,29,0.5,0.00036
28157,Wilkinson County,,MS,475,9160,9635,1,1,2,114,78,192,8,0.260318,0.273036,1607.263202,0,0.000239,130,0.000086,0,29,0,0.000118
28159,Winston County,,MS,722,19502,20224,3,3,6,226,263,489,9,0.221209,0.229532,1424.699268,0.000012,0.000033,306,0.000217,0,29,0.166667,0.000628
28161,Yalobusha County,,MS,728,13214,13942,4,2,6,413,283,696,9,0.220241,0.227939,971.511898,0.000031,0.000013,306,0.00022,0,29,0.5,0.000684
28163,Yazoo County,,MS,1114,24881,25995,4,4,8,461,597,1058,8,0.251936,0.264173,1.56214,0.000301,0.000206,130,0.000169,0,29,0.833333,0.002061
29001,Adair County,,MO,1073,23092,24165,2,3,5,320,223,543,8,0.248302,0.259722,5412,0.000001,0.000085,147,0.000226,0,29,0.166667,0.000241
29003,Andrew County,,MO,1096,20719,21815,1,1,2,696,648,1344,9,0.215474,0.222939,0,0.000014,0.000014,138,0.000098,0,29,0,0.000234
29005,Atchison County,,MO,200,6567,6767,0,0,0,0,0,0,0,0,0,0,0,0,132,0.000054,126,211,0,0
29007,Audrain County,,MO,1124,27352,28476,3,3,6,428,523,951,8,0.248209,0.259579,14.982498,0.000137,0.000089,147,0.000186,0,29,0.333333,0.000992
29009,Barry County,,MO,2291,35520,37811,7,6,13,1278,1324,2602,8,0.259558,0.273038,64.176506,0.000414,0.000366,138,0.000314,0,29,0.666667,0.003541
29011,Barton County,,MO,562,13377,13939,2,1,3,247,156,403,9,0.216278,0.224182,0,0.000018,0.000023,138,0.000131,0,29,0.5,0.000445
29013,Bates County,,MO,891,17963,18854,3,3,6,410,414,824,8,0.267818,0.281452,2591.116945,0.000577,0.000444,138,0.00014,0,29,0.333333,0.003329
29015,Benton County,,MO,1064,19082,20146,2,2,4,279,295,574,9,0.211897,0.21929,0,0.000571,0.000016,138,0.00011,0,29,0.833333,0.00317
29017,Bollinger County,,MO,774,12508,13282,1,2,3,148,364,512,9,0.219498,0.226804,0,0.000012,0.000013,147,0.000129,0,29,1,0.000234
29019,Boone County,,MO,8488,177952,186440,28,24,52,4327,4023,8350,7,0.329953,0.35742,54970.62266,0.007856,0.012301,147,0.001006,0,29,0.254902,0.049739
29021,Buchanan County,,MO,4652,95060,99712,12,12,24,2084,2341,4425,8,0.274627,0.291002,24044.339337,0.00129,0.00126,138,0.00063,0,29,0.224359,0.007939
29023,Butler County,,MO,2101,43542,45643,6,6,12,1059,763,1822,9,0.220114,0.228522,17780.519248,0.000798,0.000013,147,0.000543,0,29,0.166667,0.004655
29025,Caldwell County,,MO,419,9751,10170,1,1,2,102,107,209,9,0.21136,0.218116,0,0.000006,0.000008,138,0.0001,0,29,0,0.000179
29027,Callaway County,,MO,2417,47618,50035,3,3,6,1265,1263,2528,8,0.248278,0.259735,4.108333,0.000157,0.000109,147,0.000173,0,29,0.666667,0.001117
29029,Camden County,,MO,2967,46981,49948,10,11,21,1272,1599,2871,8,0.285531,0.302377,7242.334981,0.002278,0.001882,147,0.00036,0,29,0.463636,0.012571
29031,Cape Girardeau County,,MO,3619,86215,89834,13,9,22,1874,1479,3353,8,0.280724,0.295815,44214.631203,0.001181,0.001071,147,0.000793,0,29,0.197802,0.007548
29033,Carroll County,,MO,336,10615,10951,0,0,0,0,0,0,0,0,0,0,0,0,133,0.000054,127,212,0,0
29035,Carter County,,MO,379,6224,6603,1,1,2,97,134,231,10,0.180417,0.18483,0,0,0.000009,147,0.000131,0,29,0,0.00018
29037,Cass County,,MO,5634,118751,124385,10,9,19,4081,3711,7792,8,0.272245,0.28786,126.978316,0.001495,0.001066,138,0.000375,0,29,0.488889,0.008896
29039,Cedar County,,MO,745,14020,14765,3,3,6,303,256,559,8,0.256218,0.268597,829.057511,0.00019,0.000142,138,0.000155,0,29,0.333333,0.001388
29041,Chariton County,,MO,306,9042,9348,0,1,1,0,70,70,9,0.199045,0.204924,0,0,0.000001,147,0.000054,0,213,0,0
29043,Christian County,,MO,5635,92574,98209,7,6,13,3663,3479,7142,8,0.268546,0.28322,159.948546,0.000205,0.000582,138,0.000293,0,29,0.375,0.002032
29045,Clark County,,MO,268,7638,7906,0,1,1,0,80,80,9,0.195976,0.201699,0,0,0,47,0.000054,0,214,0,0
29047,Clay County,,MO,14537,277226,291763,22,21,43,11031,9939,20970,7,0.331017,0.358201,12261.402255,0.007065,0.010576,138,0.000738,0,29,0.38,0.045788
29049,Clinton County,,MO,1524,23673,25197,6,6,12,1077,942,2019,8,0.267979,0.282202,7073.22584,0.000725,0.000546,138,0.000328,0,29,0.466667,0.004393
29051,Cole County,,MO,4094,88922,93016,11,12,23,2070,2290,4360,8,0.284617,0.301434,13609.080723,0.002066,0.002068,147,0.000435,0,29,0.397436,0.011499
29053,Cooper County,,MO,827,18694,19521,3,3,6,389,382,771,8,0.248302,0.259797,4.2,0.000141,0.000097,147,0.000185,0,29,0.666667,0.001048
29055,Crawford County,,MO,1441,25356,26797,3,4,7,695,716,1411,8,0.280311,0.294441,1.028571,0.000822,0.000677,147,0.000135,0,29,0.833333,0.004431
29057,Dade County,,MO,336,8116,8452,1,1,2,107,134,241,8,0.256095,0.268035,0,0.000188,0.00014,138,0.000082,0,29,0,0.001121
29059,Dallas County,,MO,943,16682,17625,5,3,8,665,509,1174,8,0.256144,0.26841,2,0.000195,0.000145,138,0.000222,0,29,0.5,0.001686
29061,Daviess County,,MO,462,9417,9879,0,0,0,0,0,0,0,0,0,0,0,0,134,0.000054,128,215,0,0
29063,DeKalb County,,MO,598,10243,10841,2,2,4,325,358,683,9,0.215509,0.223189,0,0.00002,0.000022,138,0.000145,0,29,1,0.000413
29065,Dent County,,MO,646,15264,15910,1,1,2,89,138,227,9,0.220405,0.227669,0,0.000013,0.00001,138,0.000082,0,29,0,0.00019
29067,Douglas County,,MO,955,12740,13695,2,5,7,194,548,742,8,0.256243,0.26891,1368.912823,0.00019,0.000146,138,0.000112,0,29,0.5,0.001265
29069,Dunklin County,,MO,1768,29783,31551,8,8,16,797,964,1761,9,0.225776,0.235921,4296.606685,0.00002,0.000063,306,0.000578,0,29,0.277778,0.001607
29071,Franklin County,,MO,4722,122116,126838,11,10,21,2949,2962,5911,8,0.280872,0.29619,5499.595007,0.001625,0.001194,147,0.000412,0,29,0.409091,0.009414
29073,Gasconade County,,MO,645,17377,18022,1,1,2,214,229,443,9,0.2193,0.226276,0,0.000013,0.000018,147,0.000089,0,29,0,0.000245
29075,Gentry County,,MO,316,7420,7736,0,0,0,0,0,0,0,0,0,0,0,0,135,0.000054,129,216,0,0
29077,Greene County,,MO,15954,307658,323612,42,42,84,9211,9228,18439,7,0.344214,0.375511,96453.468156,0.012866,0.017325,138,0.001412,0,29,0.227041,0.085098
29079,Grundy County,,MO,359,11009,11368,0,0,0,0,0,0,0,0,0,0,0,0,136,0.000054,130,217,0,0
29081,Harrison County,,MO,344,9431,9775,0,0,0,0,0,0,0,0,0,0,0,0,137,0.000054,131,218,0,0
29083,Henry County,,MO,1260,23546,24806,6,5,11,599,524,1123,8,0.268168,0.282336,6611.613729,0.000594,0.000479,138,0.000314,0,29,0.357143,0.003886
29085,Hickory County,,MO,646,8616,9262,0,3,3,0,267,267,8,0.256191,0.268497,0,0,0.000144,138,0.000054,0,219,1,0
29087,Holt County,,MO,229,5534,5763,0,1,1,0,58,58,9,0.21552,0.223043,0,0,0.000014,138,0.000054,0,220,0,0
29089,Howard County,,MO,497,11030,11527,2,2,4,213,283,496,8,0.24814,0.259266,0,0.000135,0.000087,147,0.000142,0,29,1,0.000851
29091,Howell County,,MO,1843,41453,43296,5,5,10,784,570,1354,8,0.256341,0.269128,14924.150641,0.000191,0.000141,138,0.000479,0,29,0.05,0.001619
29093,Iron County,,MO,591,9873,10464,1,1,2,152,223,375,9,0.219156,0.22608,0,0.000012,0.000013,147,0.000086,0,29,0,0.000203
29095,Jackson County,,MO,36137,758226,794363,70,75,145,24764,25667,50431,7,0.365479,0.402269,110296.384357,0.039352,0.052037,138,0.001904,0,29,0.349111,0.262515
29097,Jasper County,,MO,6520,126841,133361,19,14,33,4048,3549,7597,8,0.275933,0.293566,14196.661739,0.002098,0.001665,138,0.000803,0,29,0.236842,0.014059
29099,Jefferson County,,MO,9683,260744,270427,15,14,29,7964,6790,14754,8,0.282627,0.299619,3989.049345,0.003582,0.00148,147,0.000531,0,29,0.352941,0.022299
29101,Johnson County,,MO,4167,54284,58451,7,8,15,1317,1500,2817,8,0.271912,0.286985,73.601523,0.001201,0.000985,138,0.000287,0,29,0.517857,0.006921
29103,Knox County,,MO,243,4501,4744,0,0,0,0,0,0,0,0,0,0,0,0,139,0.000054,132,221,0,0
29105,Laclede County,,MO,1643,38073,39716,6,5,11,787,653,1440,8,0.258452,0.271864,40.525232,0.000289,0.000232,138,0.000259,0,29,0.5,0.002392
29107,Lafayette County,,MO,1784,37048,38832,4,4,8,959,968,1927,8,0.267791,0.281515,1094.871354,0.000587,0.000448,138,0.000173,0,29,0.416667,0.003461
29109,Lawrence County,,MO,2263,41276,43539,6,6,12,1480,1424,2904,8,0.25644,0.269356,15.609462,0.000222,0.000176,138,0.000297,0,29,0.666667,0.002107
29111,Lewis County,,MO,420,10757,11177,2,2,4,194,156,350,8,0.234694,0.243467,0,0.000024,0.000017,47,0.000181,0,29,1,0.000375
29113,Lincoln County,,MO,2743,61708,64451,5,5,10,2305,1770,4075,8,0.280282,0.294503,152.572452,0.001361,0.000835,147,0.000205,0,29,0.6,0.007321
29115,Linn County,,MO,551,14083,14634,0,1,1,0,64,64,9,0.199269,0.20496,0,0,0,138,0.000054,0,223,0,0
29117,Livingston County,,MO,634,15756,16390,1,1,2,64,58,122,8,0.248765,0.2597,2669,0,0.000077,138,0.000099,0,222,0,0.000113
29119,McDonald County,,MO,1893,23388,25281,5,6,11,920,1055,1975,8,0.257728,0.270503,16.380316,0.000382,0.000396,138,0.000232,0,29,0.666667,0.003424
29121,Macon County,,MO,617,17900,18517,2,2,4,132,153,285,8,0.248278,0.259535,5488,0.000002,0.000085,147,0.00017,0,29,0.5,0.000257
29123,Madison County,,MO,484,12527,13011,2,1,3,254,208,462,9,0.219156,0.22608,0,0.000028,0.000013,147,0.000119,0,29,1,0.000596
29125,Maries County,,MO,536,9461,9997,3,2,5,261,183,444,9,0.220496,0.228044,104.729141,0.000088,0.00001,138,0.000168,0,29,0.333333,0.000871
29127,Marion County,,MO,1547,31855,33402,4,4,8,705,694,1399,8,0.234963,0.244204,5872.599732,0.000025,0.000017,47,0.000344,0,29,0.166667,0.000608
29129,Mercer County,,MO,196,3929,4125,0,0,0,0,0,0,0,0,0,0,0,0,140,0.000054,133,224,0,0
29131,Miller County,,MO,1444,25332,26776,3,3,6,785,636,1421,9,0.222278,0.230382,1.827778,0.000043,0.000047,147,0.000154,0,29,0.666667,0.000675
29133,Mississippi County,,MO,592,12494,13086,1,2,3,182,353,535,10,0.180417,0.184986,0,0,0,147,0.000122,0,29,1,0.000134
29135,Moniteau County,,MO,719,17107,17826,2,3,5,277,280,557,9,0.221779,0.229957,2.727778,0.000023,0.000033,147,0.000126,0,29,0.5,0.000402
29137,Monroe County,,MO,526,9710,10236,2,3,5,181,258,439,8,0.248487,0.260053,247.576882,0.000001,0.000087,147,0.000179,0,29,0.333333,0.000267
29139,Montgomery County,,MO,711,13026,13737,2,2,4,169,212,381,8,0.25395,0.265234,0,0.000208,0.000184,147,0.000119,0,29,1,0.00148
29141,Morgan County,,MO,1199,21118,22317,4,4,8,447,478,925,9,0.222352,0.230726,14.222202,0.000027,0.000035,147,0.000196,0,29,0.25,0.000732
29143,New Madrid County,,MO,1163,18017,19180,5,5,10,745,727,1472,9,0.220078,0.228272,1423.35054,0.000001,0.000013,147,0.000375,0,29,0.433333,0.000687
29145,Newton County,,MO,4202,61300,65502,8,8,16,2723,2760,5483,8,0.259634,0.273476,639.117635,0.000417,0.000373,138,0.000367,0,29,0.517857,0.003694
29147,Nodaway County,,MO,1074,21562,22636,1,3,4,81,174,255,8,0.267871,0.281577,0,0.000014,0.000518,138,0.000098,0,29,1,0.000234
29149,Oregon County,,MO,600,10158,10758,1,1,2,122,231,353,9,0.204054,0.210325,0,0.000002,0.000002,138,0.000135,0,29,0,0.000148
29151,Osage County,,MO,516,15832,16348,2,2,4,233,230,463,9,0.221668,0.229458,23.091147,0.000023,0.000023,147,0.000156,0,29,0,0.000399
29153,Ozark County,,MO,500,9301,9801,2,1,3,161,127,288,9,0.204054,0.210325,1.5,0.000003,0.000002,138,0.000154,0,29,0,0.000282
29155,Pemiscot County,,MO,917,16971,17888,3,3,6,362,385,747,9,0.219951,0.227836,687.231428,0.000008,0.000028,306,0.000221,0,29,0.5,0.000605
29157,Perry County,,MO,700,22936,23636,4,2,6,367,232,599,9,0.219282,0.226461,11.607937,0.000039,0.000022,147,0.00024,0,29,0.25,0.000753
29159,Pettis County,,MO,2036,47124,49160,9,9,18,988,888,1876,8,0.268383,0.283295,4951.216381,0.000905,0.000563,138,0.000373,0,29,0.263636,0.005683
29161,Phelps County,,MO,2429,43358,45787,7,10,17,751,956,1707,8,0.282687,0.298732,9044.392471,0.000895,0.001175,138,0.000333,0,29,0.322222,0.005354
29163,Pike County,,MO,733,18744,19477,3,3,6,257,283,540,8,0.254023,0.265546,37.230914,0.000209,0.000189,147,0.000169,0,29,0.333333,0.001628
29165,Platte County,,MO,8426,111486,119912,11,10,21,5364,5301,10665,7,0.307976,0.328791,729.35074,0.002522,0.00285,138,0.000377,0,29,0.576923,0.014196
29167,Polk County,,MO,1761,31016,32777,4,4,8,879,894,1773,8,0.256194,0.26866,4.583333,0.000193,0.000146,138,0.000204,0,29,0.4,0.001522
29169,Pulaski County,,MO,6452,46858,53310,15,17,32,1683,2081,3764,7,0.303596,0.327409,7611.706073,0.005782,0.006928,138,0.000402,0,29,0.378947,0.039943
29171,Putnam County,,MO,130,5340,5470,0,0,0,0,0,0,0,0,0,0,0,0,141,0.000054,134,225,0,0
29173,Ralls County,,MO,605,11822,12427,1,1,2,343,368,711,9,0.190272,0.195087,0,0,0,47,0.000127,0,29,0,0.000134
29175,Randolph County,,MO,1076,26030,27106,3,3,6,380,428,808,8,0.248417,0.259897,13211.370254,0.000135,0.000085,147,0.000186,0,29,0.166667,0.000952
29177,Ray County,,MO,1480,26123,27603,3,3,6,736,941,1677,8,0.267764,0.281327,1.761905,0.000685,0.00051,138,0.000142,0,29,0.666667,0.003783
29179,Reynolds County,,MO,270,6290,6560,0,0,0,0,0,0,0,0,0,0,0,0,142,0.000054,135,226,0,0
29181,Ripley County,,MO,944,13338,14282,1,1,2,189,318,507,10,0.180417,0.18483,0,0,0.000009,147,0.000131,0,29,0,0.00018
29183,St. Charles County,,MO,16938,466036,482974,28,26,54,13452,11212,24664,7,0.340306,0.368665,21967.60237,0.015918,0.018364,147,0.000847,0,29,0.407527,0.106475
29185,St. Clair County,,MO,420,9231,9651,1,1,2,84,77,161,9,0.211477,0.218225,0,0.000005,0.000006,138,0.000107,0,29,0,0.000173
29186,Ste. Genevieve County,,MO,1008,20742,21750,4,4,8,554,665,1219,8,0.280223,0.294253,1639.319653,0.000825,0.000663,147,0.000239,0,29,0.583333,0.004727
29187,St. Francois County,,MO,2718,63621,66339,7,10,17,1849,1682,3531,8,0.280635,0.295815,9455.069896,0.001181,0.001102,147,0.000385,0,29,0.355556,0.00669
29189,St. Louis County,,MO,56134,1190061,1246195,88,101,189,39065,43035,82100,7,0.388921,0.428264,162129.564344,0.056214,0.073367,147,0.002177,0,29,0.367353,0.361837
29195,Saline County,,MO,1114,25176,26290,2,4,6,151,370,521,8,0.268114,0.282077,5.45,0.000011,0.000529,138,0.000126,0,29,0.666667,0.000364
29197,Schuyler County,,MO,288,4486,4774,1,1,2,79,221,300,9,0.198926,0.204714,0,0.000001,0,147,0.000118,0,29,0,0.000123
29199,Scotland County,,MO,201,5499,5700,0,0,0,0,0,0,0,0,0,0,0,0,143,0.000054,136,227,0,0
29201,Scott County,,MO,2220,43096,45316,4,4,8,1372,1310,2682,9,0.219588,0.227335,4216.030854,0.000012,0.000013,147,0.000321,0,29,0.5,0.000635
29203,Shannon County,,MO,525,8013,8538,1,1,2,81,181,262,9,0.204054,0.210325,0,0.000002,0.000002,138,0.000135,0,29,0,0.000148
29205,Shelby County,,MO,215,7544,7759,0,0,0,0,0,0,0,0,0,0,0,0,144,0.000054,137,228,0,0
29207,Stoddard County,,MO,1272,31730,33002,6,5,11,692,669,1361,9,0.220114,0.228397,358.345363,0.000013,0.000022,147,0.000454,0,29,0.433333,0.000965
29209,Stone County,,MO,2248,33255,35503,5,5,10,1095,1242,2337,8,0.256317,0.268941,3.135036,0.000209,0.000157,138,0.000239,0,29,0.7,0.00179
29211,Sullivan County,,MO,358,7314,7672,0,0,0,0,0,0,0,0,0,0,0,0,145,0.000054,138,229,0,0
29213,Taney County,,MO,3990,55113,59103,5,7,12,1300,1530,2830,8,0.270506,0.285631,401.972081,0.000765,0.000792,138,0.000239,0,29,0.5,0.00457
29215,Texas County,,MO,1284,24280,25564,4,5,9,338,490,828,8,0.258577,0.272145,92.148096,0.000091,0.000216,138,0.000213,0,29,0.45,0.001038
29217,Vernon County,,MO,984,21371,22355,2,4,6,171,388,559,9,0.216435,0.225088,11.400794,0.000006,0.000031,138,0.000137,0,29,0.166667,0.000296
29219,Warren County,,MO,1979,37441,39420,5,5,10,1470,1314,2784,8,0.280252,0.294441,133.431653,0.00102,0.000818,147,0.00022,0,29,0.6,0.00587
29221,Washington County,,MO,1092,22862,23954,4,4,8,520,725,1245,8,0.280252,0.294316,2.422222,0.000838,0.00068,147,0.000172,0,29,0.833333,0.004837
29223,Wayne County,,MO,783,11434,12217,1,1,2,179,250,429,10,0.180417,0.18483,0,0,0.000009,147,0.000131,0,29,0,0.00018
29225,Webster County,,MO,2176,40358,42534,5,5,10,1461,1374,2835,8,0.256218,0.268847,4.25,0.0002,0.000149,138,0.000216,0,29,0.533333,0.001717
29227,Worth County,,MO,-2,2433,2431,0,0,0,0,0,0,0,0,0,0,0,0,146,0.000054,139,230,0,0
29229,Wright County,,MO,1088,17987,19075,4,5,9,506,598,1104,8,0.256292,0.269003,69.646798,0.000194,0.000148,138,0.000174,0,29,0.5,0.001542
29510,St. Louis city,,MO,29548,304210,333758,35,39,74,21172,24368,45540,7,0.35986,0.391174,32862.205631,0.022834,0.032593,147,0.000907,0,29,0.486473,0.146301
30001,Beaverhead County,,MT,550,10370,10920,0,0,0,0,0,0,0,0,0,0,0,0,148,0.000054,140,231,0,0
30003,Big Horn County,,MT,694,12756,13450,1,1,2,154,297,451,8,0.240751,0.251103,0,0.000076,0.000081,169,0.000108,0,29,0,0.00075
30005,Blaine County,,MT,251,6942,7193,1,1,2,91,90,181,9,0.194517,0.200178,0,0.000001,0,169,0.00011,0,29,0,0.000124
30007,Broadwater County,,MT,352,6214,6566,2,2,4,154,186,340,8,0.235294,0.245081,0,0.000058,0.000091,169,0.00014,0,29,1,0.00091
30009,Carbon County,,MT,593,11685,12278,1,1,2,261,248,509,8,0.240751,0.251103,0,0.000076,0.000081,169,0.000108,0,29,0,0.00075
30011,Carter County,,MT,-2,1413,1411,0,0,0,0,0,0,0,0,0,0,0,0,149,0.000054,141,232,0,0
30013,Cascade County,,MT,5664,96650,102314,10,10,20,1112,1389,2501,7,0.309728,0.331472,23642.218445,0.0007,0.003258,169,0.000606,0,29,0.265152,0.005861
30015,Chouteau County,,MT,274,5645,5919,1,1,2,68,79,147,8,0.236504,0.245739,0,0.000035,0.000008,169,0.000105,0,29,0,0.000206
30017,Custer County,,MT,720,13965,14685,1,1,2,57,111,168,8,0.240751,0.251103,0,0.000076,0.000081,169,0.000108,0,29,0,0.00075
30019,Daniels County,,MT,64,2290,2354,0,0,0,0,0,0,0,0,0,0,0,0,150,0.000054,142,233,0,0
30021,Dawson County,,MT,691,11002,11693,0,1,1,0,89,89,8,0.240798,0.251197,0,0,0.000081,169,0.000054,0,234,0,0
30023,Deer Lodge County,,MT,460,9670,10130,1,1,2,69,105,174,9,0.195129,0.201177,0,0.000003,0.000002,169,0.000105,0,29,0,0.000162
30025,Fallon County,,MT,157,3905,4062,0,0,0,0,0,0,0,0,0,0,0,0,151,0.000054,143,235,0,0
30027,Fergus County,,MT,593,13905,14498,0,1,1,0,79,79,8,0.240798,0.251197,0,0,0.000081,169,0.000054,0,236,0,0
30029,Flathead County,,MT,4425,114015,118440,14,12,26,1720,1532,3252,7,0.308048,0.32996,11077.148892,0.006051,0.005315,169,0.000586,0,29,0.42381,0.043446
30031,Gallatin County,,MT,5918,114138,120056,17,14,31,2428,1879,4307,7,0.307586,0.330272,26114.895777,0.008036,0.0047,169,0.000748,0,29,0.339181,0.055831
30033,Garfield County,,MT,-2,1444,1442,0,0,0,0,0,0,0,0,0,0,0,0,152,0.000054,144,237,0,0
30035,Glacier County,,MT,580,13341,13921,0,2,2,0,155,155,8,0.236781,0.246877,0,0,0.000156,169,0.000054,0,238,1,0
30037,Golden Valley County,,MT,79,1067,1146,0,0,0,0,0,0,0,0,0,0,0,0,153,0.000054,145,239,0,0
30039,Granite County,,MT,202,3175,3377,0,0,0,0,0,0,0,0,0,0,0,0,154,0.000054,146,240,0,0
30041,Hill County,,MT,865,18888,19753,2,3,5,153,282,435,8,0.24147,0.252509,5412,0.000035,0.000089,169,0.000198,0,29,0.333333,0.000324
30043,Jefferson County,,MT,865,13251,14116,2,3,5,414,452,866,8,0.235336,0.245331,0,0.00001,0.000093,169,0.000146,0,29,1,0.000339
30045,Judith Basin County,,MT,108,2297,2405,0,0,0,0,0,0,0,0,0,0,0,0,155,0.000054,147,241,0,0
30047,Lake County,,MT,1404,30479,31883,2,2,4,404,468,872,8,0.236735,0.246782,0,0.00014,0.000156,169,0.000133,0,29,1,0.001386
30049,Lewis and Clark County,,MT,3426,79230,82656,8,9,17,1418,1393,2811,8,0.254071,0.269142,1815.206772,0.000307,0.000629,169,0.000437,0,29,0.513889,0.003491
30051,Liberty County,,MT,96,2314,2410,0,1,1,0,46,46,9,0.191357,0.196363,0,0,0,169,0.000054,0,243,0,0
30053,Lincoln County,,MT,1076,19569,20645,1,1,2,154,155,309,8,0.235523,0.244808,0,0.000058,0.000066,169,0.000095,0,29,0,0.000598
30055,McCone County,,MT,75,2259,2334,0,0,0,0,0,0,0,0,0,0,0,0,156,0.000054,148,244,0,0
30057,Madison County,,MT,383,8824,9207,1,1,2,96,93,189,8,0.235253,0.244832,0,0.000051,0.000087,169,0.000099,0,29,0,0.000733
30059,Meagher County,,MT,93,1945,2038,0,0,0,0,0,0,0,0,0,0,0,0,157,0.000054,149,245,0,0
30061,Mineral County,,MT,334,4485,4819,1,1,2,91,96,187,8,0.236609,0.246376,0,0.000082,0.000091,169,0.000091,0,29,0,0.000787
30063,Missoula County,,MT,6450,126400,132850,19,18,37,3017,2857,5874,7,0.309908,0.333352,30015.057671,0.008361,0.007593,169,0.000802,0,29,0.318182,0.060362
30065,Musselshell County,,MT,213,4889,5102,1,1,2,68,93,161,8,0.240751,0.251103,0,0.000076,0.000081,169,0.000108,0,29,0,0.00075
30067,Park County,,MT,1064,19312,20376,1,1,2,268,317,585,8,0.235253,0.244832,0,0.000051,0.000087,169,0.000099,0,29,0,0.000733
30069,Petroleum County,,MT,-2,488,486,0,0,0,0,0,0,0,0,0,0,0,0,158,0.000054,150,246,0,0
30071,Phillips County,,MT,140,4965,5105,0,0,0,0,0,0,0,0,0,0,0,0,159,0.000054,151,247,0,0
30073,Pondera County,,MT,208,7252,7460,0,0,0,0,0,0,0,0,0,0,0,0,160,0.000054,152,248,0,0
30075,Powder River County,,MT,-2,1944,1942,0,0,0,0,0,0,0,0,0,0,0,0,161,0.000054,153,249,0,0
30077,Powell County,,MT,386,6311,6697,0,1,1,0,64,64,8,0.236655,0.246471,0,0,0.000091,169,0.000054,0,250,0,0
30079,Prairie County,,MT,-2,1359,1357,0,0,0,0,0,0,0,0,0,0,0,0,162,0.000054,154,251,0,0
30081,Ravalli County,,MT,2146,47203,49349,1,2,3,553,671,1224,8,0.237134,0.247376,0,0.000082,0.000178,169,0.000091,0,29,1,0.000787
30083,Richland County,,MT,1265,14158,15423,2,2,4,148,219,367,8,0.241492,0.252534,0,0.000138,0.000189,374,0.000148,0,29,1,0.001627
30085,Roosevelt County,,MT,630,11113,11743,1,0,1,59,0,59,0,0,0,0,0.000062,0,374,0.000094,0,10,0,0.000877
30087,Rosebud County,,MT,590,10405,10995,1,1,2,125,131,256,8,0.240751,0.251103,0,0.000076,0.000081,169,0.000108,0,29,0,0.00075
30089,Sanders County,,MT,538,11710,12248,1,1,2,70,54,124,8,0.236609,0.246376,0,0.000082,0.000091,169,0.000091,0,29,0,0.000787
30091,Sheridan County,,MT,205,4849,5054,0,0,0,0,0,0,0,0,0,0,0,0,163,0.000054,155,252,0,0
30093,Silver Bow County,,MT,1656,38449,40105,6,6,12,506,573,1079,8,0.242413,0.254502,6655.569608,0.000217,0.000263,169,0.000364,0,29,0.5,0.00269
30095,Stillwater County,,MT,516,10801,11317,1,1,2,234,265,499,8,0.240751,0.251103,0,0.000076,0.000081,169,0.000108,0,29,0,0.00075
30097,Sweet Grass County,,MT,156,3981,4137,0,0,0,0,0,0,0,0,0,0,0,0,164,0.000054,156,253,0,0
30099,Teton County,,MT,307,7448,7755,1,1,2,92,110,202,8,0.236504,0.245739,0,0.000035,0.000008,169,0.000105,0,29,0,0.000206
30101,Toole County,,MT,278,5485,5763,1,1,2,46,54,100,8,0.236551,0.245834,2669,0,0.000008,169,0.000099,0,242,0,0.000113
30103,Treasure County,,MT,-2,902,900,0,0,0,0,0,0,0,0,0,0,0,0,165,0.000054,157,254,0,0
30105,Valley County,,MT,353,9102,9455,0,0,0,0,0,0,0,0,0,0,0,0,166,0.000054,158,255,0,0
30107,Wheatland County,,MT,86,2113,2199,0,0,0,0,0,0,0,0,0,0,0,0,167,0.000054,159,256,0,0
30109,Wibaux County,,MT,-2,1215,1213,0,0,0,0,0,0,0,0,0,0,0,0,168,0.000054,160,257,0,0
30111,Yellowstone County,,MT,7749,185936,193685,24,21,45,3282,2671,5953,7,0.317053,0.34236,69376.08024,0.007463,0.007,169,0.001349,0,29,0.170769,0.05481
31001,Adams County,,NE,1521,36307,37828,5,5,10,573,679,1252,8,0.26309,0.276981,5412,0.000649,0.000435,209,0.000313,0,29,0.6,0.003643
31003,Antelope County,,NE,255,7866,8121,1,1,2,69,60,129,9,0.208372,0.21523,0,0.000005,0.000021,209,0.000106,0,29,0,0.000255
31005,Arthur County,,NE,-2,545,543,0,0,0,0,0,0,0,0,0,0,0,0,170,0.000054,161,258,0,0
31007,Banner County,,NE,-2,764,762,0,0,0,0,0,0,0,0,0,0,0,0,171,0.000054,162,259,0,0
31009,Blaine County,,NE,-2,586,584,0,0,0,0,0,0,0,0,0,0,0,0,172,0.000054,163,260,0,0
31011,Boone County,,NE,213,6878,7091,0,0,0,0,0,0,0,0,0,0,0,0,173,0.000054,164,261,0,0
31013,Box Butte County,,NE,686,13799,14485,0,1,1,0,67,67,8,0.234308,0.243035,0,0,0,209,0.000054,0,262,0,0
31015,Boyd County,,NE,-2,2378,2376,0,0,0,0,0,0,0,0,0,0,0,0,174,0.000054,165,263,0,0
31017,Brown County,,NE,92,3495,3587,0,0,0,0,0,0,0,0,0,0,0,0,175,0.000054,166,264,0,0
31019,Buffalo County,,NE,2520,54911,57431,8,7,15,986,1103,2089,8,0.263168,0.277418,11858.938539,0.000659,0.000435,209,0.000481,0,29,0.392857,0.004023
31021,Burt County,,NE,217,8088,8305,0,1,1,0,61,61,8,0.26249,0.275235,0,0,0.000291,209,0.000054,0,265,0,0
31023,Butler County,,NE,382,10230,10612,1,2,3,61,149,210,8,0.257206,0.269051,0,0.000019,0.000137,209,0.000099,0,29,1,0.000262
31025,Cass County,,NE,1708,31431,33139,3,3,6,923,1042,1965,8,0.262702,0.275962,0,0.000675,0.000447,209,0.000151,0,29,1,0.00348
31027,Cedar County,,NE,360,10721,11081,0,1,1,0,85,85,9,0.201464,0.207202,0,0,0.000001,209,0.000054,0,266,0,0
31029,Chase County,,NE,187,4879,5066,0,0,0,0,0,0,0,0,0,0,0,0,176,0.000054,167,267,0,0
31031,Cherry County,,NE,242,7090,7332,0,0,0,0,0,0,0,0,0,0,0,0,177,0.000054,168,268,0,0
31033,Cheyenne County,,NE,572,12543,13115,0,0,0,0,0,0,0,0,0,0,0,0,178,0.000054,169,269,0,0
31035,Clay County,,NE,313,7706,8019,1,1,2,76,94,170,9,0.208307,0.215011,0,0.000005,0.000007,209,0.000107,0,29,0,0.000168
31037,Colfax County,,NE,969,13732,14701,1,3,4,143,391,534,8,0.262702,0.275888,0.5,0.000019,0.00032,209,0.000099,0,29,0.833333,0.000262
31039,Cuming County,,NE,303,11680,11983,0,0,0,0,0,0,0,0,0,0,0,0,179,0.000054,170,270,0,0
31041,Custer County,,NE,456,13337,13793,0,1,1,0,63,63,9,0.208385,0.215212,0,0,0.000002,209,0.000054,0,271,0,0
31043,Dakota County,,NE,1667,25921,27588,1,4,5,666,826,1492,8,0.262909,0.276556,6.75,0.000008,0.000416,209,0.000097,0,29,0.5,0.000193
31045,Dawes County,,NE,493,8822,9315,0,0,0,0,0,0,0,0,0,0,0,0,180,0.000054,171,272,0,0
31047,Dawson County,,NE,1727,30030,31757,4,6,10,340,571,911,8,0.263142,0.277231,5419.453459,0.000047,0.000437,209,0.000273,0,29,0.566667,0.000712
31049,Deuel County,,NE,80,2141,2221,0,0,0,0,0,0,0,0,0,0,0,0,181,0.000054,172,273,0,0
31051,Dixon County,,NE,355,7288,7643,1,0,1,74,0,74,0,0,0,0,0,0,209,0.000098,0,13,0,0.00012
31053,Dodge County,,NE,1925,44299,46224,7,6,13,937,1016,1953,8,0.262987,0.276887,28.186806,0.000691,0.000481,209,0.000328,0,29,0.482143,0.004163
31055,Douglas County,,NE,28518,651988,680506,54,55,109,15804,16174,31978,7,0.355781,0.39001,123362.274334,0.026775,0.037889,209,0.001861,0,29,0.315016,0.182413
31057,Dundy County,,NE,82,2099,2181,0,0,0,0,0,0,0,0,0,0,0,0,182,0.000054,173,274,0,0
31059,Fillmore County,,NE,215,7112,7327,0,0,0,0,0,0,0,0,0,0,0,0,183,0.000054,174,275,0,0
31061,Franklin County,,NE,126,3699,3825,0,0,0,0,0,0,0,0,0,0,0,0,184,0.000054,175,276,0,0
31063,Frontier County,,NE,181,2923,3104,0,0,0,0,0,0,0,0,0,0,0,0,185,0.000054,176,277,0,0
31065,Furnas County,,NE,262,5759,6021,0,0,0,0,0,0,0,0,0,0,0,0,186,0.000054,177,278,0,0
31067,Gage County,,NE,850,26117,26967,3,2,5,384,374,758,8,0.257033,0.268751,2745,0.000201,0.000115,209,0.000165,0,29,0.5,0.001192
31069,Garden County,,NE,81,2195,2276,0,0,0,0,0,0,0,0,0,0,0,0,187,0.000054,178,279,0,0
31071,Garfield County,,NE,81,2054,2135,0,0,0,0,0,0,0,0,0,0,0,0,188,0.000054,179,280,0,0
31073,Gosper County,,NE,154,2357,2511,1,1,2,70,61,131,9,0.20834,0.215105,0,0.000005,0.000001,209,0.000092,0,29,0,0.000135
31075,Grant County,,NE,-2,858,856,0,0,0,0,0,0,0,0,0,0,0,0,189,0.000054,180,281,0,0
31077,Greeley County,,NE,114,2902,3016,0,0,0,0,0,0,0,0,0,0,0,0,190,0.000054,181,282,0,0
31079,Hall County,,NE,3898,73835,77733,11,11,22,1636,1785,3421,7,0.304879,0.326881,21877.743204,0.001981,0.003441,209,0.000619,0,29,0.25,0.01209
31081,Hamilton County,,NE,453,11793,12246,1,1,2,168,146,314,8,0.233666,0.24307,0,0.000037,0.000022,209,0.000101,0,29,0,0.000271
31083,Harlan County,,NE,148,3998,4146,0,0,0,0,0,0,0,0,0,0,0,0,191,0.000054,182,283,0,0
31085,Hayes County,,NE,-2,1115,1113,0,0,0,0,0,0,0,0,0,0,0,0,192,0.000054,183,284,0,0
31087,Hitchcock County,,NE,123,3393,3516,0,0,0,0,0,0,0,0,0,0,0,0,193,0.000054,184,285,0,0
31089,Holt County,,NE,414,13013,13427,0,0,0,0,0,0,0,0,0,0,0,0,194,0.000054,185,286,0,0
31091,Hooker County,,NE,-2,919,917,0,0,0,0,0,0,0,0,0,0,0,0,195,0.000054,186,287,0,0
31093,Howard County,,NE,286,7786,8072,1,1,2,110,136,246,8,0.233666,0.24307,0,0.000037,0.000022,209,0.000101,0,29,0,0.000271
31095,Jefferson County,,NE,252,8783,9035,1,2,3,78,146,224,8,0.257033,0.268751,0,0.000001,0.000117,209,0.000124,0,29,1,0.000136
31097,Johnson County,,NE,188,5257,5445,1,1,2,52,53,105,8,0.256983,0.268501,0,0.000196,0.000115,209,0.000087,0,29,0,0.000947
31099,Kearney County,,NE,344,7993,8337,1,1,2,200,147,347,9,0.208356,0.215167,0,0.000005,0.000007,209,0.000112,0,29,0,0.000182
31101,Keith County,,NE,386,9691,10077,1,1,2,81,72,153,9,0.20834,0.215105,0,0.000005,0.000002,209,0.000089,0,29,0,0.000141
31103,Keya Paha County,,NE,-2,1031,1029,0,0,0,0,0,0,0,0,0,0,0,0,196,0.000054,187,288,0,0
31105,Kimball County,,NE,209,4159,4368,0,0,0,0,0,0,0,0,0,0,0,0,197,0.000054,188,289,0,0
31107,Knox County,,NE,267,10246,10513,0,0,0,0,0,0,0,0,0,0,0,0,198,0.000054,189,290,0,0
31109,Lancaster County,,NE,10666,347999,358665,31,33,64,5476,5406,10882,7,0.34582,0.375705,70132.044057,0.010602,0.018011,209,0.001311,0,29,0.238462,0.071526
31111,Lincoln County,,NE,1606,42144,43750,4,6,10,277,465,742,8,0.263142,0.277231,8340.144734,0.0002,0.000435,209,0.000247,0,29,0.428571,0.001314
31113,Logan County,,NE,-2,957,955,0,0,0,0,0,0,0,0,0,0,0,0,199,0.000054,190,291,0,0
31115,Loup County,,NE,-2,663,661,0,0,0,0,0,0,0,0,0,0,0,0,200,0.000054,191,292,0,0
31117,McPherson County,,NE,-2,549,547,0,0,0,0,0,0,0,0,0,0,0,0,201,0.000054,192,293,0,0
31119,Madison County,,NE,2203,42257,44460,8,8,16,758,905,1663,8,0.263194,0.277605,24426.686822,0.001962,0.000435,209,0.000489,0,29,0.180556,0.011583
31121,Merrick County,,NE,377,9229,9606,1,1,2,185,131,316,8,0.233666,0.24307,0,0.000037,0.000022,209,0.000101,0,29,0,0.000271
31123,Morrill County,,NE,276,5527,5803,1,1,2,115,116,231,8,0.234261,0.242939,0,0.000024,0,209,0.000086,0,29,0,0.000127
31125,Nance County,,NE,167,4228,4395,0,0,0,0,0,0,0,0,0,0,0,0,202,0.000054,193,294,0,0
31127,Nemaha County,,NE,355,7766,8121,0,1,1,0,69,69,9,0.208093,0.214593,0,0,0.000007,209,0.000054,0,295,0,0
31129,Nuckolls County,,NE,155,5389,5544,0,0,0,0,0,0,0,0,0,0,0,0,203,0.000054,194,296,0,0
31131,Otoe County,,NE,820,19169,19989,3,2,5,382,329,711,8,0.262676,0.275775,2668,0.000607,0.000406,209,0.000162,0,29,0.333333,0.003184
31133,Pawnee County,,NE,99,3216,3315,0,0,0,0,0,0,0,0,0,0,0,0,204,0.000054,195,297,0,0
31135,Perkins County,,NE,92,3636,3728,0,0,0,0,0,0,0,0,0,0,0,0,205,0.000054,196,298,0,0
31137,Phelps County,,NE,363,11354,11717,1,1,2,121,100,221,9,0.208356,0.215167,0,0.000005,0.000007,209,0.000112,0,29,0,0.000182
31139,Pierce County,,NE,228,9070,9298,1,1,2,113,83,196,9,0.208372,0.21523,0,0.000005,0.000021,209,0.000106,0,29,0,0.000255
31141,Platte County,,NE,1799,42732,44531,9,8,17,847,775,1622,7,0.291744,0.31024,11413.387507,0.001995,0.001756,209,0.00043,0,29,0.291667,0.011907
31143,Polk County,,NE,306,6537,6843,1,1,2,70,48,118,8,0.225872,0.234091,0,0.000019,0.000022,209,0.000099,0,29,0,0.000262
31145,Red Willow County,,NE,486,12814,13300,0,0,0,0,0,0,0,0,0,0,0,0,206,0.000054,197,299,0,0
31147,Richardson County,,NE,260,9639,9899,0,0,0,0,0,0,0,0,0,0,0,0,207,0.000054,198,300,0,0
31149,Rock County,,NE,62,1652,1714,0,0,0,0,0,0,0,0,0,0,0,0,208,0.000054,199,301,0,0
31151,Saline County,,NE,900,16668,17568,1,3,4,286,460,746,8,0.262728,0.276025,0,0.000196,0.000408,209,0.000087,0,29,0.666667,0.000947
31153,Sarpy County,,NE,12885,212189,225074,12,12,24,8360,7815,16175,7,0.313698,0.336281,3945.895932,0.003793,0.006272,209,0.00049,0,29,0.333333,0.02525
31155,Saunders County,,NE,1201,25543,26744,4,4,8,737,700,1437,8,0.262728,0.27615,0,0.00068,0.000455,209,0.000197,0,29,1,0.00366
31157,Scotts Bluff County,,NE,1761,41655,43416,3,6,9,291,466,757,7,0.305893,0.325925,8587.286991,0.000001,0.002211,209,0.000226,0,29,0.238095,0.000361
31159,Seward County,,NE,878,19946,20824,1,2,3,308,440,748,8,0.257008,0.268688,0,0.000196,0.000117,209,0.000087,0,29,1,0.000947
31161,Sheridan County,,NE,245,5951,6196,0,0,0,0,0,0,0,0,0,0,0,0,210,0.000054,200,302,0,0
31163,Sherman County,,NE,125,3629,3754,0,0,0,0,0,0,0,0,0,0,0,0,211,0.000054,201,303,0,0
31165,Sioux County,,NE,-2,1427,1425,0,0,0,0,0,0,0,0,0,0,0,0,212,0.000054,202,304,0,0
31167,Stanton County,,NE,380,7084,7464,1,1,2,200,199,399,9,0.208372,0.21523,0,0.000005,0.000021,209,0.000106,0,29,0,0.000255
31169,Thayer County,,NE,213,6459,6672,0,0,0,0,0,0,0,0,0,0,0,0,213,0.000054,203,305,0,0
31171,Thomas County,,NE,-2,797,795,0,0,0,0,0,0,0,0,0,0,0,0,214,0.000054,204,306,0,0
31173,Thurston County,,NE,281,7315,7596,0,0,0,0,0,0,0,0,0,0,0,0,215,0.000054,205,307,0,0
31175,Valley County,,NE,123,5095,5218,0,0,0,0,0,0,0,0,0,0,0,0,216,0.000054,206,308,0,0
31177,Washington County,,NE,1043,24686,25729,2,2,4,565,539,1104,8,0.262469,0.275338,0,0.000417,0.000298,209,0.000129,0,29,1,0.002304
31179,Wayne County,,NE,452,9616,10068,1,2,3,73,150,223,9,0.208405,0.21548,2746,0.000005,0.000021,209,0.000106,0,29,0,0.000255
31181,Webster County,,NE,135,4087,4222,0,0,0,0,0,0,0,0,0,0,0,0,217,0.000054,207,309,0,0
31183,Wheeler County,,NE,-2,964,962,0,0,0,0,0,0,0,0,0,0,0,0,218,0.000054,208,310,0,0
31185,York County,,NE,860,16771,17631,2,1,3,123,150,273,8,0.256983,0.268501,0,0.000197,0.000115,209,0.000125,0,29,1,0.001074
32001,Churchill County,,NV,2211,26453,28664,4,3,7,578,664,1242,7,0.300857,0.319787,14.053611,0.003326,0.002142,11,0.000161,0,29,0.916667,0.022861
32003,Clark County,,NV,79670,2363576,2443246,273,221,494,85287,59680,144967,6,0.409831,0.4633,191156.932812,0.138277,0.119436,11,0.005401,0,29,0.176566,0.842298
32005,Douglas County,,NV,3442,59447,62889,12,6,18,2326,1825,4151,7,0.309082,0.329335,25.482289,0.009772,0.004011,11,0.000304,0,29,0.848485,0.06548
32007,Elko County,,NV,3548,60666,64214,8,6,14,1072,1032,2104,7,0.292801,0.31152,2943.5125,0.002892,0.002985,11,0.000296,0,29,0.428571,0.020142
32009,Esmeralda County,,NV,-2,889,887,0,0,0,0,0,0,0,0,0,0,0,0,219,0.000054,209,311,0,0
32011,Eureka County,,NV,170,1942,2112,0,0,0,0,0,0,0,0,0,0,0,0,220,0.000054,210,312,0,0
32013,Humboldt County,,NV,1495,20545,22040,2,4,6,200,431,631,8,0.256292,0.269909,8156,0.000464,0.000422,11,0.000143,0,29,0.25,0.002866
32015,Lander County,,NV,522,6722,7244,1,1,2,63,113,176,8,0.226543,0.234917,0,0.000005,0.000031,11,0.000084,0,29,0.5,0.000148
32017,Lincoln County,,NV,277,4544,4821,1,1,2,106,105,211,7,0.290727,0.307441,0,0.001297,0.001501,11,0.000074,0,29,0,0.009271
32019,Lyon County,,NV,4128,59199,63327,11,5,16,2802,2123,4925,7,0.291139,0.308659,45.976329,0.00865,0.002111,11,0.000312,0,29,0.745455,0.058717
32021,Mineral County,,NV,282,4422,4704,0,1,1,0,56,56,8,0.256044,0.269028,0,0,0.00039,11,0.000054,0,313,0,0
32023,Nye County,,NV,2997,42376,45373,4,2,6,1424,1162,2586,7,0.291044,0.308097,0,0.004272,0.001892,11,0.00012,0,29,1,0.027629
32027,Pershing County,,NV,333,5250,5583,1,1,2,106,95,201,9,0.204022,0.210672,0,0.000005,0.000005,11,0.000084,0,29,0,0.000148
32029,Storey County,,NV,290,4031,4321,1,1,2,242,135,377,8,0.255997,0.268941,0,0.000464,0.00039,11,0.000072,0,29,0,0.002748
32031,Washoe County,,NV,18526,510253,528779,65,66,131,15642,12134,27776,7,0.344036,0.37896,30233.303916,0.035954,0.042771,11,0.001429,0,29,0.452153,0.245177
32033,White Pine County,,NV,599,9956,10555,1,1,2,109,144,253,7,0.290727,0.307441,0,0.001297,0.001501,11,0.000074,0,29,0,0.009271
32510,Carson City,,NV,4145,61568,65713,9,6,15,2659,2543,5202,7,0.309082,0.329335,24.898956,0.007129,0.00404,11,0.000265,0,29,0.875,0.047946
33001,Belknap County,,NH,3728,75990,79718,10,7,17,2554,2129,4683,8,0.274203,0.291365,0.748587,0.004025,0.001752,110,0.000193,0,29,0.9,0.021189
33003,Carroll County,,NH,3051,58536,61587,13,12,25,1646,1546,3192,8,0.274655,0.292989,369.323984,0.003652,0.002463,110,0.00027,0,29,0.666667,0.018599
33005,Cheshire County,,NH,3442,88830,92272,9,9,18,1630,1465,3095,8,0.274203,0.291646,104.287185,0.002339,0.002183,110,0.000204,0,29,0.554545,0.012674
33007,Coos County,,NH,1461,35444,36905,5,5,10,446,493,939,8,0.253733,0.267087,3671.8489,0.000421,0.000382,110,0.000181,0,29,0.666667,0.002457
33009,Grafton County,,NH,5544,101140,106684,17,19,36,2751,2999,5750,7,0.285043,0.305889,2602.682676,0.005244,0.005329,110,0.00035,0,29,0.467532,0.027103
33011,Hillsborough County,,NH,19499,499094,518593,34,49,83,13750,13951,27701,7,0.33944,0.372148,11866.190926,0.022272,0.040248,110,0.00056,0,29,0.568215,0.130812
33013,Merrimack County,,NH,7863,175961,183824,13,14,27,5616,5231,10847,8,0.274853,0.293601,493.665138,0.004007,0.00339,110,0.000278,0,29,0.638095,0.022049
33015,Rockingham County,,NH,16932,388485,405417,29,36,65,13497,12549,26046,7,0.332544,0.361703,6366.89597,0.017207,0.027612,110,0.000467,0,29,0.580128,0.09771
33017,Strafford County,,NH,6801,142000,148801,13,10,23,4670,4213,8883,8,0.274627,0.292633,8.037964,0.004494,0.003291,110,0.000245,0,29,0.788462,0.023359
33019,Sullivan County,,NH,2169,50660,52829,6,5,11,1134,1002,2136,8,0.253853,0.267337,3.863116,0.000585,0.000383,110,0.000157,0,29,0.6,0.003073
34001,Atlantic County,,NJ,12264,333156,345420,25,40,65,5822,8056,13878,7,0.330484,0.358867,429.08572,0.018723,0.031585,271,0.000303,0,29,0.694231,0.095663
34003,Bergen County,,NJ,46108,1138709,1184817,67,96,163,37368,38867,76235,7,0.362746,0.402694,1665.805566,0.057692,0.07948,271,0.000841,0,29,0.583763,0.326628
34005,Burlington County,,NJ,22809,549032,571841,38,63,101,14972,15771,30743,7,0.343549,0.377754,884.96774,0.03155,0.053384,271,0.00044,0,29,0.648562,0.166785
34007,Camden County,,NJ,23803,599073,622876,37,52,89,17505,18480,35985,7,0.340176,0.372325,944.360187,0.029349,0.043003,271,0.00043,0,29,0.674675,0.153344
34009,Cape May County,,NJ,5422,114923,120345,11,16,27,2509,3053,5562,7,0.292736,0.313434,3.749125,0.005511,0.010143,271,0.000146,0,29,0.804167,0.023317
34011,Cumberland County,,NJ,5718,173976,179694,8,9,17,3400,3131,6531,7,0.318529,0.34073,179.350998,0.004398,0.004469,271,0.000133,0,29,0.861111,0.022956
34013,Essex County,,NJ,44662,876320,920982,65,89,154,33438,37905,71343,7,0.358025,0.396953,1807.057836,0.055048,0.073206,271,0.000805,0,29,0.597924,0.303866
34015,Gloucester County,,NJ,12458,348807,361265,19,20,39,9916,9005,18921,7,0.308868,0.332294,149.60711,0.011413,0.012668,271,0.000222,0,29,0.777174,0.051777
34017,Hudson County,,NJ,53279,735775,789054,82,102,184,38571,46549,85120,7,0.36719,0.408085,3113.17013,0.068564,0.082041,271,0.001049,0,29,0.547978,0.385808
34019,Hunterdon County,,NJ,6337,160066,166403,18,20,38,4473,3777,8250,7,0.293736,0.314765,3.7573,0.011678,0.011789,271,0.000195,0,29,0.909091,0.050653
34021,Mercer County,,NJ,19161,421581,440742,42,55,97,12333,14046,26379,7,0.344836,0.378141,233.2676,0.035497,0.049654,271,0.000467,0,29,0.777322,0.182012
34023,Middlesex County,,NJ,48530,1005768,1054298,76,105,181,35425,41152,76577,7,0.361518,0.402819,2724.492433,0.064891,0.082227,271,0.000977,0,29,0.532624,0.367686
34025,Monmouth County,,NJ,26223,779325,805548,40,71,111,19284,20652,39936,7,0.347939,0.383757,523.584009,0.033732,0.060854,271,0.00045,0,29,0.649061,0.176377
34027,Morris County,,NJ,26310,627355,653665,49,77,126,18905,20335,39240,7,0.352537,0.389463,1385.950938,0.042096,0.063735,271,0.000582,0,29,0.627539,0.229035
34029,Ocean County,,NJ,20326,707380,727706,42,62,104,16235,15160,31395,7,0.341613,0.375259,946.854902,0.033101,0.046663,271,0.000489,0,29,0.610087,0.175647
34031,Passaic County,,NJ,26237,610458,636695,33,52,85,17384,20608,37992,7,0.342007,0.37454,323.156455,0.027042,0.042956,271,0.000369,0,29,0.694969,0.139109
34033,Salem County,,NJ,3216,76078,79294,7,6,13,1914,1878,3792,8,0.273473,0.289881,0.253968,0.003282,0.002282,271,0.000117,0,29,0.97619,0.014871
34035,Somerset County,,NJ,21392,415251,436643,36,57,93,16104,16785,32889,7,0.346944,0.380465,432.259434,0.030598,0.052049,271,0.000411,0,29,0.75716,0.16031
34037,Sussex County,,NJ,6978,178731,185709,15,19,34,4461,4253,8714,7,0.292897,0.313988,8.69129,0.00973,0.011902,271,0.000184,0,29,0.818713,0.045492
34039,Union County,,NJ,32351,657201,689552,45,67,112,24942,26946,51888,7,0.346629,0.38154,732.514522,0.038632,0.056621,271,0.000521,0,29,0.697648,0.206798
34041,Warren County,,NJ,5510,131233,136743,17,18,35,4266,3486,7752,8,0.288308,0.308537,2.952353,0.009984,0.008656,271,0.000185,0,29,0.895425,0.042862
35001,Bernalillo County,,NM,31335,738997,770332,68,82,150,18920,21295,40215,7,0.354081,0.392472,55479.68245,0.040552,0.052627,227,0.001586,0,29,0.358934,0.278683
35003,Catron County,,NM,215,3155,3370,0,0,0,0,0,0,0,0,0,0,0,0,221,0.000054,211,314,0,0
35005,Chaves County,,NM,3100,66964,70064,7,9,16,1054,1163,2217,7,0.307338,0.328573,101.246346,0.001587,0.003411,350,0.000186,0,29,0.677778,0.009488
35006,Cibola County,,NM,1211,23196,24407,4,3,7,789,678,1467,8,0.261594,0.275839,0.967857,0.000676,0.000497,227,0.000153,0,29,0.666667,0.004078
35007,Colfax County,,NM,804,12770,13574,1,1,2,59,86,145,8,0.261517,0.275402,0,0.000571,0.00044,227,0.00007,0,29,0,0.003096
35009,Curry County,,NM,4900,53935,58835,7,12,19,910,1501,2411,7,0.315143,0.338318,9059.886212,0.001921,0.006843,350,0.000196,0,29,0.43956,0.012114
35011,De Baca County,,NM,68,2052,2120,0,0,0,0,0,0,0,0,0,0,0,0,222,0.000054,212,315,0,0
35013,Dona Ana County,,NM,12220,225898,238118,24,33,57,6291,7937,14228,7,0.335682,0.365176,4809.448057,0.016336,0.022759,350,0.000564,0,29,0.445076,0.11344
35015,Eddy County,,NM,3275,61794,65069,7,10,17,1299,1408,2707,7,0.30748,0.328917,21.169751,0.001804,0.003683,350,0.000193,0,29,0.777778,0.011231
35017,Grant County,,NM,1521,30982,32503,3,5,8,224,581,805,7,0.305054,0.324713,0.468384,0.00253,0.003152,350,0.000107,0,29,0.8,0.017316
35019,Guadalupe County,,NM,185,4339,4524,0,0,0,0,0,0,0,0,0,0,0,0,223,0.000054,213,316,0,0
35021,Harding County,,NM,-2,755,753,0,0,0,0,0,0,0,0,0,0,0,0,224,0.000054,214,317,0,0
35023,Hidalgo County,,NM,240,4628,4868,0,0,0,0,0,0,0,0,0,0,0,0,225,0.000054,215,318,0,0
35025,Lea County,,NM,4028,77500,81528,12,11,23,1788,1496,3284,7,0.303216,0.325507,1070.362051,0.003697,0.004986,350,0.000345,0,29,0.56044,0.02554
35027,Lincoln County,,NM,1427,20682,22109,5,4,9,403,476,879,8,0.262083,0.27662,0.309524,0.001533,0.000693,350,0.000133,0,29,0.9,0.009093
35028,Los Alamos County,,NM,1033,23022,24055,2,3,5,259,312,571,8,0.261569,0.275777,0,0.000797,0.00066,227,0.000089,0,29,1,0.004633
35029,Luna County,,NM,1451,27356,28807,4,3,7,465,513,978,7,0.305683,0.325231,1.552767,0.002411,0.002481,350,0.000124,0,29,0.833333,0.01645
35031,McKinley County,,NM,6449,83102,89551,8,8,16,8855,5241,14096,7,0.305158,0.325337,247.060676,0.002549,0.002501,227,0.000232,0,29,0.642857,0.016974
35033,Mora County,,NM,233,4667,4900,1,1,2,86,95,181,9,0.207384,0.214346,0,0.000008,0.000009,227,0.000089,0,29,0,0.00017
35035,Otero County,,NM,5316,64228,69544,8,13,21,1999,2219,4218,7,0.312815,0.33567,714.526545,0.005318,0.007797,350,0.000211,0,29,0.557692,0.036738
35037,Quay County,,NM,424,8700,9124,0,0,0,0,0,0,0,0,0,0,0,0,226,0.000054,216,319,0,0
35039,Rio Arriba County,,NM,2068,39347,41415,5,5,10,1197,1415,2612,8,0.261748,0.276433,4.691872,0.000864,0.000787,227,0.000166,0,29,0.633333,0.005319
35041,Roosevelt County,,NM,1692,19302,20994,1,3,4,329,516,845,8,0.261671,0.276027,0.311111,0.000074,0.000501,350,0.000068,0,29,0.666667,0.000256
35043,Sandoval County,,NM,9877,151639,161516,13,13,26,7052,5697,12749,7,0.31743,0.340557,1021.482072,0.008903,0.010276,227,0.000338,0,29,0.55,0.059645
35045,San Juan County,,NM,12770,134014,146784,12,16,28,3956,9688,13644,7,0.308689,0.331247,3192.618515,0.002862,0.004824,227,0.000343,0,29,0.30719,0.019313
35047,San Miguel County,,NM,1389,26612,28001,3,4,7,457,768,1225,8,0.26162,0.276027,5412,0.000798,0.000747,227,0.000165,0,29,0.5,0.004752
35049,Santa Fe County,,NM,8284,173318,181602,24,25,49,4339,4675,9014,7,0.335766,0.364039,10505.088911,0.019331,0.020813,227,0.000569,0,29,0.550575,0.13406
35051,Sierra County,,NM,721,10975,11696,2,2,4,177,223,400,8,0.261851,0.276008,0,0.000819,0.000618,350,0.000085,0,29,1,0.004432
35053,Socorro County,,NM,917,16907,17824,2,2,4,280,393,673,8,0.261543,0.275589,0,0.000596,0.00047,227,0.00011,0,29,1,0.003415
35055,Taos County,,NM,1790,34652,36442,3,3,6,386,541,927,8,0.261569,0.275777,0,0.000806,0.00066,227,0.000118,0,29,1,0.004816
35057,Torrance County,,NM,1058,13810,14868,2,2,4,506,576,1082,8,0.261543,0.275589,0,0.000797,0.00065,227,0.000089,0,29,1,0.004633
35059,Union County,,NM,192,4110,4302,0,0,0,0,0,0,0,0,0,0,0,0,228,0.000054,217,320,0,0
35061,Valencia County,,NM,3880,76313,80193,7,5,12,2291,2171,4462,7,0.304949,0.324588,532.118904,0.002703,0.002275,227,0.000238,0,29,0.571429,0.017947
36001,Albany County,,NY,16594,353551,370145,35,43,78,11504,11726,23230,7,0.341657,0.373316,22563.145972,0.017982,0.032451,230,0.000599,0,29,0.457058,0.096379
36003,Allegany County,,NY,1761,48871,50632,5,6,11,637,889,1526,8,0.269686,0.284809,10.444169,0.001506,0.000932,230,0.000143,0,29,0.733333,0.006047
36005,Bronx County,,NY,81360,1501131,1582491,91,126,217,64357,73822,138179,7,0.367089,0.412264,6707.749964,0.069557,0.085659,271,0.001193,0,29,0.411725,0.388645
36007,Broome County,,NY,6940,217660,224600,18,22,40,2909,3166,6075,7,0.296313,0.320347,9877.81444,0.007961,0.010734,230,0.000355,0,29,0.397233,0.040777
36009,Cattaraugus County,,NY,3032,86467,89499,5,6,11,1514,1774,3288,8,0.269631,0.284759,2879.419443,0.000804,0.000932,230,0.000166,0,29,0.5,0.003562
36011,Cayuga County,,NY,2808,87769,90577,8,8,16,1627,1556,3183,8,0.269877,0.285453,29.228808,0.001397,0.001263,230,0.000189,0,29,0.611111,0.005746
36013,Chautauqua County,,NY,3770,143157,146927,5,7,12,1258,1450,2708,8,0.279021,0.296668,158.070996,0.001632,0.001895,230,0.000126,0,29,0.47619,0.006307
36015,Chemung County,,NY,3305,98319,101624,7,9,16,1561,1467,3028,8,0.270205,0.286215,949.297618,0.00025,0.001064,230,0.000214,0,29,0.402778,0.001898
36017,Chenango County,,NY,2357,56676,59033,5,6,11,1135,1232,2367,8,0.23002,0.241653,13.477917,0.000147,0.000231,230,0.00017,0,29,0.466667,0.001448
36019,Clinton County,,NY,2252,89720,91972,4,4,8,697,543,1240,8,0.257008,0.270809,1514.488618,0.000235,0.000309,230,0.000167,0,29,0.25,0.001221
36021,Columbia County,,NY,2994,71788,74782,10,10,20,1706,1631,3337,7,0.292095,0.312067,24.587407,0.005662,0.003666,271,0.00018,0,29,0.692308,0.030903
36023,Cortland County,,NY,1998,50817,52815,6,5,11,954,902,1856,8,0.261671,0.27528,125.597093,0.00076,0.000435,230,0.000156,0,29,0.533333,0.003206
36025,Delaware County,,NY,2245,49014,51259,7,6,13,947,1032,1979,7,0.283077,0.300717,1178.758086,0.003829,0.00161,230,0.000156,0,29,0.513889,0.020428
36027,Dutchess County,,NY,12059,340992,353051,27,36,63,8079,7725,15804,7,0.336826,0.366626,576.143344,0.021523,0.030837,271,0.000349,0,29,0.649359,0.115685
36029,Erie County,,NY,22655,1078271,1100926,57,82,139,11855,14623,26478,7,0.36724,0.405537,37086.55209,0.041759,0.069363,230,0.000997,0,29,0.456044,0.257384
36031,Essex County,,NY,1851,42346,44197,4,4,8,709,837,1546,9,0.205278,0.213008,330.618021,0.000233,0.000017,230,0.000175,0,29,0.4,0.001467
36033,Franklin County,,NY,1565,50975,52540,3,3,6,636,708,1344,9,0.214798,0.223201,20.592902,0.00002,0.000021,230,0.000143,0,29,0.5,0.000469
36035,Fulton County,,NY,2294,61130,63424,5,5,10,1405,1273,2678,8,0.256317,0.269612,63.246256,0.000646,0.000436,230,0.000141,0,29,0.7,0.003001
36037,Genesee County,,NY,2410,69700,72110,6,6,12,1380,1539,2919,8,0.269468,0.284447,2.666667,0.00155,0.000948,230,0.000166,0,29,0.733333,0.006271
36039,Greene County,,NY,2420,52215,54635,9,7,16,1428,1149,2577,7,0.288121,0.306826,1.470328,0.005651,0.004303,271,0.000163,0,29,0.902778,0.030407
36041,Hamilton County,,NY,292,6106,6398,0,0,0,0,0,0,0,0,0,0,0,0,229,0.000054,218,321,0,0
36043,Herkimer County,,NY,2380,70283,72663,4,6,10,1250,1315,2565,8,0.261364,0.275055,26.582765,0.000102,0.000359,230,0.000141,0,29,0.333333,0.001051
36045,Jefferson County,,NY,13158,128346,141504,28,31,59,3611,4826,8437,7,0.334085,0.364073,10742.047168,0.016534,0.020343,230,0.000572,0,29,0.502521,0.108194
36047,Kings County,,NY,152431,2843692,2996123,206,208,414,110754,138590,249344,7,0.399282,0.452771,75750.875294,0.127386,0.121428,271,0.003138,0,29,0.248996,0.742757
36049,Lewis County,,NY,1290,31323,32613,3,3,6,596,656,1252,8,0.251579,0.26436,1.861169,0.000325,0.000267,230,0.000102,0,29,0.666667,0.001983
36051,Livingston County,,NY,2633,69924,72557,7,7,14,1659,1751,3410,8,0.269658,0.284903,10.389665,0.001529,0.000963,230,0.000189,0,29,0.666667,0.006489
36053,Madison County,,NY,3351,78050,81401,5,4,9,1900,1829,3729,8,0.26121,0.27443,89.501241,0.000611,0.000341,230,0.000144,0,29,0.5,0.002566
36055,Monroe County,,NY,20873,879666,900539,57,83,140,11132,13697,24829,7,0.361322,0.399702,48156.116518,0.039433,0.066492,230,0.000987,0,29,0.471134,0.23676
36057,Montgomery County,,NY,2544,56123,58667,6,6,12,1483,1631,3114,8,0.256341,0.269799,71.144904,0.000649,0.00044,230,0.000173,0,29,0.6,0.003151
36059,Nassau County,,NY,57213,1754558,1811771,65,121,186,47798,49928,97726,7,0.364182,0.407567,2588.241178,0.058898,0.087843,271,0.000907,0,29,0.452107,0.343478
36061,New York County,,NY,153975,1805216,1959191,212,187,399,124199,139505,263704,6,0.393626,0.444746,83674.962075,0.127706,0.113846,271,0.00335,0,29,0.25631,0.749439
36063,Niagara County,,NY,7096,254031,261127,5,7,12,4102,3997,8099,7,0.308261,0.329467,205.369207,0.001516,0.004133,230,0.000137,0,29,0.607143,0.006072
36065,Oneida County,,NY,7310,259927,267237,15,17,32,3052,3341,6393,7,0.294709,0.316736,5127.505062,0.00664,0.008102,230,0.000308,0,29,0.450292,0.034978
36067,Onondaga County,,NY,15291,545237,560528,35,53,88,7775,8972,16747,7,0.353144,0.386837,22311.719671,0.023054,0.04663,230,0.000598,0,29,0.522243,0.135203
36069,Ontario County,,NY,5185,131703,136888,9,9,18,3216,3165,6381,8,0.269904,0.285609,37.880551,0.002148,0.001204,230,0.00021,0,29,0.533333,0.008546
36071,Orange County,,NY,17457,453476,470933,32,51,83,11583,11322,22905,7,0.337764,0.36998,799.330574,0.027046,0.040747,271,0.000415,0,29,0.613933,0.149952
36073,Orleans County,,NY,1549,45605,47154,4,4,8,985,1058,2043,8,0.269413,0.284072,0,0.00153,0.000915,230,0.000114,0,29,1,0.005885
36075,Oswego County,,NY,4746,133093,137839,7,7,14,2434,2654,5088,8,0.2686,0.284203,58.412825,0.001568,0.000966,230,0.000173,0,29,0.619048,0.006556
36077,Otsego County,,NY,2788,64703,67491,7,7,14,1277,1173,2450,8,0.255482,0.269198,678.095559,0.001441,0.000403,230,0.000191,0,29,0.428571,0.00812
36079,Putnam County,,NY,5689,119450,125139,10,12,22,4275,3906,8181,7,0.291936,0.311876,0,0.008478,0.009404,271,0.000145,0,29,0.99359,0.042549
36081,Queens County,,NY,130408,2694339,2824747,141,173,314,94981,119213,214194,7,0.382564,0.433135,27640.946008,0.099739,0.111356,271,0.00202,0,29,0.331632,0.580743
36083,Rensselaer County,,NY,9231,183013,192244,17,14,31,6137,6058,12195,7,0.289245,0.3097,2394.553583,0.007279,0.005725,230,0.000314,0,29,0.506536,0.037704
36085,Richmond County,,NY,19485,554941,574426,24,45,69,14435,13892,28327,7,0.341046,0.371907,73.179017,0.022753,0.038535,271,0.000292,0,29,0.775253,0.118467
36087,Rockland County,,NY,12328,390788,403116,24,29,53,7964,8168,16132,7,0.329464,0.356872,47.94646,0.020522,0.024195,271,0.000271,0,29,0.857471,0.101106
36089,St. Lawrence County,,NY,3350,111869,115219,5,8,13,716,1018,1734,8,0.272579,0.289157,4878.749706,0.001452,0.001513,230,0.000158,0,29,0.392857,0.005782
36091,Saratoga County,,NY,12436,280260,292696,26,28,54,9113,7513,16626,7,0.335092,0.363624,13643.695513,0.015158,0.0207,230,0.000453,0,29,0.448791,0.083535
36093,Schenectady County,,NY,7787,182654,190441,12,12,24,4893,4643,9536,7,0.28887,0.308813,1529.237289,0.006233,0.005527,230,0.000248,0,29,0.516484,0.03415
36095,Schoharie County,,NY,1259,33709,34968,5,4,9,624,463,1087,8,0.254969,0.267786,7.062173,0.000439,0.000286,230,0.000153,0,29,0.45,0.002388
36097,Schuyler County,,NY,1049,21277,22326,4,4,8,505,594,1099,8,0.240122,0.251012,4.238828,0.000146,0.000101,230,0.000143,0,29,0.5,0.001077
36099,Seneca County,,NY,1606,38303,39909,5,7,12,843,888,1731,8,0.266161,0.281117,3.087179,0.00088,0.000821,230,0.000135,0,29,0.714286,0.003833
36101,Steuben County,,NY,3907,111962,115869,8,9,17,1596,1770,3366,8,0.269959,0.285684,1708.735898,0.000774,0.000951,230,0.000244,0,29,0.416667,0.003868
36103,Suffolk County,,NY,49611,1901058,1950669,87,136,223,34548,39781,74329,7,0.367949,0.413895,5434.638431,0.070301,0.09514,271,0.001263,0,29,0.407067,0.413301
36105,Sullivan County,,NY,4065,81695,85760,9,9,18,1946,1892,3838,7,0.291617,0.310908,2.375378,0.00714,0.007221,271,0.000146,0,29,0.9,0.037156
36107,Tioga County,,NY,2692,59828,62520,4,5,9,1273,1557,2830,8,0.242899,0.255031,198.608478,0.000248,0.00018,230,0.000126,0,29,0.65,0.001454
36109,Tompkins County,,NY,5252,94651,99903,14,18,32,1819,2290,4109,7,0.315292,0.339683,12058.599925,0.007549,0.010929,230,0.000285,0,29,0.44152,0.041829
36111,Ulster County,,NY,7896,203667,211563,16,20,36,5173,4416,9589,7,0.313809,0.337856,334.718556,0.010548,0.013312,271,0.000254,0,29,0.665789,0.055828
36113,Warren County,,NY,4055,78488,82543,6,5,11,2260,2369,4629,8,0.256366,0.269737,886.697129,0.000704,0.000448,230,0.000184,0,29,0.666667,0.003551
36115,Washington County,,NY,3204,69633,72837,7,6,13,2043,2106,4149,8,0.256637,0.270274,1014.952538,0.000649,0.000451,230,0.000221,0,29,0.452381,0.003355
36117,Wayne County,,NY,4018,111807,115825,6,7,13,2447,2564,5011,8,0.269686,0.284966,5.129895,0.001274,0.001197,230,0.000151,0,29,0.738095,0.005019
36119,Westchester County,,NY,48047,1174039,1222086,68,100,168,36083,40029,76112,7,0.356589,0.397375,3337.71505,0.060705,0.078089,271,0.000914,0,29,0.526014,0.348258
36121,Wyoming County,,NY,1550,45909,47459,6,5,11,1071,999,2070,8,0.269522,0.284385,5.486671,0.001516,0.000924,230,0.000164,0,29,0.766667,0.006252
36123,Yates County,,NY,1090,28556,29646,5,4,9,574,650,1224,8,0.265684,0.280022,138.55573,0.000755,0.000461,230,0.000153,0,29,0.6,0.003364
37001,Alamance County,,NC,6969,172974,179943,12,14,26,4991,4256,9247,8,0.282597,0.301838,405.164172,0.003818,0.004454,234,0.000303,0,29,0.56044,0.025445
37003,Alexander County,,NC,1611,38838,40449,4,5,9,1080,1044,2124,9,0.221282,0.231325,2.213454,0.000134,0.000137,234,0.000157,0,29,0.65,0.001387
37005,Alleghany County,,NC,446,11531,11977,1,0,1,93,0,93,0,0,0,0,0.000008,0,234,0.000083,0,2,0,0.000158
37007,Anson County,,NC,1099,23920,25019,4,5,9,520,681,1201,8,0.279753,0.296422,713.020154,0.001236,0.001319,234,0.000121,0,29,0.5,0.008248
37009,Ashe County,,NC,881,27971,28852,2,2,4,245,321,566,9,0.220642,0.229407,0.5,0.000059,0.00004,234,0.000105,0,29,0.5,0.000541
37011,Avery County,,NC,966,17074,18040,1,3,4,204,344,548,9,0.220605,0.229601,11.140419,0.000043,0.000052,234,0.000075,0,29,0,0.000365
37013,Beaufort County,,NC,2081,51521,53602,5,5,10,1112,1061,2173,8,0.275052,0.291675,3623.494537,0.001174,0.001299,234,0.000172,0,29,0.333333,0.008414
37015,Bertie County,,NC,908,19948,20856,2,3,5,385,431,816,8,0.244121,0.254715,33.664091,0.000007,0.000079,234,0.00012,0,29,0.5,0.000267
37017,Bladen County,,NC,1597,32786,34383,5,4,9,878,804,1682,8,0.268952,0.283922,1.304978,0.001059,0.000769,234,0.000154,0,29,0.75,0.006766
37019,Brunswick County,,NC,6610,128766,135376,18,11,29,3883,3045,6928,8,0.285378,0.304868,92.406721,0.009643,0.005074,234,0.000374,0,29,0.494152,0.054466
37021,Buncombe County,,NC,13714,283783,297497,51,44,95,7885,7890,15775,7,0.344436,0.376389,50677.973155,0.030798,0.028644,234,0.001381,0,29,0.362338,0.208559
37023,Burke County,,NC,3673,93429,97102,8,7,15,2205,2005,4210,8,0.28034,0.297496,1185.506972,0.001483,0.001671,234,0.000282,0,29,0.402778,0.011203
37025,Cabarrus County,,NC,11747,219951,231698,17,14,31,9472,7435,16907,8,0.282418,0.301644,364.310939,0.008391,0.003929,234,0.000365,0,29,0.538012,0.053022
37027,Caldwell County,,NC,3332,85568,88900,8,6,14,1704,1708,3412,8,0.279987,0.296853,605.871566,0.001285,0.001336,234,0.00025,0,29,0.589286,0.009618
37029,Camden County,,NC,720,11502,12222,3,2,5,338,264,602,8,0.251485,0.262927,0,0.000267,0.000188,366,0.000136,0,29,1,0.001654
37031,Carteret County,,NC,4093,77008,81101,7,5,12,1733,1495,3228,8,0.275279,0.292068,0.619048,0.002383,0.002052,234,0.000204,0,29,0.904762,0.016469
37033,Caswell County,,NC,1316,23215,24531,5,6,11,742,932,1674,8,0.264656,0.278538,853.42,0.000598,0.000547,234,0.000188,0,29,0.533333,0.003984
37035,Catawba County,,NC,7678,178810,186488,14,17,31,4716,4767,9483,8,0.283107,0.303031,1573.233723,0.003215,0.004445,234,0.000387,0,29,0.486928,0.023441
37037,Chatham County,,NC,4003,79680,83683,8,10,18,3281,2558,5839,8,0.28203,0.300432,6.651603,0.00233,0.00369,234,0.000205,0,29,0.733333,0.015607
37039,Cherokee County,,NC,1068,27080,28148,1,1,2,123,126,249,1,1,1,0,0,0,231,0.000357,219,322,0,0.000118
37041,Chowan County,,NC,741,15768,16509,1,2,3,81,188,269,9,0.217494,0.225818,0,0,0.000016,366,0.000109,0,29,1,0.000124
37043,Clay County,,NC,520,10648,11168,1,1,2,126,123,249,1,1,1,0,0,0,231,0.000357,219,322,0,0.000118
37045,Cleveland County,,NC,4383,103355,107738,8,10,18,2538,2759,5297,8,0.281049,0.299077,93.182067,0.001322,0.002344,234,0.000252,0,29,0.563636,0.009966
37047,Columbus County,,NC,2275,54419,56694,7,6,13,1129,1272,2401,8,0.271056,0.286843,29.947164,0.002355,0.001468,234,0.000217,0,29,0.809524,0.016572
37049,Craven County,,NC,9270,112806,122076,14,16,30,2604,3379,5983,7,0.314215,0.339203,6477.508335,0.006344,0.008949,234,0.000413,0,29,0.435673,0.041748
37051,Cumberland County,,NC,33886,342634,376520,97,104,201,17866,21010,38876,7,0.367594,0.408859,36495.528225,0.05967,0.065513,234,0.00183,0,29,0.327123,0.384953
37053,Currituck County,,NC,1606,27774,29380,5,5,10,919,783,1702,8,0.2664,0.281152,75.693929,0.001481,0.000962,366,0.000197,0,29,0.6,0.009121
37055,Dare County,,NC,2126,43597,45723,4,2,6,444,298,742,8,0.27491,0.290975,15.065226,0.001022,0.001167,366,0.000152,0,29,0.85,0.006332
37057,Davidson County,,NC,7525,182692,190217,11,12,23,5357,5148,10505,8,0.282448,0.301351,333.381786,0.003127,0.003802,234,0.000281,0,29,0.596154,0.021763
37059,Davie County,,NC,2025,47486,49511,6,6,12,1387,1200,2587,8,0.280105,0.296997,55.4871,0.000932,0.001601,234,0.000184,0,29,0.809524,0.006085
37061,Duplin County,,NC,4455,59547,64002,9,9,18,2056,2860,4916,7,0.319942,0.342697,215.359255,0.004327,0.004493,234,0.000241,0,29,0.736111,0.028878
37063,Durham County,,NC,22235,326701,348936,58,49,107,15345,15522,30867,7,0.353377,0.385987,11385.115098,0.040796,0.040375,234,0.001058,0,29,0.460199,0.250497
37065,Edgecombe County,,NC,3668,55560,59228,6,6,12,2369,2660,5029,7,0.318834,0.340992,1103.942058,0.001189,0.003099,234,0.000192,0,29,0.595238,0.008599
37067,Forsyth County,,NC,17094,408945,426039,38,39,77,10758,10781,21539,7,0.345417,0.376036,38912.448239,0.020041,0.025626,234,0.000824,0,29,0.405556,0.131305
37069,Franklin County,,NC,3721,64011,67732,7,7,14,3036,2361,5397,8,0.274882,0.291612,5.75,0.001598,0.001753,234,0.000211,0,29,0.619048,0.011375
37071,Gaston County,,NC,9580,230460,240040,16,17,33,7095,6385,13480,8,0.283438,0.303593,626.009473,0.005133,0.004813,234,0.000393,0,29,0.508772,0.036045
37073,Gates County,,NC,610,11570,12180,1,2,3,103,175,278,9,0.21356,0.22183,2024.809954,0.00002,0.00004,366,0.00008,0,29,0,0.000374
37075,Graham County,,NC,301,8736,9037,0,0,0,0,0,0,0,0,0,0,0,0,232,0.000054,220,323,0,0
37077,Granville County,,NC,3130,61087,64217,6,6,12,2381,1924,4305,8,0.275052,0.291637,8.553724,0.00164,0.001798,234,0.00019,0,29,0.666667,0.011449
37079,Greene County,,NC,1340,19704,21044,4,4,8,898,1000,1898,8,0.246353,0.257154,0.333333,0.000225,0.000173,234,0.000149,0,29,0.916667,0.00174
37081,Guilford County,,NC,26777,566536,593313,80,67,147,18010,18534,36544,7,0.358602,0.393961,64888.994943,0.043342,0.047731,234,0.001581,0,29,0.320974,0.270351
37083,Halifax County,,NC,2623,53788,56411,5,7,12,966,1391,2357,8,0.275279,0.292318,3447.730906,0.001114,0.001765,234,0.000173,0,29,0.47619,0.007842
37085,Harnett County,,NC,11466,126916,138382,17,17,34,7424,6522,13946,7,0.302357,0.325538,697.82036,0.008143,0.008078,234,0.000385,0,29,0.455263,0.057201
37087,Haywood County,,NC,2540,64692,67232,5,3,8,1007,878,1885,8,0.256366,0.268973,289.519486,0.002433,0.000384,234,0.00022,0,29,0.75,0.017326
37089,Henderson County,,NC,6100,126546,132646,10,10,20,3495,2969,6464,8,0.282597,0.301301,1479.356858,0.004236,0.003322,234,0.000342,0,29,0.436364,0.029093
37091,Hertford County,,NC,1257,21087,22344,3,4,7,433,615,1048,8,0.264473,0.278231,813.72129,0.000014,0.000549,234,0.000152,0,29,0.15,0.000368
37093,Hoke County,,NC,5708,51289,56997,6,6,12,3097,2541,5638,8,0.279635,0.296913,32.345577,0.001259,0.001993,234,0.000163,0,29,0.666667,0.008253
37095,Hyde County,,NC,286,5177,5463,1,0,1,79,0,79,0,0,0,0,0.000014,0,234,0.000083,0,1,0,0.000215
37097,Iredell County,,NC,8921,192505,201426,18,20,38,4699,4783,9482,8,0.282957,0.303425,4167.499167,0.006233,0.004974,234,0.000439,0,29,0.407115,0.040281
37099,Jackson County,,NC,2247,35189,37436,5,4,9,843,961,1804,8,0.256415,0.269191,8116.351036,0.000355,0.000361,234,0.000328,0,29,0.35,0.003341
37101,Johnston County,,NC,9176,201665,210841,16,15,31,8127,5716,13843,8,0.285165,0.305124,263.82135,0.006659,0.005056,234,0.000373,0,29,0.580882,0.044512
37103,Jones County,,NC,747,10381,11128,3,3,6,495,460,955,8,0.261108,0.274212,0,0.000631,0.000678,234,0.000125,0,29,1,0.004563
37105,Lee County,,NC,6354,65840,72194,6,8,14,2320,2838,5158,8,0.284647,0.303325,4.989987,0.002399,0.00411,234,0.000165,0,29,0.892857,0.015624
37107,Lenoir County,,NC,3197,61881,65078,12,9,21,2755,1964,4719,8,0.275364,0.292755,1277.349306,0.003686,0.002401,234,0.000316,0,29,0.480769,0.025265
37109,Lincoln County,,NC,4447,88350,92797,7,7,14,3170,2797,5967,8,0.279811,0.296828,4.041583,0.001329,0.001446,234,0.00021,0,29,0.678571,0.010171
37111,McDowell County,,NC,1654,46595,48249,5,4,9,759,700,1459,8,0.25644,0.269316,3694.584038,0.001436,0.000368,234,0.00025,0,29,0.5,0.010472
37113,Macon County,,NC,1582,37231,38813,2,3,5,255,304,559,8,0.256489,0.26916,348.020747,0.000004,0.000339,234,0.000183,0,29,0.333333,0.000287
37115,Madison County,,NC,1138,20915,22053,1,1,2,529,518,1047,8,0.256218,0.268379,0,0.000311,0.000334,234,0.00008,0,29,0,0.002362
37117,Martin County,,NC,1084,25737,26821,4,4,8,520,579,1099,8,0.244166,0.254965,2766.142922,0.000096,0.000104,234,0.000159,0,29,0.35,0.001143
37119,Mecklenburg County,,NC,62019,1139577,1201596,218,164,382,55022,50406,105428,7,0.387847,0.436223,191854.438901,0.114514,0.100182,234,0.003949,0,29,0.207642,0.675119
37121,Mitchell County,,NC,585,15520,16105,3,2,5,322,196,518,9,0.204147,0.210706,2.701681,0.000008,0.000019,234,0.000198,0,29,0,0.0005
37123,Montgomery County,,NC,1419,28778,30197,5,6,11,982,871,1853,8,0.280252,0.297346,511.87445,0.001248,0.001803,234,0.00015,0,29,0.6,0.008594
37125,Moore County,,NC,5065,106299,111364,13,13,26,2243,2130,4373,8,0.28483,0.304324,1702.816385,0.003712,0.004327,234,0.000297,0,29,0.504762,0.024599
37127,Nash County,,NC,6365,106682,113047,9,13,22,3956,4469,8425,7,0.320327,0.343966,698.03167,0.003792,0.005542,234,0.000243,0,29,0.549451,0.024985
37129,New Hanover County,,NC,13841,227837,241678,37,31,68,7787,7780,15567,7,0.335092,0.363746,3730.060732,0.017019,0.019415,234,0.000788,0,29,0.378049,0.109365
37131,Northampton County,,NC,1022,19718,20740,2,3,5,495,499,994,8,0.27491,0.291112,717.160784,0.000025,0.001163,234,0.000107,0,29,0.333333,0.000336
37133,Onslow County,,NC,26957,189697,216654,70,58,128,9916,9063,18979,7,0.35305,0.387262,11819.642835,0.05241,0.046752,11,0.001318,0,29,0.469474,0.327878
37135,Orange County,,NC,10479,143220,153699,19,20,39,6122,6844,12966,7,0.325326,0.351342,1635.169573,0.014019,0.014514,234,0.000409,0,29,0.606719,0.090781
37137,Pamlico County,,NC,668,13194,13862,1,1,2,248,280,528,8,0.239111,0.249466,0,0.000097,0.000069,234,0.000076,0,29,0,0.000572
37139,Pasquotank County,,NC,2514,42183,44697,7,8,15,1046,979,2025,8,0.277859,0.295701,11020.237922,0.001457,0.002192,366,0.000295,0,29,0.322222,0.009306
37141,Pender County,,NC,3810,57880,61690,7,5,12,3014,2039,5053,8,0.275165,0.29185,0.718868,0.002582,0.002056,234,0.000196,0,29,0.833333,0.017579
37143,Perquimans County,,NC,757,14415,15172,2,2,4,362,323,685,9,0.217494,0.225818,2745,0.000024,0.000016,366,0.000131,0,29,0.5,0.000346
37145,Person County,,NC,1321,43022,44343,6,6,12,878,722,1600,8,0.275506,0.292374,6773.53241,0.001664,0.002259,234,0.000182,0,29,0.535714,0.011589
37147,Pitt County,,NC,9378,171377,180755,27,21,48,4941,5310,10251,7,0.322651,0.347657,15812.25856,0.007188,0.007391,234,0.000676,0,29,0.304233,0.048524
37149,Polk County,,NC,987,21229,22216,3,4,7,433,597,1030,8,0.258678,0.271862,0.700631,0.000143,0.000604,234,0.000142,0,29,0.833333,0.001526
37151,Randolph County,,NC,6233,159858,166091,10,11,21,4242,4089,8331,8,0.282328,0.301082,42.144982,0.003096,0.003806,234,0.000253,0,29,0.568182,0.02087
37153,Richmond County,,NC,2042,46835,48877,4,9,13,528,997,1525,8,0.284891,0.303949,31.397496,0.000115,0.004054,234,0.000133,0,29,0.569444,0.001019
37155,Robeson County,,NC,5193,130123,135316,11,14,25,2505,3017,5522,7,0.321368,0.345296,1629.172923,0.005134,0.006168,234,0.000307,0,29,0.510989,0.035053
37157,Rockingham County,,NC,3551,100680,104231,8,9,17,2070,2118,4188,8,0.276019,0.293617,6688.613797,0.000911,0.001931,234,0.000253,0,29,0.463636,0.006045
37159,Rowan County,,NC,6953,151785,158738,10,11,21,3912,4229,8141,8,0.282119,0.300676,74.360232,0.003114,0.00339,234,0.000263,0,29,0.718182,0.021582
37161,Rutherford County,,NC,2148,65026,67174,8,8,16,1131,955,2086,8,0.280488,0.297902,404.430298,0.001567,0.00176,234,0.000291,0,29,0.482143,0.011902
37163,Sampson County,,NC,4515,73784,78299,8,13,21,2025,3062,5087,7,0.320211,0.343634,386.055005,0.003705,0.00501,234,0.000218,0,29,0.544872,0.024835
37165,Scotland County,,NC,1739,34385,36124,6,8,14,873,1024,1897,8,0.284496,0.303119,3435.717007,0.000891,0.003154,234,0.000168,0,29,0.553571,0.005622
37167,Stanly County,,NC,2304,65549,67853,6,6,12,1341,1293,2634,8,0.281524,0.299102,11.701248,0.00129,0.002591,234,0.000172,0,29,0.571429,0.009449
37169,Stokes County,,NC,2208,50118,52326,5,6,11,1700,1645,3345,8,0.264735,0.2787,139.41031,0.000866,0.00074,234,0.000165,0,29,0.6,0.00534
37171,Surry County,,NC,3184,78694,81878,6,8,14,1302,1772,3074,8,0.264866,0.27935,23404.660223,0.000306,0.000706,234,0.000279,0,29,0.232143,0.002334
37173,Swain County,,NC,1004,18393,19397,1,1,2,444,402,846,9,0.2041,0.2104,0,0.000004,0.000004,234,0.000123,0,29,0,0.000163
37175,Transylvania County,,NC,1623,33910,35533,2,3,5,506,522,1028,8,0.260802,0.274548,0,0.000347,0.000824,234,0.000109,0,29,1,0.002797
37177,Tyrrell County,,NC,190,4005,4195,0,0,0,0,0,0,0,0,0,0,0,0,233,0.000054,221,324,0,0
37179,Union County,,NC,10684,251083,261767,13,19,32,7473,6773,14246,7,0.308511,0.333075,1307.165212,0.005378,0.008226,234,0.000296,0,29,0.471429,0.033623
37181,Vance County,,NC,2410,46348,48758,5,5,10,1477,1538,3015,8,0.274825,0.291237,0.916667,0.001484,0.00164,234,0.00017,0,29,0.85,0.01038
37183,Wake County,,NC,52220,1169475,1221695,193,146,339,45923,40319,86242,7,0.378708,0.425658,156742.209267,0.105999,0.091561,234,0.003522,0,29,0.233551,0.625283
37185,Warren County,,NC,1165,18697,19862,4,5,9,585,791,1376,8,0.274882,0.291331,3.833333,0.00105,0.001214,234,0.00015,0,29,0.7,0.007589
37187,Washington County,,NC,667,13002,13669,0,3,3,0,246,246,8,0.244123,0.254713,0,0,0.000092,234,0.000054,0,325,1,0
37189,Watauga County,,NC,2948,42379,45327,9,11,20,973,1213,2186,8,0.282747,0.301532,9328.776907,0.003253,0.003914,234,0.00028,0,29,0.454545,0.02222
37191,Wayne County,,NC,7161,131017,138178,12,15,27,2713,3082,5795,7,0.325247,0.349506,1859.064867,0.003243,0.007739,234,0.000317,0,29,0.620833,0.022056
37193,Wilkes County,,NC,2145,71065,73210,8,8,16,967,980,1947,8,0.280399,0.297734,1413.072442,0.000402,0.001552,234,0.000282,0,29,0.402778,0.003325
37195,Wilson County,,NC,4104,89952,94056,8,10,18,2251,2575,4826,8,0.281881,0.300245,406.028537,0.001827,0.003147,234,0.000235,0,29,0.622222,0.012397
37197,Yadkin County,,NC,1611,41462,43073,6,5,11,1143,1059,2202,8,0.257405,0.270201,13.683894,0.000382,0.000303,234,0.000199,0,29,0.6,0.002845
37199,Yancey County,,NC,794,18350,19144,2,2,4,253,275,528,8,0.256267,0.268629,1704.996854,0.000311,0.000334,234,0.000164,0,29,0,0.002491
38001,Adams County,,ND,69,2705,2774,0,0,0,0,0,0,0,0,0,0,0,0,235,0.000054,222,326,0,0
38003,Barnes County,,ND,544,13276,13820,2,1,3,158,163,321,8,0.236714,0.247006,0,0.000055,0.000067,374,0.000173,0,29,1,0.000781
38005,Benson County,,ND,253,6751,7004,1,1,2,63,121,184,9,0.191535,0.197098,0,0.000001,0,374,0.000091,0,327,0,0.000118
38007,Billings County,,ND,66,1089,1155,1,0,1,69,0,69,0,0,0,0,0.000031,0,374,0.000099,0,9,0,0.00038
38009,Bottineau County,,ND,345,8308,8653,1,1,2,76,111,187,8,0.243475,0.253939,0,0.000103,0.000066,374,0.000087,0,29,0,0.00059
38011,Bowman County,,ND,141,4184,4325,0,0,0,0,0,0,0,0,0,0,0,0,236,0.000054,223,328,0,0
38013,Burke County,,ND,110,3015,3125,0,0,0,0,0,0,0,0,0,0,0,0,237,0.000054,224,329,0,0
38015,Burleigh County,,ND,4773,110573,115346,15,11,26,2883,2260,5143,7,0.307444,0.329223,17232.973373,0.002499,0.002869,374,0.000756,0,29,0.254167,0.018636
38017,Cass County,,ND,10189,195994,206183,34,25,59,6319,5033,11352,7,0.310088,0.335145,51900.447903,0.006188,0.005015,374,0.001705,0,29,0.130952,0.040916
38019,Cavalier County,,ND,142,5070,5212,0,0,0,0,0,0,0,0,0,0,0,0,238,0.000054,225,330,0,0
38021,Dickey County,,ND,213,6408,6621,0,0,0,0,0,0,0,0,0,0,0,0,239,0.000054,226,331,0,0
38023,Divide County,,ND,223,2942,3165,0,0,0,0,0,0,0,0,0,0,0,0,240,0.000054,227,332,0,0
38025,Dunn County,,ND,629,4857,5486,1,1,2,131,107,238,8,0.235108,0.244326,0,0.000031,0.000034,374,0.000099,0,29,0,0.00038
38027,Eddy County,,ND,101,2846,2947,0,0,0,0,0,0,0,0,0,0,0,0,241,0.000054,228,333,0,0
38029,Emmons County,,ND,129,4053,4182,0,1,1,0,71,71,8,0.235216,0.244534,0,0,0.000027,374,0.000054,0,334,0,0
38031,Foster County,,ND,134,4314,4448,0,0,0,0,0,0,0,0,0,0,0,0,242,0.000054,229,335,0,0
38033,Golden Valley County,,ND,79,2225,2304,0,0,0,0,0,0,0,0,0,0,0,0,243,0.000054,230,336,0,0
38035,Grand Forks County,,ND,4537,76113,80650,13,9,22,1668,1623,3291,7,0.307196,0.328536,17077.37937,0.003038,0.002879,374,0.000617,0,29,0.241758,0.020738
38037,Grant County,,ND,70,2784,2854,0,0,0,0,0,0,0,0,0,0,0,0,244,0.000054,231,337,0,0
38039,Griggs County,,ND,51,2918,2969,0,0,0,0,0,0,0,0,0,0,0,0,245,0.000054,232,338,0,0
38041,Hettinger County,,ND,125,3179,3304,1,1,2,76,80,156,8,0.235108,0.244326,0,0.000031,0.000034,374,0.000099,0,29,0,0.00038
38043,Kidder County,,ND,81,2981,3062,0,0,0,0,0,0,0,0,0,0,0,0,246,0.000054,233,339,0,0
38045,LaMoure County,,ND,146,5096,5242,0,1,1,0,53,53,9,0.191518,0.197122,0,0,0.000001,374,0.000054,0,340,0,0
38047,Logan County,,ND,85,2447,2532,0,0,0,0,0,0,0,0,0,0,0,0,247,0.000054,234,341,0,0
38049,McHenry County,,ND,341,7223,7564,1,1,2,126,119,245,8,0.243475,0.253939,0,0.000103,0.000066,374,0.000087,0,29,0,0.00059
38051,McIntosh County,,ND,148,3518,3666,0,0,0,0,0,0,0,0,0,0,0,0,248,0.000054,235,342,0,0
38053,McKenzie County,,ND,1902,9526,11428,2,2,4,311,210,521,8,0.242171,0.252921,0,0.000064,0.000135,374,0.000121,0,29,0.833333,0.001012
38055,McLean County,,ND,603,11811,12414,2,2,4,235,278,513,8,0.24504,0.255994,0,0.000135,0.000093,374,0.000146,0,29,1,0.000943
38057,Mercer County,,ND,568,11035,11603,1,2,3,71,164,235,8,0.23519,0.244625,0,0.000031,0.00003,374,0.000112,0,29,1,0.000353
38059,Morton County,,ND,2302,36127,38429,5,3,8,1454,1380,2834,8,0.236861,0.247693,18.089236,0.00022,0.000128,374,0.000297,0,29,0.7,0.002088
38061,Mountrail County,,ND,1347,10262,11609,2,4,6,146,447,593,8,0.246194,0.257962,2.878968,0.000165,0.000201,374,0.000127,0,29,0.75,0.001467
38063,Nelson County,,ND,119,3785,3904,0,0,0,0,0,0,0,0,0,0,0,0,249,0.000054,236,343,0,0
38065,Oliver County,,ND,82,2305,2387,0,0,0,0,0,0,0,0,0,0,0,0,250,0.000054,237,344,0,0
38067,Pembina County,,ND,272,8993,9265,1,2,3,62,118,180,8,0.235066,0.244407,0,0.000001,0.000033,374,0.000097,0,29,1,0.000126
38069,Pierce County,,ND,159,5289,5448,0,0,0,0,0,0,0,0,0,0,0,0,251,0.000054,238,345,0,0
38071,Ramsey County,,ND,646,13970,14616,1,3,4,121,240,361,8,0.236891,0.247663,2669,0,0.0001,374,0.000131,0,327,0.333333,0.000118
38073,Ransom County,,ND,165,6879,7044,1,1,2,59,72,131,8,0.236714,0.247006,0,0.000054,0.000067,374,0.000112,0,29,0,0.000645
38075,Renville County,,ND,199,3132,3331,1,1,2,118,129,247,8,0.243475,0.253939,0,0.000103,0.000066,374,0.000087,0,29,0,0.00059
38077,Richland County,,ND,809,19538,20347,2,2,4,321,319,640,8,0.236756,0.247255,2745,0.000055,0.000067,374,0.000144,0,29,0.5,0.000763
38079,Rolette County,,ND,490,14877,15367,0,2,2,0,124,124,8,0.236823,0.247381,0,0,0.0001,374,0.000054,0,346,1,0
38081,Sargent County,,ND,172,5148,5320,0,1,1,0,50,50,8,0.23676,0.2471,0,0,0.000067,374,0.000054,0,347,0,0
38083,Sheridan County,,ND,70,1613,1683,0,0,0,0,0,0,0,0,0,0,0,0,252,0.000054,239,348,0,0
38085,Sioux County,,ND,228,3398,3626,0,1,1,0,70,70,8,0.235216,0.244534,0,0,0.000027,374,0.000054,0,349,0,0
38087,Slope County,,ND,-2,860,858,0,0,0,0,0,0,0,0,0,0,0,0,253,0.000054,240,350,0,0
38089,Stark County,,ND,3456,37373,40829,9,10,19,896,908,1804,7,0.307338,0.328942,14844.842427,0.003086,0.002828,374,0.000539,0,29,0.372727,0.023024
38091,Steele County,,ND,87,2358,2445,0,0,0,0,0,0,0,0,0,0,0,0,254,0.000054,241,351,0,0
38093,Stutsman County,,ND,947,24872,25819,3,3,6,193,278,471,8,0.236798,0.247505,2671.805172,0.000086,0.000095,374,0.000216,0,29,0.333333,0.001111
38095,Towner County,,ND,90,2905,2995,0,0,0,0,0,0,0,0,0,0,0,0,255,0.000054,242,352,0,0
38097,Traill County,,ND,429,9413,9842,3,2,5,220,184,404,8,0.236777,0.247287,834.218739,0.000086,0.0001,374,0.000232,0,29,0.333333,0.001135
38099,Walsh County,,ND,488,13523,14011,2,3,5,164,230,394,8,0.236819,0.247536,2761.902427,0.000032,0.0001,374,0.000153,0,29,0.5,0.00049
38101,Ward County,,ND,7721,81655,89376,15,18,33,1663,1894,3557,7,0.321795,0.34741,24932.989144,0.006045,0.009524,374,0.000715,0,29,0.3,0.041938
38103,Wells County,,ND,186,5339,5525,0,0,0,0,0,0,0,0,0,0,0,0,256,0.000054,243,353,0,0
38105,Williams County,,ND,6443,37773,44216,19,15,34,1770,1602,3372,7,0.316639,0.340986,14024.260786,0.009928,0.005686,374,0.000705,0,29,0.378571,0.069248
39001,Adams County,,OH,915,28770,29685,4,4,8,456,438,894,8,0.236798,0.246896,19.647515,0.000083,0.00008,257,0.000162,0,29,0.5,0.000992
39003,Allen County,,OH,4222,117699,121921,10,13,23,1805,2252,4057,8,0.281732,0.300085,5772.930379,0.001336,0.001967,257,0.000281,0,29,0.352564,0.008745
39005,Ashland County,,OH,2342,60699,63041,9,8,17,1357,1446,2803,8,0.280783,0.298092,107.841775,0.00216,0.002134,257,0.000227,0,29,0.555556,0.012863
39007,Ashtabula County,,OH,3433,111436,114869,6,9,15,1537,1866,3403,8,0.281079,0.298767,47.434851,0.001201,0.001964,257,0.000149,0,29,0.625,0.006157
39009,Athens County,,OH,2603,51119,53722,8,7,15,938,1099,2037,8,0.280842,0.298092,5321.207574,0.001416,0.001748,257,0.000324,0,29,0.244444,0.008791
39011,Auglaize County,,OH,2134,58170,60304,6,6,12,1235,1236,2471,8,0.279226,0.295844,1117.50694,0.001047,0.001043,257,0.000179,0,29,0.7,0.007214
39013,Belmont County,,OH,2491,76421,78912,7,7,14,1258,1211,2469,8,0.279372,0.296312,8874.504116,0.002042,0.001026,257,0.00045,0,29,0.267857,0.012638
39015,Brown County,,OH,2411,47653,50064,7,6,13,1762,1723,3485,8,0.272607,0.286524,5651.001683,0.000859,0.000656,257,0.000251,0,29,0.52381,0.004924
39017,Butler County,,OH,19108,426274,445382,20,27,47,13322,13412,26734,7,0.346809,0.37583,12784.559309,0.007679,0.018066,257,0.000463,0,29,0.448276,0.045198
39019,Carroll County,,OH,1496,32132,33628,4,4,8,839,988,1827,8,0.259205,0.272108,3.389848,0.000253,0.000355,257,0.000144,0,29,0.6,0.001468
39021,Champaign County,,OH,1951,45799,47750,7,6,13,1434,1240,2674,8,0.279489,0.296118,6.626305,0.001437,0.00125,257,0.000201,0,29,0.690476,0.008764
39023,Clark County,,OH,5335,157720,163055,7,9,16,3327,3344,6671,8,0.280842,0.298099,22.999281,0.001546,0.001859,257,0.000191,0,29,0.611111,0.008919
39025,Clermont County,,OH,10543,238466,249009,13,14,27,7834,7461,15295,7,0.309477,0.331487,3884.091411,0.003354,0.004636,257,0.000342,0,29,0.52381,0.018233
39027,Clinton County,,OH,2400,47251,49651,10,10,20,1743,1753,3496,8,0.280901,0.298349,100.577595,0.002538,0.001964,257,0.000254,0,29,0.688889,0.013434
39029,Columbiana County,,OH,3843,119468,123311,10,12,22,2065,2394,4459,8,0.284193,0.303761,276.771359,0.001802,0.003117,257,0.000268,0,29,0.55303,0.009734
39031,Coshocton County,,OH,1327,41209,42536,5,6,11,773,819,1592,8,0.279196,0.295812,68.5295,0.00006,0.001032,257,0.000205,0,29,0.5,0.001015
39033,Crawford County,,OH,1935,49914,51849,6,5,11,1301,1128,2429,8,0.279079,0.295438,614.846476,0.001046,0.00103,257,0.000203,0,29,0.6,0.007262
39035,Cuyahoga County,,OH,44280,1463569,1507849,90,112,202,27146,33455,60601,7,0.379841,0.421424,33274.292933,0.066687,0.083433,257,0.001582,0,29,0.412741,0.414151
39037,Darke County,,OH,1875,64140,66015,6,6,12,1003,1073,2076,8,0.265103,0.27853,810.80489,0.000443,0.00025,257,0.000189,0,29,0.3,0.002414
39039,Defiance County,,OH,1685,47475,49160,7,7,14,897,949,1846,8,0.259105,0.273292,377.91938,0.000583,0.000321,257,0.000209,0,29,0.428571,0.003198
39041,Delaware County,,OH,10855,232942,243797,18,13,31,8847,6929,15776,7,0.318111,0.341163,2428.315475,0.008093,0.00659,257,0.000408,0,29,0.418129,0.047145
39043,Erie County,,OH,3790,92927,96717,8,9,17,2148,2182,4330,8,0.281375,0.299079,108.041305,0.002736,0.00226,257,0.000182,0,29,0.666667,0.014763
39045,Fairfield County,,OH,7899,173997,181896,9,9,18,5897,5496,11393,8,0.279255,0.296312,24.885073,0.00202,0.001151,257,0.000306,0,29,0.433333,0.012578
39047,Fayette County,,OH,1345,32163,33508,7,7,14,1024,893,1917,8,0.279167,0.295875,11.844048,0.001164,0.001106,257,0.000223,0,29,0.52381,0.007697
39049,Franklin County,,OH,56704,1439452,1496156,177,159,336,45263,43433,88696,7,0.386723,0.434243,367166.33705,0.090192,0.088943,257,0.003705,0,29,0.211094,0.550851
39051,Fulton County,,OH,1942,53041,54983,6,6,12,1286,1281,2567,8,0.257355,0.270544,8.301496,0.000381,0.000251,257,0.000181,0,29,0.566667,0.002286
39053,Gallia County,,OH,1196,31124,32320,4,5,9,460,605,1065,8,0.279401,0.295969,1500.998424,0.000022,0.000991,372,0.000218,0,29,0.25,0.000613
39055,Geauga County,,OH,4415,118530,122945,7,8,15,2970,3057,6027,8,0.280783,0.298092,25.592696,0.002427,0.002087,257,0.000163,0,29,0.857143,0.013407
39057,Greene County,,OH,10664,182030,192694,10,17,27,5632,6711,12343,7,0.330566,0.356746,995.659757,0.003905,0.011739,257,0.000235,0,29,0.584559,0.022455
39059,Guernsey County,,OH,1657,44852,46509,5,5,10,593,744,1337,8,0.279284,0.295875,4046.255376,0.00101,0.00103,257,0.000328,0,29,0.3,0.006974
39061,Hamilton County,,OH,36352,944191,980543,64,75,139,24007,27435,51442,7,0.373984,0.410415,54398.28089,0.047137,0.062023,257,0.00129,0,29,0.471846,0.299179
39063,Hancock County,,OH,3687,90470,94157,8,8,16,2124,1792,3916,8,0.279899,0.297174,2578.11154,0.001372,0.001218,257,0.000233,0,29,0.5,0.008563
39065,Hardin County,,OH,1439,32984,34423,5,7,12,712,927,1639,8,0.279226,0.296,10.582342,0.000072,0.001049,257,0.000171,0,29,0.547619,0.001059
39067,Harrison County,,OH,803,16569,17372,3,2,5,345,373,718,9,0.221521,0.230641,4.998689,0.000055,0.000039,257,0.000166,0,29,0.333333,0.000767
39069,Henry County,,OH,1207,35401,36608,4,4,8,653,687,1340,8,0.257157,0.269857,0.410256,0.000344,0.000218,257,0.000135,0,29,0.916667,0.001859
39071,Highland County,,OH,2105,46318,48423,9,9,18,1318,1453,2771,8,0.279782,0.296993,1263.599738,0.002135,0.001343,257,0.000272,0,29,0.555556,0.012336
39073,Hocking County,,OH,1393,30978,32371,6,6,12,810,973,1783,8,0.279138,0.295687,5.738889,0.001032,0.00105,257,0.000236,0,29,0.666667,0.007273
39075,Holmes County,,OH,1685,48292,49977,4,5,9,881,1105,1986,8,0.254921,0.267114,4.000312,0.000069,0.000162,257,0.000153,0,29,0.433333,0.00087
39077,Huron County,,OH,3064,70986,74050,8,9,17,1697,2057,3754,8,0.280783,0.298217,111.766456,0.002122,0.001914,257,0.000212,0,29,0.5,0.012628
39079,Jackson County,,OH,1223,34874,36097,6,5,11,712,610,1322,8,0.279167,0.295625,4069.120346,0.001021,0.001002,257,0.000233,0,29,0.5,0.007018
39081,Jefferson County,,OH,2469,74822,77291,7,9,16,1210,1292,2502,8,0.283347,0.302343,2668.620034,0.002065,0.001981,257,0.000312,0,29,0.347222,0.012741
39083,Knox County,,OH,2487,68786,71273,6,8,14,1317,1402,2719,8,0.279167,0.296,1322.661408,0.001097,0.001142,257,0.000213,0,29,0.464286,0.007646
39085,Lake County,,OH,10011,291439,301450,12,13,25,6306,5717,12023,7,0.31777,0.340882,280.053153,0.002981,0.006665,257,0.000235,0,29,0.614286,0.015995
39087,Lawrence County,,OH,2363,65051,67414,6,7,13,1381,1375,2756,8,0.279665,0.296631,2700.588408,0.000026,0.001002,372,0.000298,0,29,0.333333,0.000964
39089,Licking County,,OH,7779,199923,207702,7,8,15,5502,4964,10466,8,0.279196,0.296062,659.483041,0.001096,0.001136,257,0.000258,0,29,0.535714,0.00782
39091,Logan County,,OH,2286,55095,57381,9,10,19,1314,1422,2736,8,0.279723,0.297118,763.949575,0.001462,0.001292,257,0.000254,0,29,0.522222,0.00913
39093,Lorain County,,OH,11139,360106,371245,15,20,35,7364,6899,14263,7,0.338064,0.364958,1707.161245,0.009235,0.013933,257,0.000303,0,29,0.547368,0.057636
39095,Lucas County,,OH,15010,482474,497484,30,42,72,8846,9547,18393,7,0.34591,0.377766,24507.462732,0.015163,0.026089,257,0.000604,0,29,0.402439,0.09344
39097,Madison County,,OH,2471,46370,48841,5,6,11,1852,1792,3644,8,0.27905,0.2955,5.166667,0.001021,0.001047,257,0.000181,0,29,0.533333,0.007003
39099,Mahoning County,,OH,8602,268881,277483,12,15,27,4868,5118,9986,7,0.330321,0.355097,1129.435838,0.003632,0.007781,257,0.000267,0,29,0.529167,0.020266
39101,Marion County,,OH,2445,69555,72000,7,8,15,1271,1380,2651,8,0.279167,0.296,1290.571559,0.001096,0.00113,257,0.000247,0,29,0.5,0.00771
39103,Medina County,,OH,8049,223517,231566,10,11,21,5872,5485,11357,7,0.308725,0.330772,115.410424,0.002749,0.005113,257,0.000219,0,29,0.681818,0.01514
39105,Meigs County,,OH,775,23358,24133,3,3,6,427,367,794,9,0.220223,0.228841,18.222478,0.00003,0.000016,372,0.00017,0,29,0.333333,0.000497
39107,Mercer County,,OH,1394,52880,54274,4,6,10,553,640,1193,8,0.279342,0.296062,109.988792,0.000037,0.001026,257,0.000144,0,29,0.533333,0.000732
39109,Miami County,,OH,4782,126724,131506,9,11,20,3162,3098,6260,8,0.28099,0.29863,177.185772,0.001561,0.001947,257,0.000243,0,29,0.515152,0.009304
39111,Monroe County,,OH,489,16237,16726,2,1,3,190,124,314,9,0.218384,0.226112,2.161111,0.000022,0.000022,257,0.000146,0,29,0,0.000458
39113,Montgomery County,,OH,23067,611027,634094,33,52,85,13470,15656,29126,7,0.359714,0.393005,23741.73827,0.01925,0.036154,257,0.000709,0,29,0.392732,0.127171
39115,Morgan County,,OH,556,15147,15703,4,2,6,346,214,560,9,0.218724,0.226765,3.350433,0.000052,0.000022,257,0.000207,0,29,0.333333,0.000838
39117,Morrow County,,OH,1845,39114,40959,7,6,13,1449,1388,2837,8,0.279167,0.29575,5.069048,0.001109,0.001128,257,0.000235,0,29,0.666667,0.007921
39119,Muskingum County,,OH,3017,98241,101258,7,6,13,1847,1617,3464,8,0.279167,0.29575,2567.49101,0.001024,0.001014,257,0.000332,0,29,0.428571,0.007302
39121,Noble County,,OH,463,13661,14124,2,1,3,186,149,335,9,0.218331,0.225956,0.5,0.000022,0.000011,257,0.000147,0,29,0,0.000396
39123,Ottawa County,,OH,2167,51270,53437,6,7,13,1070,1240,2310,8,0.281286,0.298642,97.475974,0.002248,0.00196,257,0.000153,0,29,0.809524,0.012614
39125,Paulding County,,OH,846,22833,23679,4,5,9,552,515,1067,8,0.256612,0.269588,503.472925,0.00024,0.000153,257,0.000156,0,29,0.4,0.001507
39127,Perry County,,OH,1850,38383,40233,5,6,11,1182,1466,2648,8,0.279109,0.295625,631.535762,0.001013,0.001036,257,0.00021,0,29,0.566667,0.007041
39129,Pickaway County,,OH,2848,60839,63687,6,6,12,2198,2070,4268,8,0.279079,0.295562,4.25,0.001025,0.001048,257,0.000221,0,29,0.666667,0.007259
39131,Pike County,,OH,1134,28522,29656,4,4,8,785,640,1425,8,0.279226,0.2955,3.4,0.000999,0.001013,257,0.000172,0,29,0.833333,0.006769
39133,Portage County,,OH,8270,178204,186474,13,12,25,5702,5820,11522,8,0.284162,0.303699,69.45727,0.003948,0.003231,257,0.000254,0,29,0.692308,0.021252
39135,Preble County,,OH,1927,48929,50856,5,5,10,1020,1278,2298,8,0.265975,0.279342,20.699648,0.000702,0.000367,257,0.00015,0,29,0.5,0.002986
39137,Putnam County,,OH,1087,44451,45538,5,4,9,532,519,1051,8,0.279226,0.295625,173.932769,0.000041,0.001011,257,0.000169,0,29,0.4,0.000909
39139,Richland County,,OH,4689,139731,144420,10,10,20,2429,2411,4840,8,0.280931,0.298655,28.607734,0.002361,0.002191,257,0.000278,0,29,0.484848,0.013836
39141,Ross County,,OH,2728,80905,83633,10,9,19,1687,1658,3345,8,0.279255,0.296312,1405.329077,0.001072,0.001082,257,0.000349,0,29,0.377778,0.008028
39143,Sandusky County,,OH,2581,73612,76193,6,7,13,1560,1771,3331,8,0.279723,0.296674,3.934244,0.000418,0.001279,257,0.000167,0,29,0.761905,0.002578
39145,Scioto County,,OH,2281,76043,78324,5,7,12,620,952,1572,8,0.279518,0.296393,6276.369661,0.00099,0.001014,257,0.000217,0,29,0.357143,0.006748
39147,Seneca County,,OH,2557,64756,67313,9,7,16,1645,1663,3308,8,0.279782,0.296799,811.399015,0.001409,0.00123,257,0.000231,0,29,0.583333,0.009009
39149,Shelby County,,OH,2351,59686,62037,8,7,15,1282,1436,2718,8,0.279665,0.296587,132.33923,0.00144,0.001252,257,0.000216,0,29,0.625,0.008857
39151,Stark County,,OH,12902,450314,463216,19,25,44,7517,7777,15294,7,0.341351,0.369764,8064.854762,0.008595,0.016169,257,0.000407,0,29,0.448718,0.053199
39153,Summit County,,OH,21486,639769,661255,33,44,77,14407,14959,29366,7,0.349078,0.380977,9053.852206,0.020692,0.034468,257,0.000642,0,29,0.45656,0.129725
39155,Trumbull County,,OH,7292,243116,250408,13,13,26,4267,4313,8580,7,0.309836,0.332543,425.490974,0.003747,0.004855,257,0.000267,0,29,0.582418,0.020623
39157,Tuscarawas County,,OH,3621,114679,118300,9,10,19,1904,2246,4150,8,0.280931,0.298655,4189.620271,0.001567,0.002065,257,0.000331,0,29,0.344444,0.009417
39159,Union County,,OH,2920,62404,65324,7,6,13,2251,1766,4017,8,0.279109,0.295625,8.033333,0.0011,0.001122,257,0.000223,0,29,0.47619,0.007806
39161,Van Wert County,,OH,1279,35108,36387,3,5,8,482,690,1172,8,0.257132,0.270285,27.620501,0.000034,0.000161,257,0.000119,0,29,0.4,0.000515
39163,Vinton County,,OH,691,13143,13834,2,4,6,199,405,604,8,0.279109,0.295375,1.25,0.000023,0.001017,257,0.000126,0,29,0.666667,0.000434
39165,Warren County,,OH,13249,267908,281157,17,18,35,10100,9008,19108,7,0.325128,0.350221,3139.975948,0.005206,0.009084,257,0.00041,0,29,0.437229,0.02949
39167,Washington County,,OH,2366,71562,73928,4,6,10,934,1149,2083,8,0.279694,0.296352,4358.390162,0.000996,0.001007,257,0.000265,0,29,0.2,0.006723
39169,Wayne County,,OH,4484,139097,143581,8,9,17,2529,2813,5342,8,0.280872,0.298405,1341.181829,0.002524,0.002118,257,0.000207,0,29,0.652778,0.013832
39171,Williams County,,OH,1602,45529,47131,6,7,13,670,769,1439,8,0.280872,0.298611,347.765433,0.000302,0.001311,257,0.0002,0,29,0.375,0.001984
39173,Wood County,,OH,7538,144386,151924,14,15,29,4840,4926,9766,7,0.3098,0.332237,1884.533196,0.003929,0.005048,257,0.000315,0,29,0.366013,0.02119
39175,Wyandot County,,OH,1245,27462,28707,5,6,11,611,889,1500,8,0.279167,0.29575,6.755556,0.000061,0.001034,257,0.000188,0,29,0.566667,0.001029
40001,Adair County,,OK,1284,21055,22339,4,5,9,554,699,1253,8,0.264185,0.278318,14.140203,0.000369,0.000729,138,0.000175,0,29,0.75,0.003141
40003,Alfalfa County,,OK,288,5312,5600,0,0,0,0,0,0,0,0,0,0,0,0,258,0.000054,244,354,0,0
40005,Atoka County,,OK,635,13163,13798,2,2,4,174,201,375,8,0.226659,0.235177,2796.329085,0.00004,0.000034,350,0.000128,0,29,0,0.000496
40007,Beaver County,,OK,501,6114,6615,1,1,2,107,91,198,9,0.185291,0.19013,0,0,0.000002,138,0.000112,0,29,0,0.000139
40009,Beckham County,,OK,1834,23448,25282,4,3,7,395,499,894,8,0.262134,0.276478,3716.922139,0.000016,0.000468,138,0.000261,0,29,0.25,0.00057
40011,Blaine County,,OK,654,10397,11051,1,2,3,63,225,288,8,0.262057,0.276165,0,0.000494,0.000487,138,0.00008,0,29,1,0.003323
40013,Bryan County,,OK,2367,42030,44397,8,10,18,1073,1083,2156,7,0.292865,0.311545,21196.852125,0.003093,0.003704,350,0.000333,0,29,0.255556,0.023891
40015,Caddo County,,OK,1636,28200,29836,5,6,11,724,931,1655,8,0.263272,0.278583,8.046912,0.000724,0.000828,138,0.000218,0,29,0.833333,0.005388
40017,Canadian County,,OK,8498,145599,154097,16,14,30,7352,5798,13150,7,0.301708,0.324095,1638.221889,0.002435,0.004008,138,0.000565,0,29,0.352941,0.018645
40019,Carter County,,OK,2747,52408,55155,12,11,23,1211,1309,2520,7,0.293477,0.312732,8072.617734,0.002984,0.003154,350,0.000437,0,29,0.351648,0.022904
40021,Cherokee County,,OK,2590,44130,46720,9,9,18,1444,1585,3029,8,0.265314,0.281126,91.946413,0.000999,0.000869,138,0.000325,0,29,0.5,0.007296
40023,Choctaw County,,OK,806,14108,14914,4,4,8,315,397,712,8,0.22747,0.236807,5431.710714,0.000094,0.000075,350,0.000291,0,29,0.083333,0.001062
40025,Cimarron County,,OK,123,2929,3052,0,0,0,0,0,0,0,0,0,0,0,0,259,0.000054,245,355,0,0
40027,Cleveland County,,OK,17904,286173,304077,31,28,59,14035,12610,26645,7,0.338923,0.368044,25194.910084,0.01415,0.017072,138,0.000949,0,29,0.322917,0.102073
40029,Coal County,,OK,368,5211,5579,1,2,3,65,224,289,9,0.20998,0.217758,12.432225,0,0.000008,138,0.000108,0,29,0,0.000125
40031,Comanche County,,OK,11642,119829,131471,26,29,55,3648,4558,8206,7,0.327804,0.356752,28246.478696,0.0156,0.015661,138,0.000714,0,29,0.409195,0.110448
40033,Cotton County,,OK,447,6075,6522,1,1,2,137,158,295,8,0.2469,0.258405,0,0.00017,0.000169,138,0.000075,0,29,0,0.001309
40035,Craig County,,OK,757,13539,14296,4,5,9,429,453,882,8,0.26234,0.276253,3.66627,0.000464,0.000383,138,0.000176,0,29,0.7,0.003185
40037,Creek County,,OK,5018,73226,78244,9,8,17,3615,3652,7267,8,0.265261,0.280876,35.994804,0.001023,0.000873,138,0.000324,0,29,0.541667,0.007363
40039,Custer County,,OK,2086,29773,31859,6,6,12,684,904,1588,8,0.262211,0.27704,6102.864922,0.000737,0.000649,138,0.000335,0,29,0.466667,0.00538
40041,Delaware County,,OK,2510,38586,41096,8,9,17,1324,1443,2767,8,0.264499,0.279389,91.676451,0.000676,0.000763,138,0.000301,0,29,0.455556,0.00511
40043,Dewey County,,OK,329,5429,5758,0,1,1,0,73,73,9,0.20772,0.214677,0,0,0.000005,138,0.000054,0,356,0,0
40045,Ellis County,,OK,232,4544,4776,1,0,1,100,0,100,0,0,0,0,0.000005,0,138,0.000107,0,24,0,0.000155
40047,Garfield County,,OK,4196,70084,74280,11,9,20,1135,1249,2384,8,0.265341,0.281188,10971.672998,0.002227,0.00103,138,0.000505,0,29,0.336364,0.016492
40049,Garvin County,,OK,1789,28152,29941,7,8,15,839,1097,1936,8,0.26234,0.277602,32.984406,0.000743,0.000688,138,0.000283,0,29,0.607143,0.005723
40051,Grady County,,OK,3335,54537,57872,8,7,15,2632,2211,4843,8,0.263272,0.278708,11.826837,0.000926,0.000835,138,0.000292,0,29,0.696429,0.007014
40053,Grant County,,OK,249,4857,5106,1,1,2,98,76,174,9,0.209715,0.21714,0,0.000011,0.000024,138,0.000101,0,29,0,0.000316
40055,Greer County,,OK,300,4945,5245,1,1,2,81,89,170,9,0.208437,0.215751,0,0.000009,0.000002,138,0.00008,0,29,0,0.000139
40057,Harmon County,,OK,72,2699,2771,0,0,0,0,0,0,0,0,0,0,0,0,260,0.000054,246,357,0,0
40059,Harper County,,OK,179,4378,4557,0,0,0,0,0,0,0,0,0,0,0,0,261,0.000054,247,358,0,0
40061,Haskell County,,OK,665,12095,12760,2,3,5,174,337,511,9,0.209946,0.218021,1.30303,0.00002,0.000029,138,0.000121,0,29,0.166667,0.000387
40063,Hughes County,,OK,773,12021,12794,2,3,5,201,301,502,9,0.209847,0.217827,3.274733,0.000016,0.000026,138,0.000131,0,29,0.333333,0.000368
40065,Jackson County,,OK,2481,27223,29704,3,6,9,234,570,804,8,0.263298,0.278645,5970.790061,0.000172,0.000785,138,0.000185,0,29,0.3,0.001561
40067,Jefferson County,,OK,322,5773,6095,1,1,2,64,80,144,9,0.208486,0.215907,0,0.000009,0.00001,138,0.000086,0,29,0,0.000206
40069,Johnston County,,OK,847,10427,11274,3,5,8,273,451,724,8,0.22782,0.237657,15.06183,0.000075,0.00008,350,0.000156,0,29,0.45,0.000896
40071,Kay County,,OK,2375,48286,50661,8,8,16,996,1063,2059,8,0.267121,0.283633,2101.416187,0.001278,0.00111,138,0.000343,0,29,0.410714,0.008841
40073,Kingfisher County,,OK,911,17959,18870,3,4,7,357,485,842,8,0.26216,0.276665,0.6,0.000549,0.000519,138,0.000162,0,29,0.833333,0.003995
40075,Kiowa County,,OK,616,8998,9614,1,2,3,64,189,253,8,0.246991,0.25878,499.916787,0.00017,0.00017,138,0.000075,0,29,0,0.001309
40077,Latimer County,,OK,712,10738,11450,2,2,4,300,309,609,9,0.209847,0.217583,1.05303,0.00002,0.000018,138,0.000121,0,29,0,0.000387
40079,Le Flore County,,OK,2625,47227,49852,6,7,13,1185,1359,2544,8,0.26542,0.281063,3658.994901,0.000508,0.000877,138,0.000267,0,29,0.357143,0.003729
40081,Lincoln County,,OK,2013,35005,37018,4,7,11,1314,1293,2607,8,0.265209,0.280626,1.731746,0.00072,0.001034,138,0.000178,0,29,0.785714,0.005062
40083,Logan County,,OK,3146,45772,48918,5,5,10,2110,2072,4182,8,0.265156,0.280251,5.591977,0.000758,0.00101,138,0.000214,0,29,0.766667,0.005363
40085,Love County,,OK,754,10089,10843,2,2,4,316,342,658,8,0.22749,0.236495,2.153887,0.000082,0.000073,350,0.000119,0,29,0,0.000806
40087,McClain County,,OK,2915,41866,44781,5,5,10,2366,2052,4418,8,0.262134,0.276728,0.783333,0.000739,0.000658,138,0.000208,0,29,0.85,0.005341
40089,McCurtain County,,OK,1333,32669,34002,3,2,5,245,190,435,8,0.262366,0.276671,2625.619645,0.000041,0.000461,350,0.000184,0,29,0.166667,0.000639
40091,McIntosh County,,OK,1525,18408,19933,4,5,9,657,720,1377,8,0.265209,0.280376,2.685714,0.000523,0.000848,138,0.000189,0,29,0.85,0.003964
40093,Major County,,OK,527,8926,9453,1,1,2,159,189,348,9,0.209715,0.21714,0,0.000011,0.000024,138,0.000101,0,29,0,0.000316
40095,Marshall County,,OK,917,15789,16706,3,3,6,321,330,651,8,0.227723,0.237094,5.282276,0.000075,0.000067,350,0.000142,0,29,0.833333,0.000896
40097,Mayes County,,OK,2307,40876,43183,6,6,12,1260,1439,2699,8,0.262314,0.276316,3.444444,0.000487,0.000399,138,0.000227,0,29,0.7,0.003628
40099,Murray County,,OK,698,14084,14782,4,4,8,401,309,710,8,0.253371,0.265509,58.229314,0.000536,0.000202,138,0.00017,0,29,0.733333,0.004037
40101,Muskogee County,,OK,3873,68626,72499,9,7,16,2103,2168,4271,8,0.265261,0.280751,830.285165,0.000998,0.000858,138,0.000333,0,29,0.5,0.007264
40103,Noble County,,OK,596,12293,12889,2,2,4,293,265,558,8,0.232202,0.24194,0,0.000042,0.000029,138,0.000128,0,29,1,0.000495
40105,Nowata County,,OK,555,10824,11379,4,4,8,381,373,754,8,0.262521,0.276231,65.113786,0.00049,0.000379,138,0.000159,0,29,0.75,0.003199
40107,Okfuskee County,,OK,593,10412,11005,1,2,3,116,229,345,8,0.262211,0.275566,0,0.000009,0.000365,138,0.000088,0,29,1,0.000207
40109,Oklahoma County,,OK,43489,827268,870757,90,83,173,29784,30137,59921,7,0.355023,0.39363,142072.890376,0.042389,0.045483,138,0.00253,0,29,0.262085,0.292686
40111,Okmulgee County,,OK,2176,38115,40291,7,7,14,1349,1305,2654,8,0.265209,0.280626,2761.615009,0.000981,0.000853,138,0.00028,0,29,0.571429,0.00688
40113,Osage County,,OK,3399,43615,47014,6,7,13,2570,2534,5104,8,0.265393,0.280853,14.487578,0.000509,0.000866,138,0.000241,0,29,0.619048,0.003654
40115,Ottawa County,,OK,1897,32465,34362,6,6,12,762,914,1676,8,0.262573,0.276762,557.597289,0.000481,0.000394,138,0.000273,0,29,0.466667,0.00361
40117,Pawnee County,,OK,982,16024,17006,4,4,8,612,684,1296,8,0.262289,0.276004,0.416667,0.000495,0.000386,138,0.000179,0,29,0.833333,0.003274
40119,Payne County,,OK,4800,68770,73570,13,11,24,2197,2303,4500,7,0.300755,0.322277,3990.978294,0.001408,0.002729,138,0.000484,0,29,0.395604,0.0105
40121,Pittsburg County,,OK,2368,45270,47638,7,7,14,885,880,1765,8,0.265235,0.280688,7482.631688,0.001135,0.000985,138,0.000288,0,29,0.285714,0.007737
40123,Pontotoc County,,OK,2053,40364,42417,9,8,17,923,909,1832,8,0.265314,0.281001,5704.207425,0.000706,0.001027,138,0.000356,0,29,0.345455,0.005703
40125,Pottawatomie County,,OK,4499,72297,76796,7,7,14,2492,2932,5424,8,0.265209,0.280626,24.617064,0.001196,0.001016,138,0.000266,0,29,0.642857,0.008099
40127,Pushmataha County,,OK,634,10390,11024,1,1,2,125,103,228,9,0.185329,0.190244,0,0.000001,0.000001,350,0.000115,0,29,0,0.000138
40129,Roger Mills County,,OK,176,3992,4168,0,1,1,0,75,75,9,0.207753,0.214771,0,0,0,138,0.000054,0,359,0,0
40131,Rogers County,,OK,6066,99349,105415,10,11,21,4395,4306,8701,8,0.265499,0.281603,95.010259,0.001018,0.000894,138,0.000353,0,29,0.445455,0.007459
40133,Seminole County,,OK,1515,23620,25135,4,4,8,1076,825,1901,8,0.262134,0.276603,1601.510277,0.000516,0.000481,138,0.000187,0,29,0.666667,0.003869
40135,Sequoyah County,,OK,2122,40293,42415,6,7,13,1003,1175,2178,8,0.265446,0.281126,43.453029,0.000526,0.000898,138,0.000254,0,29,0.595238,0.003914
40137,Stephens County,,OK,2252,46863,49115,7,8,15,944,1003,1947,8,0.263376,0.279083,5425.676718,0.0009,0.00086,138,0.000301,0,29,0.535714,0.006798
40139,Texas County,,OK,2353,25884,28237,2,3,5,277,406,683,7,0.292127,0.310206,4359.529812,0.000002,0.001769,138,0.000133,0,29,0.166667,0.000275
40141,Tillman County,,OK,456,7563,8019,2,2,4,143,141,284,8,0.246968,0.258718,0,0.000179,0.000171,138,0.000101,0,29,1,0.001448
40143,Tulsa County,,OK,33271,707495,740766,70,68,138,23685,23077,46762,7,0.355212,0.39106,96682.49206,0.032618,0.041087,138,0.001954,0,29,0.291629,0.227083
40145,Wagoner County,,OK,5952,79936,85888,8,8,16,4976,4408,9384,8,0.265261,0.280876,22.871602,0.000992,0.000874,138,0.000303,0,29,0.678571,0.007201
40147,Washington County,,OK,2759,58335,61094,6,7,13,1198,1347,2545,7,0.300891,0.321693,579.341697,0.00097,0.00253,138,0.000221,0,29,0.52381,0.006653
40149,Washita County,,OK,896,11813,12709,3,2,5,643,341,984,9,0.207772,0.215039,2,0.000014,0.000008,138,0.000207,0,29,0.333333,0.000451
40151,Woods County,,OK,642,9232,9874,0,0,0,0,0,0,0,0,0,0,0,0,262,0.000054,248,360,0,0
40153,Woodward County,,OK,1405,23474,24879,2,2,4,149,230,379,8,0.262083,0.276228,5413,0.000494,0.00046,138,0.000125,0,29,0,0.003437
41001,Baker County,,OR,726,17086,17812,1,1,2,74,88,162,10,0.174311,0.178587,0,0,0.000007,11,0.000156,0,29,0,0.000182
41003,Benton County,,OR,5623,85984,91607,15,13,28,3054,3607,6661,7,0.305578,0.327099,72.938098,0.006167,0.006327,11,0.000397,0,29,0.841912,0.047755
41005,Clackamas County,,OR,25129,457510,482639,48,42,90,23319,20430,43749,7,0.332627,0.362362,7390.20835,0.027268,0.022446,11,0.001102,0,29,0.468703,0.19079
41007,Clatsop County,,OR,2198,40770,42968,9,8,17,1110,827,1937,7,0.2855,0.303174,31.064761,0.002969,0.003815,11,0.000289,0,29,0.688889,0.025366
41009,Columbia County,,OR,2601,54154,56755,5,6,11,1723,1521,3244,8,0.267094,0.282111,0.142857,0.001657,0.002163,11,0.000176,0,29,0.966667,0.014715
41011,Coos County,,OR,2871,64077,66948,9,9,18,1031,1196,2227,8,0.267201,0.282736,148.764032,0.003643,0.002752,11,0.000271,0,29,0.822222,0.028679
41013,Crook County,,OR,1119,22413,23532,4,3,7,711,526,1237,8,0.249696,0.261546,1.143695,0.000889,0.000543,11,0.000177,0,29,0.666667,0.007986
41015,Curry County,,OR,1411,23477,24888,5,4,9,395,381,776,8,0.240707,0.25156,3.713178,0.001212,0.000412,11,0.000163,0,29,0.6,0.00923
41017,Deschutes County,,OR,8599,193786,202385,40,29,69,7256,4975,12231,7,0.330157,0.357624,4894.870153,0.02179,0.015958,11,0.000935,0,29,0.526713,0.151319
41019,Douglas County,,OR,4108,110628,114736,13,13,26,1855,2123,3978,7,0.285714,0.304236,22.647611,0.005536,0.004742,11,0.000357,0,29,0.795833,0.041824
41021,Gilliam County,,OR,113,1977,2090,0,0,0,0,0,0,0,0,0,0,0,0,263,0.000054,249,361,0,0
41023,Grant County,,OR,351,7387,7738,0,0,0,0,0,0,0,0,0,0,0,0,264,0.000054,250,362,0,0
41025,Harney County,,OR,300,7477,7777,0,0,0,0,0,0,0,0,0,0,0,0,265,0.000054,251,363,0,0
41027,Hood River County,,OR,1307,29772,31079,5,5,10,601,682,1283,8,0.267014,0.281799,4.18491,0.001323,0.001448,11,0.000227,0,29,0.566667,0.011985
41029,Jackson County,,OR,8196,234796,242992,39,27,66,5781,4726,10507,7,0.316752,0.342113,3328.871919,0.022676,0.015932,11,0.000814,0,29,0.559233,0.158296
41031,Jefferson County,,OR,1201,22527,23728,4,3,7,619,525,1144,8,0.266587,0.280843,27.725225,0.000974,0.0011,11,0.000178,0,29,0.666667,0.008907
41033,Josephine County,,OR,3612,85735,89347,14,10,24,2102,1756,3858,7,0.314363,0.336441,1246.5813,0.00909,0.007452,11,0.000348,0,29,0.669118,0.063618
41035,Klamath County,,OR,3075,67020,70095,8,9,17,938,1097,2035,8,0.267228,0.282767,11.99094,0.001642,0.002771,11,0.00025,0,29,0.777778,0.014276
41037,Lake County,,OR,442,7658,8100,0,0,0,0,0,0,0,0,0,0,0,0,266,0.000054,252,364,0,0
41039,Lane County,,OR,12847,379625,392472,45,41,86,9024,8545,17569,7,0.336147,0.366691,3221.219581,0.026954,0.027339,11,0.000954,0,29,0.553061,0.185894
41041,Lincoln County,,OR,2635,48736,51371,12,11,23,1340,1310,2650,7,0.285623,0.303799,15.843152,0.002538,0.004129,11,0.000343,0,29,0.865385,0.022158
41043,Linn County,,OR,6094,127312,133406,18,13,31,4520,4093,8613,7,0.305543,0.327036,146.722045,0.009442,0.006105,11,0.000451,0,29,0.80719,0.069148
41045,Malheur County,,OR,1494,28391,29885,3,4,7,638,812,1450,8,0.253299,0.266443,0.333333,0.000449,0.000492,11,0.000156,0,29,0.916667,0.003751
41047,Marion County,,OR,15212,358683,373895,33,31,64,11584,11186,22770,7,0.331429,0.35956,2605.143709,0.018003,0.018391,11,0.000741,0,29,0.562753,0.126374
41049,Morrow County,,OR,868,13138,14006,1,2,3,319,462,781,8,0.240274,0.250548,0,0.000027,0.00015,11,0.000082,0,29,1,0.000291
41051,Multnomah County,,OR,49516,867491,917007,136,90,226,43820,40428,84248,7,0.36324,0.402292,54300.675303,0.07865,0.054766,11,0.002791,0,29,0.301418,0.500805
41053,Polk County,,OR,5235,83023,88258,12,12,24,4124,3931,8055,7,0.285653,0.303986,7.747419,0.003519,0.004458,11,0.000345,0,29,0.935897,0.029917
41055,Sherman County,,OR,84,1955,2039,0,0,0,0,0,0,0,0,0,0,0,0,267,0.000054,253,365,0,0
41057,Tillamook County,,OR,1402,27681,29083,4,5,9,529,540,1069,8,0.267014,0.281799,0.142857,0.001498,0.001767,11,0.000146,0,29,0.866667,0.012983
41059,Umatilla County,,OR,4089,82006,86095,9,11,20,1352,2061,3413,8,0.267495,0.28361,8291.416073,0.00172,0.002465,11,0.00037,0,29,0.378788,0.015037
41061,Union County,,OR,1157,27901,29058,3,2,5,244,149,393,9,0.211093,0.218763,5412,0.000621,0.000019,11,0.000241,0,29,0.333333,0.005893
41063,Wallowa County,,OR,309,8136,8445,0,0,0,0,0,0,0,0,0,0,0,0,268,0.000054,254,366,0,0
41065,Wasco County,,OR,1273,27257,28530,5,3,8,662,433,1095,8,0.266533,0.280718,0.944049,0.001329,0.00088,11,0.000207,0,29,0.75,0.011985
41067,Washington County,,OR,33682,658375,692057,84,66,150,28876,27162,56038,7,0.348941,0.384782,18952.448476,0.051339,0.042375,11,0.001785,0,29,0.41732,0.351288
41069,Wheeler County,,OR,92,1292,1384,0,0,0,0,0,0,0,0,0,0,0,0,269,0.000054,255,367,0,0
41071,Yamhill County,,OR,5774,109439,115213,12,13,25,3774,3497,7271,7,0.305543,0.327036,104.406482,0.006676,0.006148,11,0.000327,0,29,0.917582,0.050484
42001,Adams County,,PA,4396,126201,130597,10,8,18,3112,2641,5753,8,0.26688,0.282894,8.399796,0.003151,0.001528,271,0.000196,0,29,0.766667,0.016151
42003,Allegheny County,,PA,40655,1485329,1525984,137,149,286,25828,30205,56033,7,0.383278,0.429876,207259.412229,0.084836,0.095098,257,0.002577,0,29,0.295752,0.508781
42005,Armstrong County,,PA,2460,82004,84464,5,5,10,1561,1696,3257,8,0.277224,0.29337,2.666667,0.001143,0.000992,257,0.000181,0,29,0.7,0.006549
42007,Beaver County,,PA,5822,210795,216617,9,7,16,3594,3213,6807,8,0.277339,0.29387,12.206659,0.001285,0.001052,257,0.000249,0,29,0.513889,0.007571
42009,Bedford County,,PA,1403,59434,60837,4,4,8,489,562,1051,9,0.219607,0.228807,71.676161,0.000037,0.000039,257,0.000163,0,29,0.3,0.000682
42011,Berks County,,PA,13693,505273,518966,28,33,61,8378,8661,17039,7,0.33271,0.361316,616.814545,0.018508,0.025556,271,0.000375,0,29,0.651652,0.097617
42013,Blair County,,PA,3005,148499,151504,7,6,13,1428,1194,2622,8,0.277859,0.294394,2530.925592,0.001214,0.001041,257,0.000233,0,29,0.5,0.007265
42015,Bradford County,,PA,2402,73772,76174,7,8,15,975,939,1914,8,0.247151,0.2599,2895.665454,0.000067,0.000114,271,0.000237,0,29,0.267857,0.001091
42017,Bucks County,,PA,26374,806896,833270,48,72,120,20593,20225,40818,7,0.349123,0.384734,2185.895418,0.037437,0.055686,271,0.000559,0,29,0.585045,0.199493
42019,Butler County,,PA,7389,233883,241272,10,10,20,4771,4103,8874,8,0.277541,0.294607,27.585678,0.001324,0.00111,257,0.000295,0,29,0.466667,0.007874
42021,Cambria County,,PA,3889,160898,164787,8,7,15,1595,1887,3482,8,0.277714,0.294344,940.594859,0.002174,0.001086,257,0.000252,0,29,0.458333,0.012379
42023,Cameron County,,PA,126,5895,6021,0,0,0,0,0,0,0,0,0,0,0,0,270,0.000054,256,368,0,0
42025,Carbon County,,PA,2921,75249,78170,8,8,16,1914,1858,3772,8,0.273697,0.290706,0.541459,0.003516,0.002957,271,0.000129,0,29,0.928571,0.016605
42027,Centre County,,PA,5113,143672,148785,18,15,33,1995,1759,3754,7,0.316564,0.340029,11970.219808,0.007559,0.007285,257,0.000402,0,29,0.392105,0.042031
42029,Chester County,,PA,22835,637288,660123,52,61,113,16072,16373,32445,7,0.351932,0.386752,1892.27326,0.039265,0.052068,271,0.000667,0,29,0.576258,0.219108
42031,Clarion County,,PA,1407,43195,44602,6,5,11,669,735,1404,8,0.27731,0.293482,2672.38254,0.001077,0.000973,257,0.00023,0,29,0.4,0.006507
42033,Clearfield County,,PA,2496,92010,94506,7,7,14,1378,1318,2696,8,0.277772,0.294438,1447.587979,0.001166,0.001065,257,0.000253,0,29,0.52381,0.007164
42035,Clinton County,,PA,1350,43112,44462,2,2,4,660,735,1395,8,0.249416,0.260061,0,0.000127,0.000097,271,0.000098,0,29,1,0.000828
42037,Columbia County,,PA,2486,72465,74951,5,6,11,1195,1264,2459,8,0.273697,0.290393,393.019553,0.000347,0.001213,271,0.000143,0,29,0.633333,0.001966
42039,Crawford County,,PA,3029,98686,101715,6,6,12,1552,1553,3105,8,0.277512,0.294013,244.107475,0.001225,0.001029,257,0.000157,0,29,0.566667,0.006831
42041,Cumberland County,,PA,11325,300608,311933,24,17,41,7696,6439,14135,7,0.292769,0.314655,1642.280975,0.009547,0.008146,271,0.000414,0,29,0.441667,0.049982
42043,Dauphin County,,PA,13551,332124,345675,34,31,65,8532,8495,17027,7,0.338493,0.366631,16537.26517,0.018135,0.019504,271,0.000572,0,29,0.465149,0.100818
42045,Delaware County,,PA,25455,668833,694288,39,53,92,19628,19845,39473,7,0.34726,0.380262,1354.008539,0.030716,0.045559,271,0.000505,0,29,0.655892,0.171427
42047,Elk County,,PA,674,40706,41380,3,4,7,270,249,519,8,0.277425,0.293545,68.703474,0.000032,0.000946,257,0.000157,0,29,0.583333,0.000535
42049,Erie County,,PA,7271,321129,328400,12,20,32,2239,2846,5085,7,0.330402,0.356493,5894.923604,0.006011,0.012525,257,0.000261,0,29,0.42381,0.035083
42051,Fayette County,,PA,3910,152488,156398,6,6,12,2315,2231,4546,8,0.278264,0.294844,53.376383,0.001153,0.001003,257,0.000232,0,29,0.666667,0.00677
42053,Forest County,,PA,241,5373,5614,0,1,1,0,72,72,9,0.217168,0.224708,0,0,0.000012,257,0.000054,0,369,0,0
42055,Franklin County,,PA,5273,193220,198493,11,12,23,2943,2626,5569,8,0.28096,0.299788,3883.883175,0.002292,0.002977,271,0.000313,0,29,0.462121,0.012935
42057,Fulton County,,PA,455,17967,18422,2,1,3,224,139,363,9,0.219354,0.227739,0,0.000103,0.000025,271,0.000091,0,29,1,0.000793
42059,Greene County,,PA,1285,40623,41908,4,4,8,620,680,1300,8,0.27809,0.294344,0,0.001066,0.000959,257,0.000182,0,29,1,0.006245
42061,Huntingdon County,,PA,1248,49150,50398,5,6,11,624,709,1333,8,0.241251,0.252558,154.41312,0.000129,0.000225,257,0.000193,0,29,0.3,0.001353
42063,Indiana County,,PA,3029,92584,95613,6,6,12,1445,1435,2880,8,0.277339,0.29367,6.16746,0.001153,0.001014,257,0.000213,0,29,0.6,0.006782
42065,Jefferson County,,PA,1651,54307,55958,5,5,10,886,955,1841,8,0.277368,0.293576,1364.380167,0.001076,0.000958,257,0.000202,0,29,0.55,0.006313
42067,Juniata County,,PA,753,29265,30018,4,4,8,378,394,772,8,0.253107,0.264695,264.578658,0.000225,0.000208,271,0.00015,0,29,0.416667,0.001668
42069,Lackawanna County,,PA,8574,247467,256041,15,19,34,3826,3695,7521,7,0.324377,0.349634,7593.85711,0.009185,0.01171,271,0.000265,0,29,0.57619,0.052433
42071,Lancaster County,,PA,15506,669867,685373,37,43,80,9115,9226,18341,7,0.343239,0.373734,6410.808019,0.02253,0.03287,271,0.000538,0,29,0.522449,0.121822
42073,Lawrence County,,PA,2902,104348,107250,5,6,11,1552,1636,3188,8,0.277339,0.293745,1.573975,0.001153,0.001044,257,0.000158,0,29,0.766667,0.006595
42075,Lebanon County,,PA,5276,171130,176406,9,8,17,2991,2875,5866,8,0.273753,0.290799,7.374682,0.003967,0.002525,271,0.000166,0,29,0.888889,0.02128
42077,Lehigh County,,PA,17474,432147,449621,43,46,89,13176,12380,25556,7,0.337167,0.368221,1169.062633,0.030993,0.034288,271,0.000481,0,29,0.59798,0.157354
42079,Luzerne County,,PA,10165,375147,385312,28,36,64,6225,5702,11927,7,0.334923,0.364292,11203.063887,0.016463,0.023412,271,0.0004,0,29,0.506707,0.084703
42081,Lycoming County,,PA,3903,136682,140585,11,13,24,1579,1704,3283,7,0.321601,0.345299,22433.617471,0.001336,0.004408,271,0.000333,0,29,0.295238,0.008515
42083,McKean County,,PA,1240,47736,48976,4,4,8,335,350,685,8,0.277627,0.293876,3182.659085,0.000031,0.00093,257,0.000181,0,29,0.1,0.000552
42085,Mercer County,,PA,3822,133346,137168,8,9,17,1797,1976,3773,8,0.277541,0.294482,13.282462,0.001352,0.001134,257,0.000208,0,29,0.541667,0.007629
42087,Mifflin County,,PA,1178,55142,56320,4,5,9,474,494,968,8,0.256317,0.268999,59.417052,0.000086,0.000527,271,0.000158,0,29,0.4,0.001011
42089,Monroe County,,PA,8981,184054,193035,30,31,61,6166,5507,11673,7,0.312852,0.338512,1193.012037,0.018238,0.018296,271,0.000336,0,29,0.664773,0.085144
42091,Montgomery County,,PA,38382,1021131,1059513,74,88,162,31051,30997,62048,7,0.352351,0.390875,5390.051873,0.055288,0.06855,271,0.000958,0,29,0.526974,0.307201
42093,Montour County,,PA,1140,22445,23585,3,4,7,497,568,1065,8,0.243542,0.253976,0.666667,0.000022,0.000036,271,0.000123,0,29,0.833333,0.000519
42095,Northampton County,,PA,14095,363695,377790,33,36,69,11060,9817,20877,7,0.326561,0.355009,809.562727,0.021616,0.02629,271,0.000367,0,29,0.651163,0.106693
42097,Northumberland County,,PA,3512,108082,111594,9,10,19,2046,2113,4159,8,0.256884,0.270905,6803.868784,0.001586,0.000782,271,0.000224,0,29,0.454545,0.008886
42099,Perry County,,PA,1682,57154,58836,5,4,9,1237,1119,2356,8,0.255629,0.268056,14.455008,0.000945,0.000479,271,0.000143,0,29,0.7,0.004556
42101,Philadelphia County,,PA,69042,1520743,1589785,127,139,266,50795,59312,110107,7,0.375775,0.421741,50449.863807,0.088735,0.093913,271,0.00179,0,29,0.360327,0.507455
42103,Pike County,,PA,3651,64388,68039,14,11,25,2160,1773,3933,7,0.288495,0.307876,442.185314,0.008711,0.005326,271,0.000193,0,29,0.670833,0.042832
42105,Potter County,,PA,631,19784,20415,2,2,4,190,184,374,9,0.217903,0.226079,22.119668,0.00001,0.000001,257,0.000126,0,29,0,0.000273
42107,Schuylkill County,,PA,4285,168893,173178,12,14,26,2569,2429,4998,8,0.274119,0.292361,176.006278,0.003603,0.003338,271,0.000207,0,29,0.620879,0.017863
42109,Snyder County,,PA,1289,47060,48349,3,5,8,605,725,1330,8,0.253179,0.265008,39.739095,0.000011,0.000218,271,0.000135,0,29,0.45,0.000512
42111,Somerset County,,PA,2144,88924,91068,4,5,9,796,902,1698,8,0.277483,0.293701,1317.811018,0.001132,0.00099,257,0.00015,0,29,0.55,0.006386
42113,Sullivan County,,PA,275,7080,7355,1,2,3,71,125,196,8,0.24372,0.253951,0,0.000001,0.000015,271,0.000079,0,29,1,0.00015
42115,Susquehanna County,,PA,1807,49347,51154,5,5,10,901,876,1777,8,0.246923,0.259057,268.249362,0.000254,0.000198,271,0.000152,0,29,0.4,0.001718
42117,Tioga County,,PA,1506,47859,49365,5,5,10,509,562,1071,8,0.244524,0.25585,2317.97343,0.000071,0.000026,271,0.000197,0,29,0.3,0.000846
42119,Union County,,PA,1666,44016,45682,4,4,8,903,859,1762,8,0.243586,0.254101,12.901985,0.000059,0.000032,271,0.000144,0,29,0.583333,0.000727
42121,Venango County,,PA,1704,63141,64845,6,6,12,842,907,1749,8,0.277425,0.293857,6.171429,0.001215,0.00104,257,0.000185,0,29,0.733333,0.006927
42123,Warren County,,PA,1304,48096,49400,3,5,8,445,547,992,8,0.277599,0.294044,504.979405,0.000168,0.001018,257,0.000102,0,29,0.5,0.000902
42125,Washington County,,PA,7797,254644,262441,8,10,18,4605,4456,9061,8,0.278294,0.295531,132.569115,0.001176,0.001054,257,0.00033,0,29,0.422222,0.007221
42127,Wayne County,,PA,2715,59093,61808,5,5,10,1170,1207,2377,8,0.252508,0.265403,20.747547,0.00064,0.000574,271,0.000125,0,29,0.65,0.003484
42129,Westmoreland County,,PA,11298,449727,461025,11,15,26,7175,6940,14115,7,0.316039,0.339061,2505.176572,0.002975,0.007033,257,0.000328,0,29,0.305147,0.019142
42131,Wyoming County,,PA,1525,33490,35015,4,4,8,820,1101,1921,8,0.252412,0.264891,431.380709,0.000385,0.000282,271,0.000126,0,29,0.5,0.00202
42133,York County,,PA,14886,549155,564041,31,38,69,10494,9410,19904,7,0.337935,0.367531,3716.173806,0.016168,0.026281,271,0.000476,0,29,0.506969,0.086386
44001,Bristol County,,RI,2262,57472,59734,4,6,10,1418,1405,2823,8,0.27426,0.291321,0,0.001197,0.002851,110,0.000093,0,29,1,0.005009
44003,Kent County,,RI,9221,203901,213122,11,16,27,6918,6338,13256,7,0.312412,0.335357,123.157369,0.005088,0.009439,110,0.000171,0,29,0.725,0.02533
44005,Newport County,,RI,5618,97417,103035,16,16,32,2485,2739,5224,7,0.308368,0.331328,378.66497,0.009643,0.009672,110,0.000248,0,29,0.594737,0.054416
44007,Providence County,,RI,25334,708651,733985,50,68,118,16065,19548,35613,7,0.353377,0.389242,4523.739356,0.041901,0.060621,110,0.000707,0,29,0.644501,0.245587
44009,Washington County,,RI,5966,149864,155830,10,14,24,3751,3606,7357,7,0.286604,0.306135,7.103914,0.005931,0.007736,110,0.000149,0,29,0.804762,0.026841
45001,Abbeville County,,SC,1204,24886,26090,3,3,6,797,853,1650,8,0.258477,0.271268,0,0.000444,0.000507,234,0.000146,0,29,1,0.003643
45003,Aiken County,,SC,7505,180177,187682,11,17,28,3903,4071,7974,7,0.321098,0.345896,5386.523531,0.003667,0.007712,234,0.000329,0,29,0.5,0.025566
45005,Allendale County,,SC,506,7844,8350,1,2,3,80,192,272,9,0.208259,0.21549,2.699578,0.000009,0.000005,234,0.000085,0,29,0,0.000151
45007,Anderson County,,SC,8381,210840,219221,14,13,27,5447,5200,10647,7,0.290032,0.310587,1795.767024,0.004629,0.004642,234,0.000445,0,29,0.5,0.032663
45009,Bamberg County,,SC,828,13328,14156,2,3,5,272,394,666,8,0.262469,0.276067,35.039134,0.000038,0.000459,234,0.000107,0,29,0.666667,0.000623
45011,Barnwell County,,SC,987,22274,23261,4,4,8,447,511,958,8,0.244121,0.255512,294.962182,0.000125,0.000193,234,0.000156,0,29,0.4,0.001138
45013,Beaufort County,,SC,11634,194812,206446,49,35,84,5707,4735,10442,7,0.34408,0.374206,13747.436037,0.037717,0.033035,234,0.000944,0,29,0.56464,0.232224
45015,Berkeley County,,SC,17529,207808,225337,27,24,51,11577,11555,23132,7,0.317166,0.343947,1717.070543,0.017712,0.011702,234,0.000603,0,29,0.482008,0.121753
45017,Calhoun County,,SC,865,15454,16319,3,3,6,577,628,1205,8,0.262495,0.276129,0,0.000636,0.000557,234,0.000116,0,29,1,0.004106
45019,Charleston County,,SC,26144,406476,432620,86,64,150,19850,17657,37507,7,0.356256,0.391587,13603.781449,0.062129,0.050994,234,0.001569,0,29,0.445353,0.3813
45021,Cherokee County,,SC,2323,57594,59917,6,6,12,1574,1531,3105,8,0.259382,0.273149,4.834458,0.000639,0.000698,234,0.000199,0,29,0.666667,0.005405
45023,Chester County,,SC,1549,34464,36013,4,3,7,972,935,1907,8,0.279665,0.295985,21.104962,0.001192,0.001333,234,0.00013,0,29,0.583333,0.008509
45025,Chesterfield County,,SC,1791,45374,47165,6,7,13,813,961,1774,8,0.279987,0.297172,627.511027,0.000195,0.001404,234,0.000171,0,29,0.380952,0.001831
45027,Clarendon County,,SC,1779,32912,34691,5,6,11,805,994,1799,8,0.265314,0.280168,3.147934,0.000645,0.001287,234,0.000163,0,29,0.738095,0.004429
45029,Colleton County,,SC,1767,40542,42309,4,5,9,757,928,1685,8,0.265446,0.280262,0,0.001134,0.001755,234,0.00014,0,29,1,0.008788
45031,Darlington County,,SC,3098,70480,73578,5,8,13,1639,1893,3532,8,0.281405,0.299233,366.24375,0.001662,0.002227,234,0.000162,0,29,0.642857,0.011074
45033,Dillon County,,SC,1231,32009,33240,5,5,10,601,621,1222,7,0.317619,0.339299,1826.701747,0.000427,0.002371,234,0.000173,0,29,0.433333,0.003994
45035,Dorchester County,,SC,13110,162834,175944,14,14,28,8999,8666,17665,7,0.306808,0.330623,319.059138,0.006844,0.008686,234,0.000348,0,29,0.676471,0.048127
45037,Edgefield County,,SC,1418,25732,27150,4,3,7,1113,798,1911,8,0.250141,0.262463,27.006548,0.000459,0.000277,234,0.000147,0,29,0.666667,0.003157
45039,Fairfield County,,SC,1188,23605,24793,2,5,7,466,843,1309,8,0.26265,0.276754,4.580421,0.000599,0.000595,234,0.000096,0,29,0.6,0.003621
45041,Florence County,,SC,6619,148574,155193,17,18,35,3651,4009,7660,8,0.282268,0.302107,3270.231499,0.004653,0.003823,234,0.000439,0,29,0.426316,0.033402
45043,Georgetown County,,SC,3834,69689,73523,7,8,15,1848,2189,4037,8,0.281851,0.299983,56.120456,0.00264,0.003483,234,0.00021,0,29,0.839286,0.019217
45045,Greenville County,,SC,23440,544356,567796,65,47,112,17158,14918,32076,7,0.348212,0.380909,32108.696126,0.040847,0.035116,234,0.001385,0,29,0.400604,0.260518
45047,Greenwood County,,SC,3107,75073,78180,11,9,20,1781,1863,3644,8,0.264709,0.279856,5542.884323,0.001227,0.001108,234,0.000406,0,29,0.436364,0.009058
45049,Hampton County,,SC,1049,19855,20904,3,4,7,278,478,756,8,0.262754,0.276785,5127.785542,0.000368,0.000823,234,0.00015,0,29,0.333333,0.002867
45051,Horry County,,SC,16724,332063,348787,84,45,129,10828,6902,17730,7,0.339527,0.370364,17040.950826,0.042721,0.028386,234,0.001407,0,29,0.30932,0.234486
45053,Jasper County,,SC,2000,24904,26904,3,3,6,1075,1101,2176,8,0.261159,0.274455,39.901959,0.000823,0.000854,234,0.000131,0,29,0.666667,0.005763
45055,Kershaw County,,SC,3157,69369,72526,7,6,13,2052,1524,3576,8,0.281227,0.298608,49.353918,0.000706,0.001822,234,0.0002,0,29,0.553571,0.004918
45057,Lancaster County,,SC,3835,89917,93752,7,9,16,3505,2375,5880,8,0.281464,0.299483,315.000553,0.001811,0.002318,234,0.000212,0,29,0.472222,0.011908
45059,Laurens County,,SC,3149,67454,70603,5,6,11,2155,2178,4333,8,0.258652,0.27208,6.724269,0.000538,0.000644,234,0.000206,0,29,0.666667,0.004669
45061,Lee County,,SC,984,17176,18160,5,5,10,696,718,1414,8,0.262573,0.276535,1.257576,0.000642,0.000529,234,0.000161,0,29,0.8,0.004177
45063,Lexington County,,SC,15273,308911,324184,28,25,53,11245,10383,21628,8,0.292769,0.31673,5353.88563,0.009179,0.008076,234,0.00071,0,29,0.363911,0.064437
45065,McCormick County,,SC,484,9390,9874,1,1,2,74,172,246,9,0.209321,0.216434,0,0.000012,0.000013,234,0.000092,0,29,0,0.000242
45067,Marion County,,SC,1527,33304,34831,3,4,7,703,835,1538,8,0.264106,0.278363,1.825213,0.000375,0.000924,234,0.00013,0,29,0.833333,0.003378
45069,Marlboro County,,SC,1118,26506,27624,2,3,5,273,377,650,8,0.243275,0.253622,4.490366,0.000049,0.000016,234,0.000092,0,29,0,0.000343
45071,Newberry County,,SC,1626,41421,43047,4,4,8,686,849,1535,8,0.262547,0.276379,13.698582,0.000988,0.000524,234,0.000151,0,29,0.8,0.00671
45073,Oconee County,,SC,3194,80046,83240,4,4,8,1390,1501,2891,8,0.258552,0.271581,3.73464,0.001381,0.00062,234,0.000153,0,29,0.8,0.009496
45075,Orangeburg County,,SC,4133,89984,94117,12,14,26,2107,2552,4659,8,0.282059,0.301201,5071.346985,0.004887,0.003333,234,0.000326,0,29,0.470833,0.033003
45077,Pickens County,,SC,6493,119221,125714,8,8,16,4112,4192,8304,8,0.281762,0.299795,115.572085,0.002687,0.003028,234,0.000258,0,29,0.708333,0.019025
45079,Richland County,,SC,26230,410337,436567,73,71,144,18604,18416,37020,7,0.355638,0.391897,53530.484153,0.03727,0.047132,234,0.001562,0,29,0.329832,0.24405
45081,Saluda County,,SC,1172,22528,23700,4,5,9,704,836,1540,8,0.26265,0.276754,26.181598,0.000186,0.000562,234,0.000174,0,29,0.65,0.001659
45083,Spartanburg County,,SC,11432,323004,334436,28,23,51,8543,7150,15693,7,0.294092,0.317571,9523.553948,0.008962,0.008116,234,0.000764,0,29,0.358065,0.062468
45085,Sumter County,,SC,6935,117838,124773,12,12,24,2034,2505,4539,8,0.284132,0.303568,785.886232,0.004406,0.004119,234,0.000316,0,29,0.552381,0.031061
45087,Union County,,SC,843,27768,28611,1,1,2,276,349,625,8,0.227277,0.237217,0,0.000088,0.000097,234,0.000082,0,29,0,0.000832
45089,Williamsburg County,,SC,1597,32451,34048,5,5,10,907,1059,1966,8,0.264132,0.27855,9.660992,0.000913,0.000955,234,0.000165,0,29,0.8,0.006481
45091,York County,,SC,11776,279656,291432,19,20,39,8390,6610,15000,7,0.291808,0.314135,858.933706,0.006417,0.006723,234,0.000466,0,29,0.428333,0.04471
46003,Aurora County,,SD,113,3475,3588,0,1,1,0,65,65,9,0.201495,0.207265,0,0,0.000001,209,0.000054,0,370,0,0
46005,Beadle County,,SD,1107,22114,23221,1,2,3,68,219,287,8,0.252245,0.263553,0,0.000125,0.000128,209,0.000109,0,29,1,0.00103
46007,Bennett County,,SD,85,3041,3126,0,0,0,0,0,0,0,0,0,0,0,0,272,0.000054,257,371,0,0
46009,Bon Homme County,,SD,268,7078,7346,0,2,2,0,120,120,8,0.252245,0.263517,0,0,0.000128,209,0.000054,0,372,1,0
46011,Brookings County,,SD,1665,33428,35093,5,3,8,477,385,862,8,0.252222,0.263616,4,0.00013,0.00013,209,0.000386,0,29,0.35,0.001556
46013,Brown County,,SD,1865,46104,47969,5,5,10,434,476,910,8,0.253853,0.266764,13501.087984,0.000126,0.000195,209,0.00041,0,29,0.142857,0.001508
46015,Brule County,,SD,186,6257,6443,0,0,0,0,0,0,0,0,0,0,0,0,273,0.000054,258,373,0,0
46017,Buffalo County,,SD,98,1963,2061,0,0,0,0,0,0,0,0,0,0,0,0,274,0.000054,259,374,0,0
46019,Butte County,,SD,775,11559,12334,2,2,4,264,277,541,9,0.198527,0.20416,0,0.000084,0.000002,209,0.000145,0,29,1,0.000702
46021,Campbell County,,SD,-2,1871,1869,0,0,0,0,0,0,0,0,0,0,0,0,275,0.000054,260,375,0,0
46023,Charles Mix County,,SD,292,9804,10096,0,0,0,0,0,0,0,0,0,0,0,0,276,0.000054,261,376,0,0
46025,Clark County,,SD,128,4222,4350,0,0,0,0,0,0,0,0,0,0,0,0,277,0.000054,262,377,0,0
46027,Clay County,,SD,921,11890,12811,2,2,4,201,186,387,8,0.252198,0.263428,0,0.000126,0.000128,209,0.000224,0,29,1,0.001171
46029,Codington County,,SD,1412,33973,35385,3,3,6,252,349,601,8,0.252245,0.263678,5414,0.000127,0.000128,209,0.000295,0,29,0.333333,0.001294
46031,Corson County,,SD,251,3364,3615,0,0,0,0,0,0,0,0,0,0,0,0,278,0.000054,263,378,0,0
46033,Custer County,,SD,653,9681,10334,1,1,2,193,183,376,8,0.247266,0.257348,0,0.000083,0.000062,209,0.000094,0,29,0,0.000569
46035,Davison County,,SD,1108,23669,24777,3,2,5,253,246,499,8,0.252245,0.263553,7244.981261,0.000125,0.000127,209,0.000216,0,29,0,0.001262
46037,Day County,,SD,233,6673,6906,0,0,0,0,0,0,0,0,0,0,0,0,279,0.000054,264,379,0,0
46039,Deuel County,,SD,192,5484,5676,0,0,0,0,0,0,0,0,0,0,0,0,280,0.000054,265,380,0,0
46041,Dewey County,,SD,287,6728,7015,0,0,0,0,0,0,0,0,0,0,0,0,281,0.000054,266,381,0,0
46043,Douglas County,,SD,100,3695,3795,0,0,0,0,0,0,0,0,0,0,0,0,282,0.000054,267,382,0,0
46045,Edmunds County,,SD,147,4487,4634,1,1,2,115,90,205,9,0.202474,0.208798,0,0.000002,0.000001,209,0.000123,0,29,0,0.000146
46047,Fall River County,,SD,472,7878,8350,1,1,2,97,131,228,8,0.247266,0.257348,0,0.000083,0.000062,209,0.000094,0,29,0,0.000569
46049,Faulk County,,SD,63,2433,2496,0,0,0,0,0,0,0,0,0,0,0,0,283,0.000054,268,383,0,0
46051,Grant County,,SD,352,9424,9776,0,0,0,0,0,0,0,0,0,0,0,0,284,0.000054,269,384,0,0
46053,Gregory County,,SD,102,5126,5228,0,0,0,0,0,0,0,0,0,0,0,0,285,0.000054,270,385,0,0
46055,Haakon County,,SD,60,2438,2498,0,0,0,0,0,0,0,0,0,0,0,0,286,0.000054,271,386,0,0
46057,Hamlin County,,SD,245,7030,7275,1,1,2,84,96,180,9,0.20145,0.207186,0,0.000001,0.000001,209,0.000137,0,29,0,0.000137
46059,Hand County,,SD,81,4174,4255,0,0,0,0,0,0,0,0,0,0,0,0,287,0.000054,272,387,0,0
46061,Hanson County,,SD,490,5392,5882,1,2,3,71,111,182,9,0.202489,0.208973,3.2,0.000001,0.000002,209,0.000145,0,29,0,0.000137
46063,Harding County,,SD,-2,1531,1529,0,0,0,0,0,0,0,0,0,0,0,0,288,0.000054,273,388,0,0
46065,Hughes County,,SD,1127,21748,22875,3,3,6,281,398,679,8,0.252604,0.264478,5412,0.000207,0.000189,209,0.000256,0,29,0.333333,0.001717
46067,Hutchinson County,,SD,214,8653,8867,0,1,1,0,60,60,8,0.252221,0.263329,0,0,0.000127,209,0.000054,0,389,0,0
46069,Hyde County,,SD,-2,1653,1651,0,0,0,0,0,0,0,0,0,0,0,0,289,0.000054,274,390,0,0
46071,Jackson County,,SD,99,2863,2962,0,0,0,0,0,0,0,0,0,0,0,0,290,0.000054,275,391,0,0
46073,Jerauld County,,SD,96,2215,2311,0,0,0,0,0,0,0,0,0,0,0,0,291,0.000054,276,392,0,0
46075,Jones County,,SD,-2,1239,1237,0,0,0,0,0,0,0,0,0,0,0,0,292,0.000054,277,393,0,0
46077,Kingsbury County,,SD,409,6558,6967,0,2,2,0,138,138,8,0.252245,0.263517,0,0,0.000128,209,0.000054,0,394,1,0
46079,Lake County,,SD,1026,15739,16765,1,1,2,175,148,323,8,0.252174,0.263241,0,0.000125,0.000127,209,0.000109,0,29,0,0.00103
46081,Lawrence County,,SD,1682,28628,30310,3,4,7,623,708,1331,8,0.247656,0.25846,1347.977693,0.000083,0.000067,209,0.000243,0,29,0.5,0.000829
46083,Lincoln County,,SD,4053,64853,68906,4,4,8,3211,2528,5739,8,0.252245,0.263803,3.5,0.000129,0.000131,209,0.000368,0,29,0.5,0.001452
46085,Lyman County,,SD,131,4314,4445,0,0,0,0,0,0,0,0,0,0,0,0,293,0.000054,278,395,0,0
46087,McCook County,,SD,301,6832,7133,1,1,2,88,136,224,8,0.252174,0.263241,0,0.000125,0.000127,209,0.000109,0,29,0,0.00103
46089,McPherson County,,SD,87,2447,2534,0,1,1,0,49,49,9,0.202519,0.208907,0,0,0.000001,209,0.000054,0,396,0,0
46091,Marshall County,,SD,219,5089,5308,0,0,0,0,0,0,0,0,0,0,0,0,294,0.000054,279,397,0,0
46093,Meade County,,SD,2701,31300,34001,3,2,5,1422,1375,2797,8,0.247289,0.257536,1322.622307,0.000084,0.000063,209,0.000207,0,29,0.833333,0.000829
46095,Mellette County,,SD,69,1807,1876,0,0,0,0,0,0,0,0,0,0,0,0,295,0.000054,280,398,0,0
46097,Miner County,,SD,130,2794,2924,0,0,0,0,0,0,0,0,0,0,0,0,296,0.000054,281,399,0,0
46099,Minnehaha County,,SD,13514,230935,244449,34,32,66,6122,6018,12140,7,0.337167,0.365576,152703.25378,0.011673,0.01147,209,0.002067,0,29,0.151147,0.078686
46101,Moody County,,SD,269,7575,7844,2,2,4,189,168,357,8,0.252198,0.263428,0,0.000126,0.000128,209,0.000218,0,29,1,0.001177
46103,Pennington County,,SD,8582,128252,136834,13,17,30,2781,2962,5743,7,0.32845,0.353363,48078.455032,0.005712,0.007624,209,0.000799,0,29,0.25731,0.040576
46105,Perkins County,,SD,54,3453,3507,0,0,0,0,0,0,0,0,0,0,0,0,297,0.000054,282,400,0,0
46107,Potter County,,SD,51,3132,3183,0,0,0,0,0,0,0,0,0,0,0,0,298,0.000054,283,401,0,0
46109,Roberts County,,SD,417,11115,11532,0,0,0,0,0,0,0,0,0,0,0,0,299,0.000054,284,402,0,0
46111,Sanborn County,,SD,116,2883,2999,0,0,0,0,0,0,0,0,0,0,0,0,300,0.000054,285,403,0,0
46115,Spink County,,SD,219,7424,7643,1,1,2,76,90,166,9,0.202474,0.208798,0,0.000002,0.000001,209,0.000123,0,29,0,0.000146
46117,Stanley County,,SD,275,3757,4032,1,1,2,217,156,373,9,0.201678,0.207598,0,0.000002,0.000002,209,0.000126,0,29,0,0.000142
46119,Sully County,,SD,71,1829,1900,0,0,0,0,0,0,0,0,0,0,0,0,301,0.000054,286,404,0,0
46121,Todd County,,SD,311,8101,8412,1,1,2,68,73,141,8,0.247266,0.257348,0,0.000083,0.000062,209,0.000094,0,29,0,0.000569
46123,Tripp County,,SD,164,6690,6854,0,0,0,0,0,0,0,0,0,0,0,0,302,0.000054,287,405,0,0
46125,Turner County,,SD,386,10108,10494,2,2,4,235,257,492,8,0.252198,0.263428,0,0.000126,0.000128,209,0.000187,0,29,1,0.001172
46127,Union County,,SD,1131,18780,19911,4,3,7,560,480,1040,8,0.252365,0.263959,14.784201,0.000138,0.000137,209,0.00025,0,29,0.5,0.001484
46129,Walworth County,,SD,300,6597,6897,0,0,0,0,0,0,0,0,0,0,0,0,303,0.000054,288,406,0,0
46135,Yankton County,,SD,1102,26272,27374,4,2,6,332,221,553,8,0.252198,0.263428,2668.5,0.000127,0.000128,209,0.000272,0,29,0.25,0.001389
46137,Ziebach County,,SD,-2,1341,1339,0,0,0,0,0,0,0,0,0,0,0,0,304,0.000054,289,407,0,0
47001,Anderson County,,TN,4701,82508,87209,9,9,18,2974,3042,6016,7,0.281881,0.297134,658.696031,0.001166,0.001306,306,0.000359,0,29,0.402778,0.009444
47003,Bedford County,,TN,2495,52816,55311,5,7,12,1510,1463,2973,7,0.281257,0.295759,1573.447934,0.001011,0.001132,306,0.000197,0,29,0.547619,0.007799
47005,Benton County,,TN,642,16710,17352,3,3,6,260,255,515,9,0.184241,0.189471,212.045566,0.000001,0.000009,306,0.000235,0,29,0.333333,0.000467
47007,Bledsoe County,,TN,506,11524,12030,2,3,5,262,214,476,8,0.254289,0.266581,0.75,0.000258,0.000238,306,0.000105,0,29,0.666667,0.001852
47009,Blount County,,TN,5731,144681,150412,9,7,16,3354,2930,6284,7,0.281702,0.296571,357.545376,0.001428,0.001295,306,0.000313,0,29,0.486111,0.010999
47011,Bradley County,,TN,5211,114036,119247,12,10,22,3064,2671,5735,7,0.282418,0.298277,3809.242454,0.000929,0.001573,306,0.000495,0,29,0.252747,0.00679
47013,Campbell County,,TN,1433,37731,39164,4,5,9,658,776,1434,8,0.26542,0.278565,4574.459009,0.000386,0.000328,306,0.000182,0,29,0.2,0.002722
47015,Cannon County,,TN,779,14764,15543,2,2,4,501,423,924,8,0.255018,0.266818,0,0.000237,0.00016,306,0.000127,0,29,1,0.001403
47017,Carroll County,,TN,1560,29468,31028,6,6,12,811,906,1717,8,0.224164,0.232763,2901.893929,0.000059,0.000057,306,0.000347,0,29,0.4,0.001184
47019,Carter County,,TN,2782,56062,58844,5,4,9,1825,1660,3485,8,0.22511,0.234246,5440.573438,0.000052,0.000024,306,0.000366,0,29,0.4,0.000886
47021,Cheatham County,,TN,2939,46211,49150,8,8,16,2010,2142,4152,7,0.283951,0.299295,8.582555,0.001557,0.001715,306,0.000289,0,29,0.839286,0.012129
47023,Chester County,,TN,833,17215,18048,3,3,6,465,420,885,8,0.223807,0.231682,9.716667,0.000029,0.00004,306,0.000208,0,29,0.666667,0.000687
47025,Claiborne County,,TN,1377,30988,32365,3,4,7,475,535,1010,8,0.26442,0.277338,5327.846448,0.00037,0.00032,306,0.000172,0,29,0.333333,0.002484
47027,Clay County,,TN,369,7593,7962,2,0,2,133,0,133,0,0,0,0,0.000019,0,306,0.000118,0,16,1,0.000386
47029,Cocke County,,TN,1594,36087,37681,5,5,10,748,891,1639,8,0.264289,0.277257,1.5,0.000392,0.000329,306,0.000188,0,29,0.8,0.00287
47031,Coffee County,,TN,3241,59631,62872,7,8,15,1851,1885,3736,7,0.281851,0.296977,6068.247264,0.001015,0.001359,306,0.000302,0,29,0.410714,0.00804
47033,Crockett County,,TN,847,15852,16699,4,3,7,493,461,954,8,0.223769,0.231664,1.611111,0.000078,0.000057,306,0.000178,0,29,0.583333,0.000962
47035,Cumberland County,,TN,2553,64733,67286,6,7,13,831,793,1624,7,0.282328,0.297758,5281.649838,0.001143,0.001517,306,0.000251,0,29,0.404762,0.00893
47037,Davidson County,,TN,50535,756306,806841,152,102,254,36596,35600,72196,6,0.390458,0.429579,254898.345835,0.087701,0.069286,306,0.003356,0,29,0.257376,0.54725
47039,Decatur County,,TN,562,11638,12200,1,1,2,191,224,415,9,0.18294,0.187204,0,0,0,306,0.000125,0,29,0,0.000141
47041,DeKalb County,,TN,1127,20067,21194,7,5,12,696,602,1298,8,0.255287,0.26788,128.559541,0.001038,0.00021,306,0.000288,0,29,0.690476,0.008349
47043,Dickson County,,TN,2653,56619,59272,7,8,15,1879,1566,3445,7,0.284193,0.299409,3193.264876,0.001508,0.001693,306,0.000291,0,29,0.642857,0.011459
47045,Dyer County,,TN,1760,41617,43377,5,9,14,663,984,1647,7,0.287593,0.303763,7440.03761,0.000823,0.001798,306,0.000216,0,29,0.402778,0.004862
47047,Fayette County,,TN,2589,46157,48746,4,5,9,2178,1744,3922,8,0.280399,0.295202,2.833333,0.000862,0.000705,306,0.000167,0,29,0.6,0.005022
47049,Fentress County,,TN,603,17528,18131,2,2,4,153,239,392,8,0.220441,0.228118,0,0.000036,0.000028,306,0.000113,0,29,1,0.000489
47051,Franklin County,,TN,1945,45201,47146,6,5,11,1246,912,2158,7,0.281227,0.295447,2262.445958,0.000257,0.001116,306,0.000245,0,29,0.47619,0.00201
47053,Gibson County,,TN,2654,54344,56998,7,10,17,1651,1696,3347,7,0.287934,0.304263,5197.065994,0.000845,0.001798,306,0.000324,0,29,0.411111,0.005429
47055,Giles County,,TN,1388,31260,32648,6,8,14,725,916,1641,7,0.283227,0.298477,1041.989576,0.001109,0.001372,306,0.000224,0,29,0.5,0.008495
47057,Grainger County,,TN,1221,22980,24201,6,5,11,806,743,1549,8,0.264263,0.277226,1311.010068,0.000382,0.000329,306,0.000247,0,29,0.4,0.002976
47059,Greene County,,TN,2420,73506,75926,6,7,13,982,1161,2143,8,0.264709,0.278213,501.463936,0.000425,0.000349,306,0.000269,0,29,0.619048,0.003184
47061,Grundy County,,TN,570,14537,15107,3,4,7,239,384,623,8,0.220223,0.228093,14.719719,0.00003,0.000028,306,0.000167,0,29,0.333333,0.000522
47063,Hamblen County,,TN,3569,69749,73318,7,9,16,1799,2334,4133,8,0.264735,0.278525,30.026257,0.000399,0.000361,306,0.000276,0,29,0.569444,0.003195
47065,Hamilton County,,TN,15969,394307,410276,45,40,85,9565,9166,18731,7,0.340828,0.371894,58472.215525,0.021407,0.023527,306,0.001256,0,29,0.305807,0.144601
47067,Hancock County,,TN,158,6031,6189,0,0,0,0,0,0,0,0,0,0,0,0,305,0.000054,290,408,0,0
47069,Hardeman County,,TN,1230,25265,26495,3,3,6,439,538,977,8,0.280547,0.295202,5.075,0.000814,0.000678,306,0.000141,0,29,0.666667,0.00478
47071,Hardin County,,TN,1311,26840,28151,3,3,6,439,453,892,9,0.219697,0.227455,4958.709734,0.000793,0.000001,306,0.000183,0,29,0.333333,0.004459
47073,Hawkins County,,TN,2738,58882,61620,7,7,14,1884,1808,3692,8,0.264683,0.27815,1015.087559,0.000426,0.000348,306,0.000333,0,29,0.571429,0.003314
47075,Haywood County,,TN,1014,20574,21588,5,5,10,527,597,1124,7,0.287283,0.30267,984.838504,0.000842,0.00163,306,0.000211,0,29,0.533333,0.005092
47077,Henderson County,,TN,1216,30289,31505,5,4,9,709,608,1317,8,0.223882,0.231914,5420.033333,0.000042,0.00004,306,0.000336,0,29,0.4,0.000998
47079,Henry County,,TN,1505,34843,36348,4,4,8,413,410,823,8,0.223957,0.231932,19724.007934,0.000019,0.00001,306,0.000263,0,29,0.333333,0.000588
47081,Hickman County,,TN,1336,23376,24712,4,5,9,777,860,1637,7,0.281168,0.295291,1.855952,0.000973,0.001335,306,0.000169,0,29,0.9,0.007987
47083,Houston County,,TN,479,8589,9068,1,2,3,82,208,290,8,0.261159,0.273631,0,0.000312,0.000313,306,0.000073,0,29,1,0.002184
47085,Humphreys County,,TN,824,20289,21113,3,2,5,312,239,551,8,0.22176,0.228997,3318.334081,0.000771,0.000016,306,0.000179,0,29,0.333333,0.006399
47087,Jackson County,,TN,604,10962,11566,1,1,2,310,278,588,8,0.220405,0.227868,0,0.000019,0.000015,306,0.000083,0,29,0,0.000266
47089,Jefferson County,,TN,3362,54196,57558,5,6,11,2313,2107,4420,8,0.264263,0.277351,3.666667,0.000392,0.000344,306,0.000201,0,29,0.666667,0.002867
47091,Johnson County,,TN,498,16210,16708,1,1,2,72,95,167,9,0.183759,0.188587,0,0,0.000001,306,0.000131,0,29,0,0.00014
47093,Knox County,,TN,21123,497737,518860,52,56,108,12977,13253,26230,7,0.358892,0.392298,115889.494792,0.028706,0.033752,306,0.001458,0,29,0.330226,0.192612
47095,Lake County,,TN,327,5346,5673,1,2,3,100,205,305,8,0.223582,0.231051,0,0.00002,0.000018,306,0.000074,0,29,1,0.000179
47097,Lauderdale County,,TN,1198,25142,26340,4,5,9,577,713,1290,7,0.28716,0.302451,4.972222,0.00084,0.001609,306,0.000151,0,29,0.6,0.004732
47099,Lawrence County,,TN,1444,43774,45218,5,6,11,702,679,1381,7,0.281702,0.296265,3815.952882,0.000049,0.001144,306,0.000231,0,29,0.357143,0.00095
47101,Lewis County,,TN,526,12158,12684,1,2,3,84,175,259,8,0.220259,0.227605,0,0.000017,0.000023,306,0.000083,0,29,1,0.000289
47103,Lincoln County,,TN,1630,38299,39929,5,6,11,766,821,1587,8,0.261415,0.27533,48.463965,0.00036,0.000407,306,0.000189,0,29,0.47619,0.00244
47105,Loudon County,,TN,3364,59399,62763,5,6,11,1951,2035,3986,8,0.264342,0.277538,3.275,0.000413,0.000356,306,0.000213,0,29,0.7,0.003038
47107,McMinn County,,TN,2837,55047,57884,7,6,13,1537,1596,3133,8,0.265631,0.27945,1085.048211,0.00066,0.000562,306,0.000325,0,29,0.47619,0.004743
47109,McNairy County,,TN,1248,26444,27692,4,5,9,608,709,1317,8,0.280813,0.295952,2285.23173,0.000029,0.000677,306,0.000249,0,29,0.35,0.000846
47111,Macon County,,TN,1148,24455,25603,4,2,6,641,397,1038,8,0.225605,0.233923,0,0.0008,0.00006,306,0.000228,0,29,0.916667,0.007051
47113,Madison County,,TN,5869,107927,113796,14,12,26,3044,3213,6257,7,0.287997,0.304607,26096.200017,0.00357,0.001956,306,0.00057,0,29,0.271429,0.02433
47115,Marion County,,TN,1251,30418,31669,4,4,8,717,603,1320,8,0.254483,0.2671,483.606689,0.000268,0.000242,306,0.000185,0,29,0.333333,0.002158
47117,Marshall County,,TN,1680,35250,36930,7,7,14,1327,1104,2431,7,0.281316,0.295853,114.883431,0.001212,0.001346,306,0.000239,0,29,0.595238,0.009492
47119,Maury County,,TN,5388,101027,106415,10,10,20,3581,3256,6837,7,0.282059,0.297558,5861.127676,0.002036,0.001592,306,0.000341,0,29,0.454545,0.014237
47121,Meigs County,,TN,880,12176,13056,4,3,7,630,520,1150,8,0.254313,0.266644,0.333333,0.000281,0.00025,306,0.000193,0,29,0.75,0.002262
47123,Monroe County,,TN,2255,47320,49575,5,7,12,1365,1363,2728,7,0.28191,0.296946,61.763386,0.000408,0.001306,306,0.000232,0,29,0.571429,0.003031
47125,Montgomery County,,TN,17887,199916,217803,48,50,98,9645,7884,17529,7,0.353377,0.386376,29572.463632,0.028516,0.028752,306,0.001147,0,29,0.359336,0.191262
47127,Moore County,,TN,436,7070,7506,2,2,4,200,239,439,8,0.219951,0.227093,0,0.000027,0.000014,306,0.00011,0,29,0.833333,0.000427
47129,Morgan County,,TN,996,19717,20713,3,3,6,451,575,1026,8,0.264211,0.276851,0,0.000385,0.000329,306,0.000146,0,29,1,0.002622
47131,Obion County,,TN,1528,35204,36732,6,4,10,742,606,1348,8,0.223844,0.231801,5426.6,0.000842,0.000027,306,0.00028,0,29,0.4,0.004982
47133,Overton County,,TN,1033,22957,23990,1,2,3,393,484,877,8,0.220423,0.228055,0,0.000019,0.000015,306,0.000083,0,29,0.5,0.000266
47135,Perry County,,TN,271,7696,7967,0,0,0,0,0,0,0,0,0,0,0,0,307,0.000054,291,409,0,0
47137,Pickett County,,TN,236,5357,5593,0,0,0,0,0,0,0,0,0,0,0,0,308,0.000054,292,410,0,0
47139,Polk County,,TN,1056,17271,18327,3,3,6,645,648,1293,8,0.220441,0.228149,195.569991,0.000023,0.000039,306,0.000239,0,29,0.333333,0.000678
47141,Putnam County,,TN,4435,77180,81615,12,15,27,2058,2545,4603,7,0.282687,0.299507,19643.473335,0.001404,0.001768,306,0.000514,0,29,0.27619,0.011099
47143,Rhea County,,TN,1794,33909,35703,3,5,8,570,904,1474,8,0.254556,0.267412,19.519784,0.000262,0.000253,306,0.000147,0,29,0.4,0.002024
47145,Roane County,,TN,2890,56413,59303,8,7,15,1756,1645,3401,8,0.264446,0.277882,67.307911,0.000436,0.000364,306,0.000303,0,29,0.428571,0.003539
47147,Robertson County,,TN,4635,82866,87501,6,7,13,3265,3090,6355,7,0.28392,0.299108,1070.924879,0.001355,0.001506,306,0.000234,0,29,0.666667,0.010474
47149,Rutherford County,,TN,16956,328652,345608,38,35,73,13966,10812,24778,7,0.342139,0.372193,33592.798255,0.013701,0.020729,306,0.001114,0,29,0.27343,0.09202
47151,Scott County,,TN,531,21050,21581,1,1,2,63,64,127,10,0.177713,0.181721,52.777374,0.000004,0,306,0.000085,0,29,0,0.000154
47153,Sequatchie County,,TN,920,15222,16142,3,3,6,458,515,973,8,0.254337,0.266706,3.120455,0.000261,0.000245,306,0.00015,0,29,0.5,0.001996
47155,Sevier County,,TN,6195,107748,113943,6,8,14,2421,2747,5168,7,0.28197,0.297027,109.085645,0.000406,0.001316,306,0.000234,0,29,0.517857,0.003189
47157,Shelby County,,TN,40506,1093129,1133635,103,119,222,23919,28181,52100,7,0.389375,0.431348,287075.389565,0.05797,0.072312,306,0.002588,0,29,0.283005,0.376757
47159,Smith County,,TN,965,21028,21993,4,5,9,579,589,1168,7,0.281257,0.295478,48.419358,0.000789,0.001154,306,0.000197,0,29,0.95,0.006836
47161,Stewart County,,TN,727,13897,14624,2,1,3,408,277,685,8,0.261133,0.273444,0,0.000316,0.00031,306,0.000104,0,29,1,0.002323
47163,Sullivan County,,TN,7146,173313,180459,11,10,21,4467,4247,8714,7,0.282567,0.298183,45635.000888,0.001165,0.001285,306,0.000622,0,29,0.309091,0.009646
47165,Sumner County,,TN,10475,199973,210448,18,16,34,7658,6627,14285,7,0.291266,0.310066,13008.395041,0.004712,0.002899,306,0.000701,0,29,0.374269,0.03259
47167,Tipton County,,TN,3541,68775,72316,4,6,10,1978,2137,4115,7,0.28716,0.302576,19.403963,0.000862,0.001657,306,0.000158,0,29,0.566667,0.005024
47169,Trousdale County,,TN,668,8702,9370,4,3,7,506,414,920,8,0.225796,0.234473,2.248413,0.0008,0.000086,306,0.000253,0,29,0.833333,0.007051
47171,Unicoi County,,TN,762,18499,19261,2,2,4,462,446,908,8,0.224958,0.23359,0,0.000034,0.000011,306,0.000173,0,29,1,0.000368
47173,Union County,,TN,1067,18560,19627,4,3,7,879,724,1603,8,0.264185,0.276788,3.5,0.000388,0.000328,306,0.000188,0,29,0.5,0.002757
47175,Van Buren County,,TN,261,5766,6027,1,2,3,78,156,234,8,0.219697,0.226706,0,0.000001,0.000012,306,0.000087,0,29,1,0.000136
47177,Warren County,,TN,1586,43446,45032,9,7,16,1003,860,1863,7,0.281405,0.29604,5973.586296,0.001016,0.001142,306,0.000378,0,29,0.333333,0.008418
47179,Washington County,,TN,7212,133642,140854,11,11,22,4183,4082,8265,7,0.290158,0.309334,18699.48862,0.000973,0.003097,306,0.000541,0,29,0.320513,0.00761
47181,Wayne County,,TN,600,14978,15578,3,2,5,213,171,384,8,0.220168,0.227281,29.381771,0.000029,0.000009,306,0.00016,0,29,0.333333,0.000501
47183,Weakley County,,TN,1550,32374,33924,5,7,12,662,835,1497,7,0.287872,0.30357,26865.521618,0.000806,0.00164,306,0.000264,0,29,0.47619,0.00485
47185,White County,,TN,1208,27361,28569,4,5,9,744,712,1456,8,0.220587,0.22893,2764.682368,0.000048,0.00005,306,0.000196,0,29,0.45,0.000836
47187,Williamson County,,TN,13793,250699,264492,28,23,51,9651,8832,18483,7,0.338364,0.366115,7574.468799,0.018011,0.017069,306,0.000734,0,29,0.507056,0.12081
47189,Wilson County,,TN,7669,149019,156688,13,11,24,6057,4869,10926,7,0.281524,0.29679,970.107683,0.002433,0.001432,306,0.000485,0,29,0.445055,0.017195
48001,Anderson County,,TX,2836,48602,51438,8,8,16,1210,1328,2538,7,0.300112,0.320647,31.194632,0.004292,0.004687,350,0.000259,0,29,0.597222,0.033195
48003,Andrews County,,TX,1138,20264,21402,3,2,5,446,316,762,8,0.2512,0.263118,0,0.000955,0.000431,350,0.000134,0,29,1,0.007234
48005,Angelina County,,TX,4286,94426,98712,13,13,26,1969,2218,4187,7,0.322067,0.346339,2867.000504,0.006091,0.008279,350,0.000404,0,29,0.457143,0.045714
48007,Aransas County,,TX,2550,26143,28693,6,5,11,1296,1195,2491,7,0.320404,0.343085,0.601271,0.005536,0.005026,350,0.000189,0,29,0.933333,0.040427
48009,Archer County,,TX,762,10025,10787,1,1,2,374,424,798,8,0.247656,0.258298,0,0.000134,0.000109,350,0.000081,0,29,0,0.000906
48011,Armstrong County,,TX,129,2204,2333,0,0,0,0,0,0,0,0,0,0,0,0,309,0.000054,293,411,0,0
48013,Atascosa County,,TX,3785,50440,54225,8,5,13,2611,2281,4892,7,0.320327,0.34296,235.554024,0.003996,0.004722,350,0.00028,0,29,0.611111,0.030155
48015,Austin County,,TX,1813,34302,36115,5,5,10,1389,1071,2460,7,0.298034,0.317473,2.1,0.001929,0.002375,350,0.000181,0,29,0.65,0.01567
48017,Bailey County,,TX,476,7859,8335,3,1,4,634,105,739,8,0.251627,0.263682,8.075824,0.000078,0.000215,350,0.000117,0,29,0.5,0.000515
48019,Bandera County,,TX,1299,22029,23328,4,3,7,722,628,1350,7,0.284617,0.301429,0,0.002571,0.001299,350,0.000154,0,29,1,0.019386
48021,Bastrop County,,TX,5402,83032,88434,9,9,18,4906,3653,8559,7,0.321562,0.345059,27.750286,0.005331,0.00673,350,0.000294,0,29,0.688889,0.039858
48023,Baylor County,,TX,126,3700,3826,0,0,0,0,0,0,0,0,0,0,0,0,310,0.000054,294,412,0,0
48025,Bee County,,TX,1781,27384,29165,5,7,12,680,842,1522,7,0.301095,0.32164,27.290133,0.001606,0.003331,350,0.000181,0,29,0.625,0.012398
48027,Bell County,,TX,33117,353089,386206,92,80,172,20269,19325,39594,7,0.356351,0.394116,17725.493444,0.054654,0.047864,350,0.001985,0,29,0.32495,0.362415
48029,Bexar County,,TX,76993,2071313,2148306,233,187,420,70099,59735,129834,6,0.397675,0.448801,158183.193414,0.110996,0.094421,350,0.005045,0,29,0.172081,0.698953
48031,Blanco County,,TX,650,12097,12747,5,4,9,419,277,696,7,0.318605,0.340336,0,0.004446,0.003374,350,0.000178,0,29,1,0.032775
48033,Borden County,,TX,-2,657,655,0,0,0,0,0,0,0,0,0,0,0,0,311,0.000054,295,413,0,0
48035,Bosque County,,TX,1130,18749,19879,5,3,8,715,541,1256,7,0.285837,0.302222,1.666667,0.00135,0.001444,350,0.000189,0,29,0.65,0.01058
48037,Bowie County,,TX,5771,99468,105239,14,11,25,2955,3166,6121,7,0.302254,0.324008,22499.475878,0.007259,0.005674,350,0.000505,0,29,0.347619,0.05347
48039,Brazoria County,,TX,20292,373439,393731,27,26,53,16843,15048,31891,7,0.329627,0.356959,613.63036,0.018634,0.016287,350,0.000652,0,29,0.655172,0.133156
48041,Brazos County,,TX,11146,182688,193834,33,29,62,7151,7088,14239,7,0.327724,0.355191,3870.309545,0.016344,0.014829,350,0.000961,0,29,0.524955,0.121619
48043,Brewster County,,TX,728,9760,10488,1,0,1,66,0,66,0,0,0,0,0.000005,0,350,0.000078,0,27,0,0.000132
48045,Briscoe County,,TX,91,1627,1718,0,0,0,0,0,0,0,0,0,0,0,0,312,0.000054,296,414,0,0
48047,Brooks County,,TX,449,7854,8303,1,2,3,137,230,367,8,0.253853,0.265911,0,0.000036,0.000294,350,0.000082,0,29,1,0.000379
48049,Brown County,,TX,1876,38842,40718,5,4,9,412,359,771,7,0.318948,0.34073,5227.826278,0.002374,0.003188,350,0.000223,0,29,0.433333,0.0182
48051,Burleson County,,TX,985,19480,20465,3,3,6,513,530,1043,7,0.297967,0.317099,0,0.001638,0.001905,350,0.000127,0,29,1,0.012548
48053,Burnet County,,TX,3242,50248,53490,9,8,17,2037,1864,3901,7,0.321678,0.345059,39.999686,0.006307,0.00707,350,0.000276,0,29,0.75,0.047283
48055,Caldwell County,,TX,2993,41426,44419,9,8,17,2871,2095,4966,7,0.320442,0.343522,12.698498,0.005045,0.005567,350,0.000283,0,29,0.819444,0.037871
48057,Calhoun County,,TX,1581,24067,25648,3,4,7,524,678,1202,7,0.31933,0.341473,55.147897,0.001533,0.003579,350,0.000154,0,29,0.833333,0.011678
48059,Callahan County,,TX,961,14194,15155,1,1,2,564,499,1063,8,0.248834,0.259676,0,0.000139,0.000142,350,0.000085,0,29,0,0.001172
48061,Cameron County,,TX,15977,449180,465157,21,26,47,6862,9835,16697,7,0.329586,0.356968,2108.006642,0.014294,0.016267,350,0.000522,0,29,0.670635,0.104304
48063,Camp County,,TX,812,13674,14486,2,2,4,256,300,556,8,0.225662,0.233796,0.75,0.000019,0.00003,350,0.000112,0,29,0.333333,0.000355
48065,Carson County,,TX,448,6467,6915,3,4,7,257,335,592,8,0.248741,0.259925,0.333333,0.000115,0.000176,350,0.000151,0,29,0.916667,0.001153
48067,Cass County,,TX,1757,31962,33719,6,7,13,815,858,1673,7,0.291808,0.30944,507.895026,0.000331,0.001725,350,0.00026,0,29,0.380952,0.00305
48069,Castro County,,TX,526,8290,8816,0,1,1,0,102,102,9,0.199313,0.205034,0,0,0.000003,350,0.000054,0,415,0,0
48071,Chambers County,,TX,3927,45949,49876,5,5,10,2792,2862,5654,7,0.298067,0.317536,0.142857,0.00209,0.002501,350,0.000184,0,29,0.95,0.016889
48073,Cherokee County,,TX,2531,53455,55986,10,10,20,1750,1576,3326,7,0.300349,0.321334,26.029311,0.005899,0.004872,350,0.000292,0,29,0.754545,0.042899
48075,Childress County,,TX,287,6281,6568,0,0,0,0,0,0,0,0,0,0,0,0,313,0.000054,297,416,0,0
48077,Clay County,,TX,740,11475,12215,1,1,2,316,374,690,8,0.247656,0.258298,0,0.000134,0.000109,350,0.000081,0,29,0,0.000906
48079,Cochran County,,TX,207,3214,3421,0,1,1,0,77,77,9,0.201085,0.207221,0,0,0.000002,350,0.000054,0,417,0,0
48081,Coke County,,TX,214,3483,3697,1,1,2,90,84,174,8,0.249392,0.260408,0,0.000181,0.000115,350,0.000084,0,29,0,0.000986
48083,Coleman County,,TX,495,8587,9082,1,2,3,98,177,275,8,0.248881,0.259925,0,0.000035,0.000168,350,0.000101,0,29,1,0.000313
48085,Collin County,,TX,62882,1034920,1097802,135,111,246,60154,52328,112482,7,0.379841,0.42178,46223.273886,0.085709,0.070991,350,0.002825,0,29,0.31077,0.542757
48087,Collingsworth County,,TX,164,3290,3454,0,0,0,0,0,0,0,0,0,0,0,0,314,0.000054,298,418,0,0
48089,Colorado County,,TX,1133,23922,25055,5,5,10,631,572,1203,7,0.298034,0.317473,3,0.001926,0.002355,350,0.000185,0,29,0.6,0.015539
48091,Comal County,,TX,10254,145047,155301,25,16,41,9111,7042,16153,7,0.322183,0.346902,271.483436,0.015763,0.010302,350,0.00066,0,29,0.706154,0.117028
48093,Comanche County,,TX,760,14221,14981,2,2,4,196,238,434,8,0.242325,0.252136,1.733333,0.000047,0.000069,350,0.000113,0,29,0.166667,0.000583
48095,Concho County,,TX,182,2508,2690,0,1,1,0,69,69,8,0.249439,0.260498,0,0,0.000115,350,0.000054,0,419,0,0
48097,Cooke County,,TX,2515,44483,46998,7,7,14,1638,1471,3109,7,0.292287,0.310171,3037.76243,0.003735,0.004437,350,0.000261,0,29,0.571429,0.02869
48099,Coryell County,,TX,9048,68162,77210,21,13,34,5126,4316,9442,7,0.325326,0.350028,4505.862929,0.013061,0.011309,350,0.000515,0,29,0.62381,0.09271
48101,Cottle County,,TX,79,1499,1578,0,0,0,0,0,0,0,0,0,0,0,0,315,0.000054,299,420,0,0
48103,Crane County,,TX,313,5719,6032,1,1,2,92,91,183,8,0.24916,0.260225,0,0.00016,0.000198,350,0.000086,0,29,0,0.001527
48105,Crockett County,,TX,286,4357,4643,0,1,1,0,81,81,8,0.249439,0.260498,0,0,0.000115,350,0.000054,0,421,0,0
48107,Crosby County,,TX,437,6132,6569,1,1,2,217,269,486,8,0.251603,0.26362,0,0.000216,0.000215,350,0.000087,0,29,0,0.001726
48109,Culberson County,,TX,166,2516,2682,0,0,0,0,0,0,0,0,0,0,0,0,316,0.000054,300,422,0,0
48111,Dallam County,,TX,805,8402,9207,3,1,4,342,244,586,1,1,1,2747,0.000113,0,350,0.000519,0,28,0.333333,0.001121
48113,Dallas County,,TX,147298,2852128,2999426,264,209,473,129105,130026,259131,6,0.410083,0.462,233110.863428,0.13006,0.109494,350,0.005566,0,29,0.16998,0.798696
48115,Dawson County,,TX,677,13167,13844,2,1,3,188,143,331,8,0.251603,0.26362,0,0.000418,0.000215,350,0.000119,0,29,1,0.003512
48117,Deaf Smith County,,TX,1250,22776,24026,4,3,7,396,507,903,8,0.248834,0.259988,2891.495196,0.000244,0.000172,350,0.000169,0,29,0.25,0.001739
48119,Delta County,,TX,354,5019,5373,1,1,2,68,74,142,8,0.226274,0.234277,0,0.000055,0.000034,350,0.000078,0,29,1,0.000784
48121,Denton County,,TX,55973,855424,911397,115,88,203,56693,45147,101840,7,0.363736,0.402743,27944.976697,0.068867,0.057173,350,0.002606,0,29,0.321335,0.448612
48123,DeWitt County,,TX,1394,21020,22414,4,3,7,606,611,1217,7,0.284769,0.301741,4.62291,0.002578,0.001316,350,0.000175,0,29,0.833333,0.019555
48125,Dickens County,,TX,155,1953,2108,0,0,0,0,0,0,0,0,0,0,0,0,317,0.000054,301,423,0,0
48127,Dimmit County,,TX,693,11260,11953,2,2,4,172,260,432,7,0.284587,0.301241,0,0.001039,0.001217,350,0.000126,0,29,1,0.00796
48129,Donley County,,TX,183,3410,3593,0,0,0,0,0,0,0,0,0,0,0,0,318,0.000054,302,424,0,0
48131,Duval County,,TX,765,12285,13050,2,2,4,321,409,730,8,0.253853,0.265911,0,0.000296,0.000294,350,0.000106,0,29,1,0.002385
48133,Eastland County,,TX,1060,18101,19161,1,4,5,104,299,403,7,0.286143,0.302909,61.418329,0.000139,0.001435,350,0.000085,0,29,0.5,0.001172
48135,Ector County,,TX,11027,175205,186232,36,29,65,8844,6794,15638,7,0.3318,0.359829,25710.345344,0.018281,0.014749,350,0.001089,0,29,0.392949,0.129026
48137,Edwards County,,TX,146,1973,2119,0,0,0,0,0,0,0,0,0,0,0,0,319,0.000054,303,425,0,0
48139,Ellis County,,TX,9573,185451,195024,14,13,27,8511,6624,15135,7,0.322028,0.346277,140.391703,0.008548,0.009551,350,0.000409,0,29,0.752747,0.063712
48141,El Paso County,,TX,41586,948329,989915,90,94,184,21189,26945,48134,7,0.36488,0.405703,34234.837704,0.053361,0.054604,350,0.001845,0,29,0.294495,0.355651
48143,Erath County,,TX,2232,37260,39492,10,8,18,1102,890,1992,7,0.292384,0.310483,4647.913599,0.00395,0.002926,350,0.000387,0,29,0.4,0.03034
48145,Falls County,,TX,919,15822,16741,3,2,5,568,495,1063,8,0.262909,0.276873,1.282095,0.000704,0.000759,350,0.000127,0,29,0.666667,0.005589
48147,Fannin County,,TX,1856,33173,35029,6,6,12,1193,1121,2314,7,0.292352,0.31014,0.333333,0.002772,0.003798,350,0.000208,0,29,0.97619,0.021554
48149,Fayette County,,TX,1190,28850,30040,5,6,11,581,532,1113,7,0.319368,0.341785,70.992189,0.003292,0.003641,350,0.000174,0,29,0.52381,0.023288
48151,Fisher County,,TX,288,3913,4201,1,1,2,55,93,148,9,0.200768,0.206724,0,0.000003,0.000002,350,0.000102,0,29,0,0.000133
48153,Floyd County,,TX,426,6514,6940,2,2,4,158,207,365,8,0.251651,0.26387,0,0.000223,0.00022,350,0.000117,0,29,1,0.001892
48155,Foard County,,TX,56,1277,1333,0,0,0,0,0,0,0,0,0,0,0,0,320,0.000054,304,426,0,0
48157,Fort Bend County,,TX,44235,786976,831211,74,51,125,47485,36095,83580,7,0.345462,0.378894,5725.893405,0.053895,0.035016,350,0.001546,0,29,0.452215,0.352715
48159,Franklin County,,TX,818,10447,11265,3,3,6,356,375,731,8,0.226543,0.235245,4.37619,0.000081,0.000091,350,0.000168,0,29,0.333333,0.001074
48161,Freestone County,,TX,1170,20363,21533,3,3,6,416,377,793,7,0.29098,0.307672,11.711348,0.001245,0.001499,350,0.000155,0,29,0.25,0.009372
48163,Frio County,,TX,1110,16170,17280,2,3,5,286,530,816,7,0.284617,0.301429,0,0.001058,0.001261,350,0.00012,0,29,1,0.007968
48165,Gaines County,,TX,911,21068,21979,3,2,5,334,235,569,8,0.251674,0.263932,0.738095,0.000273,0.000255,350,0.000136,0,29,0.5,0.002251
48167,Galveston County,,TX,18945,353014,371959,32,25,57,16348,13069,29417,7,0.332254,0.359754,726.777281,0.020142,0.019062,350,0.000785,0,29,0.578151,0.145198
48169,Garza County,,TX,310,4780,5090,1,1,2,140,157,297,8,0.251603,0.26362,0,0.000216,0.000215,350,0.000087,0,29,0,0.001726
48171,Gillespie County,,TX,1363,31217,32580,4,4,8,575,500,1075,7,0.320288,0.342772,0,0.004234,0.004739,350,0.000138,0,29,1,0.030271
48173,Glasscock County,,TX,90,1581,1671,0,0,0,0,0,0,0,0,0,0,0,0,321,0.000054,305,427,0,0
48175,Goliad County,,TX,513,8034,8547,1,1,2,226,201,427,8,0.243497,0.253492,0,0.000081,0.000074,350,0.00009,0,29,0,0.000703
48177,Gonzales County,,TX,1191,22397,23588,5,6,11,450,565,1015,7,0.320365,0.343147,6.027672,0.002691,0.004911,350,0.000192,0,29,0.8,0.020431
48179,Gray County,,TX,1357,24323,25680,3,4,7,287,443,730,8,0.248741,0.259925,0.333333,0.000244,0.000175,350,0.000131,0,29,0.916667,0.001636
48181,Grayson County,,TX,6696,136455,143151,11,10,21,4537,3722,8259,7,0.321214,0.34479,700.119234,0.007005,0.008021,350,0.000332,0,29,0.672727,0.05204
48183,Gregg County,,TX,9903,140542,150445,19,18,37,6379,6930,13309,7,0.32269,0.347857,11099.759055,0.007395,0.009555,350,0.000582,0,29,0.402381,0.055745
48185,Grimes County,,TX,1927,27399,29326,6,6,12,1527,1310,2837,7,0.298067,0.317661,2.5,0.002018,0.002414,350,0.000209,0,29,0.690476,0.016136
48187,Guadalupe County,,TX,12143,168987,181130,17,17,34,9413,8337,17750,7,0.327845,0.353398,286.880546,0.011772,0.012284,350,0.000465,0,29,0.688095,0.087057
48189,Hale County,,TX,2185,35687,37872,5,6,11,810,1011,1821,8,0.253131,0.266775,51.565094,0.000463,0.000623,350,0.000213,0,29,0.5,0.003497
48191,Hall County,,TX,189,3106,3295,0,0,0,0,0,0,0,0,0,0,0,0,322,0.000054,306,428,0,0
48193,Hamilton County,,TX,682,8597,9279,2,2,4,147,282,429,8,0.245695,0.256233,1.299582,0.000155,0.000185,350,0.000128,0,29,0,0.001563
48195,Hansford County,,TX,250,6465,6715,0,0,0,0,0,0,0,0,0,0,0,0,323,0.000054,307,429,0,0
48197,Hardeman County,,TX,228,4142,4370,0,0,0,0,0,0,0,0,0,0,0,0,324,0.000054,308,430,0,0
48199,Hardin County,,TX,3477,61250,64727,6,7,13,2290,2232,4522,7,0.298167,0.317973,3.592857,0.001655,0.002355,350,0.00021,0,29,0.666667,0.013281
48201,Harris County,,TX,192284,4993902,5186186,396,308,704,182395,168626,351021,6,0.424233,0.487144,527747.342837,0.155664,0.131913,350,0.008406,0,29,0.099396,0.94485
48203,Harrison County,,TX,4390,73502,77892,11,10,21,2999,2715,5714,7,0.300552,0.321603,2088.253588,0.004209,0.004772,350,0.000362,0,29,0.581818,0.032283
48205,Hartley County,,TX,402,4732,5134,1,1,2,244,210,454,1,1,1,0,0,0.000001,350,0.000495,0,28,0,0.000135
48207,Haskell County,,TX,348,5490,5838,1,2,3,81,131,212,8,0.248881,0.259925,0,0.000002,0.000144,350,0.00011,0,29,1,0.000133
48209,Hays County,,TX,14010,191287,205297,32,25,57,14701,10387,25088,7,0.32918,0.356441,304.769585,0.018507,0.014772,350,0.000821,0,29,0.622159,0.135805
48211,Hemphill County,,TX,244,5032,5276,0,0,0,0,0,0,0,0,0,0,0,0,325,0.000054,309,431,0,0
48213,Henderson County,,TX,5309,79560,84869,14,14,28,3805,3623,7428,7,0.321175,0.34529,169.04171,0.007386,0.00847,350,0.000403,0,29,0.680952,0.055495
48215,Hidalgo County,,TX,22723,853395,876118,32,38,70,10372,14011,24383,7,0.33815,0.368387,8460.359975,0.021685,0.022469,350,0.000766,0,29,0.482281,0.152689
48217,Hill County,,TX,2350,36522,38872,7,7,14,1329,1386,2715,7,0.292319,0.310233,15.665906,0.002669,0.003099,350,0.000266,0,29,0.785714,0.02061
48219,Hockley County,,TX,1739,24641,26380,3,1,4,580,760,1340,8,0.251603,0.26362,2668,0.000219,0.000215,350,0.000157,0,29,0.333333,0.001974
48221,Hood County,,TX,3440,60039,63479,10,7,17,2288,1829,4117,7,0.292352,0.310296,2762.668007,0.005502,0.003643,350,0.000338,0,29,0.7,0.042353
48223,Hopkins County,,TX,1927,38976,40903,8,6,14,1057,890,1947,7,0.292384,0.310202,4706.806194,0.003109,0.002836,350,0.000329,0,29,0.486111,0.024425
48225,Houston County,,TX,1076,20675,21751,4,4,8,444,451,895,7,0.298001,0.317286,1.27732,0.001659,0.001885,350,0.000158,0,29,0.5,0.012569
48227,Howard County,,TX,2092,33862,35954,7,5,12,608,547,1155,7,0.287283,0.304808,0,0.002535,0.002011,350,0.000254,0,29,0.928571,0.019069
48229,Hudspeth County,,TX,242,3440,3682,1,1,2,326,96,422,8,0.267361,0.281855,0,0.000593,0.000579,350,0.00007,0,29,0,0.003921
48231,Hunt County,,TX,6106,91728,97834,15,16,31,4659,4107,8766,7,0.292704,0.312076,3113.859415,0.008252,0.005037,350,0.000455,0,29,0.497076,0.061503
48233,Hutchinson County,,TX,1210,24179,25389,4,3,7,391,435,826,8,0.248718,0.259738,0.333333,0.000246,0.000172,350,0.000159,0,29,0.916667,0.001776
48235,Irion County,,TX,180,1863,2043,0,1,1,0,105,105,8,0.249439,0.260498,0,0,0.000115,350,0.000054,0,432,0,0
48237,Jack County,,TX,508,8395,8903,2,3,5,133,215,348,7,0.285806,0.30216,2745.5,0.001058,0.001344,350,0.000101,0,29,0.5,0.00807
48239,Jackson County,,TX,907,17341,18248,5,4,9,514,473,987,7,0.298034,0.317348,1,0.001629,0.001804,350,0.000194,0,29,0.75,0.012274
48241,Jasper County,,TX,2147,36492,38639,6,7,13,1225,1369,2594,7,0.298167,0.317973,2998.733075,0.001651,0.001915,350,0.00021,0,29,0.571429,0.01298
48243,Jeff Davis County,,TX,144,2359,2503,0,0,0,0,0,0,0,0,0,0,0,0,326,0.000054,310,433,0,0
48245,Jefferson County,,TX,12167,268184,280351,27,20,47,7714,7998,15712,7,0.323276,0.349057,2915.821853,0.013773,0.009937,350,0.000672,0,29,0.452381,0.098432
48247,Jim Hogg County,,TX,277,5593,5870,0,0,0,0,0,0,0,0,0,0,0,0,327,0.000054,311,434,0,0
48249,Jim Wells County,,TX,2663,46055,48718,8,8,16,1439,1721,3160,7,0.301129,0.321827,3532.538015,0.003094,0.003283,350,0.000269,0,29,0.527778,0.023525
48251,Johnson County,,TX,10698,177626,188324,14,15,29,8207,7447,15654,7,0.322339,0.346964,371.320863,0.008762,0.010125,350,0.00044,0,29,0.638095,0.065779
48253,Jones County,,TX,1121,16242,17363,2,2,4,714,620,1334,8,0.248881,0.259925,2745,0.000141,0.000142,350,0.000132,0,29,0.5,0.00129
48255,Karnes County,,TX,835,14350,15185,3,2,5,259,279,538,7,0.284587,0.301241,0.333333,0.001116,0.001223,350,0.00013,0,29,0.666667,0.008269
48257,Kaufman County,,TX,8326,128085,136411,12,12,24,7684,6092,13776,7,0.320982,0.344728,76.273727,0.00731,0.008389,350,0.000344,0,29,0.840909,0.054559
48259,Kendall County,,TX,3040,47693,50733,6,6,12,2525,1819,4344,7,0.320365,0.343147,137.335488,0.00436,0.004938,350,0.000217,0,29,0.766667,0.031969
48261,Kenedy County,,TX,63,386,449,0,0,0,0,0,0,0,0,0,0,0,0,328,0.000054,312,435,0,0
48263,Kent County,,TX,-2,857,855,0,0,0,0,0,0,0,0,0,0,0,0,329,0.000054,313,436,0,0
48265,Kerr County,,TX,3083,57302,60385,6,8,14,1331,1469,2800,7,0.320519,0.343647,141.300421,0.004293,0.005533,350,0.000219,0,29,0.660714,0.031043
48267,Kimble County,,TX,297,4845,5142,0,0,0,0,0,0,0,0,0,0,0,0,330,0.000054,314,437,0,0
48269,King County,,TX,-2,291,289,0,0,0,0,0,0,0,0,0,0,0,0,331,0.000054,315,438,0,0
48271,Kinney County,,TX,169,3267,3436,0,0,0,0,0,0,0,0,0,0,0,0,332,0.000054,316,439,0,0
48273,Kleberg County,,TX,2516,31559,34075,7,8,15,1088,1368,2456,7,0.321485,0.344996,44.594997,0.003234,0.006138,350,0.000212,0,29,0.791667,0.024483
48275,Knox County,,TX,224,3925,4149,0,0,0,0,0,0,0,0,0,0,0,0,333,0.000054,317,440,0,0
48277,Lamar County,,TX,2363,52736,55099,9,9,18,983,940,1923,7,0.292512,0.310827,9377.889933,0.003752,0.004537,350,0.000346,0,29,0.522222,0.029382
48279,Lamb County,,TX,1115,14332,15447,1,3,4,208,602,810,8,0.251674,0.264057,272.904274,0.000216,0.000218,350,0.000087,0,29,0.5,0.001726
48281,Lampasas County,,TX,1475,22484,23959,5,5,10,888,745,1633,7,0.317884,0.339412,0.521825,0.002774,0.003059,350,0.00018,0,29,0.9,0.020234
48283,La Salle County,,TX,419,6289,6708,0,1,1,0,60,60,7,0.284602,0.301128,0,0,0.001205,350,0.000054,0,441,0,0
48285,Lavaca County,,TX,1017,23495,24512,6,5,11,682,573,1255,7,0.319368,0.34166,147.696419,0.003337,0.003619,350,0.00023,0,29,0.533333,0.023805
48287,Lee County,,TX,928,19434,20362,5,3,8,483,319,802,7,0.319253,0.341223,0,0.0036,0.003545,350,0.000171,0,29,0.9,0.026144
48289,Leon County,,TX,1174,19188,20362,5,3,8,476,347,823,7,0.298001,0.317161,35.846432,0.001979,0.001881,350,0.000189,0,29,0.466667,0.015792
48291,Liberty County,,TX,5491,78667,84158,9,9,18,4946,4065,9011,7,0.298201,0.318286,54.725823,0.003971,0.002782,350,0.000289,0,29,0.622222,0.029576
48293,Limestone County,,TX,1389,23757,25146,3,5,8,472,684,1156,7,0.299775,0.319679,129.856847,0.001597,0.003289,350,0.000148,0,29,0.5,0.012278
48295,Lipscomb County,,TX,253,4022,4275,0,0,0,0,0,0,0,0,0,0,0,0,334,0.000054,318,442,0,0
48297,Live Oak County,,TX,887,11694,12581,5,4,9,431,355,786,7,0.284739,0.301804,0.25,0.001417,0.001556,350,0.000177,0,29,0.9,0.011043
48299,Llano County,,TX,1368,19067,20435,4,4,8,855,689,1544,7,0.318605,0.340336,0,0.00425,0.003529,350,0.000144,0,29,1,0.030442
48301,Loving County,,TX,0,71,71,0,0,0,0,0,0,0,0,0,0,0,0,335,0.000054,319,443,0,0
48303,Lubbock County,,TX,13995,303296,317291,48,45,93,9586,8584,18170,7,0.336147,0.367456,70895.663118,0.019826,0.019926,350,0.001765,0,29,0.296995,0.144766
48305,Lynn County,,TX,458,6301,6759,1,1,2,211,256,467,8,0.251603,0.26362,0,0.000216,0.000215,350,0.000087,0,29,0,0.001726
48307,McCulloch County,,TX,446,9113,9559,0,0,0,0,0,0,0,0,0,0,0,0,336,0.000054,320,444,0,0
48309,McLennan County,,TX,10465,260778,271243,26,24,50,6083,6126,12209,7,0.329098,0.356191,2126.449124,0.01525,0.013703,350,0.000759,0,29,0.575499,0.113405
48311,McMullen County,,TX,72,1055,1127,0,0,0,0,0,0,0,0,0,0,0,0,337,0.000054,321,445,0,0
48313,Madison County,,TX,789,12699,13488,5,5,10,508,493,1001,7,0.298067,0.317536,0.85,0.002018,0.001994,350,0.000187,0,29,0.8,0.016073
48315,Marion County,,TX,777,9495,10272,4,4,8,512,398,910,8,0.244211,0.255053,1.666667,0.000193,0.000147,350,0.000182,0,29,0.666667,0.001651
48317,Martin County,,TX,443,5901,6344,1,1,2,151,163,314,8,0.250988,0.262493,0,0.000202,0.000233,350,0.000086,0,29,0,0.001786
48319,Mason County,,TX,256,4510,4766,0,0,0,0,0,0,0,0,0,0,0,0,338,0.000054,322,446,0,0
48321,Matagorda County,,TX,1989,40946,42935,4,6,10,895,962,1857,7,0.298101,0.317723,0.5,0.002037,0.002593,350,0.000151,0,29,0.833333,0.016419
48323,Maverick County,,TX,2687,72430,75117,3,7,10,739,1305,2044,7,0.321485,0.344684,5.750717,0.001175,0.006286,350,0.000126,0,29,0.642857,0.009046
48325,Medina County,,TX,2925,48922,51847,4,4,8,2123,1782,3905,7,0.318605,0.340336,217.849921,0.001104,0.003057,350,0.000202,0,29,0.55,0.008726
48327,Menard County,,TX,123,2161,2284,0,0,0,0,0,0,0,0,0,0,0,0,339,0.000054,323,447,0,0
48329,Midland County,,TX,13377,179794,193171,43,32,75,9698,8056,17754,7,0.33505,0.36442,19136.933203,0.02145,0.018615,350,0.001209,0,29,0.367715,0.152536
48331,Milam County,,TX,1359,26096,27455,5,4,9,761,642,1403,7,0.317998,0.339474,0,0.004168,0.003026,350,0.000168,0,29,1,0.030664
48333,Mills County,,TX,269,5213,5482,0,0,0,0,0,0,0,0,0,0,0,0,340,0.000054,324,448,0,0
48335,Mitchell County,,TX,500,7597,8097,1,1,2,70,94,164,9,0.20107,0.207205,0,0.000002,0.000002,350,0.000142,0,29,0,0.000139
48337,Montague County,,TX,1287,21212,22499,5,5,10,530,579,1109,7,0.28599,0.302784,4.430952,0.001885,0.002188,350,0.000205,0,29,0.75,0.014633
48339,Montgomery County,,TX,34356,580554,614910,63,50,113,33657,25446,59103,7,0.343903,0.376939,6443.159727,0.036816,0.028804,350,0.001478,0,29,0.370393,0.255384
48341,Moore County,,TX,2136,25882,28018,2,4,6,343,650,993,8,0.250375,0.261906,1696.462899,0.000242,0.000172,350,0.000099,0,29,0.25,0.001501
48343,Morris County,,TX,975,13408,14383,3,4,7,354,487,841,8,0.244278,0.255241,105.062455,0.00014,0.000097,350,0.000141,0,29,0.416667,0.001126
48345,Motley County,,TX,-2,1182,1180,0,0,0,0,0,0,0,0,0,0,0,0,341,0.000054,325,449,0,0
48347,Nacogdoches County,,TX,3599,62476,66075,10,14,24,1698,2084,3782,7,0.322106,0.346527,5559.138172,0.005713,0.009066,350,0.00032,0,29,0.582418,0.042167
48349,Navarro County,,TX,2841,52519,55360,10,8,18,1733,1515,3248,7,0.300146,0.320709,64.767466,0.006395,0.005467,350,0.000319,0,29,0.711111,0.047196
48351,Newton County,,TX,978,12391,13369,3,4,7,591,599,1190,7,0.298067,0.317411,0,0.000172,0.001895,350,0.000129,0,29,1,0.001853
48353,Nolan County,,TX,1088,16439,17527,2,3,5,251,319,570,8,0.251177,0.263054,5412,0.000139,0.000258,350,0.000172,0,29,0.333333,0.00129
48355,Nueces County,,TX,17549,381746,399295,46,42,88,11475,11648,23123,7,0.340089,0.371032,14937.17282,0.023996,0.023949,350,0.001178,0,29,0.400392,0.174191
48357,Ochiltree County,,TX,654,12863,13517,0,0,0,0,0,0,0,0,0,0,0,0,342,0.000054,326,450,0,0
48359,Oldham County,,TX,139,2263,2402,0,0,0,0,0,0,0,0,0,0,0,0,343,0.000054,327,451,0,0
48361,Orange County,,TX,4583,93275,97858,7,9,16,2709,2947,5656,7,0.319827,0.34291,847.231993,0.003412,0.003987,350,0.000227,0,29,0.583333,0.024641
48363,Palo Pinto County,,TX,1954,29089,31043,3,4,7,725,946,1671,7,0.292223,0.309671,0,0.001162,0.002799,350,0.000162,0,29,1,0.009245
48365,Panola County,,TX,1477,26390,27867,5,5,10,605,657,1262,8,0.248071,0.259995,14.742164,0.00034,0.000341,350,0.000204,0,29,0.566667,0.003005
48367,Parker County,,TX,11115,141369,152484,17,11,28,7288,5713,13001,7,0.32102,0.344665,619.010073,0.00878,0.008079,350,0.000551,0,29,0.577206,0.066337
48369,Parmer County,,TX,978,11975,12953,2,4,6,211,459,670,8,0.249392,0.261019,12.273287,0.000076,0.000126,350,0.000115,0,29,0.333333,0.0004
48371,Pecos County,,TX,930,15847,16777,3,2,5,264,199,463,8,0.2512,0.263118,0,0.000955,0.000431,350,0.000134,0,29,1,0.007234
48373,Polk County,,TX,4742,53631,58373,12,9,21,2054,1499,3553,7,0.313403,0.335345,174.815928,0.005513,0.004481,350,0.000362,0,29,0.538462,0.041923
48375,Potter County,,TX,11259,125536,136795,14,18,32,6345,7705,14050,7,0.33073,0.356862,17194.652278,0.006318,0.0121,350,0.000448,0,29,0.457895,0.04636
48377,Presidio County,,TX,917,9879,10796,1,3,4,142,475,617,8,0.251248,0.263367,2746,0.00016,0.000431,350,0.000086,0,29,0.333333,0.001527
48379,Rains County,,TX,744,10371,11115,3,4,7,363,393,756,7,0.291012,0.307859,0.4,0.001276,0.00158,350,0.00014,0,29,0.916667,0.010086
48381,Randall County,,TX,10275,144617,154892,20,20,40,7671,6861,14532,7,0.323865,0.349794,28718.872906,0.009403,0.010225,350,0.000569,0,29,0.36413,0.068183
48383,Reagan County,,TX,268,4412,4680,0,1,1,0,65,65,8,0.249439,0.260498,0,0,0.000115,350,0.000054,0,452,0,0
48385,Real County,,TX,285,3519,3804,0,0,0,0,0,0,0,0,0,0,0,0,344,0.000054,328,453,0,0
48387,Red River County,,TX,738,13002,13740,1,2,3,219,332,551,8,0.232404,0.242255,2.788761,0.000049,0.00012,350,0.000086,0,29,0,0.000435
48389,Reeves County,,TX,751,12441,13192,2,2,4,206,171,377,8,0.2512,0.263118,0,0.000753,0.000431,350,0.000102,0,29,1,0.005449
48391,Refugio County,,TX,474,8658,9132,1,2,3,72,159,231,8,0.253974,0.266224,0,0.00026,0.000335,350,0.000077,0,29,1,0.002006
48393,Roberts County,,TX,60,992,1052,0,0,0,0,0,0,0,0,0,0,0,0,345,0.000054,329,454,0,0
48395,Robertson County,,TX,1155,18085,19240,2,1,3,745,564,1309,8,0.246854,0.257758,0,0.001593,0.000177,350,0.000105,0,29,1,0.012161
48397,Rockwall County,,TX,7130,101623,108753,9,8,17,5711,5033,10744,7,0.320827,0.343978,32.851587,0.008127,0.007996,350,0.000248,0,29,0.916667,0.058703
48399,Runnels County,,TX,529,11565,12094,2,2,4,298,255,553,8,0.25113,0.262804,0,0.00032,0.000257,350,0.000115,0,29,1,0.002158
48401,Rusk County,,TX,3619,54292,57911,9,9,18,2449,2500,4949,7,0.300011,0.320616,520.663714,0.0031,0.003527,350,0.000302,0,29,0.666667,0.02363
48403,Sabine County,,TX,551,10417,10968,1,0,1,84,0,84,0,0,0,0,0.000021,0,350,0.000079,0,19,0,0.000268
48405,San Augustine County,,TX,575,8325,8900,1,2,3,63,164,227,8,0.243787,0.254166,0,0.000098,0.000128,350,0.000073,0,29,1,0.000577
48407,San Jacinto County,,TX,1940,24447,26387,5,5,10,1662,1408,3070,7,0.298034,0.317473,0.342857,0.001909,0.002275,350,0.000191,0,29,0.9,0.015357
48409,San Patricio County,,TX,6037,77729,83766,12,11,23,3392,3828,7220,7,0.32075,0.344397,374.112301,0.006706,0.005505,350,0.000337,0,29,0.621795,0.049048
48411,San Saba County,,TX,286,6189,6475,0,0,0,0,0,0,0,0,0,0,0,0,346,0.000054,330,455,0,0
48413,Schleicher County,,TX,198,3272,3470,1,1,2,82,96,178,8,0.249392,0.260408,0,0.000181,0.000115,350,0.000084,0,29,0,0.000986
48415,Scurry County,,TX,1024,18377,19401,2,2,4,168,172,340,8,0.251651,0.26387,5412,0.000216,0.000215,350,0.000207,0,29,0,0.001844
48417,Shackelford County,,TX,188,3687,3875,1,1,2,56,64,120,8,0.248834,0.259676,0,0.000139,0.000142,350,0.000085,0,29,0,0.001172
48419,Shelby County,,TX,1464,27454,28918,4,3,7,427,483,910,8,0.243943,0.254635,250.879781,0.002723,0.000132,350,0.000154,0,29,0.6,0.020288
48421,Sherman County,,TX,236,2917,3153,0,0,0,0,0,0,0,0,0,0,0,0,347,0.000054,331,456,0,0
48423,Smith County,,TX,12383,243983,256366,32,28,60,8091,7953,16044,7,0.329098,0.356722,3046.569136,0.013957,0.013764,350,0.000885,0,29,0.415966,0.104718
48425,Somervell County,,TX,534,9427,9961,1,3,4,154,271,425,7,0.285806,0.30216,0.333333,0.00004,0.001323,350,0.000095,0,29,0.666667,0.000571
48427,Starr County,,TX,2390,71360,73750,2,3,5,932,1506,2438,7,0.300891,0.320766,0,0.001676,0.003131,350,0.000094,0,29,1,0.012465
48429,Stephens County,,TX,448,9142,9590,1,0,1,52,0,52,0,0,0,0,0.000139,0,350,0.000085,0,18,0,0.001172
48431,Sterling County,,TX,101,1501,1602,0,0,0,0,0,0,0,0,0,0,0,0,348,0.000054,332,457,0,0
48433,Stonewall County,,TX,68,1574,1642,0,0,0,0,0,0,0,0,0,0,0,0,349,0.000054,333,458,0,0
48435,Sutton County,,TX,287,4778,5065,0,1,1,0,70,70,8,0.249439,0.260498,0,0,0.000115,350,0.000054,0,459,0,0
48437,Swisher County,,TX,438,7534,7972,2,3,5,155,249,404,8,0.248741,0.2598,0,0.000118,0.000176,350,0.000108,0,29,1,0.001034
48439,Tarrant County,,TX,101894,2248737,2350631,236,180,416,94306,84119,178425,6,0.39994,0.449569,177008.7373,0.115029,0.096056,350,0.005142,0,29,0.179133,0.717614
48441,Taylor County,,TX,9130,147881,157011,26,25,51,4203,4573,8776,7,0.331223,0.358486,40674.07322,0.013092,0.01284,350,0.000929,0,29,0.337438,0.096054
48443,Terrell County,,TX,70,925,995,0,0,0,0,0,0,0,0,0,0,0,0,351,0.000054,334,460,0,0
48445,Terry County,,TX,747,12606,13353,1,1,2,207,326,533,8,0.251603,0.26362,0,0.000216,0.000215,350,0.000087,0,29,0,0.001726
48447,Throckmorton County,,TX,106,1652,1758,0,0,0,0,0,0,0,0,0,0,0,0,352,0.000054,335,461,0,0
48449,Titus County,,TX,1948,36701,38649,4,6,10,672,700,1372,7,0.291203,0.308484,5531.205084,0.001191,0.001647,350,0.000202,0,29,0.3,0.009225
48451,Tom Green County,,TX,7961,125980,133941,25,26,51,3277,3447,6724,7,0.332213,0.36001,30138.858738,0.010622,0.016665,350,0.000925,0,29,0.309269,0.078327
48453,Travis County,,TX,241517,1264505,1506022,424,476,900,161383,200098,361481,6,0.463758,0.538918,1116848.123492,0.165498,0.158039,350,0.008526,0,29,0.073964,1
48455,Trinity County,,TX,922,13672,14594,4,5,9,651,501,1152,7,0.298034,0.317473,0.369444,0.00192,0.002298,350,0.000156,0,29,0.9,0.014954
48457,Tyler County,,TX,1181,19096,20277,5,5,10,587,616,1203,7,0.298101,0.317598,1.142857,0.00163,0.001936,350,0.000178,0,29,0.733333,0.012842
48459,Upshur County,,TX,3172,40725,43897,8,7,15,2200,2091,4291,7,0.291203,0.308609,1734.445737,0.001567,0.001769,350,0.000316,0,29,0.535714,0.012448
48461,Upton County,,TX,248,3906,4154,0,0,0,0,0,0,0,0,0,0,0,0,353,0.000054,336,462,0,0
48463,Uvalde County,,TX,1722,30667,32389,4,3,7,472,541,1013,7,0.284617,0.301429,100.104227,0.002823,0.001229,350,0.000156,0,29,0.5,0.019521
48465,Val Verde County,,TX,3327,56810,60137,7,6,13,769,1042,1811,7,0.320519,0.343216,88.624298,0.005048,0.004578,350,0.000217,0,29,0.690476,0.036535
48467,Van Zandt County,,TX,3492,55005,58497,10,9,19,2480,2146,4626,7,0.292384,0.310608,15.459837,0.005476,0.004784,350,0.00031,0,29,0.866667,0.04228
48469,Victoria County,,TX,4936,105506,110442,18,14,32,2912,2642,5554,7,0.321834,0.346121,6527.669739,0.006845,0.007493,350,0.000596,0,29,0.409524,0.052397
48471,Walker County,,TX,4454,53379,57833,15,14,29,2738,2833,5571,7,0.32102,0.34504,499.399404,0.007603,0.007873,350,0.00045,0,29,0.520833,0.058284
48473,Waller County,,TX,4237,45141,49378,6,7,13,3489,3299,6788,7,0.299775,0.319928,41.384996,0.003893,0.004167,350,0.000203,0,29,0.642857,0.029359
48475,Ward County,,TX,1010,12777,13787,2,2,4,223,201,424,8,0.2512,0.263118,0,0.000362,0.000431,350,0.000118,0,29,1,0.003313
48477,Washington County,,TX,1865,38950,40815,6,8,14,918,970,1888,7,0.319444,0.34216,208.654784,0.003401,0.004161,350,0.000212,0,29,0.513889,0.024483
48479,Webb County,,TX,7996,308784,316780,11,13,24,2553,4476,7029,7,0.322768,0.347308,1705.924223,0.008803,0.00926,350,0.000288,0,29,0.752747,0.062666
48481,Wharton County,,TX,2058,49248,51306,7,8,15,1383,1380,2763,7,0.319483,0.342223,155.648608,0.002144,0.00441,350,0.000254,0,29,0.625,0.017644
48483,Wheeler County,,TX,359,6406,6765,0,0,0,0,0,0,0,0,0,0,0,0,354,0.000054,337,463,0,0
48485,Wichita County,,TX,7466,132204,139670,16,18,34,2593,3127,5720,7,0.329139,0.355485,16836.294978,0.010011,0.012371,350,0.000573,0,29,0.452632,0.073133
48487,Wilbarger County,,TX,764,14105,14869,1,1,2,137,157,294,8,0.247656,0.258298,0,0.000134,0.000109,350,0.000081,0,29,0,0.000906
48489,Willacy County,,TX,896,20334,21230,2,2,4,410,555,965,8,0.253516,0.265405,0,0.000421,0.000391,350,0.000088,0,29,1,0.002975
48491,Williamson County,,TX,34557,568032,602589,68,49,117,33565,25893,59458,7,0.344391,0.37741,4020.604897,0.042235,0.031236,350,0.001547,0,29,0.420383,0.284714
48493,Wilson County,,TX,3039,51488,54527,6,7,13,2048,1914,3962,7,0.320404,0.343335,155.292938,0.001595,0.005047,350,0.000262,0,29,0.696429,0.012835
48495,Winkler County,,TX,554,8675,9229,1,1,2,100,129,229,8,0.24916,0.260225,0,0.00016,0.000198,350,0.000086,0,29,0,0.001527
48497,Wise County,,TX,3937,68616,72553,7,5,12,3073,2179,5252,7,0.292191,0.309734,11.189541,0.003869,0.003525,350,0.000252,0,29,0.809524,0.029631
48499,Wood County,,TX,2774,44566,47340,12,9,21,1798,1593,3391,7,0.29248,0.310795,2382.731733,0.004051,0.003018,350,0.000418,0,29,0.537879,0.031987
48501,Yoakum County,,TX,614,10181,10795,0,2,2,0,233,233,8,0.251674,0.263896,0,0,0.000218,350,0.000054,0,464,1,0
48503,Young County,,TX,950,20567,21517,1,3,4,74,281,355,7,0.285898,0.302347,2,0.000015,0.001369,350,0.000082,0,29,0.666667,0.000201
48505,Zapata County,,TX,486,14939,15425,2,2,4,167,195,362,8,0.252771,0.26466,0,0.000345,0.000331,350,0.00009,0,29,1,0.002533
48507,Zavala County,,TX,636,12462,13098,3,3,6,292,288,580,7,0.284617,0.301429,1,0.001052,0.001247,350,0.000174,0,29,0.666667,0.008281
49001,Beaver County,,UT,376,7510,7886,0,1,1,0,145,145,8,0.234596,0.243399,0,0,0.000064,11,0.000054,0,465,0,0
49003,Box Elder County,,UT,2849,60679,63528,5,6,11,1845,1913,3758,8,0.270506,0.285815,0,0.001451,0.001476,11,0.000181,0,29,1,0.009672
49005,Cache County,,UT,6595,129403,135998,14,9,23,3259,3558,6817,7,0.306455,0.327068,5582.25519,0.006227,0.00465,11,0.000443,0,29,0.587912,0.04319
49007,Carbon County,,UT,1064,21681,22745,3,3,6,376,397,773,8,0.270396,0.28519,5412,0.001077,0.001005,11,0.000185,0,29,0.333333,0.007051
49009,Daggett County,,UT,64,1071,1135,0,0,0,0,0,0,0,0,0,0,0,0,355,0.000054,338,466,0,0
49011,Davis County,,UT,21214,386040,407254,27,26,53,15750,15201,30951,7,0.333917,0.361912,6137.730506,0.016424,0.019431,11,0.00067,0,29,0.475269,0.113439
49013,Duchesne County,,UT,1490,23013,24503,4,4,8,814,824,1638,8,0.270396,0.285315,0.72619,0.001299,0.001137,11,0.000161,0,29,0.85,0.008468
49015,Emery County,,UT,651,11542,12193,1,1,2,110,149,259,9,0.212861,0.219907,0,0.000011,0.000012,11,0.000106,0,29,0,0.000193
49017,Garfield County,,UT,334,5467,5801,0,0,0,0,0,0,0,0,0,0,0,0,356,0.000054,339,467,0,0
49019,Grand County,,UT,729,11304,12033,2,2,4,175,183,358,8,0.270396,0.285034,149.764035,0.000705,0.000675,11,0.000126,0,29,0.5,0.004697
49021,Iron County,,UT,3258,47154,50412,8,7,15,1669,1705,3374,7,0.306385,0.326693,2669.146522,0.005894,0.004595,11,0.00024,0,29,0.766667,0.039383
49023,Juab County,,UT,546,11585,12131,1,1,2,269,261,530,8,0.253444,0.265918,0,0.000373,0.000339,11,0.000076,0,29,0,0.002422
49025,Kane County,,UT,516,7429,7945,1,2,3,80,179,259,8,0.248997,0.260159,0,0.000185,0.00025,11,0.000068,0,29,0.5,0.000954
49027,Millard County,,UT,578,14573,15151,2,3,5,148,258,406,8,0.270369,0.285128,0,0.001077,0.001124,11,0.000095,0,29,1,0.006932
49029,Morgan County,,UT,592,13088,13680,2,2,4,392,309,701,8,0.250493,0.261827,0,0.000324,0.000284,11,0.000098,0,29,1,0.002144
49031,Piute County,,UT,68,1478,1546,0,0,0,0,0,0,0,0,0,0,0,0,357,0.000054,340,468,0,0
49033,Rich County,,UT,87,2510,2597,0,0,0,0,0,0,0,0,0,0,0,0,358,0.000054,341,469,0,0
49035,Salt Lake County,,UT,49621,1287939,1337560,105,105,210,36443,37206,73649,7,0.37035,0.411696,88223.465,0.061349,0.064847,11,0.002395,0,29,0.322105,0.410578
49037,San Juan County,,UT,876,11195,12071,5,3,8,744,276,1020,8,0.236044,0.246027,14.602065,0.000851,0.000077,227,0.000187,0,29,0.5,0.005776
49039,Sanpete County,,UT,1532,26668,28200,2,2,4,606,632,1238,8,0.270341,0.284941,0,0.001077,0.001005,11,0.000095,0,29,1,0.006932
49041,Sevier County,,UT,956,22527,23483,3,3,6,289,404,693,8,0.270369,0.285128,0,0.001198,0.001124,11,0.000121,0,29,1,0.007839
49043,Summit County,,UT,3787,51811,55598,7,6,13,1711,1998,3709,7,0.310847,0.331747,180.823372,0.005697,0.004602,11,0.000202,0,29,0.833333,0.036844
49045,Tooele County,,UT,3657,69693,73350,6,8,14,2608,2311,4919,7,0.292223,0.310771,32.994287,0.001554,0.003032,11,0.000208,0,29,0.625,0.010323
49047,Uintah County,,UT,2502,39452,41954,4,3,7,1034,895,1929,8,0.270369,0.285128,0.45,0.00121,0.001019,11,0.000156,0,29,0.916667,0.008049
49049,Utah County,,UT,26550,611514,638064,56,53,109,20107,19017,39124,7,0.33944,0.3724,21905.672951,0.031198,0.034322,11,0.00138,0,29,0.426776,0.214304
49051,Wasatch County,,UT,2265,31880,34145,4,3,7,1686,1336,3022,8,0.270369,0.285128,0,0.001338,0.001067,11,0.000146,0,29,1,0.008766
49053,Washington County,,UT,8844,163470,172314,21,17,38,6084,4906,10990,7,0.315106,0.338377,2274.847018,0.01099,0.011129,11,0.000527,0,29,0.443723,0.072655
49055,Wayne County,,UT,109,2919,3028,0,0,0,0,0,0,0,0,0,0,0,0,359,0.000054,342,470,0,0
49057,Weber County,,UT,13113,275938,289051,15,15,30,9034,9156,18190,7,0.315702,0.339127,2336.582157,0.009724,0.010393,11,0.000398,0,29,0.588235,0.064931
50001,Addison County,,VT,2170,44531,46701,4,4,8,793,861,1654,8,0.252484,0.264481,3.658333,0.000248,0.000131,110,0.000157,0,29,0.65,0.001362
50003,Bennington County,,VT,1692,44064,45756,5,6,11,534,588,1122,8,0.253083,0.266137,28.40446,0.000193,0.000278,230,0.000167,0,29,0.333333,0.001549
50005,Caledonia County,,VT,1484,35757,37241,7,7,14,739,750,1489,8,0.252771,0.265637,2847.022741,0.000295,0.000189,110,0.000283,0,29,0.404762,0.001976
50007,Chittenden County,,VT,8117,194736,202853,27,28,55,4203,3733,7936,7,0.337423,0.366413,48601.077323,0.010219,0.02007,110,0.000628,0,29,0.388336,0.057181
50009,Essex County,,VT,295,6846,7141,3,2,5,223,136,359,9,0.204476,0.211694,4.43254,0.000007,0.000008,110,0.000151,0,29,0.333333,0.000443
50011,Franklin County,,VT,2115,60576,62691,4,5,9,1175,1218,2393,8,0.25246,0.264575,781.811238,0.000222,0.000131,110,0.000185,0,29,0.5,0.00118
50013,Grand Isle County,,VT,565,8973,9538,2,2,4,341,343,684,8,0.252365,0.26395,0,0.000219,0.000113,110,0.000104,0,29,1,0.000902
50015,Lamoille County,,VT,1556,31160,32716,5,5,10,782,835,1617,8,0.252484,0.264637,864.915337,0.000236,0.000131,110,0.000204,0,29,0.65,0.001414
50017,Orange County,,VT,1548,35568,37116,5,5,10,973,944,1917,8,0.252723,0.265262,2.648339,0.000307,0.000201,110,0.000176,0,29,0.75,0.00181
50019,Orleans County,,VT,1041,32864,33905,3,4,7,315,390,705,8,0.252484,0.264512,3.416667,0.000005,0.000117,110,0.000154,0,29,0.6,0.000444
50021,Rutland County,,VT,2655,73770,76425,5,5,10,698,884,1582,8,0.252747,0.2652,39.069471,0.000242,0.000138,110,0.000182,0,29,0.4,0.001452
50023,Washington County,,VT,3107,73236,76343,8,7,15,1319,1423,2742,8,0.274401,0.291771,1395.217471,0.001343,0.001273,110,0.000271,0,29,0.464286,0.008396
50025,Windham County,,VT,2455,52334,54789,7,7,14,804,914,1718,8,0.274429,0.291834,426.664996,0.002033,0.001329,110,0.000176,0,29,0.446429,0.011112
50027,Windsor County,,VT,3454,70356,73810,8,10,18,1612,1648,3260,8,0.274514,0.292396,899.641289,0.001413,0.00138,110,0.000244,0,29,0.411111,0.0088
51001,Accomack County,,VA,1718,39732,41450,5,5,10,582,579,1161,8,0.267228,0.282464,24.180392,0.001296,0.001078,366,0.00018,0,29,0.366667,0.008559
51003,Albemarle County,,VA,7340,116228,123568,18,19,37,3962,3980,7942,7,0.316526,0.340539,48378.625747,0.003891,0.007712,366,0.000602,0,29,0.287879,0.025061
51005,Alleghany County,,VA,734,17420,18154,1,1,2,270,258,528,1,1,1,0,0,0,365,0.000357,343,471,0,0.000118
51007,Amelia County,,VA,745,15231,15976,2,3,5,273,338,611,8,0.251746,0.263481,27.890421,0.000486,0.000283,366,0.000101,0,29,0.666667,0.003729
51009,Amherst County,,VA,1531,35090,36621,4,4,8,985,954,1939,8,0.223694,0.233449,28.782702,0.000041,0.000003,372,0.00017,0,29,0.5,0.000573
51011,Appomattox County,,VA,739,17710,18449,2,3,5,330,411,741,8,0.223976,0.233739,38.463434,0.000039,0.000001,372,0.000113,0,29,0.333333,0.000291
51013,Arlington County,,VA,28772,257411,286183,72,63,135,20008,22016,42024,7,0.357305,0.392562,12325.960619,0.061337,0.056709,366,0.001177,0,29,0.573321,0.373452
51015,Augusta County,,VA,3717,86830,90547,6,6,12,2648,2282,4930,8,0.240794,0.251829,16318.116155,0.000101,0.000057,366,0.000391,0,29,0.4,0.00118
51017,Bath County,,VA,251,5426,5677,0,0,0,0,0,0,0,0,0,0,0,0,360,0.000054,344,472,0,0
51019,Bedford County,,VA,4240,90587,94827,8,8,16,2707,2535,5242,8,0.224315,0.235088,1989.395481,0.000104,0.000034,372,0.000302,0,29,0.428571,0.001314
51021,Bland County,,VA,217,6570,6787,0,0,0,0,0,0,0,0,0,0,0,0,361,0.000054,345,473,0,0
51023,Botetourt County,,VA,1923,40757,42680,4,5,9,1195,1161,2356,8,0.223938,0.233958,1.166667,0.000064,0.000033,372,0.000173,0,29,0.9,0.000769
51025,Brunswick County,,VA,718,15954,16672,1,1,2,143,149,292,9,0.21605,0.223757,0,0.000013,0,234,0.000108,0,29,0,0.000128
51027,Buchanan County,,VA,737,21038,21775,1,2,3,141,304,445,10,0.158057,0.162315,0,0,0,372,0.000158,0,29,1,0.000133
51029,Buckingham County,,VA,619,15714,16333,3,3,6,264,211,475,8,0.240729,0.25113,319.364911,0.00009,0.000044,366,0.000159,0,29,0.333333,0.000703
51031,Campbell County,,VA,3612,61969,65581,6,6,12,2421,2423,4844,8,0.223976,0.234355,153.793522,0.000045,0.000004,372,0.000267,0,29,0.4,0.000854
51033,Caroline County,,VA,2138,33298,35436,8,8,16,1383,1288,2671,8,0.265552,0.280708,48.560627,0.002489,0.001405,366,0.000208,0,29,0.708333,0.014496
51035,Carroll County,,VA,1118,30966,32084,4,4,8,784,555,1339,9,0.210145,0.217965,11306.000764,0.000008,0.000003,372,0.000317,0,29,0.166667,0.000532
51036,Charles City County,,VA,308,8166,8474,1,2,3,114,180,294,8,0.261082,0.273724,0,0.000431,0.000348,366,0.000071,0,29,1,0.00216
51037,Charlotte County,,VA,614,13132,13746,1,1,2,78,132,210,9,0.203898,0.210196,0,0.000006,0,366,0.000098,0,29,0,0.000142
51041,Chesterfield County,,VA,20534,401409,421943,43,39,82,14010,13533,27543,7,0.336105,0.365451,42324.352021,0.024876,0.021821,366,0.001013,0,29,0.396135,0.154712
51043,Clarke County,,VA,956,16727,17683,3,3,6,515,501,1016,8,0.261902,0.275067,0,0.000589,0.000503,366,0.000131,0,29,1,0.003399
51045,Craig County,,VA,177,5676,5853,0,0,0,0,0,0,0,0,0,0,0,0,362,0.000054,346,474,0,0
51047,Culpeper County,,VA,2892,56045,58937,10,9,19,1735,1439,3174,7,0.280842,0.298183,3779.681891,0.002655,0.002304,366,0.000264,0,29,0.566667,0.015691
51049,Cumberland County,,VA,674,10352,11026,2,3,5,247,283,530,9,0.208129,0.215439,2780.789255,0.000243,0.000011,366,0.00012,0,29,0.416667,0.001936
51051,Dickenson County,,VA,437,13673,14110,1,1,2,97,142,239,9,0.180857,0.185218,0,0,0,306,0.000126,0,29,0,0.000143
51053,Dinwiddie County,,VA,1809,31293,33102,6,7,13,1403,1285,2688,8,0.262031,0.275817,7.510421,0.000524,0.00096,366,0.000238,0,29,0.952381,0.004723
51057,Essex County,,VA,580,12895,13475,1,0,1,59,0,59,0,0,0,0,0,0,366,0.000095,0,0,0,0.000123
51059,Fairfax County,,VA,91312,1353964,1445276,166,170,336,59922,71286,131208,6,0.389432,0.438037,155021.242143,0.105646,0.107631,366,0.002816,0,29,0.275746,0.628904
51061,Fauquier County,,VA,4320,82921,87241,9,13,22,2547,2491,5038,7,0.283197,0.301656,3464.753396,0.003542,0.004302,366,0.000237,0,29,0.551282,0.021678
51063,Floyd County,,VA,638,17276,17914,1,2,3,183,238,421,8,0.223807,0.233167,0,0.000049,0.000042,372,0.000084,0,29,1,0.000224
51065,Fluvanna County,,VA,1523,29765,31288,4,4,8,736,734,1470,8,0.261748,0.275061,77.070876,0.000148,0.000438,366,0.000175,0,29,0.65,0.001208
51067,Franklin County,,VA,2085,60495,62580,5,5,10,1226,999,2225,8,0.224202,0.234495,268.603361,0.000069,0.000032,372,0.000209,0,29,0.466667,0.000902
51069,Frederick County,,VA,4949,97848,102797,11,9,20,3812,2805,6617,7,0.281464,0.298848,11620.945111,0.00248,0.002259,366,0.000346,0,29,0.463636,0.015185
51071,Giles County,,VA,679,18848,19527,3,3,6,297,339,636,8,0.224145,0.233623,3527.059487,0.000049,0.000014,372,0.000242,0,29,0.333333,0.000481
51073,Gloucester County,,VA,2184,44648,46832,6,6,12,963,903,1866,8,0.254994,0.267859,10822,0.00061,0.000421,366,0.000291,0,29,0.4,0.003407
51075,Goochland County,,VA,1261,26073,27334,5,5,10,1049,721,1770,8,0.26198,0.275486,2.627169,0.000945,0.000939,366,0.000174,0,29,0.85,0.006449
51077,Grayson County,,VA,783,15499,16282,2,2,4,307,370,677,10,0.173675,0.178123,0,0,0,372,0.000211,0,29,1,0.000256
51079,Greene County,,VA,1152,22441,23593,3,4,7,547,563,1110,8,0.241404,0.252248,18.030441,0.00016,0.000114,366,0.000127,0,29,0.666667,0.001138
51081,Greensville County,,VA,755,8586,9341,2,2,4,333,433,766,10,0.172062,0.176263,5412,0.000001,0,366,0.000263,0,29,0,0.00025
51083,Halifax County,,VA,1093,38126,39219,5,4,9,401,298,699,9,0.216858,0.225805,5608.954674,0.000048,0.000007,234,0.000244,0,29,0.2,0.000838
51085,Hanover County,,VA,5519,125727,131246,11,9,20,4155,3462,7617,8,0.268114,0.284228,303.407031,0.002951,0.001724,366,0.000314,0,29,0.527273,0.019018
51087,Henrico County,,VA,24916,380037,404953,54,55,109,16510,16806,33316,7,0.353237,0.386868,45096.705993,0.030794,0.039716,366,0.001138,0,29,0.413702,0.189467
51089,Henry County,,VA,2294,55928,58222,5,6,11,1329,1534,2863,8,0.265024,0.279125,6708.164483,0.000027,0.000482,234,0.000285,0,29,0.166667,0.000739
51091,Highland County,,VA,-2,2659,2657,0,0,0,0,0,0,0,0,0,0,0,0,363,0.000054,347,475,0,0
51093,Isle of Wight County,,VA,2338,43694,46032,11,8,19,1553,1256,2809,8,0.267576,0.283182,5902.847695,0.002141,0.001849,366,0.000315,0,29,0.518182,0.012822
51095,James City County,,VA,5012,87531,92543,13,11,24,2994,2408,5402,7,0.282388,0.301,845.070261,0.003898,0.003207,366,0.000356,0,29,0.557692,0.023691
51097,King and Queen County,,VA,429,7573,8002,1,1,2,91,103,194,9,0.207368,0.213869,0,0.000008,0.000005,366,0.000083,0,29,0,0.00015
51099,King George County,,VA,2044,28853,30897,7,7,14,892,863,1755,7,0.301912,0.321552,2306.283216,0.001031,0.002006,366,0.000197,0,29,0.339286,0.005847
51101,King William County,,VA,1023,20089,21112,3,5,8,494,592,1086,8,0.261594,0.275036,5412.433333,0.00045,0.000698,366,0.000171,0,29,0.5,0.002617
51103,Lancaster County,,VA,631,13646,14277,1,1,2,145,133,278,10,0.166459,0.169959,0,0,0,366,0.000106,0,29,0,0.000123
51105,Lee County,,VA,647,20635,21282,1,1,2,151,170,321,9,0.180857,0.185218,0,0,0,306,0.000126,0,29,0,0.000143
51107,Loudoun County,,VA,24938,453229,478167,56,63,119,19980,15916,35896,7,0.354363,0.389113,19863.378949,0.041407,0.050295,366,0.001031,0,29,0.500978,0.254986
51109,Louisa County,,VA,1904,38280,40184,9,9,18,1145,1013,2158,8,0.262314,0.276676,217.300437,0.00128,0.000848,366,0.000275,0,29,0.488889,0.007786
51111,Lunenburg County,,VA,656,12182,12838,3,3,6,207,255,462,9,0.216858,0.225483,559.880906,0.000022,0.000003,234,0.000212,0,29,0.333333,0.00042
51113,Madison County,,VA,621,15210,15831,3,3,6,343,264,607,8,0.240772,0.251392,7.026712,0.000048,0.000095,366,0.000128,0,29,0.666667,0.000719
51115,Mathews County,,VA,397,10250,10647,1,1,2,139,106,245,9,0.203199,0.209494,0,0.000005,0.000007,366,0.000095,0,29,0,0.000168
51117,Mecklenburg County,,VA,1304,33240,34544,3,4,7,302,374,676,8,0.275563,0.292112,8448.093908,0,0.001152,234,0.000258,0,29,0,0.000386
51119,Middlesex County,,VA,674,12267,12941,1,1,2,90,110,200,9,0.203199,0.209494,0,0.000005,0.000007,366,0.000095,0,29,0,0.000168
51121,Montgomery County,,VA,4754,81041,85795,9,12,21,1668,1870,3538,7,0.287748,0.308028,32835.912922,0.001234,0.004529,372,0.000431,0,29,0.262821,0.008078
51125,Nelson County,,VA,798,17750,18548,2,4,6,220,385,605,8,0.24147,0.252248,928.594363,0.000084,0.000092,366,0.000117,0,29,0.416667,0.000554
51127,New Kent County,,VA,1280,24138,25418,7,5,12,847,658,1505,8,0.262031,0.27558,9.869488,0.001296,0.000968,366,0.000221,0,29,0.666667,0.008212
51131,Northampton County,,VA,623,14005,14628,3,2,5,371,297,668,8,0.266241,0.280508,0,0.001223,0.000775,366,0.000115,0,29,0.833333,0.00771
51133,Northumberland County,,VA,736,14639,15375,2,3,5,219,331,550,9,0.199686,0.20582,5412,0,0.000001,366,0.000185,0,29,0.333333,0.000241
51135,Nottoway County,,VA,866,15536,16402,4,3,7,322,264,586,8,0.251864,0.263731,6163.069673,0.000246,0.00027,366,0.000209,0,29,0.416667,0.002221
51137,Orange County,,VA,2429,40237,42666,11,11,22,1576,1467,3043,7,0.281227,0.299033,2235.736204,0.002184,0.00202,366,0.000294,0,29,0.431818,0.013368
51139,Page County,,VA,763,26766,27529,2,2,4,246,268,514,8,0.219498,0.227522,0,0.000014,0.000013,366,0.000121,0,29,1,0.000353
51141,Patrick County,,VA,673,18776,19449,2,2,4,279,286,565,9,0.209913,0.217278,39.778038,0.000013,0.000004,234,0.000124,0,29,0,0.000297
51143,Pittsylvania County,,VA,2792,69157,71949,8,7,15,1797,1819,3616,8,0.265367,0.279756,1753.840027,0.000077,0.000485,234,0.000324,0,29,0.305556,0.001245
51145,Powhatan County,,VA,1336,32833,34169,5,3,8,1045,703,1748,8,0.261851,0.274955,1771.539848,0.00092,0.000893,366,0.000181,0,29,0.5,0.006186
51147,Prince Edward County,,VA,1130,18534,19664,6,7,13,592,586,1178,8,0.256095,0.269124,7269.69959,0.000004,0.000566,366,0.000368,0,29,0.142857,0.000791
51149,Prince George County,,VA,3766,37525,41291,10,7,17,2059,1623,3682,8,0.255948,0.268812,9010.140659,0.002831,0.000601,366,0.000351,0,29,0.5,0.020453
51153,Prince William County,,VA,34461,531230,565691,65,74,139,27218,25288,52506,7,0.354128,0.390713,19521.139902,0.04804,0.055028,366,0.001145,0,29,0.457978,0.297613
51155,Pulaski County,,VA,1405,35721,37126,4,4,8,915,771,1686,8,0.223957,0.233617,2287.57939,0.00005,0.000014,372,0.000268,0,29,0.416667,0.000605
51157,Rappahannock County,,VA,426,8579,9005,2,2,4,155,146,301,8,0.220751,0.229156,0,0.000072,0.000067,366,0.000094,0,29,1,0.000655
51159,Richmond County,,VA,464,8457,8921,2,3,5,191,288,479,9,0.199686,0.20582,8234,0.000002,0.000001,366,0.000146,0,29,0.166667,0.000261
51161,Roanoke County,,VA,6729,113040,119769,6,9,15,4392,4423,8815,7,0.284526,0.30373,3908.813587,0.000085,0.002678,372,0.000245,0,29,0.444444,0.001123
51163,Rockbridge County,,VA,983,24501,25484,3,3,6,610,464,1074,9,0.194135,0.200125,10822,0.000001,0.000001,366,0.000386,0,29,0,0.000384
51165,Rockingham County,,VA,3761,93781,97542,5,6,11,2301,2261,4562,8,0.220005,0.229052,46.086778,0.000031,0.000029,366,0.000275,0,29,0.466667,0.000828
51167,Russell County,,VA,859,26472,27331,4,3,7,452,390,842,9,0.185034,0.190935,1962.903649,0,0.000001,372,0.000382,0,29,0.25,0.000539
51169,Scott County,,VA,787,21483,22270,3,3,6,356,523,879,8,0.220551,0.228226,11.215823,0.000018,0.000017,306,0.00022,0,29,0.666667,0.000563
51171,Shenandoah County,,VA,2247,50646,52893,6,7,13,1034,1125,2159,7,0.280872,0.297877,5292.931715,0.001252,0.00124,366,0.000238,0,29,0.452381,0.008041
51173,Smyth County,,VA,1070,32508,33578,2,2,4,381,510,891,9,0.186704,0.192771,226.40152,0,0.000001,306,0.000192,0,29,0,0.000273
51175,Southampton County,,VA,1034,18767,19801,3,3,6,474,424,898,9,0.211226,0.218971,1.142857,0.000041,0.000063,366,0.000148,0,29,0.833333,0.000775
51177,Spotsylvania County,,VA,8724,151228,159952,18,17,35,6039,5127,11166,7,0.283167,0.303193,1459.278839,0.006196,0.005281,366,0.000416,0,29,0.488095,0.038836
51179,Stafford County,,VA,11181,159389,170570,23,26,49,7645,6598,14243,7,0.331346,0.357799,9970.081627,0.011699,0.015645,366,0.000473,0,29,0.511396,0.072911
51181,Surry County,,VA,406,7517,7923,0,1,1,0,57,57,9,0.211155,0.218508,0,0,0.000023,366,0.000054,0,476,0,0
51183,Sussex County,,VA,659,10380,11039,3,3,6,234,213,447,9,0.207772,0.214883,10820,0.000017,0.000049,366,0.000243,0,29,0.333333,0.000727
51185,Tazewell County,,VA,1565,42415,43980,4,3,7,686,650,1336,10,0.184854,0.191099,4015.040158,0,0,372,0.00037,0,29,0.25,0.000508
51187,Warren County,,VA,2436,44928,47364,8,7,15,1444,1129,2573,7,0.280872,0.297889,11.354423,0.002461,0.002223,366,0.000221,0,29,0.714286,0.01449
51191,Washington County,,VA,2504,56957,59461,6,5,11,1323,1327,2650,8,0.225586,0.235077,9477.057497,0.000048,0.000023,306,0.000492,0,29,0.266667,0.001001
51193,Westmoreland County,,VA,1137,20024,21161,4,4,8,520,445,965,8,0.249346,0.260597,18964.242857,0.000111,0.000206,366,0.000186,0,29,0.333333,0.001132
51195,Wise County,,VA,1514,36003,37517,6,7,13,850,782,1632,8,0.22077,0.22915,18318.12057,0.000014,0.000013,306,0.000599,0,29,0.142857,0.000867
51197,Wythe County,,VA,1088,31896,32984,3,4,7,335,446,781,8,0.224277,0.234129,1674.772702,0,0.000014,372,0.00026,0,29,0.166667,0.00039
51199,York County,,VA,6137,78616,84753,8,12,20,3152,3086,6238,7,0.282328,0.301032,465.044218,0.001798,0.003256,366,0.00025,0,29,0.590909,0.010897
51510,Alexandria city,,VA,22135,173198,195333,46,42,88,16007,16595,32602,7,0.348713,0.380296,1785.568739,0.041922,0.040775,366,0.000768,0,29,0.720202,0.260148
51515,Bedford city,,VA,0,0,0,0,0,0,0,0,0,0,0,0,0,0,0,364,0.000054,348,477,0,0
51520,Bristol city,,VA,1445,16499,17944,2,2,4,970,951,1921,8,0.220551,0.227882,0,0.000014,0.000013,306,0.00019,0,29,1,0.000393
51530,Buena Vista city,,VA,555,6710,7265,1,1,2,209,244,453,10,0.162584,0.166032,0,0,0,366,0.000163,0,29,0,0.000128
51540,Charlottesville city,,VA,4119,41680,45799,11,11,22,2308,2403,4711,7,0.289402,0.309677,6427.34501,0.004356,0.005045,366,0.000306,0,29,0.410256,0.029002
51550,Chesapeake city,,VA,19607,269237,288844,27,30,57,13467,12927,26394,7,0.33564,0.364196,9980.618782,0.015859,0.021459,366,0.000608,0,29,0.539773,0.101714
51570,Colonial Heights city,,VA,2093,20336,22429,6,7,13,1301,1510,2811,8,0.262031,0.275817,6.038032,0.000706,0.000958,366,0.000231,0,29,0.952381,0.004945
51580,Covington city,,VA,530,6563,7093,1,1,2,258,270,528,1,1,1,0,0,0,365,0.000357,343,471,0,0.000118
51590,Danville city,,VA,2740,43481,46221,4,5,9,1446,1526,2972,8,0.264709,0.278475,2932.050402,0.00053,0.000488,234,0.000191,0,29,0.6,0.003523
51595,Emporia city,,VA,634,6052,6686,1,1,2,348,260,608,11,0.146811,0.149426,0,0,0,366,0.000165,0,29,0,0.000123
51600,Fairfax city,,VA,2972,27590,30562,7,7,14,1980,1972,3952,7,0.283588,0.301406,0,0.005266,0.005447,366,0.00015,0,29,1,0.030392
51610,Falls Church city,,VA,1601,14834,16435,5,5,10,913,920,1833,7,0.282717,0.299764,0,0.003738,0.003946,366,0.00013,0,29,1,0.023231
51620,Franklin city,,VA,743,8949,9692,2,3,5,381,427,808,9,0.211226,0.218971,0,0.000021,0.000063,366,0.000122,0,29,1,0.000506
51630,Fredericksburg city,,VA,4370,25836,30206,7,8,15,2626,2928,5554,7,0.281108,0.298433,42.931134,0.002052,0.002214,366,0.000186,0,29,0.75,0.012306
51640,Galax city,,VA,674,7270,7944,2,2,4,351,433,784,10,0.173675,0.178123,0,0,0,372,0.000211,0,29,1,0.000256
51650,Hampton city,,VA,14572,145847,160419,25,29,54,8033,9228,17261,7,0.329139,0.357739,12687.670302,0.013776,0.020191,366,0.000561,0,29,0.524194,0.088141
51660,Harrisonburg city,,VA,3780,39505,43285,6,6,12,1692,1868,3560,7,0.281108,0.298171,12256.272383,0.001184,0.001451,366,0.000288,0,29,0.357143,0.007589
51670,Hopewell city,,VA,2450,23635,26085,7,7,14,1794,1638,3432,8,0.262031,0.275817,8.707162,0.000955,0.000956,366,0.000253,0,29,0.928571,0.006858
51678,Lexington city,,VA,506,5261,5767,1,1,2,147,275,422,10,0.162584,0.166032,0,0,0,366,0.000163,0,29,0,0.000128
51680,Lynchburg city,,VA,5645,71899,77544,6,10,16,2739,3206,5945,7,0.287686,0.307809,13077.403411,0.000089,0.003615,372,0.000258,0,29,0.277778,0.001132
51683,Manassas city,,VA,5519,48110,53629,10,10,20,4199,4009,8208,7,0.282149,0.300388,23.409066,0.005088,0.004188,366,0.000217,0,29,0.681818,0.02942
51685,Manassas Park city,,VA,2180,17253,19433,5,4,9,1775,1505,3280,7,0.280576,0.296996,0,0.003198,0.002174,366,0.000124,0,29,1,0.017833
51690,Martinsville city,,VA,1107,14203,15310,1,1,2,759,723,1482,9,0.209518,0.216235,0,0.000005,0,234,0.000094,0,29,0,0.000139
51700,Newport News city,,VA,18831,194415,213246,31,40,71,10992,11744,22736,7,0.339916,0.370967,20384.014934,0.019311,0.029554,366,0.000684,0,29,0.523229,0.12548
51710,Norfolk city,,VA,27115,224856,251971,53,56,109,15846,18146,33992,7,0.351979,0.385483,14733.684139,0.040761,0.042019,366,0.000943,0,29,0.460492,0.256079
51720,Norton city,,VA,514,3910,4424,1,1,2,219,312,531,9,0.180857,0.185218,0,0,0,306,0.000126,0,29,0,0.000143
51730,Petersburg city,,VA,4501,33005,37506,9,8,17,2496,2783,5279,8,0.262108,0.276098,7605.362645,0.001667,0.000948,366,0.000333,0,29,0.597222,0.011178
51735,Poquoson city,,VA,718,14864,15582,3,3,6,373,364,737,8,0.254872,0.267172,0,0.000575,0.000379,366,0.000102,0,29,1,0.00278
51740,Portsmouth city,,VA,10017,102186,112203,11,13,24,6474,6573,13047,7,0.326361,0.350427,907.392046,0.006846,0.009182,366,0.000259,0,29,0.780952,0.044229
51750,Radford city,,VA,1138,10926,12064,2,2,4,517,645,1162,8,0.223619,0.232742,0,0.000049,0.000014,372,0.000141,0,29,1,0.000358
51760,Richmond city,,VA,20880,201009,221889,52,40,92,16890,15984,32874,7,0.341133,0.371407,32618.974122,0.02661,0.022945,366,0.00119,0,29,0.326936,0.166329
51770,Roanoke city,,VA,7893,106102,113995,11,10,21,4610,4845,9455,8,0.283528,0.302675,19607.245765,0.002625,0.003172,372,0.000356,0,29,0.339744,0.017445
51775,Salem city,,VA,2124,27658,29782,5,5,10,1444,1525,2969,8,0.224164,0.234279,28.073755,0.000113,0.000045,372,0.000199,0,29,0.8,0.000987
51790,Staunton city,,VA,2133,26272,28405,4,5,9,1288,1371,2659,8,0.240729,0.251517,55.097683,0.000017,0.000058,366,0.000265,0,29,0.65,0.000644
51800,Suffolk city,,VA,6600,98378,104978,11,10,21,4641,3949,8590,8,0.26771,0.283682,14313.71138,0.003648,0.001833,366,0.000308,0,29,0.536364,0.022589
51810,Virginia Beach city,,VA,36245,520678,556923,100,95,195,23913,24291,48204,7,0.362549,0.402196,42350.081566,0.070037,0.069544,366,0.001814,0,29,0.399533,0.43081
51820,Waynesboro city,,VA,1875,24230,26105,6,3,9,1355,1229,2584,8,0.240642,0.251017,112.164666,0.000141,0.000044,366,0.000268,0,29,0.466667,0.001402
51830,Williamsburg city,,VA,1814,10797,12611,4,3,7,975,988,1963,8,0.253757,0.26602,0,0.00061,0.000272,366,0.00013,0,29,1,0.003169
51840,Winchester city,,VA,3330,29706,33036,8,7,15,1872,2218,4090,7,0.281286,0.298254,113.273675,0.002407,0.001738,366,0.000255,0,29,0.642857,0.014375
53001,Adams County,,WA,1394,24976,26370,2,4,6,611,887,1498,8,0.252771,0.265956,0,0.000096,0.000507,11,0.000109,0,29,1,0.00087
53003,Asotin County,,WA,1429,23477,24906,4,3,7,856,795,1651,8,0.252747,0.2658,1.333333,0.000387,0.000324,11,0.000183,0,29,0.916667,0.00311
53005,Benton County,,WA,11007,215919,226926,24,19,43,8562,6886,15448,7,0.315964,0.340001,4067.051222,0.012117,0.010566,11,0.000625,0,29,0.538333,0.088097
53007,Chelan County,,WA,4901,92433,97334,11,11,22,3275,3253,6528,7,0.287686,0.306029,137.690656,0.006843,0.003417,11,0.000307,0,29,0.692308,0.048012
53009,Clallam County,,WA,3160,81415,84575,11,8,19,1449,1261,2710,7,0.287655,0.305561,39.667101,0.008576,0.003707,11,0.000292,0,29,0.878788,0.060337
53011,Clark County,,WA,21381,529454,550835,58,48,106,20484,15269,35753,7,0.336105,0.367784,7879.734201,0.031301,0.027697,11,0.00135,0,29,0.465027,0.217983
53013,Columbia County,,WA,199,4156,4355,1,1,2,61,100,161,8,0.223488,0.231536,0,0.00003,0.000017,11,0.000082,0,29,0,0.000264
53015,Cowlitz County,,WA,4929,111744,116673,14,12,26,3629,2881,6510,7,0.288183,0.307091,159.589544,0.007715,0.005323,11,0.000379,0,29,0.714286,0.057991
53017,Douglas County,,WA,3050,46039,49089,6,6,12,2544,2246,4790,7,0.285195,0.302269,0,0.002038,0.00231,11,0.000198,0,29,1,0.015653
53019,Ferry County,,WA,339,6680,7019,0,2,2,0,141,141,8,0.252698,0.265513,0,0,0.000314,11,0.000054,0,478,1,0
53021,Franklin County,,WA,6856,102804,109660,11,8,19,4950,5019,9969,7,0.28547,0.303018,2094.000309,0.004602,0.00203,11,0.000312,0,29,0.654545,0.033144
53023,Garfield County,,WA,104,2340,2444,0,0,0,0,0,0,0,0,0,0,0,0,367,0.000054,349,479,0,0
53025,Grant County,,WA,5414,112203,117617,12,14,26,2472,3374,5846,7,0.314623,0.337222,1467.587846,0.00297,0.00685,11,0.000366,0,29,0.631868,0.02363
53027,Grays Harbor County,,WA,3146,71279,74425,9,9,18,1952,1800,3752,7,0.287562,0.305592,9.287995,0.003227,0.003656,11,0.000282,0,29,0.766667,0.024916
53029,Island County,,WA,6730,92993,99723,17,13,30,4018,3456,7474,7,0.312888,0.335466,46.639092,0.013341,0.010046,11,0.000383,0,29,0.783088,0.091425
53031,Jefferson County,,WA,1733,35342,37075,6,5,11,897,815,1712,7,0.287314,0.304592,0.166667,0.002556,0.003035,11,0.000201,0,29,0.933333,0.020409
53033,King County,,WA,104486,2518291,2622777,254,186,440,92981,87843,180824,6,0.39809,0.448195,172074.130599,0.130443,0.104168,11,0.0051,0,29,0.191314,0.795153
53035,Kitsap County,,WA,14722,293753,308475,45,30,75,11811,8395,20206,7,0.324614,0.352829,1484.398698,0.029544,0.021797,11,0.000946,0,29,0.498299,0.202438
53037,Kittitas County,,WA,2343,41236,43579,10,7,17,1639,1225,2864,7,0.287562,0.30528,1.631154,0.003414,0.003141,11,0.000295,0,29,0.844444,0.026655
53039,Klickitat County,,WA,1394,23757,25151,6,6,12,656,681,1337,8,0.26688,0.281843,35.534451,0.001072,0.001352,11,0.000302,0,29,0.533333,0.009637
53041,Lewis County,,WA,3900,82042,85942,8,10,18,2474,2354,4828,7,0.306139,0.327211,29.858107,0.003482,0.005963,11,0.000247,0,29,0.833333,0.028135
53043,Lincoln County,,WA,570,11519,12089,1,1,2,212,243,455,8,0.252628,0.265237,0,0.000314,0.000294,11,0.000082,0,29,0,0.002256
53045,Mason County,,WA,3478,62359,65837,7,7,14,2515,2340,4855,7,0.287376,0.304967,1.01516,0.002831,0.00328,11,0.000217,0,29,0.839286,0.02213
53047,Okanogan County,,WA,1999,46122,48121,7,7,14,936,1042,1978,7,0.285256,0.302518,1.767477,0.002694,0.002422,11,0.000219,0,29,0.910714,0.020601
53049,Pacific County,,WA,1029,22483,23512,7,5,12,632,426,1058,7,0.285012,0.301862,2.870963,0.002822,0.002098,11,0.000231,0,29,0.803571,0.023223
53051,Pend Oreille County,,WA,883,12711,13594,2,2,4,445,484,929,8,0.252675,0.265487,0,0.000338,0.000299,11,0.00011,0,29,1,0.002419
53053,Pierce County,,WA,51275,953029,1004304,120,106,226,43667,37258,80925,7,0.360005,0.402229,27198.2463,0.068246,0.060498,11,0.002432,0,29,0.304625,0.455931
53055,San Juan County,,WA,914,19252,20166,3,3,6,331,326,657,7,0.28483,0.301238,0,0.001735,0.001679,11,0.00012,0,29,1,0.013318
53057,Skagit County,,WA,5970,141470,147440,12,10,22,4119,3555,7674,7,0.305998,0.32693,63.492367,0.008639,0.005667,11,0.00031,0,29,0.766667,0.060525
53059,Skamania County,,WA,708,11496,12204,4,2,6,452,348,800,8,0.251651,0.263994,0.332908,0.000926,0.000352,11,0.000185,0,29,0.833333,0.008425
53061,Snohomish County,,WA,38165,894696,932861,71,67,138,34469,29780,64249,7,0.345462,0.380927,9253.845902,0.042735,0.041936,11,0.001584,0,29,0.418695,0.296958
53063,Spokane County,,WA,18411,548857,567268,66,56,122,13531,11946,25477,7,0.337978,0.371363,42456.400952,0.02705,0.028914,11,0.001859,0,29,0.299195,0.193683
53065,Stevens County,,WA,2467,45818,48285,4,2,6,1388,1237,2625,7,0.285043,0.301456,73.837595,0.001904,0.00171,11,0.000148,0,29,0.583333,0.014405
53067,Thurston County,,WA,17474,309797,327271,42,31,73,12723,10880,23603,7,0.333417,0.361974,1632.468021,0.025289,0.022673,11,0.000961,0,29,0.552049,0.178679
53069,Wahkiakum County,,WA,200,4146,4346,0,0,0,0,0,0,0,0,0,0,0,0,368,0.000054,350,480,0,0
53071,Walla Walla County,,WA,2889,64236,67125,6,8,14,1402,1445,2847,7,0.287779,0.305779,5479.585351,0.001609,0.002771,11,0.000264,0,29,0.607143,0.012973
53073,Whatcom County,,WA,8324,233752,242076,22,20,42,5270,4487,9757,7,0.317619,0.341978,462.232309,0.015522,0.013685,11,0.000541,0,29,0.69,0.109892
53075,Whitman County,,WA,2808,37444,40252,8,9,17,1140,1208,2348,7,0.287748,0.305873,316.172041,0.002853,0.003687,11,0.000271,0,29,0.627273,0.021844
53077,Yakima County,,WA,8717,296266,304983,22,22,44,5091,5161,10252,7,0.31743,0.342394,1631.306791,0.010982,0.013629,11,0.00059,0,29,0.514778,0.079009
54001,Barbour County,,WV,651,16755,17406,3,3,6,318,351,669,10,0.185213,0.191726,2744.833333,0,0,257,0.000221,0,29,0.5,0.000405
54003,Berkeley County,,WV,5408,128117,133525,18,11,29,4075,2628,6703,8,0.278555,0.296327,7158.779042,0.006195,0.00246,366,0.00045,0,29,0.388889,0.034707
54005,Boone County,,WV,857,23318,24175,2,2,4,332,338,670,9,0.225243,0.234982,0,0.000043,0.000011,372,0.000156,0,29,1,0.000396
54007,Braxton County,,WV,473,13887,14360,0,2,2,0,152,152,10,0.18391,0.189356,0,0,0,372,0.000054,0,482,0,0
54009,Brooke County,,WV,1070,26663,27733,5,4,9,594,675,1269,8,0.277281,0.29337,2.32619,0.001087,0.000968,257,0.000221,0,29,0.7,0.006454
54011,Cabell County,,WV,4972,97805,102777,9,8,17,2643,2442,5085,9,0.227006,0.238739,16523.450681,0.001022,0.000024,372,0.000443,0,29,0.277778,0.007355
54013,Calhoun County,,WV,267,7058,7325,0,0,0,0,0,0,0,0,0,0,0,0,369,0.000054,351,483,0,0
54015,Clay County,,WV,306,8834,9140,2,1,3,159,76,235,9,0.225186,0.234701,2668,0.000042,0.000011,372,0.00013,0,29,0,0.000375
54017,Doddridge County,,WV,308,7379,7687,1,1,2,216,158,374,10,0.185149,0.191195,0,0,0,257,0.000115,0,29,0,0.000149
54019,Fayette County,,WV,2024,43600,45624,3,4,7,859,889,1748,9,0.225528,0.235851,252.77068,0.000043,0.00003,372,0.000226,0,29,0.416667,0.000651
54021,Gilmer County,,WV,236,6498,6734,1,0,1,72,0,72,0,0,0,0,0,0,372,0.000076,0,481,0,0.000113
54023,Grant County,,WV,346,13076,13422,2,1,3,291,81,372,10,0.153563,0.156689,2.759524,0,0,366,0.000201,0,29,0,0.000246
54025,Greenbrier County,,WV,1418,37506,38924,4,1,5,423,165,588,10,0.1572,0.160986,2093.793266,0.000001,0,372,0.000274,0,29,0.333333,0.000634
54027,Hampshire County,,WV,1079,24598,25677,4,4,8,436,445,881,8,0.221558,0.230942,10085.803127,0.000026,0.000094,366,0.000263,0,29,0.2,0.000677
54029,Hancock County,,WV,1507,36164,37671,5,5,10,852,808,1660,8,0.277281,0.293495,3.471429,0.00111,0.000989,257,0.000192,0,29,0.633333,0.006493
54031,Hardy County,,WV,634,16060,16694,2,2,4,148,188,336,9,0.18141,0.186599,3260.475945,0.000001,0,366,0.00028,0,29,0,0.000257
54033,Harrison County,,WV,3022,78761,81783,7,8,15,1268,1513,2781,9,0.227199,0.239152,26019.134018,0.000012,0.000023,257,0.000578,0,29,0.214286,0.001027
54035,Jackson County,,WV,941,31897,32838,4,2,6,524,330,854,9,0.225376,0.235326,5.981818,0.000054,0.000022,372,0.000267,0,29,0.5,0.000739
54037,Jefferson County,,WV,3140,63891,67031,7,7,14,1781,1676,3457,7,0.282448,0.300022,12.379031,0.003642,0.002922,366,0.000171,0,29,0.785714,0.020854
54039,Kanawha County,,WV,9652,215907,225559,17,17,34,3428,3705,7133,8,0.2906,0.312719,84571.454631,0.000992,0.003896,372,0.001066,0,29,0.115789,0.00868
54041,Lewis County,,WV,769,19688,20457,2,2,4,299,332,631,10,0.185188,0.191476,0,0,0,257,0.000166,0,29,1,0.000277
54043,Lincoln County,,WV,831,20750,21581,3,4,7,443,503,946,9,0.225528,0.235826,6.385714,0.000043,0.000023,372,0.000203,0,29,0.75,0.000615
54045,Logan County,,WV,1305,33758,35063,4,5,9,469,617,1086,9,0.225681,0.236191,2578.654682,0.000043,0.000023,372,0.000288,0,29,0.4,0.00064
54047,McDowell County,,WV,656,16528,17184,1,2,3,96,318,414,10,0.184458,0.190257,0,0,0,372,0.000136,0,29,1,0.000138
54049,Marion County,,WV,2457,64209,66666,5,3,8,1210,1061,2271,9,0.218958,0.227764,12,0.000012,0.000013,257,0.00034,0,29,0.5,0.000788
54051,Marshall County,,WV,1516,36419,37935,3,2,5,1068,797,1865,9,0.220861,0.229585,47.063481,0.000022,0.000034,257,0.000211,0,29,0.333333,0.000594
54053,Mason County,,WV,972,26967,27939,4,5,9,480,600,1080,9,0.225624,0.236232,114.256779,0.000011,0.000023,372,0.000236,0,29,0.4,0.000618
54055,Mercer County,,WV,2289,62744,65033,5,4,9,889,586,1475,9,0.225834,0.23625,18192.301935,0,0.00003,372,0.000389,0,29,0.166667,0.000754
54057,Mineral County,,WV,1164,32000,33164,2,4,6,463,704,1167,9,0.220861,0.230551,2253.314827,0.000014,0.000014,366,0.000133,0,29,0,0.000271
54059,Mingo County,,WV,1269,23288,24557,2,2,4,270,424,694,9,0.208796,0.215631,92.946105,0.000002,0,306,0.000169,0,29,0,0.000262
54061,Monongalia County,,WV,6400,96486,102886,16,13,29,2273,2218,4491,8,0.280076,0.298642,60897.797637,0.001147,0.00106,257,0.00081,0,29,0.113971,0.008482
54063,Monroe County,,WV,652,14209,14861,2,3,5,253,361,614,9,0.186508,0.193041,2767.197737,0,0.000001,372,0.000355,0,29,0,0.000263
54065,Morgan County,,WV,869,19007,19876,2,3,5,274,427,701,8,0.222797,0.232297,66.477762,0.000097,0.000137,366,0.000104,0,29,0.5,0.001026
54067,Nicholas County,,WV,869,26730,27599,3,3,6,241,254,495,9,0.2253,0.235251,5412,0.000043,0.000011,372,0.000264,0,29,0.333333,0.00051
54069,Ohio County,,WV,2604,49586,52190,7,5,12,1211,1452,2663,8,0.277368,0.293651,2135.489559,0.001099,0.000968,257,0.00037,0,29,0.428571,0.006895
54071,Pendleton County,,WV,203,8498,8701,0,0,0,0,0,0,0,0,0,0,0,0,370,0.000054,352,484,0,0
54073,Pleasants County,,WV,272,8304,8576,1,1,2,85,89,174,9,0.219318,0.227295,0,0.000011,0.000011,257,0.000118,0,29,0,0.000222
54075,Pocahontas County,,WV,310,9282,9592,0,0,0,0,0,0,0,0,0,0,0,0,371,0.000054,353,485,0,0
54077,Preston County,,WV,1155,35714,36869,2,3,5,579,554,1133,9,0.218994,0.227733,527.749935,0.000012,0.000013,257,0.00014,0,29,0.5,0.000378
54079,Putnam County,,WV,3114,66876,69990,4,4,8,1971,1806,3777,9,0.225528,0.235857,38.123593,0.000043,0.000023,372,0.000237,0,29,0.55,0.000746
54081,Raleigh County,,WV,3065,80212,83277,6,7,13,1084,1127,2211,9,0.22749,0.23937,29770.961858,0.001759,0.000024,372,0.000364,0,29,0.142857,0.012117
54083,Randolph County,,WV,1026,30958,31984,3,4,7,305,345,650,9,0.219012,0.228045,6245.477956,0,0.000012,257,0.00026,0,29,0.083333,0.000375
54085,Ritchie County,,WV,341,10933,11274,1,1,2,75,111,186,9,0.219318,0.227295,0,0.000011,0.000011,257,0.000118,0,29,0,0.000222
54087,Roane County,,WV,632,14456,15088,1,2,3,138,251,389,9,0.225205,0.234889,0,0.000042,0.000011,372,0.000107,0,29,1,0.000261
54089,Summers County,,WV,510,10989,11499,1,3,4,97,247,344,10,0.185613,0.192221,0,0,0.000019,372,0.000098,0,29,0.5,0.00026
54091,Taylor County,,WV,781,18398,19179,4,3,7,609,462,1071,9,0.218958,0.227764,375.207493,0.000012,0.000013,257,0.000327,0,29,0.666667,0.000671
54093,Tucker County,,WV,229,7917,8146,1,1,2,91,70,161,10,0.179675,0.184494,0,0,0,257,0.000109,0,29,0,0.000128
54095,Tyler County,,WV,355,9898,10253,1,1,2,155,129,284,10,0.179651,0.184438,0,0,0,257,0.000093,0,29,0,0.000125
54097,Upshur County,,WV,932,26010,26942,3,4,7,292,400,692,10,0.185226,0.191914,2747.833333,0,0,257,0.000241,0,29,0.5,0.0004
54099,Wayne County,,WV,1788,40321,42109,4,4,8,1088,1098,2186,9,0.220532,0.229584,1328.969353,0.000013,0.000012,372,0.000253,0,29,0.666667,0.000636
54101,Webster County,,WV,171,8184,8355,1,1,2,76,74,150,10,0.183886,0.189154,0,0,0,372,0.000128,0,29,0,0.00013
54103,Wetzel County,,WV,831,17705,18536,2,4,6,207,385,592,9,0.218976,0.227933,5432.342184,0.000012,0.000013,257,0.000186,0,29,0.166667,0.000373
54105,Wirt County,,WV,235,6073,6308,1,1,2,149,145,294,9,0.219318,0.227295,0,0.000011,0.000011,257,0.000118,0,29,0,0.000222
54107,Wood County,,WV,2949,98317,101266,9,9,18,1375,1383,2758,8,0.280901,0.298607,19361.603979,0.001031,0.00103,257,0.000677,0,29,0.166667,0.00756
54109,Wyoming County,,WV,631,20542,21173,1,1,2,131,178,309,10,0.185342,0.191377,0,0,0.000019,372,0.000098,0,29,0,0.00026
55001,Adams County,,WI,1146,21108,22254,6,4,10,533,410,943,8,0.265367,0.279184,3.608669,0.00052,0.000405,47,0.000194,0,29,0.6,0.003418
55003,Ashland County,,WI,771,18057,18828,1,2,3,126,250,376,9,0.1806,0.184947,2746,0,0,374,0.000111,0,29,0,0.000123
55005,Barron County,,WI,2228,56183,58411,8,9,17,981,1145,2126,7,0.282687,0.299323,11201.646314,0.000076,0.000909,374,0.000333,0,29,0.375,0.00156
55007,Bayfield County,,WI,677,18812,19489,2,2,4,253,222,475,8,0.22035,0.227829,8156,0.00001,0.000001,374,0.000136,0,29,0,0.00025
55009,Brown County,,WI,9157,323957,333114,26,23,49,6349,5257,11606,7,0.334587,0.361478,31325.742023,0.007384,0.008609,374,0.000722,0,29,0.284483,0.047571
55011,Buffalo County,,WI,633,16790,17423,4,3,7,373,236,609,8,0.221613,0.230506,20.906724,0.000039,0.000034,374,0.000177,0,29,0.333333,0.000777
55013,Burnett County,,WI,769,18553,19322,2,2,4,156,156,312,8,0.261236,0.274284,0,0.000398,0.000261,374,0.000105,0,29,1,0.002088
55015,Calumet County,,WI,2769,62718,65487,6,8,14,2281,1997,4278,8,0.275222,0.2905,0.619048,0.00028,0.001075,374,0.000187,0,29,0.946429,0.002355
55017,Chippewa County,,WI,3050,76742,79792,6,6,12,1786,1856,3642,7,0.282627,0.298823,2063.304584,0.000047,0.000872,374,0.000246,0,29,0.428571,0.00109
55019,Clark County,,WI,1631,41496,43127,6,6,12,827,1054,1881,8,0.236567,0.247818,38.388906,0.000088,0.000064,374,0.000225,0,29,0.4,0.001239
55021,Columbia County,,WI,3476,72535,76011,7,7,14,2001,2091,4092,8,0.275052,0.290031,70.623632,0.00123,0.000913,47,0.000228,0,29,0.5,0.006616
55023,Crawford County,,WI,702,19320,20022,3,4,7,319,294,613,8,0.241842,0.252605,65.022988,0.00001,0.000052,374,0.000172,0,29,0.166667,0.000445
55025,Dane County,,WI,22337,637073,659410,73,73,146,14120,13475,27595,7,0.36098,0.39775,81355.401124,0.03204,0.04263,47,0.001601,0,29,0.261423,0.201452
55027,Dodge County,,WI,4287,106326,110613,8,8,16,2992,2781,5773,8,0.275137,0.290344,4.581912,0.001544,0.001092,47,0.000212,0,29,0.767857,0.007955
55029,Door County,,WI,1256,37378,38634,5,4,9,405,463,868,8,0.275052,0.289625,677.422811,0.002372,0.00092,374,0.000183,0,29,0.733333,0.013854
55031,Douglas County,,WI,1993,49757,51750,3,4,7,714,826,1540,7,0.282478,0.298123,13571.851003,0.000072,0.000898,374,0.000164,0,29,0.416667,0.000815
55033,Dunn County,,WI,2270,46938,49208,8,7,15,1114,1220,2334,7,0.282627,0.298948,6271.340015,0.001371,0.001139,374,0.000274,0,29,0.517857,0.00855
55035,Eau Claire County,,WI,5065,115470,120535,17,16,33,3097,3026,6123,7,0.284435,0.303496,15807.992486,0.002017,0.002195,374,0.000566,0,29,0.276316,0.012935
55037,Florence County,,WI,232,5365,5597,1,1,2,81,61,142,10,0.167241,0.170772,0,0,0,374,0.000125,0,29,0,0.000129
55039,Fond du Lac County,,WI,4032,126601,130633,12,12,24,2532,2499,5031,7,0.306174,0.326658,2547.408489,0.003185,0.002724,47,0.0003,0,29,0.681818,0.018556
55041,Forest County,,WI,318,10570,10888,0,0,0,0,0,0,0,0,0,0,0,0,373,0.000054,354,486,0,0
55043,Grant County,,WI,2056,57846,59902,7,7,14,969,1074,2043,8,0.266347,0.281108,2590.459175,0.000537,0.000402,47,0.000281,0,29,0.285714,0.003504
55045,Green County,,WI,1705,47610,49315,4,4,8,1151,985,2136,8,0.265499,0.279434,14.281894,0.000536,0.00041,47,0.000156,0,29,0.416667,0.003118
55047,Green Lake County,,WI,1096,23090,24186,4,4,8,574,568,1142,8,0.241361,0.251855,2.95,0.000093,0.000077,374,0.000147,0,29,0.5,0.001036
55049,Iowa County,,WI,1202,29954,31156,5,4,9,773,713,1486,8,0.265525,0.279434,2.290909,0.000502,0.000388,47,0.0002,0,29,0.7,0.003171
55051,Iron County,,WI,346,7145,7491,1,1,2,62,55,117,1,1,1,0,0,0,111,0.000357,108,189,0,0.000118
55053,Jackson County,,WI,974,23040,24014,5,5,10,496,551,1047,8,0.241754,0.252692,31.474401,0.000089,0.000074,374,0.000207,0,29,0.5,0.001188
55055,Jefferson County,,WI,4314,102173,106487,8,8,16,3040,2943,5983,7,0.305788,0.325502,93.080984,0.001548,0.002628,47,0.000208,0,29,0.722222,0.00798
55057,Juneau County,,WI,1526,29617,31143,5,6,11,707,811,1518,8,0.265552,0.279871,7.249761,0.000565,0.000447,47,0.000169,0,29,0.595238,0.00348
55059,Kenosha County,,WI,7975,197962,205937,9,10,19,5049,4841,9890,7,0.315217,0.336781,1.614188,0.004667,0.00546,47,0.000174,0,29,0.9,0.02405
55061,Kewaunee County,,WI,816,25975,26791,2,2,4,496,537,1033,8,0.250752,0.261586,0,0.000103,0.000106,374,0.000119,0,29,1,0.000961
55063,La Crosse County,,WI,4639,135910,140549,17,16,33,2534,2295,4829,7,0.317922,0.341607,19752.61888,0.004108,0.005421,374,0.0005,0,29,0.30117,0.024916
55065,Lafayette County,,WI,846,22019,22865,4,4,8,473,545,1018,8,0.265578,0.279528,3.64057,0.000476,0.000365,47,0.000182,0,29,0.666667,0.002872
55067,Langlade County,,WI,712,23611,24323,2,1,3,139,95,234,8,0.236064,0.24585,0,0.000044,0.000026,374,0.000104,0,29,1,0.000464
55069,Lincoln County,,WI,1187,35085,36272,2,2,4,392,575,967,8,0.236106,0.2461,0,0.000052,0.000039,374,0.000103,0,29,1,0.000502
55071,Manitowoc County,,WI,2617,101484,104101,6,7,13,1205,1321,2526,8,0.275193,0.290312,65.401153,0.001371,0.001028,47,0.000176,0,29,0.952381,0.007165
55073,Marathon County,,WI,4822,171197,176019,15,17,32,2845,2693,5538,7,0.308975,0.332365,18910.142781,0.00237,0.003861,374,0.000491,0,29,0.349265,0.014132
55075,Marinette County,,WI,2030,49426,51456,5,5,10,883,1044,1927,8,0.251059,0.262542,8670.873353,0.000817,0.000116,374,0.00026,0,29,0.4,0.004299
55077,Marquette County,,WI,838,18411,19249,4,5,9,396,451,847,8,0.265446,0.279496,351.530027,0.000475,0.000369,47,0.000156,0,29,0.4,0.002861
55078,Menominee County,,WI,253,4417,4670,1,1,2,124,188,312,9,0.200798,0.2068,0,0.000002,0.000002,374,0.000079,0,29,0,0.000154
55079,Milwaukee County,,WI,37113,1090947,1128060,76,93,169,23338,27988,51326,7,0.377262,0.415964,63767.73896,0.045235,0.065891,47,0.001508,0,29,0.373423,0.285955
55081,Monroe County,,WI,2461,54650,57111,5,6,11,969,1162,2131,8,0.265631,0.280027,281.273907,0.000532,0.00043,374,0.000187,0,29,0.533333,0.003248
55083,Oconto County,,WI,1801,46604,48405,3,5,8,1011,1122,2133,8,0.27457,0.288969,196.874359,0.000097,0.000617,374,0.00015,0,29,0.7,0.001018
55085,Oneida County,,WI,1978,46325,48303,5,6,11,835,752,1587,8,0.27525,0.290312,3927.039537,0.00123,0.000946,47,0.000177,0,29,0.533333,0.006148
55087,Outagamie County,,WI,10890,231273,242163,18,17,35,6888,7017,13905,7,0.317846,0.341669,6274.764255,0.003222,0.005323,374,0.00045,0,29,0.409524,0.019575
55089,Ozaukee County,,WI,4487,114368,118855,6,6,12,2794,2602,5396,7,0.305753,0.32519,0,0.002951,0.002551,47,0.000156,0,29,1,0.016578
55091,Pepin County,,WI,387,8877,9264,0,2,2,0,159,159,8,0.220524,0.228334,0,0,0.000015,374,0.000054,0,487,0,0
55093,Pierce County,,WI,2277,46258,48535,9,8,17,1515,1424,2939,7,0.282478,0.29876,10.693295,0.001736,0.001368,374,0.000287,0,29,0.694444,0.01042
55095,Polk County,,WI,2068,53647,55715,9,9,18,1221,1274,2495,7,0.282597,0.299135,2469.94981,0.001604,0.001305,374,0.000304,0,29,0.569444,0.009808
55097,Portage County,,WI,3167,82635,85802,9,10,19,1346,1577,2923,7,0.283981,0.301903,686.297603,0.001454,0.001875,374,0.000244,0,29,0.711111,0.007902
55099,Price County,,WI,562,17320,17882,1,0,1,82,0,82,0,0,0,0,0,0,374,0.000101,0,12,0,0.000118
55101,Racine County,,WI,8312,237884,246196,9,13,22,5449,4984,10433,7,0.330976,0.355278,238.397874,0.005431,0.006772,47,0.000192,0,29,0.698718,0.031407
55103,Richland County,,WI,863,20077,20940,4,5,9,355,500,855,8,0.265578,0.279684,120.981476,0.000498,0.000389,47,0.000163,0,29,0.55,0.002993
55105,Rock County,,WI,5713,196576,202289,11,9,20,3143,2937,6080,7,0.314957,0.336447,438.528241,0.003459,0.004378,47,0.000234,0,29,0.606061,0.018737
55107,Rusk County,,WI,760,16432,17192,2,3,5,226,325,551,8,0.221576,0.230444,0,0.000019,0.000023,374,0.00012,0,29,1,0.000305
55109,St. Croix County,,WI,4270,109339,113609,10,10,20,2893,2730,5623,7,0.282747,0.299573,2664.601593,0.001857,0.001464,374,0.00032,0,29,0.655556,0.011127
55111,Sauk County,,WI,3231,80808,84039,9,9,18,1848,1723,3571,7,0.305998,0.326002,1387.535206,0.002714,0.002445,47,0.000291,0,29,0.411111,0.01606
55113,Sawyer County,,WI,854,19956,20810,2,2,4,164,158,322,8,0.220423,0.228107,0,0.00001,0.000001,374,0.000124,0,29,1,0.000282
55115,Shawano County,,WI,2091,49397,51488,6,8,14,1008,1375,2383,8,0.251224,0.263523,5523.449694,0.000211,0.000189,374,0.000243,0,29,0.410714,0.00182
55117,Sheboygan County,,WI,3822,147048,150870,12,12,24,2138,2138,4276,7,0.306174,0.326658,436.632224,0.003211,0.002752,47,0.00029,0,29,0.75,0.018703
55119,Taylor County,,WI,738,23822,24560,2,3,5,235,308,543,8,0.236273,0.246631,4.002392,0.000043,0.000027,374,0.00011,0,29,0.666667,0.000458
55121,Trempealeau County,,WI,1726,39636,41362,5,5,10,817,951,1768,8,0.24171,0.252567,51.751341,0.000098,0.000079,374,0.000228,0,29,0.6,0.001225
55123,Vernon County,,WI,1381,35318,36699,4,5,9,623,745,1368,8,0.265631,0.279871,292.511146,0.000068,0.000404,374,0.000171,0,29,0.45,0.000877
55125,Vilas County,,WI,1390,26559,27949,1,3,4,316,472,788,8,0.274938,0.289282,0,0.00001,0.000852,47,0.000079,0,29,1,0.000193
55127,Walworth County,,WI,5493,120177,125670,13,13,26,3665,3634,7299,7,0.315329,0.337343,59.132673,0.005227,0.005601,47,0.000239,0,29,0.736264,0.026365
55129,Washburn County,,WI,989,19765,20754,2,3,5,267,339,606,8,0.221576,0.230444,17.356429,0.00001,0.000023,374,0.000138,0,29,0.666667,0.000282
55131,Washington County,,WI,5637,173734,179371,11,11,22,4481,3812,8293,7,0.305998,0.326252,117.119552,0.003151,0.002713,47,0.000258,0,29,0.727273,0.018187
55133,Waukesha County,,WI,18967,513406,532373,24,29,53,12988,12936,25924,7,0.340567,0.369677,2682.852621,0.01083,0.019345,47,0.00048,0,29,0.465726,0.065632
55135,Waupaca County,,WI,2244,63433,65677,7,8,15,1511,1402,2913,8,0.275279,0.290625,613.897636,0.000948,0.001009,374,0.000209,0,29,0.714286,0.005199
55137,Waushara County,,WI,1292,27858,29150,5,6,11,531,666,1197,8,0.241492,0.252449,8.349206,0.000094,0.000103,374,0.000175,0,29,0.533333,0.001105
55139,Winnebago County,,WI,8534,200018,208552,20,19,39,5475,5956,11431,7,0.317884,0.341982,8438.037251,0.00333,0.005346,374,0.000468,0,29,0.419913,0.020411
55141,Wood County,,WI,2856,92842,95698,7,12,19,1444,1602,3046,8,0.275848,0.29228,847.166413,0.001304,0.001111,374,0.000225,0,29,0.492424,0.006838
56001,Albany County,,WY,2863,34481,37344,8,8,16,772,906,1678,8,0.278642,0.293867,3573.755809,0.001282,0.001821,227,0.000316,0,29,0.281818,0.011271
56003,Big Horn County,,WY,606,13303,13909,1,1,2,120,153,273,9,0.194816,0.200628,0,0.000001,0.000001,169,0.000105,0,29,0,0.000134
56005,Campbell County,,WY,2853,57954,60807,9,6,15,782,572,1354,8,0.249113,0.261046,12831.492342,0.000274,0.000204,227,0.000603,0,29,0.152778,0.002643
56007,Carbon County,,WY,1361,17751,19112,2,1,3,148,103,251,8,0.24722,0.257348,0,0.000029,0.000079,227,0.000108,0,29,0.833333,0.000432
56009,Converse County,,WY,1169,16769,17938,1,1,2,226,255,481,8,0.235232,0.24439,0,0.000072,0.000061,227,0.000083,0,29,0,0.00057
56011,Crook County,,WY,437,8469,8906,1,1,2,127,134,261,9,0.199447,0.20535,0,0.000002,0.000003,227,0.000139,0,29,0,0.000171
56013,Fremont County,,WY,2022,45482,47504,1,4,5,128,390,518,8,0.247725,0.25871,0,0.000072,0.000157,227,0.000083,0,29,0.833333,0.00057
56015,Goshen County,,WY,759,14269,15028,2,2,4,129,203,332,8,0.248394,0.25886,5486,0.000139,0.000079,209,0.000127,0,29,0.5,0.000865
56017,Hot Springs County,,WY,243,5446,5689,0,0,0,0,0,0,0,0,0,0,0,0,375,0.000054,355,488,0,0
56019,Johnson County,,WY,579,10356,10935,1,2,3,114,213,327,9,0.201131,0.20783,0,0.000002,0.000005,169,0.000131,0,29,1,0.000155
56021,Laramie County,,WY,7350,113755,121105,20,16,36,2562,2022,4584,7,0.328329,0.353207,28396.760823,0.007309,0.010618,227,0.000776,0,29,0.378788,0.056367
56023,Lincoln County,,WY,1177,21360,22537,1,1,2,109,66,175,9,0.217441,0.224222,0,0.000012,0.000008,227,0.000095,0,29,0,0.00017
56025,Natrona County,,WY,4940,95527,100467,12,15,27,1395,1493,2888,7,0.30755,0.329273,17227.016685,0.005597,0.006601,227,0.000517,0,29,0.441667,0.041365
56027,Niobrara County,,WY,99,2757,2856,0,0,0,0,0,0,0,0,0,0,0,0,376,0.000054,356,489,0,0
56029,Park County,,WY,1870,35943,37813,3,4,7,303,374,677,8,0.24193,0.253384,8111.899957,0.000076,0.000097,169,0.000243,0,29,0.15,0.000982
56031,Platte County,,WY,584,10561,11145,1,1,2,82,66,148,8,0.247197,0.257286,0,0.000115,0.000079,227,0.000095,0,29,0,0.000738
56033,Sheridan County,,WY,1878,35631,37509,6,4,10,538,401,939,8,0.242303,0.254089,3800.862822,0.000171,0.000145,169,0.000364,0,29,0.266667,0.001995
56035,Sublette County,,WY,788,10880,11668,1,0,1,60,0,60,0,0,0,0,0.000009,0,227,0.000075,0,23,0,0.000181
56037,Sweetwater County,,WY,3123,54442,57565,4,7,11,346,705,1051,8,0.271248,0.287015,3555.222695,0.000803,0.000828,227,0.000176,0,29,0.238095,0.005497
56039,Teton County,,WY,2333,32421,34754,3,4,7,295,458,753,8,0.27783,0.292255,8528.77312,0.000705,0.001145,227,0.000194,0,29,0.2,0.004747
56041,Uinta County,,WY,1245,25362,26607,2,2,4,246,240,486,8,0.270753,0.285465,0,0.000713,0.000675,227,0.000094,0,29,1,0.004691
56043,Washakie County,,WY,392,9991,10383,0,1,1,0,61,61,9,0.19486,0.20074,0,0,0.000001,169,0.000054,0,490,0,0
56045,Weston County,,WY,385,8412,8797,1,1,2,68,53,121,9,0.199447,0.20535,0,0.000002,0.000003,227,0.000139,0,29,0,0.000171
2270,Kusilvak Census Area,,AK,243,7885,8128,2,1,3,150,127,277,8,0.259281,0.272542,0,0.000416,0.000346,11,0.000096,0,29,1,0.002626
46113,Oglala Lakota County,,SD,3158,8944,12102,1,1,2,185,227,412,8,0.247266,0.257348,0,0.000083,0.000062,209,0.000094,0,29,0,0.000569
