id,label,timeset,state,totalMig,totalNonMig,population
1001,Autauga County,,AL,3871,60496,64367
1003,Baldwin County,,AL,9528,221228,230756
1005,Barbour County,,AL,1304,25014,26318
1007,Bibb County,,AL,1030,21040,22070
1009,Blount County,,AL,2911,59765,62676
1011,Bullock County,,AL,577,9587,10164
1013,Butler County,,AL,941,20882,21823
1015,Calhoun County,,AL,5737,122104,127841
1017,Chambers County,,AL,2192,36067,38259
1019,Cherokee County,,AL,1113,24092,25205
1021,Chilton County,,AL,2157,45800,47957
1023,Choctaw County,,AL,546,13608,14154
1025,Clarke County,,AL,1155,26891,28046
1027,Clay County,,AL,677,14625,15302
1029,Cleburne County,,AL,754,15259,16013
1031,Coffee County,,AL,4180,52773,56953
1033,Colbert County,,AL,2963,59882,62845
1035,Conecuh County,,AL,690,12453,13143
1037,Coosa County,,AL,897,9716,10613
1039,Covington County,,AL,1466,38612,40078
1041,Crenshaw County,,AL,800,14507,15307
1043,Cullman County,,AL,3101,87492,90593
1045,Dale County,,AL,5167,49921,55088
1047,Dallas County,,AL,1924,43238,45162
1049,DeKalb County,,AL,3143,72358,75501
1051,Elmore County,,AL,4935,88435,93370
1053,Escambia County,,AL,1664,36959,38623
1055,Etowah County,,AL,4117,108193,112310
1057,Fayette County,,AL,733,16760,17493
1059,Franklin County,,AL,1913,33435,35348
1061,Geneva County,,AL,1449,26169,27618
1063,Greene County,,AL,455,8622,9077
1065,Hale County,,AL,1001,16135,17136
1067,Henry County,,AL,1064,17863,18927
1069,Houston County,,AL,6321,112005,118326
1071,Jackson County,,AL,2205,55266,57471
1073,Jefferson County,,AL,31408,733578,764986
1075,Lamar County,,AL,640,14391,15031
1077,Lauderdale County,,AL,4008,96737,100745
1079,Lawrence County,,AL,1546,35479,37025
1081,Lee County,,AL,9668,150438,160106
1083,Limestone County,,AL,4455,99605,104060
1085,Lowndes County,,AL,860,12222,13082
1087,Macon County,,AL,1278,18445,19723
1089,Madison County,,AL,16821,409037,425858
1091,Marengo County,,AL,1084,21720,22804
1093,Marion County,,AL,1457,28185,29642
1095,Marshall County,,AL,5467,104563,110030
1097,Mobile County,,AL,13955,442718,456673
1099,Monroe County,,AL,885,22005,22890
1101,Montgomery County,,AL,12609,247075,259684
1103,Morgan County,,AL,6372,136584,142956
1105,Perry County,,AL,535,9665,10200
1107,Pickens County,,AL,839,19642,20481
1109,Pike County,,AL,1899,30554,32453
1111,Randolph County,,AL,893,23083,23976
1113,Russell County,,AL,6925,57608,64533
1115,St. Clair County,,AL,4660,91053,95713
1117,Shelby County,,AL,13155,235435,248590
1119,Sumter County,,AL,712,12591,13303
1121,Talladega County,,AL,4017,83216,87233
1123,Tallapoosa County,,AL,2496,43698,46194
1125,Tuscaloosa County,,AL,9246,201864,211110
1127,Walker County,,AL,2225,67019,69244
1129,Washington County,,AL,793,17678,18471
1131,Wilcox County,,AL,545,11517,12062
1133,Winston County,,AL,1387,23401,24788
2013,Aleutians East Borough,,AK,324,1914,2238
2016,Aleutians West Census Area,,AK,647,4932,5579
2020,Anchorage Municipality,,AK,24250,348681,372931
2050,Bethel Census Area,,AK,754,17679,18433
2060,Bristol Bay Borough,,AK,133,977,1110
2068,Denali Borough,,AK,252,2483,2735
2070,Dillingham Census Area,,AK,274,5364,5638
2090,Fairbanks North Star Borough,,AK,9245,109083,118328
2100,Haines Borough,,AK,158,2882,3040
2105,Hoonah-Angoon Census Area,,AK,93,2341,2434
2110,Juneau City and Borough,,AK,2026,38665,40691
2122,Kenai Peninsula Borough,,AK,3550,66897,70447
2130,Ketchikan Gateway Borough,,AK,1014,16237,17251
2150,Kodiak Island Borough,,AK,1454,16930,18384
2164,Lake and Peninsula Borough,,AK,134,1594,1728
2170,Matanuska-Susitna Borough,,AK,6034,106646,112680
2180,Nome Census Area,,AK,384,9428,9812
2185,North Slope Borough,,AK,439,7399,7838
2188,Northwest Arctic Borough,,AK,374,6615,6989
2195,Petersburg Census Area,,AK,257,4373,4630
2198,Prince of Wales-Hyder Census Area,,AK,339,5272,5611
2220,Sitka City and Borough,,AK,629,10411,11040
2230,Skagway Municipality,,AK,104,1467,1571
2240,Southeast Fairbanks Census Area,,AK,465,8321,8786
2261,Valdez-Cordova Census Area,,AK,845,11302,12147
2275,Wrangell City and Borough,,AK,-2,2413,2411
2282,Yakutat City and Borough,,AK,-2,579,577
2290,Yukon-Koyukuk Census Area,,AK,269,5801,6070
4001,Apache County,,AZ,6471,63179,69650
4003,Cochise County,,AZ,8909,134269,143178
4005,Coconino County,,AZ,10126,137331,147457
4007,Gila County,,AZ,2762,53648,56410
4009,Graham County,,AZ,1648,32120,33768
4011,Greenlee County,,AZ,562,9227,9789
4012,La Paz County,,AZ,1352,15846,17198
4013,Maricopa County,,AZ,135845,4492528,4628373
4015,Mohave County,,AZ,10547,188664,199211
4017,Navajo County,,AZ,7304,100976,108280
4019,Pima County,,AZ,36870,1077575,1114445
4021,Pinal County,,AZ,25106,344218,369324
4023,Santa Cruz County,,AZ,2707,55274,57981
4025,Yavapai County,,AZ,11582,239302,250884
4027,Yuma County,,AZ,11743,228107,239850
5001,Arkansas County,,AR,849,20335,21184
5003,Ashley County,,AR,833,22096,22929
5005,Baxter County,,AR,1817,43639,45456
5007,Benton County,,AR,13626,277045,290671
5009,Boone County,,AR,1913,39255,41168
5011,Bradley County,,AR,505,11314,11819
5013,Calhoun County,,AR,218,4938,5156
5015,Carroll County,,AR,1638,30358,31996
5017,Chicot County,,AR,602,10511,11113
5019,Clark County,,AR,1123,20595,21718
5021,Clay County,,AR,821,15300,16121
5023,Cleburne County,,AR,1723,26722,28445
5025,Cleveland County,,AR,344,8434,8778
5027,Columbia County,,AR,1069,23310,24379
5029,Conway County,,AR,1060,21721,22781
5031,Craighead County,,AR,5094,104849,109943
5033,Crawford County,,AR,3435,61970,65405
5035,Crittenden County,,AR,3332,53833,57165
5037,Cross County,,AR,997,18939,19936
5039,Dallas County,,AR,468,7367,7835
5041,Desha County,,AR,735,12802,13537
5043,Drew County,,AR,925,18455,19380
5045,Faulkner County,,AR,7487,122324,129811
5047,Franklin County,,AR,937,17556,18493
5049,Fulton County,,AR,686,11121,11807
5051,Garland County,,AR,5223,105282,110505
5053,Grant County,,AR,1003,19148,20151
5055,Greene County,,AR,2321,44541,46862
5057,Hempstead County,,AR,1133,22676,23809
5059,Hot Spring County,,AR,1734,31814,33548
5061,Howard County,,AR,893,14163,15056
5063,Independence County,,AR,1886,38787,40673
5065,Izard County,,AR,714,11758,12472
5067,Jackson County,,AR,835,14710,15545
5069,Jefferson County,,AR,3919,75212,79131
5071,Johnson County,,AR,1204,25734,26938
5073,Lafayette County,,AR,370,6664,7034
5075,Lawrence County,,AR,1025,15916,16941
5077,Lee County,,AR,500,7613,8113
5079,Lincoln County,,AR,659,10729,11388
5081,Little River County,,AR,694,12466,13160
5083,Logan County,,AR,956,22138,23094
5085,Lonoke County,,AR,5273,77433,82706
5087,Madison County,,AR,887,16385,17272
5089,Marion County,,AR,1053,15640,16693
5091,Miller County,,AR,3204,43032,46236
5093,Mississippi County,,AR,2351,45117,47468
5095,Monroe County,,AR,548,7696,8244
5097,Montgomery County,,AR,453,8027,8480
5099,Nevada County,,AR,539,8667,9206
5101,Newton County,,AR,335,7624,7959
5103,Ouachita County,,AR,1125,24739,25864
5105,Perry County,,AR,584,10283,10867
5107,Phillips County,,AR,1131,19241,20372
5109,Pike County,,AR,627,10661,11288
5111,Poinsett County,,AR,1249,23164,24413
5113,Polk County,,AR,762,20297,21059
5115,Pope County,,AR,3029,64675,67704
5117,Prairie County,,AR,328,8445,8773
5119,Pulaski County,,AR,25914,438932,464846
5121,Randolph County,,AR,770,17517,18287
5123,St. Francis County,,AR,1554,22857,24411
5125,Saline County,,AR,6528,127899,134427
5127,Scott County,,AR,597,10673,11270
5129,Searcy County,,AR,511,7480,7991
5131,Sebastian County,,AR,7315,134545,141860
5133,Sevier County,,AR,775,16889,17664
5135,Sharp County,,AR,1070,15854,16924
5137,Stone County,,AR,491,12024,12515
5139,Union County,,AR,1741,45369,47110
5141,Van Buren County,,AR,947,16587,17534
5143,Washington County,,AR,12575,229866,242441
5145,White County,,AR,3932,79536,83468
5147,Woodruff County,,AR,392,6701,7093
5149,Yell County,,AR,1489,21836,23325
6001,Alameda County,,CA,86765,1874582,1961347
6003,Alpine County,,CA,-2,984,982
6005,Amador County,,CA,1667,39342,41009
6007,Butte County,,CA,8227,221842,230069
6009,Calaveras County,,CA,2438,47777,50215
6011,Colusa County,,CA,1075,28240,29315
6013,Contra Costa County,,CA,53668,1336067,1389735
6015,Del Norte County,,CA,1244,23390,24634
6017,El Dorado County,,CA,10449,213266,223715
6019,Fresno County,,CA,30565,1053623,1084188
6021,Glenn County,,CA,1480,32397,33877
6023,Humboldt County,,CA,4786,131810,136596
6025,Imperial County,,CA,9954,220771,230725
6027,Inyo County,,CA,1026,20290,21316
6029,Kern County,,CA,29093,931805,960898
6031,Kings County,,CA,8394,150626,159020
6033,Lake County,,CA,2897,60181,63078
6035,Lassen County,,CA,1321,24532,25853
6037,Los Angeles County,,CA,311796,11438056,11749852
6039,Madera County,,CA,7003,164575,171578
6041,Marin County,,CA,14086,315100,329186
6043,Mariposa County,,CA,1161,18085,19246
6045,Mendocino County,,CA,3481,94559,98040
6047,Merced County,,CA,11160,280846,292006
6049,Modoc County,,CA,435,8466,8901
6051,Mono County,,CA,1164,15208,16372
6053,Monterey County,,CA,22246,540032,562278
6055,Napa County,,CA,7368,174248,181616
6057,Nevada County,,CA,5783,114557,120340
6059,Orange County,,CA,134072,3769556,3903628
6061,Placer County,,CA,21876,437890,459766
6063,Plumas County,,CA,1087,20346,21433
6065,Riverside County,,CA,107200,2489652,2596852
6067,Sacramento County,,CA,58573,1659834,1718407
6069,San Benito County,,CA,3544,70935,74479
6071,San Bernardino County,,CA,109296,2269673,2378969
6073,San Diego County,,CA,139371,3830135,3969506
6075,San Francisco County,,CA,62489,1000709,1063198
6077,San Joaquin County,,CA,28337,800195,828532
6079,San Luis Obispo County,,CA,11998,313006,325004
6081,San Mateo County,,CA,47035,936652,983687
6083,Santa Barbara County,,CA,18951,511668,530619
6085,Santa Clara County,,CA,91113,2324329,2415442
6087,Santa Cruz County,,CA,13158,320407,333565
6089,Shasta County,,CA,7824,186654,194478
6091,Sierra County,,CA,178,2938,3116
6093,Siskiyou County,,CA,1986,45610,47596
6095,Solano County,,CA,23805,494812,518617
6097,Sonoma County,,CA,17806,601846,619652
6099,Stanislaus County,,CA,19850,586129,605979
6101,Sutter County,,CA,5464,105472,110936
6103,Tehama County,,CA,3163,63417,66580
6105,Trinity County,,CA,567,11029,11596
6107,Tulare County,,CA,15040,500327,515367
6109,Tuolumne County,,CA,2342,56285,58627
6111,Ventura County,,CA,37071,1049812,1086883
6113,Yolo County,,CA,11580,217345,228925
6115,Yuba County,,CA,5993,72640,78633
8001,Adams County,,CO,41200,543267,584467
8003,Alamosa County,,CO,1108,15716,16824
8005,Arapahoe County,,CO,57672,713670,771342
8007,Archuleta County,,CO,830,13625,14455
8009,Baca County,,CO,74,3938,4012
8011,Bent County,,CO,131,4017,4148
8013,Boulder County,,CO,21335,357572,378907
8014,Broomfield County,,CO,7002,72129,79131
8015,Chaffee County,,CO,1086,20288,21374
8017,Cheyenne County,,CO,75,2115,2190
8019,Clear Creek County,,CO,827,10076,10903
8021,Conejos County,,CO,467,8000,8467
8023,Costilla County,,CO,129,3134,3263
8025,Crowley County,,CO,168,2759,2927
8027,Custer County,,CO,213,4522,4735
8029,Delta County,,CO,1771,32050,33821
8031,Denver County,,CO,70658,730427,801085
8033,Dolores County,,CO,67,1950,2017
8035,Douglas County,,CO,23086,379904,402990
8037,Eagle County,,CO,4476,64542,69018
8039,Elbert County,,CO,2016,27747,29763
8041,El Paso County,,CO,46051,753368,799419
8043,Fremont County,,CO,2088,41855,43943
8045,Garfield County,,CO,3675,65031,68706
8047,Gilpin County,,CO,526,5732,6258
8049,Grand County,,CO,1445,15604,17049
8051,Gunnison County,,CO,1138,16655,17793
8053,Hinsdale County,,CO,79,852,931
8055,Huerfano County,,CO,292,6075,6367
8057,Jackson County,,CO,147,1517,1664
8059,Jefferson County,,CO,43349,666546,709895
8061,Kiowa County,,CO,64,1505,1569
8063,Kit Carson County,,CO,428,8453,8881
8065,Lake County,,CO,606,7231,7837
8067,La Plata County,,CO,3529,60215,63744
8069,Larimer County,,CO,18649,372403,391052
8071,Las Animas County,,CO,748,14119,14867
8073,Lincoln County,,CO,295,5067,5362
8075,Logan County,,CO,1034,20846,21880
8077,Mesa County,,CO,6872,165464,172336
8079,Mineral County,,CO,-2,938,936
8081,Moffat County,,CO,847,14365,15212
8083,Montezuma County,,CO,1637,27485,29122
8085,Montrose County,,CO,2165,45404,47569
8087,Morgan County,,CO,1866,32849,34715
8089,Otero County,,CO,899,19270,20169
8091,Ouray County,,CO,443,5509,5952
8093,Park County,,CO,1350,15982,17332
8095,Phillips County,,CO,379,5125,5504
8097,Pitkin County,,CO,1896,20555,22451
8099,Prowers County,,CO,600,12600,13200
8101,Pueblo County,,CO,6024,169978,176002
8103,Rio Blanco County,,CO,417,7314,7731
8105,Rio Grande County,,CO,923,14549,15472
8107,Routt County,,CO,1849,28404,30253
8109,Saguache County,,CO,334,4059,4393
8111,San Juan County,,CO,-2,695,693
8113,San Miguel County,,CO,739,8892,9631
8115,Sedgwick County,,CO,68,2615,2683
8117,Summit County,,CO,3292,35472,38764
8119,Teller County,,CO,2072,26777,28849
8121,Washington County,,CO,186,5058,5244
8123,Weld County,,CO,18024,310868,328892
8125,Yuma County,,CO,484,11690,12174
9001,Fairfield County,,CT,40738,1110976,1151714
9003,Hartford County,,CT,34337,1075964,1110301
9005,Litchfield County,,CT,8505,227652,236157
9007,Middlesex County,,CT,8688,198388,207076
9009,New Haven County,,CT,33577,990412,1023989
9011,New London County,,CT,13515,321274,334789
9013,Tolland County,,CT,7628,166486,174114
9015,Windham County,,CT,4887,132488,137375
10001,Kent County,,DE,8676,190529,199205
10003,New Castle County,,DE,21682,637809,659491
10005,Sussex County,,DE,8914,241035,249949
11001,District of Columbia,,DC,53302,682329,735631
12001,Alachua County,,FL,15445,248642,264087
12003,Baker County,,FL,1193,26250,27443
12005,Bay County,,FL,11937,199190,211127
12007,Bradford County,,FL,1624,23864,25488
12009,Brevard County,,FL,23890,639912,663802
12011,Broward County,,FL,105571,2114081,2219652
12013,Calhoun County,,FL,747,12028,12775
12015,Charlotte County,,FL,10160,177314,187474
12017,Citrus County,,FL,8063,147850,155913
12019,Clay County,,FL,15204,228877,244081
12021,Collier County,,FL,19814,408839,428653
12023,Columbia County,,FL,3848,64880,68728
12027,DeSoto County,,FL,1658,29540,31198
12029,Dixie County,,FL,703,12351,13054
12031,Duval County,,FL,51741,1018081,1069822
12033,Escambia County,,FL,21969,327942,349911
12035,Flagler County,,FL,6685,114725,121410
12037,Franklin County,,FL,511,10160,10671
12039,Gadsden County,,FL,2833,49105,51938
12041,Gilchrist County,,FL,1001,15838,16839
12043,Glades County,,FL,781,8645,9426
12045,Gulf County,,FL,727,13220,13947
12047,Hamilton County,,FL,820,11576,12396
12049,Hardee County,,FL,1539,26380,27919
12051,Hendry County,,FL,3027,39403,42430
12053,Hernando County,,FL,9726,180399,190125
12055,Highlands County,,FL,4740,97950,102690
12057,Hillsborough County,,FL,72183,1458808,1530991
12059,Holmes County,,FL,1223,16635,17858
12061,Indian River County,,FL,7847,165517,173364
12063,Jackson County,,FL,2227,45341,47568
12065,Jefferson County,,FL,664,14206,14870
12067,Lafayette County,,FL,386,6376,6762
12069,Lake County,,FL,21083,356226,377309
12071,Lee County,,FL,32695,745272,777967
12073,Leon County,,FL,16861,280607,297468
12075,Levy County,,FL,2701,39500,42201
12077,Liberty County,,FL,288,6724,7012
12079,Madison County,,FL,839,17809,18648
12081,Manatee County,,FL,19464,387340,406804
12083,Marion County,,FL,16528,363219,379747
12085,Martin County,,FL,9931,171482,181413
12086,Miami-Dade County,,FL,114444,2925547,3039991
12087,Monroe County,,FL,7606,93442,101048
12089,Nassau County,,FL,4890,90189,95079
12091,Okaloosa County,,FL,17450,231404,248854
12093,Okeechobee County,,FL,2073,36715,38788
12095,Orange County,,FL,90998,1388767,1479765
12097,Osceola County,,FL,28820,340086,368906
12099,Palm Beach County,,FL,67527,1591185,1658712
12101,Pasco County,,FL,29219,512194,541413
12103,Pinellas County,,FL,46606,1043681,1090287
12105,Polk County,,FL,32950,674126,707076
12107,Putnam County,,FL,3923,68241,72164
12109,St. Johns County,,FL,13705,254271,267976
12111,St. Lucie County,,FL,16967,316926,333893
12113,Santa Rosa County,,FL,11407,177084,188491
12115,Sarasota County,,FL,23534,453235,476769
12117,Seminole County,,FL,34938,501048,535986
12119,Sumter County,,FL,6071,122537,128608
12121,Suwannee County,,FL,2495,39749,42244
12123,Taylor County,,FL,769,20175,20944
12125,Union County,,FL,734,11376,12110
12127,Volusia County,,FL,25443,554420,579863
12129,Wakulla County,,FL,1668,31462,33130
12131,Walton County,,FL,4695,64497,69192
12133,Washington County,,FL,1419,22165,23584
13001,Appling County,,GA,829,18534,19363
13003,Atkinson County,,GA,516,8289,8805
13005,Bacon County,,GA,564,10872,11436
13007,Baker County,,GA,170,2973,3143
13009,Baldwin County,,GA,2424,40939,43363
13011,Banks County,,GA,1361,17746,19107
13013,Barrow County,,GA,5184,80134,85318
13015,Bartow County,,GA,5905,109319,115224
13017,Ben Hill County,,GA,1054,17249,18303
13019,Berrien County,,GA,1277,17053,18330
13021,Bibb County,,GA,8890,162682,171572
13023,Bleckley County,,GA,625,12293,12918
13025,Brantley County,,GA,908,16636,17544
13027,Brooks County,,GA,1158,15462,16620
13029,Bryan County,,GA,3631,41107,44738
13031,Bulloch County,,GA,4317,61242,65559
13033,Burke County,,GA,1505,23564,25069
13035,Butts County,,GA,1641,22999,24640
13037,Calhoun County,,GA,275,5028,5303
13039,Camden County,,GA,4664,53948,58612
13043,Candler County,,GA,617,10482,11099
13045,Carroll County,,GA,7136,118455,125591
13047,Catoosa County,,GA,4320,66868,71188
13049,Charlton County,,GA,641,8849,9490
13051,Chatham County,,GA,19391,293074,312465
13053,Chattahoochee County,,GA,3191,6571,9762
13055,Chattooga County,,GA,1073,24002,25075
13057,Cherokee County,,GA,14234,266946,281180
13059,Clarke County,,GA,8567,101882,110449
13061,Clay County,,GA,230,3016,3246
13063,Clayton County,,GA,31394,281475,312869
13065,Clinch County,,GA,223,6730,6953
13067,Cobb County,,GA,59681,829444,889125
13069,Coffee County,,GA,1720,41470,43190
13071,Colquitt County,,GA,2256,46344,48600
13073,Columbia County,,GA,9837,156855,166692
13075,Cook County,,GA,1118,16496,17614
13077,Coweta County,,GA,9495,158361,167856
13079,Crawford County,,GA,850,12619,13469
13081,Crisp County,,GA,1247,21115,22362
13083,Dade County,,GA,839,15203,16042
13085,Dawson County,,GA,1661,23939,25600
13087,Decatur County,,GA,1372,28952,30324
13089,DeKalb County,,GA,74855,770416,845271
13091,Dodge County,,GA,912,18845,19757
13093,Dooly County,,GA,679,10241,10920
13095,Dougherty County,,GA,6619,92374,98993
13097,Douglas County,,GA,12851,146466,159317
13099,Early County,,GA,512,11073,11585
13101,Echols County,,GA,234,3661,3895
13103,Effingham County,,GA,3520,61710,65230
13105,Elbert County,,GA,873,21218,22091
13107,Emanuel County,,GA,1186,23259,24445
13109,Evans County,,GA,808,10786,11594
13111,Fannin County,,GA,1064,24180,25244
13113,Fayette County,,GA,10254,131152,141406
13115,Floyd County,,GA,4533,102485,107018
13117,Forsyth County,,GA,11867,239737,251604
13119,Franklin County,,GA,1638,22714,24352
13121,Fulton County,,GA,100405,1015491,1115896
13123,Gilmer County,,GA,1564,29948,31512
13125,Glascock County,,GA,125,2817,2942
13127,Glynn County,,GA,4664,88199,92863
13129,Gordon County,,GA,2991,60296,63287
13131,Grady County,,GA,1375,26553,27928
13133,Greene County,,GA,1063,18243,19306
13135,Gwinnett County,,GA,66611,998635,1065246
13137,Habersham County,,GA,2248,45580,47828
13139,Hall County,,GA,10790,218742,229532
13141,Hancock County,,GA,374,7608,7982
13143,Haralson County,,GA,1713,28470,30183
13145,Harris County,,GA,2164,35593,37757
13147,Hart County,,GA,1291,26053,27344
13149,Heard County,,GA,781,10513,11294
13151,Henry County,,GA,17469,235483,252952
13153,Houston County,,GA,10622,171910,182532
13155,Irwin County,,GA,631,9067,9698
13157,Jackson County,,GA,4475,69532,74007
13159,Jasper County,,GA,915,14069,14984
13161,Jeff Davis County,,GA,796,14853,15649
13163,Jefferson County,,GA,932,18007,18939
13165,Jenkins County,,GA,531,7702,8233
13167,Johnson County,,GA,384,7694,8078
13169,Jones County,,GA,1733,30258,31991
13171,Lamar County,,GA,1174,17438,18612
13173,Lanier County,,GA,907,8302,9209
13175,Laurens County,,GA,2187,51701,53888
13177,Lee County,,GA,2245,34947,37192
13179,Liberty County,,GA,12441,63317,75758
13181,Lincoln County,,GA,392,7844,8236
13183,Long County,,GA,1863,12857,14720
13185,Lowndes County,,GA,8215,109759,117974
13187,Lumpkin County,,GA,1923,28079,30002
13189,McDuffie County,,GA,1241,23760,25001
13191,McIntosh County,,GA,847,11555,12402
13193,Macon County,,GA,781,11557,12338
13195,Madison County,,GA,1721,29787,31508
13197,Marion County,,GA,487,7300,7787
13199,Meriwether County,,GA,1760,21985,23745
13201,Miller County,,GA,426,5713,6139
13205,Mitchell County,,GA,1375,22024,23399
13207,Monroe County,,GA,1668,28469,30137
13209,Montgomery County,,GA,628,7812,8440
13211,Morgan County,,GA,1078,20648,21726
13213,Murray County,,GA,2353,40147,42500
13215,Muscogee County,,GA,17973,212014,229987
13217,Newton County,,GA,8209,109728,117937
13219,Oconee County,,GA,2490,41041,43531
13221,Oglethorpe County,,GA,843,14581,15424
13223,Paulding County,,GA,11073,161122,172195
13225,Peach County,,GA,2450,27395,29845
13227,Pickens County,,GA,1878,34526,36404
13229,Pierce County,,GA,1169,19637,20806
13231,Pike County,,GA,1161,19355,20516
13233,Polk County,,GA,2174,42805,44979
13235,Pulaski County,,GA,605,9179,9784
13237,Putnam County,,GA,1324,22341,23665
13239,Quitman County,,GA,118,2020,2138
13241,Rabun County,,GA,698,17691,18389
13243,Randolph County,,GA,382,6815,7197
13245,Richmond County,,GA,16398,201521,217919
13247,Rockdale County,,GA,8564,91523,100087
13249,Schley County,,GA,217,4690,4907
13251,Screven County,,GA,704,14045,14749
13253,Seminole County,,GA,558,8812,9370
13255,Spalding County,,GA,4481,65368,69849
13257,Stephens County,,GA,1216,25570,26786
13259,Stewart County,,GA,235,4128,4363
13261,Sumter County,,GA,1680,31839,33519
13263,Talbot County,,GA,528,6446,6974
13265,Taliaferro County,,GA,85,1555,1640
13267,Tattnall County,,GA,1296,20525,21821
13269,Taylor County,,GA,463,8341,8804
13271,Telfair County,,GA,709,10158,10867
13273,Terrell County,,GA,696,10093,10789
13275,Thomas County,,GA,2479,47954,50433
13277,Tift County,,GA,2645,43034,45679
13279,Toombs County,,GA,1544,28630,30174
13281,Towns County,,GA,724,11561,12285
13283,Treutlen County,,GA,261,6248,6509
13285,Troup County,,GA,4331,74974,79305
13287,Turner County,,GA,494,8863,9357
13289,Twiggs County,,GA,789,8835,9624
13291,Union County,,GA,1186,23043,24229
13293,Upson County,,GA,1042,26804,27846
13295,Walker County,,GA,4006,64576,68582
13297,Walton County,,GA,5316,94939,100255
13299,Ware County,,GA,2008,34245,36253
13301,Warren County,,GA,322,5625,5947
13303,Washington County,,GA,638,20921,21559
13305,Wayne County,,GA,1231,28478,29709
13307,Webster County,,GA,147,2400,2547
13309,Wheeler County,,GA,309,4613,4922
13311,White County,,GA,1612,27130,28742
13313,Whitfield County,,GA,5245,116165,121410
13315,Wilcox County,,GA,445,7134,7579
13317,Wilkes County,,GA,398,10565,10963
13319,Wilkinson County,,GA,601,10253,10854
13321,Worth County,,GA,1463,21577,23040
15001,Hawaii County,,HI,7475,206555,214030
15003,Honolulu County,,HI,51383,1172573,1223956
15005,Kalawao County,,HI,0,0,0
15007,Kauai County,,HI,2965,83281,86246
15009,Maui County,,HI,6918,187807,194725
16001,Ada County,,ID,21125,491251,512376
16003,Adams County,,ID,274,3994,4268
16005,Bannock County,,ID,4192,88363,92555
16007,Bear Lake County,,ID,284,6854,7138
16009,Benewah County,,ID,521,9716,10237
16011,Bingham County,,ID,2883,51991,54874
16013,Blaine County,,ID,1183,28476,29659
16015,Boise County,,ID,403,7169,7572
16017,Bonner County,,ID,2449,45431,47880
16019,Bonneville County,,ID,5759,126325,132084
16021,Boundary County,,ID,521,12484,13005
16023,Butte County,,ID,151,2703,2854
16025,Camas County,,ID,-2,1106,1104
16027,Canyon County,,ID,11200,219288,230488
16029,Caribou County,,ID,419,7847,8266
16031,Cassia County,,ID,1739,27327,29066
16033,Clark County,,ID,-2,956,954
16035,Clearwater County,,ID,400,8529,8929
16037,Custer County,,ID,349,4635,4984
16039,Elmore County,,ID,2786,28386,31172
16041,Franklin County,,ID,613,15115,15728
16043,Fremont County,,ID,844,14728,15572
16045,Gem County,,ID,1152,18396,19548
16047,Gooding County,,ID,1058,17524,18582
16049,Idaho County,,ID,679,16172,16851
16051,Jefferson County,,ID,1842,30841,32683
16053,Jerome County,,ID,1979,26528,28507
16055,Kootenai County,,ID,7634,171936,179570
16057,Latah County,,ID,2382,36948,39330
16059,Lemhi County,,ID,360,8533,8893
16061,Lewis County,,ID,415,4355,4770
16063,Lincoln County,,ID,441,5617,6058
16065,Madison County,,ID,4132,32018,36150
16067,Minidoka County,,ID,1483,24133,25616
16069,Nez Perce County,,ID,2284,44384,46668
16071,Oneida County,,ID,205,4780,4985
16073,Owyhee County,,ID,945,12096,13041
16075,Payette County,,ID,1710,25433,27143
16077,Power County,,ID,544,9078,9622
16079,Shoshone County,,ID,624,12631,13255
16081,Teton County,,ID,735,11547,12282
16083,Twin Falls County,,ID,4828,92485,97313
16085,Valley County,,ID,750,11504,12254
16087,Washington County,,ID,613,10687,11300
17001,Adams County,,IL,2044,81283,83327
17003,Alexander County,,IL,532,6713,7245
17005,Bond County,,IL,800,17677,18477
17007,Boone County,,IL,3462,67407,70869
17009,Brown County,,IL,220,5831,6051
17011,Bureau County,,IL,1652,42053,43705
17013,Calhoun County,,IL,147,5773,5920
17015,Carroll County,,IL,751,18857,19608
17017,Cass County,,IL,768,16372,17140
17019,Champaign County,,IL,9214,207040,216254
17021,Christian County,,IL,1359,39209,40568
17023,Clark County,,IL,642,19290,19932
17025,Clay County,,IL,520,16110,16630
17027,Clinton County,,IL,1586,44416,46002
17029,Coles County,,IL,2296,51696,53992
17031,Cook County,,IL,202036,6288416,6490452
17033,Crawford County,,IL,592,22635,23227
17035,Cumberland County,,IL,561,12772,13333
17037,DeKalb County,,IL,5979,114020,119999
17039,De Witt County,,IL,695,19468,20163
17041,Douglas County,,IL,1201,25923,27124
17043,DuPage County,,IL,57446,1194209,1251655
17045,Edgar County,,IL,751,20598,21349
17047,Edwards County,,IL,335,7697,8032
17049,Effingham County,,IL,1406,44351,45757
17051,Fayette County,,IL,855,23760,24615
17053,Ford County,,IL,690,16553,17243
17055,Franklin County,,IL,1621,42800,44421
17057,Fulton County,,IL,1344,40341,41685
17059,Gallatin County,,IL,196,5891,6087
17061,Greene County,,IL,611,15038,15649
17063,Grundy County,,IL,2942,63281,66223
17065,Hamilton County,,IL,476,9394,9870
17067,Hancock County,,IL,948,22245,23193
17069,Hardin County,,IL,153,4078,4231
17071,Henderson County,,IL,339,8283,8622
17073,Henry County,,IL,2268,62326,64594
17075,Iroquois County,,IL,1327,35463,36790
17077,Jackson County,,IL,3750,53821,57571
17079,Jasper County,,IL,352,12214,12566
17081,Jefferson County,,IL,1759,42586,44345
17083,Jersey County,,IL,1066,25721,26787
17085,Jo Daviess County,,IL,1058,29191,30249
17087,Johnson County,,IL,570,12808,13378
17089,Kane County,,IL,29035,648178,677213
17091,Kankakee County,,IL,4401,130228,134629
17093,Kendall County,,IL,8102,149569,157671
17095,Knox County,,IL,2022,57848,59870
17097,Lake County,,IL,35767,891533,927300
17099,LaSalle County,,IL,4742,135596,140338
17101,Lawrence County,,IL,612,16291,16903
17103,Lee County,,IL,1687,40535,42222
17105,Livingston County,,IL,1592,43203,44795
17107,Logan County,,IL,1272,31507,32779
17109,McDonough County,,IL,1445,30037,31482
17111,McHenry County,,IL,15067,396819,411886
17113,McLean County,,IL,8192,196962,205154
17115,Macon County,,IL,3913,123876,127789
17117,Macoupin County,,IL,2220,53532,55752
17119,Madison County,,IL,11468,311284,322752
17121,Marion County,,IL,1656,45103,46759
17123,Marshall County,,IL,678,14912,15590
17125,Mason County,,IL,712,16219,16931
17127,Massac County,,IL,589,16560,17149
17129,Menard County,,IL,676,15583,16259
17131,Mercer County,,IL,806,20198,21004
17133,Monroe County,,IL,1542,43040,44582
17135,Montgomery County,,IL,1037,32585,33622
17137,Morgan County,,IL,1482,38962,40444
17139,Moultrie County,,IL,773,17439,18212
17141,Ogle County,,IL,2615,65098,67713
17143,Peoria County,,IL,9422,223080,232502
17145,Perry County,,IL,841,22521,23362
17147,Piatt County,,IL,875,20441,21316
17149,Pike County,,IL,484,18068,18552
17151,Pope County,,IL,110,4181,4291
17153,Pulaski County,,IL,316,6216,6532
17155,Putnam County,,IL,313,7281,7594
17157,Randolph County,,IL,1392,35199,36591
17159,Richland County,,IL,692,19157,19849
17161,Rock Island County,,IL,7043,176910,183953
17163,St. Clair County,,IL,13448,300373,313821
17165,Saline County,,IL,872,27016,27888
17167,Sangamon County,,IL,7611,246618,254229
17169,Schuyler County,,IL,450,7997,8447
17171,Scott County,,IL,215,6235,6450
17173,Shelby County,,IL,1151,26120,27271
17175,Stark County,,IL,301,6861,7162
17177,Stephenson County,,IL,1967,55982,57949
17179,Tazewell County,,IL,6220,164898,171118
17181,Union County,,IL,686,19868,20554
17183,Vermilion County,,IL,2798,87539,90337
17185,Wabash County,,IL,460,13760,14220
17187,Warren County,,IL,943,20525,21468
17189,Washington County,,IL,847,17892,18739
17191,Wayne County,,IL,582,19766,20348
17193,White County,,IL,598,16696,17294
17195,Whiteside County,,IL,2004,71251,73255
17197,Will County,,IL,35154,852306,887460
17199,Williamson County,,IL,3317,75054,78371
17201,Winnebago County,,IL,11147,344867,356014
17203,Woodford County,,IL,1933,48342,50275
18001,Adams County,,IN,1098,42929,44027
18003,Allen County,,IN,12475,442923,455398
18005,Bartholomew County,,IN,4272,101004,105276
18007,Benton County,,IN,561,10352,10913
18009,Blackford County,,IN,559,14554,15113
18011,Boone County,,IN,3543,76762,80305
18013,Brown County,,IN,1055,18276,19331
18015,Carroll County,,IN,1134,24339,25473
18017,Cass County,,IN,2107,47232,49339
18019,Clark County,,IN,7022,136522,143544
18021,Clay County,,IN,1303,30714,32017
18023,Clinton County,,IN,1599,40245,41844
18025,Crawford County,,IN,563,11829,12392
18027,Daviess County,,IN,1126,38944,40070
18029,Dearborn County,,IN,2478,61727,64205
18031,Decatur County,,IN,1478,32597,34075
18033,DeKalb County,,IN,2346,51118,53464
18035,Delaware County,,IN,5082,117432,122514
18037,Dubois County,,IN,1661,55641,57302
18039,Elkhart County,,IN,8336,251136,259472
18041,Fayette County,,IN,981,25440,26421
18043,Floyd County,,IN,5083,90814,95897
18045,Fountain County,,IN,1080,20110,21190
18047,Franklin County,,IN,1192,28364,29556
18049,Fulton County,,IN,1168,24847,26015
18051,Gibson County,,IN,1544,40505,42049
18053,Grant County,,IN,2867,74355,77222
18055,Greene County,,IN,1540,36736,38276
18057,Hamilton County,,IN,16782,377720,394502
18059,Hancock County,,IN,4381,87721,92102
18061,Harrison County,,IN,1828,46684,48512
18063,Hendricks County,,IN,10362,189977,200339
18065,Henry County,,IN,2359,54630,56989
18067,Howard County,,IN,3359,99424,102783
18069,Huntington County,,IN,1613,44860,46473
18071,Jackson County,,IN,2507,56938,59445
18073,Jasper County,,IN,1719,40139,41858
18075,Jay County,,IN,942,25328,26270
18077,Jefferson County,,IN,1452,37093,38545
18079,Jennings County,,IN,1634,32300,33934
18081,Johnson County,,IN,9446,178681,188127
18083,Knox County,,IN,1428,41289,42717
18085,Kosciusko County,,IN,3910,98285,102195
18087,LaGrange County,,IN,1961,47235,49196
18089,Lake County,,IN,23321,568884,592205
18091,LaPorte County,,IN,4555,127815,132370
18093,Lawrence County,,IN,1773,53276,55049
18095,Madison County,,IN,5988,146565,152553
18097,Marion County,,IN,52234,1093651,1145885
18099,Marshall County,,IN,2399,57443,59842
18101,Martin County,,IN,436,11802,12238
18103,Miami County,,IN,1826,39051,40877
18105,Monroe County,,IN,6974,128701,135675
18107,Montgomery County,,IN,1779,46222,48001
18109,Morgan County,,IN,4166,83775,87941
18111,Newton County,,IN,987,16618,17605
18113,Noble County,,IN,2437,57821,60258
18115,Ohio County,,IN,352,6834,7186
18117,Orange County,,IN,891,21830,22721
18119,Owen County,,IN,1357,23903,25260
18121,Parke County,,IN,750,17862,18612
18123,Perry County,,IN,687,21835,22522
18125,Pike County,,IN,598,14620,15218
18127,Porter County,,IN,7922,202324,210246
18129,Posey County,,IN,1232,31449,32681
18131,Pulaski County,,IN,658,15185,15843
18133,Putnam County,,IN,2018,39242,41260
18135,Randolph County,,IN,1368,30156,31524
18137,Ripley County,,IN,1608,33863,35471
18139,Rush County,,IN,912,19955,20867
18141,St. Joseph County,,IN,11250,308783,320033
18143,Scott County,,IN,1085,26015,27100
18145,Shelby County,,IN,2671,53886,56557
18147,Spencer County,,IN,904,24943,25847
18149,Starke County,,IN,1224,25993,27217
18151,Steuben County,,IN,1939,39302,41241
18153,Sullivan County,,IN,839,22399,23238
18155,Switzerland County,,IN,557,10415,10972
18157,Tippecanoe County,,IN,9028,179283,188311
18159,Tipton County,,IN,925,19034,19959
18161,Union County,,IN,433,8295,8728
18163,Vanderburgh County,,IN,8255,205732,213987
18165,Vermillion County,,IN,876,18444,19320
18167,Vigo County,,IN,4532,112983,117515
18169,Wabash County,,IN,1303,38152,39455
18171,Warren County,,IN,507,10254,10761
18173,Warrick County,,IN,3177,75178,78355
18175,Washington County,,IN,1243,31528,32771
18177,Wayne County,,IN,2723,76561,79284
18179,Wells County,,IN,1427,34010,35437
18181,White County,,IN,1597,30226,31823
18183,Whitley County,,IN,1706,41936,43642
19001,Adair County,,IA,350,8745,9095
19003,Adams County,,IA,158,4735,4893
19005,Allamakee County,,IA,679,17722,18401
19007,Appanoose County,,IA,513,14157,14670
19009,Audubon County,,IA,175,7149,7324
19011,Benton County,,IA,1255,31755,33010
19013,Black Hawk County,,IA,5379,148150,153529
19015,Boone County,,IA,1323,31969,33292
19017,Bremer County,,IA,1184,29068,30252
19019,Buchanan County,,IA,947,25116,26063
19021,Buena Vista County,,IA,1537,25262,26799
19023,Butler County,,IA,649,18310,18959
19025,Calhoun County,,IA,385,11735,12120
19027,Carroll County,,IA,886,26354,27240
19029,Cass County,,IA,520,16350,16870
19031,Cedar County,,IA,970,22537,23507
19033,Cerro Gordo County,,IA,1951,51082,53033
19035,Cherokee County,,IA,493,14735,15228
19037,Chickasaw County,,IA,533,15242,15775
19039,Clarke County,,IA,454,10972,11426
19041,Clay County,,IA,852,20769,21621
19043,Clayton County,,IA,759,21724,22483
19045,Clinton County,,IA,2108,57098,59206
19047,Crawford County,,IA,1010,21331,22341
19049,Dallas County,,IA,5758,95515,101273
19051,Davis County,,IA,227,10109,10336
19053,Decatur County,,IA,324,8047,8371
19055,Delaware County,,IA,777,22040,22817
19057,Des Moines County,,IA,1915,47922,49837
19059,Dickinson County,,IA,849,21717,22566
19061,Dubuque County,,IA,3357,119312,122669
19063,Emmet County,,IA,391,11611,12002
19065,Fayette County,,IA,936,23095,24031
19067,Floyd County,,IA,692,19040,19732
19069,Franklin County,,IA,483,12419,12902
19071,Fremont County,,IA,400,8189,8589
19073,Greene County,,IA,481,10884,11365
19075,Grundy County,,IA,482,15531,16013
19077,Guthrie County,,IA,544,13086,13630
19079,Hamilton County,,IA,779,18378,19157
19081,Hancock County,,IA,497,13693,14190
19083,Hardin County,,IA,724,20089,20813
19085,Harrison County,,IA,525,17214,17739
19087,Henry County,,IA,1028,22738,23766
19089,Howard County,,IA,431,11953,12384
19091,Humboldt County,,IA,424,11966,12390
19093,Ida County,,IA,284,8704,8988
19095,Iowa County,,IA,794,20835,21629
19097,Jackson County,,IA,867,24132,24999
19099,Jasper County,,IA,1793,42791,44584
19101,Jefferson County,,IA,1018,18017,19035
19103,Johnson County,,IA,7241,149125,156366
19105,Jones County,,IA,795,23482,24277
19107,Keokuk County,,IA,413,12089,12502
19109,Kossuth County,,IA,542,19376,19918
19111,Lee County,,IA,1425,39823,41248
19113,Linn County,,IA,7913,264267,272180
19115,Louisa County,,IA,566,13512,14078
19117,Lucas County,,IA,328,10150,10478
19119,Lyon County,,IA,403,14875,15278
19121,Madison County,,IA,838,18556,19394
19123,Mahaska County,,IA,1077,25282,26359
19125,Marion County,,IA,1347,39548,40895
19127,Marshall County,,IA,1787,48130,49917
19129,Mills County,,IA,675,17312,17987
19131,Mitchell County,,IA,358,12780,13138
19133,Monona County,,IA,362,10364,10726
19135,Monroe County,,IA,360,8898,9258
19137,Montgomery County,,IA,467,11991,12458
19139,Muscatine County,,IA,2253,53230,55483
19141,O'Brien County,,IA,584,17493,18077
19143,Osceola County,,IA,340,8019,8359
19145,Page County,,IA,592,16670,17262
19147,Palo Alto County,,IA,385,10750,11135
19149,Plymouth County,,IA,1253,31750,33003
19151,Pocahontas County,,IA,326,8706,9032
19153,Polk County,,IA,23516,554460,577976
19155,Pottawattamie County,,IA,4336,106497,110833
19157,Poweshiek County,,IA,889,20741,21630
19159,Ringgold County,,IA,138,5561,5699
19161,Sac County,,IA,373,12486,12859
19163,Scott County,,IA,8437,205079,213516
19165,Shelby County,,IA,516,14988,15504
19167,Sioux County,,IA,1196,41785,42981
19169,Story County,,IA,4731,86197,90928
19171,Tama County,,IA,709,21192,21901
19173,Taylor County,,IA,236,7255,7491
19175,Union County,,IA,610,14149,14759
19177,Van Buren County,,IA,238,8532,8770
19179,Wapello County,,IA,1574,40009,41583
19181,Warren County,,IA,2540,57668,60208
19183,Washington County,,IA,1014,27490,28504
19185,Wayne County,,IA,200,7275,7475
19187,Webster County,,IA,1659,41248,42907
19189,Winnebago County,,IA,512,12996,13508
19191,Winneshiek County,,IA,688,24245,24933
19193,Woodbury County,,IA,4930,118655,123585
19195,Worth County,,IA,447,9133,9580
19197,Wright County,,IA,607,15492,16099
20001,Allen County,,KS,636,14808,15444
20003,Anderson County,,KS,319,9244,9563
20005,Atchison County,,KS,723,17701,18424
20007,Barber County,,KS,193,5800,5993
20009,Barton County,,KS,1165,32399,33564
20011,Bourbon County,,KS,643,16453,17096
20013,Brown County,,KS,427,11439,11866
20015,Butler County,,KS,3767,74722,78489
20017,Chase County,,KS,135,3057,3192
20019,Chautauqua County,,KS,211,3677,3888
20021,Cherokee County,,KS,1111,22046,23157
20023,Cheyenne County,,KS,-2,3248,3246
20025,Clark County,,KS,101,2434,2535
20027,Clay County,,KS,445,10341,10786
20029,Cloud County,,KS,398,10683,11081
20031,Coffey County,,KS,417,10358,10775
20033,Comanche County,,KS,97,2165,2262
20035,Cowley County,,KS,1820,40339,42159
20037,Crawford County,,KS,1896,40464,42360
20039,Decatur County,,KS,75,3518,3593
20041,Dickinson County,,KS,1237,23067,24304
20043,Doniphan County,,KS,485,8638,9123
20045,Douglas County,,KS,6077,115446,121523
20047,Edwards County,,KS,123,3760,3883
20049,Elk County,,KS,125,2946,3071
20051,Ellis County,,KS,1508,32975,34483
20053,Ellsworth County,,KS,287,6809,7096
20055,Finney County,,KS,2394,47280,49674
20057,Ford County,,KS,2749,44052,46801
20059,Franklin County,,KS,1421,29609,31030
20061,Geary County,,KS,9117,44385,53502
20063,Gove County,,KS,106,3483,3589
20065,Graham County,,KS,102,3233,3335
20067,Grant County,,KS,437,9527,9964
20069,Gray County,,KS,427,7367,7794
20071,Greeley County,,KS,-2,1667,1665
20073,Greenwood County,,KS,235,7183,7418
20075,Hamilton County,,KS,117,2984,3101
20077,Harper County,,KS,294,7004,7298
20079,Harvey County,,KS,1683,41006,42689
20081,Haskell County,,KS,243,4834,5077
20083,Hodgeman County,,KS,84,2276,2360
20085,Jackson County,,KS,634,16114,16748
20087,Jefferson County,,KS,1058,22008,23066
20089,Jewell County,,KS,102,3746,3848
20091,Johnson County,,KS,30502,712988,743490
20093,Kearny County,,KS,254,4967,5221
20095,Kingman County,,KS,360,9206,9566
20097,Kiowa County,,KS,114,2916,3030
20099,Labette County,,KS,1062,24235,25297
20101,Lane County,,KS,56,2226,2282
20103,Leavenworth County,,KS,5314,83146,88460
20105,Lincoln County,,KS,137,3763,3900
20107,Linn County,,KS,558,10747,11305
20109,Logan County,,KS,148,3459,3607
20111,Lyon County,,KS,1656,36109,37765
20113,McPherson County,,KS,1604,35503,37107
20115,Marion County,,KS,574,14069,14643
20117,Marshall County,,KS,394,13245,13639
20119,Meade County,,KS,214,5162,5376
20121,Miami County,,KS,1801,38333,40134
20123,Mitchell County,,KS,233,7820,8053
20125,Montgomery County,,KS,2005,36482,38487
20127,Morris County,,KS,262,6733,6995
20129,Morton County,,KS,226,3722,3948
20131,Nemaha County,,KS,339,13215,13554
20133,Neosho County,,KS,689,18364,19053
20135,Ness County,,KS,124,3767,3891
20137,Norton County,,KS,155,5949,6104
20139,Osage County,,KS,793,18709,19502
20141,Osborne County,,KS,137,4651,4788
20143,Ottawa County,,KS,263,7292,7555
20145,Pawnee County,,KS,310,7126,7436
20147,Phillips County,,KS,237,6815,7052
20149,Pottawatomie County,,KS,1559,27886,29445
20151,Pratt County,,KS,529,11417,11946
20153,Rawlins County,,KS,98,3143,3241
20155,Reno County,,KS,2555,72972,75527
20157,Republic County,,KS,136,6000,6136
20159,Rice County,,KS,437,11258,11695
20161,Riley County,,KS,7799,59361,67160
20163,Rooks County,,KS,178,6197,6375
20165,Rush County,,KS,161,3806,3967
20167,Russell County,,KS,236,8145,8381
20169,Saline County,,KS,2647,66663,69310
20171,Scott County,,KS,238,6385,6623
20173,Sedgwick County,,KS,21357,596025,617382
20175,Seward County,,KS,2193,29580,31773
20177,Shawnee County,,KS,7359,210413,217772
20179,Sheridan County,,KS,68,3351,3419
20181,Sherman County,,KS,316,6861,7177
20183,Smith County,,KS,95,4835,4930
20185,Stafford County,,KS,186,5038,5224
20187,Stanton County,,KS,77,2771,2848
20189,Stevens County,,KS,383,6726,7109
20191,Sumner County,,KS,1331,27008,28339
20193,Thomas County,,KS,374,9374,9748
20195,Trego County,,KS,132,3795,3927
20197,Wabaunsee County,,KS,363,8334,8697
20199,Wallace County,,KS,-2,1865,1863
20201,Washington County,,KS,178,7359,7537
20203,Wichita County,,KS,70,2860,2930
20205,Wilson County,,KS,404,10255,10659
20207,Woodson County,,KS,100,3636,3736
20209,Wyandotte County,,KS,11803,172151,183954
21001,Adair County,,KY,826,17941,18767
21003,Allen County,,KY,920,20056,20976
21005,Anderson County,,KY,1207,26637,27844
21007,Ballard County,,KY,419,8901,9320
21009,Barren County,,KY,1983,47498,49481
21011,Bath County,,KY,581,11891,12472
21013,Bell County,,KY,1126,23551,24677
21015,Boone County,,KY,9655,148590,158245
21017,Bourbon County,,KY,1210,22405,23615
21019,Boyd County,,KY,2585,49637,52222
21021,Boyle County,,KY,1646,30002,31648
21023,Bracken County,,KY,560,9307,9867
21025,Breathitt County,,KY,374,12237,12611
21027,Breckinridge County,,KY,931,20966,21897
21029,Bullitt County,,KY,4467,91459,95926
21031,Butler County,,KY,624,13843,14467
21033,Caldwell County,,KY,555,13906,14461
21035,Calloway County,,KY,1727,36147,37874
21037,Campbell County,,KY,5690,102646,108336
21039,Carlisle County,,KY,194,5622,5816
21041,Carroll County,,KY,839,11873,12712
21043,Carter County,,KY,1030,27977,29007
21045,Casey County,,KY,726,15362,16088
21047,Christian County,,KY,10505,73826,84331
21049,Clark County,,KY,1927,39564,41491
21051,Clay County,,KY,543,17394,17937
21053,Clinton County,,KY,360,9971,10331
21055,Crittenden County,,KY,280,9546,9826
21057,Cumberland County,,KY,206,6561,6767
21059,Daviess County,,KY,3432,114972,118404
21061,Edmonson County,,KY,702,12171,12873
21063,Elliott County,,KY,203,5878,6081
21065,Estill County,,KY,461,14252,14713
21067,Fayette County,,KY,16698,334562,351260
21069,Fleming County,,KY,529,16154,16683
21071,Floyd County,,KY,1624,35178,36802
21073,Franklin County,,KY,2865,58319,61184
21075,Fulton County,,KY,415,5739,6154
21077,Gallatin County,,KY,694,8785,9479
21079,Garrard County,,KY,967,17298,18265
21081,Grant County,,KY,1858,26268,28126
21083,Graves County,,KY,1761,40440,42201
21085,Grayson County,,KY,1062,26996,28058
21087,Green County,,KY,552,11435,11987
21089,Greenup County,,KY,1780,39213,40993
21091,Hancock County,,KY,448,10201,10649
21093,Hardin County,,KY,9222,117462,126684
21095,Harlan County,,KY,934,25288,26222
21097,Harrison County,,KY,945,19764,20709
21099,Hart County,,KY,955,19502,20457
21101,Henderson County,,KY,1850,51457,53307
21103,Henry County,,KY,975,16985,17960
21105,Hickman County,,KY,139,4841,4980
21107,Hopkins County,,KY,1701,50295,51996
21109,Jackson County,,KY,494,12193,12687
21111,Jefferson County,,KY,36384,881432,917816
21113,Jessamine County,,KY,3126,54450,57576
21115,Johnson County,,KY,844,21773,22617
21117,Kenton County,,KY,11045,187566,198611
21119,Knott County,,KY,625,13159,13784
21121,Knox County,,KY,1565,29146,30711
21123,Larue County,,KY,822,15545,16367
21125,Laurel County,,KY,3146,60602,63748
21127,Lawrence County,,KY,700,15210,15910
21129,Lee County,,KY,202,5691,5893
21131,Leslie County,,KY,378,9830,10208
21133,Letcher County,,KY,736,21017,21753
21135,Lewis County,,KY,454,13496,13950
21137,Lincoln County,,KY,1343,24756,26099
21139,Livingston County,,KY,559,9988,10547
21141,Logan County,,KY,1252,29671,30923
21143,Lyon County,,KY,417,7867,8284
21145,McCracken County,,KY,3387,74019,77406
21147,McCreary County,,KY,465,13495,13960
21149,McLean County,,KY,425,10492,10917
21151,Madison County,,KY,4391,86155,90546
21153,Magoffin County,,KY,287,11156,11443
21155,Marion County,,KY,653,21063,21716
21157,Marshall County,,KY,1455,35294,36749
21159,Martin County,,KY,455,9101,9556
21161,Mason County,,KY,806,18605,19411
21163,Meade County,,KY,3541,31416,34957
21165,Menifee County,,KY,249,5827,6076
21167,Mercer County,,KY,1075,24536,25611
21169,Metcalfe County,,KY,457,10377,10834
21171,Monroe County,,KY,469,11543,12012
21173,Montgomery County,,KY,1482,29113,30595
21175,Morgan County,,KY,304,11436,11740
21177,Muhlenberg County,,KY,938,32614,33552
21179,Nelson County,,KY,2033,54132,56165
21181,Nicholas County,,KY,316,7708,8024
21183,Ohio County,,KY,971,26223,27194
21185,Oldham County,,KY,3714,72076,75790
21187,Owen County,,KY,525,11045,11570
21189,Owsley County,,KY,137,3536,3673
21191,Pendleton County,,KY,714,15501,16215
21193,Perry County,,KY,1188,27220,28408
21195,Pike County,,KY,2220,55644,57864
21197,Powell County,,KY,599,12809,13408
21199,Pulaski County,,KY,2514,66626,69140
21201,Robertson County,,KY,122,2072,2194
21203,Rockcastle County,,KY,569,15860,16429
21205,Rowan County,,KY,1248,21050,22298
21207,Russell County,,KY,899,18399,19298
21209,Scott County,,KY,3101,58245,61346
21211,Shelby County,,KY,2970,51901,54871
21213,Simpson County,,KY,1036,20024,21060
21215,Spencer County,,KY,1139,20708,21847
21217,Taylor County,,KY,1117,25913,27030
21219,Todd County,,KY,596,13288,13884
21221,Trigg County,,KY,645,15038,15683
21223,Trimble County,,KY,517,9324,9841
21225,Union County,,KY,618,15478,16096
21227,Warren County,,KY,6294,128573,134867
21229,Washington County,,KY,510,13216,13726
21231,Wayne County,,KY,704,20117,20821
21233,Webster County,,KY,781,14317,15098
21235,Whitley County,,KY,1996,35307,37303
21237,Wolfe County,,KY,306,6352,6658
21239,Woodford County,,KY,1664,30920,32584
22001,Acadia Parish,,LA,3247,66478,69725
22003,Allen Parish,,LA,1122,22979,24101
22005,Ascension Parish,,LA,6530,131950,138480
22007,Assumption Parish,,LA,1306,25038,26344
22009,Avoyelles Parish,,LA,1374,42677,44051
22011,Beauregard Parish,,LA,2190,36528,38718
22013,Bienville Parish,,LA,783,14807,15590
22015,Bossier Parish,,LA,10510,134421,144931
22017,Caddo Parish,,LA,13821,276086,289907
22019,Calcasieu Parish,,LA,7568,217048,224616
22021,Caldwell Parish,,LA,476,10043,10519
22023,Cameron Parish,,LA,631,7517,8148
22025,Catahoula Parish,,LA,488,9893,10381
22027,Claiborne Parish,,LA,727,14007,14734
22029,Concordia Parish,,LA,1064,19497,20561
22031,De Soto Parish,,LA,1632,30220,31852
22033,East Baton Rouge Parish,,LA,25158,473175,498333
22035,East Carroll Parish,,LA,465,6957,7422
22037,East Feliciana Parish,,LA,1189,20460,21649
22039,Evangeline Parish,,LA,1524,34721,36245
22041,Franklin Parish,,LA,793,21186,21979
22043,Grant Parish,,LA,1233,20255,21488
22045,Iberia Parish,,LA,4180,84042,88222
22047,Iberville Parish,,LA,1937,33348,35285
22049,Jackson Parish,,LA,803,15746,16549
22051,Jefferson Parish,,LA,27363,479383,506746
22053,Jefferson Davis Parish,,LA,1803,34716,36519
22055,Lafayette Parish,,LA,13943,260619,274562
22057,Lafourche Parish,,LA,4754,108091,112845
22059,La Salle Parish,,LA,541,14583,15124
22061,Lincoln Parish,,LA,2854,43290,46144
22063,Livingston Parish,,LA,7406,143444,150850
22065,Madison Parish,,LA,585,10649,11234
22067,Morehouse Parish,,LA,1481,28578,30059
22069,Natchitoches Parish,,LA,1899,38911,40810
22071,Orleans Parish,,LA,25810,349484,375294
22073,Ouachita Parish,,LA,7526,168834,176360
22075,Plaquemines Parish,,LA,2009,25504,27513
22077,Pointe Coupee Parish,,LA,1138,24673,25811
22079,Rapides Parish,,LA,5930,146102,152032
22081,Red River Parish,,LA,483,8820,9303
22083,Richland Parish,,LA,1203,21465,22668
22085,Sabine Parish,,LA,792,23954,24746
22087,St. Bernard Parish,,LA,2633,40482,43115
22089,St. Charles Parish,,LA,3403,60245,63648
22091,St. Helena Parish,,LA,1367,13633,15000
22093,St. James Parish,,LA,1085,25308,26393
22095,St. John the Baptist Parish,,LA,2805,47722,50527
22097,St. Landry Parish,,LA,4714,94253,98967
22099,St. Martin Parish,,LA,3390,59451,62841
22101,St. Mary Parish,,LA,3027,60589,63616
22103,St. Tammany Parish,,LA,11814,275986,287800
22105,Tangipahoa Parish,,LA,6138,126652,132790
22107,Tensas Parish,,LA,258,4711,4969
22109,Terrebonne Parish,,LA,5910,125716,131626
22111,Union Parish,,LA,1342,22604,23946
22113,Vermilion Parish,,LA,3015,65737,68752
22115,Vernon Parish,,LA,7259,52578,59837
22117,Washington Parish,,LA,1764,43318,45082
22119,Webster Parish,,LA,2050,41897,43947
22121,West Baton Rouge Parish,,LA,1906,28443,30349
22123,West Carroll Parish,,LA,696,11485,12181
22125,West Feliciana Parish,,LA,615,11575,12190
22127,Winn Parish,,LA,719,13381,14100
23001,Androscoggin County,,ME,4802,117613,122415
23003,Aroostook County,,ME,1969,76424,78393
23005,Cumberland County,,ME,14074,346975,361049
23007,Franklin County,,ME,1413,31377,32790
23009,Hancock County,,ME,2505,63676,66181
23011,Kennebec County,,ME,4836,138978,143814
23013,Knox County,,ME,1611,46988,48599
23015,Lincoln County,,ME,1812,41219,43031
23017,Oxford County,,ME,2536,61124,63660
23019,Penobscot County,,ME,6155,163538,169693
23021,Piscataquis County,,ME,761,17749,18510
23023,Sagadahoc County,,ME,2204,42916,45120
23025,Somerset County,,ME,2534,53532,56066
23027,Waldo County,,ME,1915,43247,45162
23029,Washington County,,ME,1014,34019,35033
23031,York County,,ME,9325,243244,252569
24001,Allegany County,,MD,2153,72517,74670
24003,Anne Arundel County,,MD,36262,671076,707338
24005,Baltimore County,,MD,49197,972908,1022105
24009,Calvert County,,MD,5392,109824,115216
24011,Caroline County,,MD,1669,37067,38736
24013,Carroll County,,MD,7522,210007,217529
24015,Cecil County,,MD,5259,114918,120177
24017,Charles County,,MD,9926,184075,194001
24019,Dorchester County,,MD,1688,36261,37949
24021,Frederick County,,MD,13293,299568,312861
24023,Garrett County,,MD,1023,33991,35014
24025,Harford County,,MD,12267,308398,320665
24027,Howard County,,MD,21367,374556,395923
24029,Kent County,,MD,979,21792,22771
24031,Montgomery County,,MD,62886,1252041,1314927
24033,Prince George's County,,MD,66078,1060744,1126822
24035,Queen Anne's County,,MD,2576,58248,60824
24037,St. Mary's County,,MD,5955,129886,135841
24039,Somerset County,,MD,1218,21128,22346
24041,Talbot County,,MD,2028,45210,47238
24043,Washington County,,MD,6894,169127,176021
24045,Wicomico County,,MD,4996,107842,112838
24047,Worcester County,,MD,3332,62235,65567
24510,Baltimore city,,MD,43434,590628,634062
25001,Barnstable County,,MA,10951,280002,290953
25003,Berkshire County,,MA,3831,151868,155699
25005,Bristol County,,MA,18662,643414,662076
25007,Dukes County,,MA,1111,23000,24111
25009,Essex County,,MA,30647,926442,957089
25011,Franklin County,,MA,3285,83519,86804
25013,Hampden County,,MA,14014,527937,541951
25015,Hampshire County,,MA,7635,167009,174644
25017,Middlesex County,,MA,78058,1863727,1941785
25019,Nantucket County,,MA,902,15078,15980
25021,Norfolk County,,MA,40432,835336,875768
25023,Plymouth County,,MA,20954,617439,638393
25025,Suffolk County,,MA,56736,773259,829995
25027,Worcester County,,MA,27342,961679,989021
26001,Alcona County,,MI,526,11679,12205
26003,Alger County,,MI,368,9881,10249
26005,Allegan County,,MI,6638,138455,145093
26007,Alpena County,,MI,1109,34138,35247
26009,Antrim County,,MI,1526,27051,28577
26011,Arenac County,,MI,795,17590,18385
26013,Baraga County,,MI,239,8576,8815
26015,Barry County,,MI,3094,70093,73187
26017,Bay County,,MI,3850,130359,134209
26019,Benzie County,,MI,1153,21128,22281
26021,Berrien County,,MI,7363,181127,188490
26023,Branch County,,MI,1834,48560,50394
26025,Calhoun County,,MI,6116,151097,157213
26027,Cass County,,MI,3122,57402,60524
26029,Charlevoix County,,MI,1523,31970,33493
26031,Cheboygan County,,MI,1350,29480,30830
26033,Chippewa County,,MI,1267,38882,40149
26035,Clare County,,MI,1626,32357,33983
26037,Clinton County,,MI,4501,91041,95542
26039,Crawford County,,MI,758,14327,15085
26041,Delta County,,MI,1223,44214,45437
26043,Dickinson County,,MI,945,31903,32848
26045,Eaton County,,MI,7711,129073,136784
26047,Emmet County,,MI,2018,41324,43342
26049,Genesee County,,MI,15919,470013,485932
26051,Gladwin County,,MI,1276,28397,29673
26053,Gogebic County,,MI,623,16056,16679
26055,Grand Traverse County,,MI,4987,111565,116552
26057,Gratiot County,,MI,1807,43149,44956
26059,Hillsdale County,,MI,2104,50669,52773
26061,Houghton County,,MI,1310,36214,37524
26063,Huron County,,MI,1106,41064,42170
26065,Ingham County,,MI,16106,287224,303330
26067,Ionia County,,MI,3200,69599,72799
26069,Iosco County,,MI,1340,28867,30207
26071,Iron County,,MI,374,13222,13596
26073,Isabella County,,MI,3561,62513,66074
26075,Jackson County,,MI,5783,176019,181802
26077,Kalamazoo County,,MI,11538,287725,299263
26079,Kalkaska County,,MI,1124,19304,20428
26081,Kent County,,MI,25641,752988,778629
26083,Keweenaw County,,MI,96,2551,2647
26085,Lake County,,MI,684,10584,11268
26087,Lapeer County,,MI,4034,106424,110458
26089,Leelanau County,,MI,1463,27610,29073
26091,Lenawee County,,MI,3880,114649,118529
26093,Livingston County,,MI,9022,231332,240354
26095,Luce County,,MI,157,6147,6304
26097,Mackinac County,,MI,853,13540,14393
26099,Macomb County,,MI,35795,1057706,1093501
26101,Manistee County,,MI,1117,27331,28448
26103,Marquette County,,MI,2346,74564,76910
26105,Mason County,,MI,1351,34210,35561
26107,Mecosta County,,MI,2373,40926,43299
26109,Menominee County,,MI,918,27210,28128
26111,Midland County,,MI,4334,100762,105096
26113,Missaukee County,,MI,726,16993,17719
26115,Monroe County,,MI,6395,182741,189136
26117,Montcalm County,,MI,3311,68210,71521
26119,Montmorency County,,MI,455,10320,10775
26121,Muskegon County,,MI,6017,191981,197998
26123,Newaygo County,,MI,2641,53693,56334
26125,Oakland County,,MI,62688,1504166,1566854
26127,Oceana County,,MI,1554,30735,32289
26129,Ogemaw County,,MI,1083,22941,24024
26131,Ontonagon County,,MI,233,6673,6906
26133,Osceola County,,MI,1366,25316,26682
26135,Oscoda County,,MI,328,8805,9133
26137,Otsego County,,MI,1432,29161,30593
26139,Ottawa County,,MI,12927,332657,345584
26141,Presque Isle County,,MI,628,15741,16369
26143,Roscommon County,,MI,1352,25828,27180
26145,Saginaw County,,MI,7201,222567,229768
26147,St. Clair County,,MI,5914,192004,197918
26149,St. Joseph County,,MI,2796,71846,74642
26151,Sanilac County,,MI,1752,48644,50396
26153,Schoolcraft County,,MI,174,9409,9583
26155,Shiawassee County,,MI,3215,82364,85579
26157,Tuscola County,,MI,2251,64786,67037
26159,Van Buren County,,MI,4414,86970,91384
26161,Washtenaw County,,MI,20566,382164,402730
26163,Wayne County,,MI,70535,1919184,1989719
26165,Wexford County,,MI,1865,37223,39088
27001,Aitkin County,,MN,723,17391,18114
27003,Anoka County,,MN,19776,424967,444743
27005,Becker County,,MN,1643,39114,40757
27007,Beltrami County,,MN,2155,48362,50517
27009,Benton County,,MN,3290,46354,49644
27011,Big Stone County,,MN,228,6137,6365
27013,Blue Earth County,,MN,3900,69423,73323
27015,Brown County,,MN,1012,32714,33726
27017,Carlton County,,MN,1556,40235,41791
27019,Carver County,,MN,5434,123162,128596
27021,Cass County,,MN,1983,34013,35996
27023,Chippewa County,,MN,581,15274,15855
27025,Chisago County,,MN,2997,65412,68409
27027,Clay County,,MN,3759,67788,71547
27029,Clearwater County,,MN,368,9774,10142
27031,Cook County,,MN,184,6683,6867
27033,Cottonwood County,,MN,568,14594,15162
27035,Crow Wing County,,MN,3043,75279,78322
27037,Dakota County,,MN,24977,525636,550613
27039,Dodge County,,MN,970,25484,26454
27041,Douglas County,,MN,1799,46035,47834
27043,Faribault County,,MN,592,17503,18095
27045,Fillmore County,,MN,933,25243,26176
27047,Freeborn County,,MN,1328,38361,39689
27049,Goodhue County,,MN,2409,58013,60422
27051,Grant County,,MN,293,7352,7645
27053,Hennepin County,,MN,69888,1480020,1549908
27055,Houston County,,MN,768,23936,24704
27057,Hubbard County,,MN,1287,23441,24728
27059,Isanti County,,MN,2252,44970,47222
27061,Itasca County,,MN,1562,52221,53783
27063,Jackson County,,MN,520,13127,13647
27065,Kanabec County,,MN,889,17718,18607
27067,Kandiyohi County,,MN,2119,53432,55551
27069,Kittson County,,MN,150,5542,5692
27071,Koochiching County,,MN,356,14801,15157
27073,Lac qui Parle County,,MN,291,8739,9030
27075,Lake County,,MN,490,12857,13347
27077,Lake of the Woods County,,MN,155,4840,4995
27079,Le Sueur County,,MN,1658,34701,36359
27081,Lincoln County,,MN,247,7060,7307
27083,Lyon County,,MN,1400,30582,31982
27085,McLeod County,,MN,1738,45844,47582
27087,Mahnomen County,,MN,258,5712,5970
27089,Marshall County,,MN,393,11604,11997
27091,Martin County,,MN,850,25845,26695
27093,Meeker County,,MN,1177,28192,29369
27095,Mille Lacs County,,MN,1571,29359,30930
27097,Morrison County,,MN,1338,40130,41468
27099,Mower County,,MN,2003,47781,49784
27101,Murray County,,MN,324,10746,11070
27103,Nicollet County,,MN,2266,38460,40726
27105,Nobles County,,MN,1295,27195,28490
27107,Norman County,,MN,232,7960,8192
27109,Olmsted County,,MN,6765,189564,196329
27111,Otter Tail County,,MN,2516,70925,73441
27113,Pennington County,,MN,660,17043,17703
27115,Pine County,,MN,1445,30966,32411
27117,Pipestone County,,MN,362,11563,11925
27119,Polk County,,MN,1774,36628,38402
27121,Pope County,,MN,517,13906,14423
27123,Ramsey County,,MN,37012,615172,652184
27125,Red Lake County,,MN,187,4885,5072
27127,Redwood County,,MN,668,19176,19844
27129,Renville County,,MN,842,18948,19790
27131,Rice County,,MN,3005,73038,76043
27133,Rock County,,MN,360,11635,11995
27135,Roseau County,,MN,653,19952,20605
27137,St. Louis County,,MN,7032,225042,232074
27139,Scott County,,MN,7861,174559,182420
27141,Sherburne County,,MN,5722,108346,114068
27143,Sibley County,,MN,712,18920,19632
27145,Stearns County,,MN,8902,178368,187270
27147,Steele County,,MN,1737,46589,48326
27149,Stevens County,,MN,491,11221,11712
27151,Swift County,,MN,474,11712,12186
27153,Todd County,,MN,1324,28059,29383
27155,Traverse County,,MN,121,4156,4277
27157,Wabasha County,,MN,1093,27200,28293
27159,Wadena County,,MN,907,15415,16322
27161,Waseca County,,MN,911,22701,23612
27163,Washington County,,MN,14526,313778,328304
27165,Watonwan County,,MN,395,13550,13945
27167,Wilkin County,,MN,382,8144,8526
27169,Winona County,,MN,2071,54637,56708
27171,Wright County,,MN,6811,160948,167759
27173,Yellow Medicine County,,MN,477,12369,12846
28001,Adams County,,MS,1775,31103,32878
28003,Alcorn County,,MS,1576,36218,37794
28005,Amite County,,MS,830,12463,13293
28007,Attala County,,MS,870,19931,20801
28009,Benton County,,MS,596,7919,8515
28011,Bolivar County,,MS,1942,35529,37471
28013,Calhoun County,,MS,649,15553,16202
28015,Carroll County,,MS,711,10843,11554
28017,Chickasaw County,,MS,1080,19182,20262
28019,Choctaw County,,MS,498,8721,9219
28021,Claiborne County,,MS,489,9014,9503
28023,Clarke County,,MS,942,17431,18373
28025,Clay County,,MS,1001,21197,22198
28027,Coahoma County,,MS,1385,26375,27760
28029,Copiah County,,MS,1395,29999,31394
28031,Covington County,,MS,1161,20444,21605
28033,DeSoto County,,MS,11427,197382,208809
28035,Forrest County,,MS,6918,74279,81197
28037,Franklin County,,MS,445,8409,8854
28039,George County,,MS,1058,23826,24884
28041,Greene County,,MS,601,11807,12408
28043,Grenada County,,MS,1167,24098,25265
28045,Hancock County,,MS,2733,43610,46343
28047,Harrison County,,MS,18709,205856,224565
28049,Hinds County,,MS,15525,261655,277180
28051,Holmes County,,MS,1158,19440,20598
28053,Humphreys County,,MS,437,8833,9270
28055,Issaquena County,,MS,68,1126,1194
28057,Itawamba County,,MS,1330,24230,25560
28059,Jackson County,,MS,9479,151938,161417
28061,Jasper County,,MS,1123,17995,19118
28063,Jefferson County,,MS,443,8197,8640
28065,Jefferson Davis County,,MS,934,12360,13294
28067,Jones County,,MS,3225,73542,76767
28069,Kemper County,,MS,671,9374,10045
28071,Lafayette County,,MS,2829,44957,47786
28073,Lamar County,,MS,5395,59943,65338
28075,Lauderdale County,,MS,4260,81220,85480
28077,Lawrence County,,MS,627,12898,13525
28079,Leake County,,MS,1173,22746,23919
28081,Lee County,,MS,5149,94309,99458
28083,Leflore County,,MS,1857,31397,33254
28085,Lincoln County,,MS,1501,37237,38738
28087,Lowndes County,,MS,3667,63694,67361
28089,Madison County,,MS,7098,119937,127035
28091,Marion County,,MS,1358,26055,27413
28093,Marshall County,,MS,2534,37192,39726
28095,Monroe County,,MS,1730,38284,40014
28097,Montgomery County,,MS,698,10833,11531
28099,Neshoba County,,MS,1352,30493,31845
28101,Newton County,,MS,1223,23433,24656
28103,Noxubee County,,MS,580,12342,12922
28105,Oktibbeha County,,MS,2933,42363,45296
28107,Panola County,,MS,2021,37429,39450
28109,Pearl River County,,MS,2874,54538,57412
28111,Perry County,,MS,717,12132,12849
28113,Pike County,,MS,1903,42235,44138
28115,Pontotoc County,,MS,1874,34394,36268
28117,Prentiss County,,MS,1206,25224,26430
28119,Quitman County,,MS,519,7269,7788
28121,Rankin County,,MS,8589,163973,172562
28123,Scott County,,MS,1818,32323,34141
28125,Sharkey County,,MS,295,4863,5158
28127,Simpson County,,MS,1588,27271,28859
28129,Smith County,,MS,942,16103,17045
28131,Stone County,,MS,1002,17274,18276
28133,Sunflower County,,MS,1549,25490,27039
28135,Tallahatchie County,,MS,827,13355,14182
28137,Tate County,,MS,1777,30042,31819
28139,Tippah County,,MS,903,23797,24700
28141,Tishomingo County,,MS,878,19553,20431
28143,Tunica County,,MS,1112,12342,13454
28145,Union County,,MS,1538,30554,32092
28147,Walthall County,,MS,869,14503,15372
28149,Warren County,,MS,2432,54200,56632
28151,Washington County,,MS,2964,52749,55713
28153,Wayne County,,MS,1041,22299,23340
28155,Webster County,,MS,624,10600,11224
28157,Wilkinson County,,MS,475,9160,9635
28159,Winston County,,MS,722,19502,20224
28161,Yalobusha County,,MS,728,13214,13942
28163,Yazoo County,,MS,1114,24881,25995
29001,Adair County,,MO,1073,23092,24165
29003,Andrew County,,MO,1096,20719,21815
29005,Atchison County,,MO,200,6567,6767
29007,Audrain County,,MO,1124,27352,28476
29009,Barry County,,MO,2291,35520,37811
29011,Barton County,,MO,562,13377,13939
29013,Bates County,,MO,891,17963,18854
29015,Benton County,,MO,1064,19082,20146
29017,Bollinger County,,MO,774,12508,13282
29019,Boone County,,MO,8488,177952,186440
29021,Buchanan County,,MO,4652,95060,99712
29023,Butler County,,MO,2101,43542,45643
29025,Caldwell County,,MO,419,9751,10170
29027,Callaway County,,MO,2417,47618,50035
29029,Camden County,,MO,2967,46981,49948
29031,Cape Girardeau County,,MO,3619,86215,89834
29033,Carroll County,,MO,336,10615,10951
29035,Carter County,,MO,379,6224,6603
29037,Cass County,,MO,5634,118751,124385
29039,Cedar County,,MO,745,14020,14765
29041,Chariton County,,MO,306,9042,9348
29043,Christian County,,MO,5635,92574,98209
29045,Clark County,,MO,268,7638,7906
29047,Clay County,,MO,14537,277226,291763
29049,Clinton County,,MO,1524,23673,25197
29051,Cole County,,MO,4094,88922,93016
29053,Cooper County,,MO,827,18694,19521
29055,Crawford County,,MO,1441,25356,26797
29057,Dade County,,MO,336,8116,8452
29059,Dallas County,,MO,943,16682,17625
29061,Daviess County,,MO,462,9417,9879
29063,DeKalb County,,MO,598,10243,10841
29065,Dent County,,MO,646,15264,15910
29067,Douglas County,,MO,955,12740,13695
29069,Dunklin County,,MO,1768,29783,31551
29071,Franklin County,,MO,4722,122116,126838
29073,Gasconade County,,MO,645,17377,18022
29075,Gentry County,,MO,316,7420,7736
29077,Greene County,,MO,15954,307658,323612
29079,Grundy County,,MO,359,11009,11368
29081,Harrison County,,MO,344,9431,9775
29083,Henry County,,MO,1260,23546,24806
29085,Hickory County,,MO,646,8616,9262
29087,Holt County,,MO,229,5534,5763
29089,Howard County,,MO,497,11030,11527
29091,Howell County,,MO,1843,41453,43296
29093,Iron County,,MO,591,9873,10464
29095,Jackson County,,MO,36137,758226,794363
29097,Jasper County,,MO,6520,126841,133361
29099,Jefferson County,,MO,9683,260744,270427
29101,Johnson County,,MO,4167,54284,58451
29103,Knox County,,MO,243,4501,4744
29105,Laclede County,,MO,1643,38073,39716
29107,Lafayette County,,MO,1784,37048,38832
29109,Lawrence County,,MO,2263,41276,43539
29111,Lewis County,,MO,420,10757,11177
29113,Lincoln County,,MO,2743,61708,64451
29115,Linn County,,MO,551,14083,14634
29117,Livingston County,,MO,634,15756,16390
29119,McDonald County,,MO,1893,23388,25281
29121,Macon County,,MO,617,17900,18517
29123,Madison County,,MO,484,12527,13011
29125,Maries County,,MO,536,9461,9997
29127,Marion County,,MO,1547,31855,33402
29129,Mercer County,,MO,196,3929,4125
29131,Miller County,,MO,1444,25332,26776
29133,Mississippi County,,MO,592,12494,13086
29135,Moniteau County,,MO,719,17107,17826
29137,Monroe County,,MO,526,9710,10236
29139,Montgomery County,,MO,711,13026,13737
29141,Morgan County,,MO,1199,21118,22317
29143,New Madrid County,,MO,1163,18017,19180
29145,Newton County,,MO,4202,61300,65502
29147,Nodaway County,,MO,1074,21562,22636
29149,Oregon County,,MO,600,10158,10758
29151,Osage County,,MO,516,15832,16348
29153,Ozark County,,MO,500,9301,9801
29155,Pemiscot County,,MO,917,16971,17888
29157,Perry County,,MO,700,22936,23636
29159,Pettis County,,MO,2036,47124,49160
29161,Phelps County,,MO,2429,43358,45787
29163,Pike County,,MO,733,18744,19477
29165,Platte County,,MO,8426,111486,119912
29167,Polk County,,MO,1761,31016,32777
29169,Pulaski County,,MO,6452,46858,53310
29171,Putnam County,,MO,130,5340,5470
29173,Ralls County,,MO,605,11822,12427
29175,Randolph County,,MO,1076,26030,27106
29177,Ray County,,MO,1480,26123,27603
29179,Reynolds County,,MO,270,6290,6560
29181,Ripley County,,MO,944,13338,14282
29183,St. Charles County,,MO,16938,466036,482974
29185,St. Clair County,,MO,420,9231,9651
29186,Ste. Genevieve County,,MO,1008,20742,21750
29187,St. Francois County,,MO,2718,63621,66339
29189,St. Louis County,,MO,56134,1190061,1246195
29195,Saline County,,MO,1114,25176,26290
29197,Schuyler County,,MO,288,4486,4774
29199,Scotland County,,MO,201,5499,5700
29201,Scott County,,MO,2220,43096,45316
29203,Shannon County,,MO,525,8013,8538
29205,Shelby County,,MO,215,7544,7759
29207,Stoddard County,,MO,1272,31730,33002
29209,Stone County,,MO,2248,33255,35503
29211,Sullivan County,,MO,358,7314,7672
29213,Taney County,,MO,3990,55113,59103
29215,Texas County,,MO,1284,24280,25564
29217,Vernon County,,MO,984,21371,22355
29219,Warren County,,MO,1979,37441,39420
29221,Washington County,,MO,1092,22862,23954
29223,Wayne County,,MO,783,11434,12217
29225,Webster County,,MO,2176,40358,42534
29227,Worth County,,MO,-2,2433,2431
29229,Wright County,,MO,1088,17987,19075
29510,St. Louis city,,MO,29548,304210,333758
30001,Beaverhead County,,MT,550,10370,10920
30003,Big Horn County,,MT,694,12756,13450
30005,Blaine County,,MT,251,6942,7193
30007,Broadwater County,,MT,352,6214,6566
30009,Carbon County,,MT,593,11685,12278
30011,Carter County,,MT,-2,1413,1411
30013,Cascade County,,MT,5664,96650,102314
30015,Chouteau County,,MT,274,5645,5919
30017,Custer County,,MT,720,13965,14685
30019,Daniels County,,MT,64,2290,2354
30021,Dawson County,,MT,691,11002,11693
30023,Deer Lodge County,,MT,460,9670,10130
30025,Fallon County,,MT,157,3905,4062
30027,Fergus County,,MT,593,13905,14498
30029,Flathead County,,MT,4425,114015,118440
30031,Gallatin County,,MT,5918,114138,120056
30033,Garfield County,,MT,-2,1444,1442
30035,Glacier County,,MT,580,13341,13921
30037,Golden Valley County,,MT,79,1067,1146
30039,Granite County,,MT,202,3175,3377
30041,Hill County,,MT,865,18888,19753
30043,Jefferson County,,MT,865,13251,14116
30045,Judith Basin County,,MT,108,2297,2405
30047,Lake County,,MT,1404,30479,31883
30049,Lewis and Clark County,,MT,3426,79230,82656
30051,Liberty County,,MT,96,2314,2410
30053,Lincoln County,,MT,1076,19569,20645
30055,McCone County,,MT,75,2259,2334
30057,Madison County,,MT,383,8824,9207
30059,Meagher County,,MT,93,1945,2038
30061,Mineral County,,MT,334,4485,4819
30063,Missoula County,,MT,6450,126400,132850
30065,Musselshell County,,MT,213,4889,5102
30067,Park County,,MT,1064,19312,20376
30069,Petroleum County,,MT,-2,488,486
30071,Phillips County,,MT,140,4965,5105
30073,Pondera County,,MT,208,7252,7460
30075,Powder River County,,MT,-2,1944,1942
30077,Powell County,,MT,386,6311,6697
30079,Prairie County,,MT,-2,1359,1357
30081,Ravalli County,,MT,2146,47203,49349
30083,Richland County,,MT,1265,14158,15423
30085,Roosevelt County,,MT,630,11113,11743
30087,Rosebud County,,MT,590,10405,10995
30089,Sanders County,,MT,538,11710,12248
30091,Sheridan County,,MT,205,4849,5054
30093,Silver Bow County,,MT,1656,38449,40105
30095,Stillwater County,,MT,516,10801,11317
30097,Sweet Grass County,,MT,156,3981,4137
30099,Teton County,,MT,307,7448,7755
30101,Toole County,,MT,278,5485,5763
30103,Treasure County,,MT,-2,902,900
30105,Valley County,,MT,353,9102,9455
30107,Wheatland County,,MT,86,2113,2199
30109,Wibaux County,,MT,-2,1215,1213
30111,Yellowstone County,,MT,7749,185936,193685
31001,Adams County,,NE,1521,36307,37828
31003,Antelope County,,NE,255,7866,8121
31005,Arthur County,,NE,-2,545,543
31007,Banner County,,NE,-2,764,762
31009,Blaine County,,NE,-2,586,584
31011,Boone County,,NE,213,6878,7091
31013,Box Butte County,,NE,686,13799,14485
31015,Boyd County,,NE,-2,2378,2376
31017,Brown County,,NE,92,3495,3587
31019,Buffalo County,,NE,2520,54911,57431
31021,Burt County,,NE,217,8088,8305
31023,Butler County,,NE,382,10230,10612
31025,Cass County,,NE,1708,31431,33139
31027,Cedar County,,NE,360,10721,11081
31029,Chase County,,NE,187,4879,5066
31031,Cherry County,,NE,242,7090,7332
31033,Cheyenne County,,NE,572,12543,13115
31035,Clay County,,NE,313,7706,8019
31037,Colfax County,,NE,969,13732,14701
31039,Cuming County,,NE,303,11680,11983
31041,Custer County,,NE,456,13337,13793
31043,Dakota County,,NE,1667,25921,27588
31045,Dawes County,,NE,493,8822,9315
31047,Dawson County,,NE,1727,30030,31757
31049,Deuel County,,NE,80,2141,2221
31051,Dixon County,,NE,355,7288,7643
31053,Dodge County,,NE,1925,44299,46224
31055,Douglas County,,NE,28518,651988,680506
31057,Dundy County,,NE,82,2099,2181
31059,Fillmore County,,NE,215,7112,7327
31061,Franklin County,,NE,126,3699,3825
31063,Frontier County,,NE,181,2923,3104
31065,Furnas County,,NE,262,5759,6021
31067,Gage County,,NE,850,26117,26967
31069,Garden County,,NE,81,2195,2276
31071,Garfield County,,NE,81,2054,2135
31073,Gosper County,,NE,154,2357,2511
31075,Grant County,,NE,-2,858,856
31077,Greeley County,,NE,114,2902,3016
31079,Hall County,,NE,3898,73835,77733
31081,Hamilton County,,NE,453,11793,12246
31083,Harlan County,,NE,148,3998,4146
31085,Hayes County,,NE,-2,1115,1113
31087,Hitchcock County,,NE,123,3393,3516
31089,Holt County,,NE,414,13013,13427
31091,Hooker County,,NE,-2,919,917
31093,Howard County,,NE,286,7786,8072
31095,Jefferson County,,NE,252,8783,9035
31097,Johnson County,,NE,188,5257,5445
31099,Kearney County,,NE,344,7993,8337
31101,Keith County,,NE,386,9691,10077
31103,Keya Paha County,,NE,-2,1031,1029
31105,Kimball County,,NE,209,4159,4368
31107,Knox County,,NE,267,10246,10513
31109,Lancaster County,,NE,10666,347999,358665
31111,Lincoln County,,NE,1606,42144,43750
31113,Logan County,,NE,-2,957,955
31115,Loup County,,NE,-2,663,661
31117,McPherson County,,NE,-2,549,547
31119,Madison County,,NE,2203,42257,44460
31121,Merrick County,,NE,377,9229,9606
31123,Morrill County,,NE,276,5527,5803
31125,Nance County,,NE,167,4228,4395
31127,Nemaha County,,NE,355,7766,8121
31129,Nuckolls County,,NE,155,5389,5544
31131,Otoe County,,NE,820,19169,19989
31133,Pawnee County,,NE,99,3216,3315
31135,Perkins County,,NE,92,3636,3728
31137,Phelps County,,NE,363,11354,11717
31139,Pierce County,,NE,228,9070,9298
31141,Platte County,,NE,1799,42732,44531
31143,Polk County,,NE,306,6537,6843
31145,Red Willow County,,NE,486,12814,13300
31147,Richardson County,,NE,260,9639,9899
31149,Rock County,,NE,62,1652,1714
31151,Saline County,,NE,900,16668,17568
31153,Sarpy County,,NE,12885,212189,225074
31155,Saunders County,,NE,1201,25543,26744
31157,Scotts Bluff County,,NE,1761,41655,43416
31159,Seward County,,NE,878,19946,20824
31161,Sheridan County,,NE,245,5951,6196
31163,Sherman County,,NE,125,3629,3754
31165,Sioux County,,NE,-2,1427,1425
31167,Stanton County,,NE,380,7084,7464
31169,Thayer County,,NE,213,6459,6672
31171,Thomas County,,NE,-2,797,795
31173,Thurston County,,NE,281,7315,7596
31175,Valley County,,NE,123,5095,5218
31177,Washington County,,NE,1043,24686,25729
31179,Wayne County,,NE,452,9616,10068
31181,Webster County,,NE,135,4087,4222
31183,Wheeler County,,NE,-2,964,962
31185,York County,,NE,860,16771,17631
32001,Churchill County,,NV,2211,26453,28664
32003,Clark County,,NV,79670,2363576,2443246
32005,Douglas County,,NV,3442,59447,62889
32007,Elko County,,NV,3548,60666,64214
32009,Esmeralda County,,NV,-2,889,887
32011,Eureka County,,NV,170,1942,2112
32013,Humboldt County,,NV,1495,20545,22040
32015,Lander County,,NV,522,6722,7244
32017,Lincoln County,,NV,277,4544,4821
32019,Lyon County,,NV,4128,59199,63327
32021,Mineral County,,NV,282,4422,4704
32023,Nye County,,NV,2997,42376,45373
32027,Pershing County,,NV,333,5250,5583
32029,Storey County,,NV,290,4031,4321
32031,Washoe County,,NV,18526,510253,528779
32033,White Pine County,,NV,599,9956,10555
32510,Carson City,,NV,4145,61568,65713
33001,Belknap County,,NH,3728,75990,79718
33003,Carroll County,,NH,3051,58536,61587
33005,Cheshire County,,NH,3442,88830,92272
33007,Coos County,,NH,1461,35444,36905
33009,Grafton County,,NH,5544,101140,106684
33011,Hillsborough County,,NH,19499,499094,518593
33013,Merrimack County,,NH,7863,175961,183824
33015,Rockingham County,,NH,16932,388485,405417
33017,Strafford County,,NH,6801,142000,148801
33019,Sullivan County,,NH,2169,50660,52829
34001,Atlantic County,,NJ,12264,333156,345420
34003,Bergen County,,NJ,46108,1138709,1184817
34005,Burlington County,,NJ,22809,549032,571841
34007,Camden County,,NJ,23803,599073,622876
34009,Cape May County,,NJ,5422,114923,120345
34011,Cumberland County,,NJ,5718,173976,179694
34013,Essex County,,NJ,44662,876320,920982
34015,Gloucester County,,NJ,12458,348807,361265
34017,Hudson County,,NJ,53279,735775,789054
34019,Hunterdon County,,NJ,6337,160066,166403
34021,Mercer County,,NJ,19161,421581,440742
34023,Middlesex County,,NJ,48530,1005768,1054298
34025,Monmouth County,,NJ,26223,779325,805548
34027,Morris County,,NJ,26310,627355,653665
34029,Ocean County,,NJ,20326,707380,727706
34031,Passaic County,,NJ,26237,610458,636695
34033,Salem County,,NJ,3216,76078,79294
34035,Somerset County,,NJ,21392,415251,436643
34037,Sussex County,,NJ,6978,178731,185709
34039,Union County,,NJ,32351,657201,689552
34041,Warren County,,NJ,5510,131233,136743
35001,Bernalillo County,,NM,31335,738997,770332
35003,Catron County,,NM,215,3155,3370
35005,Chaves County,,NM,3100,66964,70064
35006,Cibola County,,NM,1211,23196,24407
35007,Colfax County,,NM,804,12770,13574
35009,Curry County,,NM,4900,53935,58835
35011,De Baca County,,NM,68,2052,2120
35013,Dona Ana County,,NM,12220,225898,238118
35015,Eddy County,,NM,3275,61794,65069
35017,Grant County,,NM,1521,30982,32503
35019,Guadalupe County,,NM,185,4339,4524
35021,Harding County,,NM,-2,755,753
35023,Hidalgo County,,NM,240,4628,4868
35025,Lea County,,NM,4028,77500,81528
35027,Lincoln County,,NM,1427,20682,22109
35028,Los Alamos County,,NM,1033,23022,24055
35029,Luna County,,NM,1451,27356,28807
35031,McKinley County,,NM,6449,83102,89551
35033,Mora County,,NM,233,4667,4900
35035,Otero County,,NM,5316,64228,69544
35037,Quay County,,NM,424,8700,9124
35039,Rio Arriba County,,NM,2068,39347,41415
35041,Roosevelt County,,NM,1692,19302,20994
35043,Sandoval County,,NM,9877,151639,161516
35045,San Juan County,,NM,12770,134014,146784
35047,San Miguel County,,NM,1389,26612,28001
35049,Santa Fe County,,NM,8284,173318,181602
35051,Sierra County,,NM,721,10975,11696
35053,Socorro County,,NM,917,16907,17824
35055,Taos County,,NM,1790,34652,36442
35057,Torrance County,,NM,1058,13810,14868
35059,Union County,,NM,192,4110,4302
35061,Valencia County,,NM,3880,76313,80193
36001,Albany County,,NY,16594,353551,370145
36003,Allegany County,,NY,1761,48871,50632
36005,Bronx County,,NY,81360,1501131,1582491
36007,Broome County,,NY,6940,217660,224600
36009,Cattaraugus County,,NY,3032,86467,89499
36011,Cayuga County,,NY,2808,87769,90577
36013,Chautauqua County,,NY,3770,143157,146927
36015,Chemung County,,NY,3305,98319,101624
36017,Chenango County,,NY,2357,56676,59033
36019,Clinton County,,NY,2252,89720,91972
36021,Columbia County,,NY,2994,71788,74782
36023,Cortland County,,NY,1998,50817,52815
36025,Delaware County,,NY,2245,49014,51259
36027,Dutchess County,,NY,12059,340992,353051
36029,Erie County,,NY,22655,1078271,1100926
36031,Essex County,,NY,1851,42346,44197
36033,Franklin County,,NY,1565,50975,52540
36035,Fulton County,,NY,2294,61130,63424
36037,Genesee County,,NY,2410,69700,72110
36039,Greene County,,NY,2420,52215,54635
36041,Hamilton County,,NY,292,6106,6398
36043,Herkimer County,,NY,2380,70283,72663
36045,Jefferson County,,NY,13158,128346,141504
36047,Kings County,,NY,152431,2843692,2996123
36049,Lewis County,,NY,1290,31323,32613
36051,Livingston County,,NY,2633,69924,72557
36053,Madison County,,NY,3351,78050,81401
36055,Monroe County,,NY,20873,879666,900539
36057,Montgomery County,,NY,2544,56123,58667
36059,Nassau County,,NY,57213,1754558,1811771
36061,New York County,,NY,153975,1805216,1959191
36063,Niagara County,,NY,7096,254031,261127
36065,Oneida County,,NY,7310,259927,267237
36067,Onondaga County,,NY,15291,545237,560528
36069,Ontario County,,NY,5185,131703,136888
36071,Orange County,,NY,17457,453476,470933
36073,Orleans County,,NY,1549,45605,47154
36075,Oswego County,,NY,4746,133093,137839
36077,Otsego County,,NY,2788,64703,67491
36079,Putnam County,,NY,5689,119450,125139
36081,Queens County,,NY,130408,2694339,2824747
36083,Rensselaer County,,NY,9231,183013,192244
36085,Richmond County,,NY,19485,554941,574426
36087,Rockland County,,NY,12328,390788,403116
36089,St. Lawrence County,,NY,3350,111869,115219
36091,Saratoga County,,NY,12436,280260,292696
36093,Schenectady County,,NY,7787,182654,190441
36095,Schoharie County,,NY,1259,33709,34968
36097,Schuyler County,,NY,1049,21277,22326
36099,Seneca County,,NY,1606,38303,39909
36101,Steuben County,,NY,3907,111962,115869
36103,Suffolk County,,NY,49611,1901058,1950669
36105,Sullivan County,,NY,4065,81695,85760
36107,Tioga County,,NY,2692,59828,62520
36109,Tompkins County,,NY,5252,94651,99903
36111,Ulster County,,NY,7896,203667,211563
36113,Warren County,,NY,4055,78488,82543
36115,Washington County,,NY,3204,69633,72837
36117,Wayne County,,NY,4018,111807,115825
36119,Westchester County,,NY,48047,1174039,1222086
36121,Wyoming County,,NY,1550,45909,47459
36123,Yates County,,NY,1090,28556,29646
37001,Alamance County,,NC,6969,172974,179943
37003,Alexander County,,NC,1611,38838,40449
37005,Alleghany County,,NC,446,11531,11977
37007,Anson County,,NC,1099,23920,25019
37009,Ashe County,,NC,881,27971,28852
37011,Avery County,,NC,966,17074,18040
37013,Beaufort County,,NC,2081,51521,53602
37015,Bertie County,,NC,908,19948,20856
37017,Bladen County,,NC,1597,32786,34383
37019,Brunswick County,,NC,6610,128766,135376
37021,Buncombe County,,NC,13714,283783,297497
37023,Burke County,,NC,3673,93429,97102
37025,Cabarrus County,,NC,11747,219951,231698
37027,Caldwell County,,NC,3332,85568,88900
37029,Camden County,,NC,720,11502,12222
37031,Carteret County,,NC,4093,77008,81101
37033,Caswell County,,NC,1316,23215,24531
37035,Catawba County,,NC,7678,178810,186488
37037,Chatham County,,NC,4003,79680,83683
37039,Cherokee County,,NC,1068,27080,28148
37041,Chowan County,,NC,741,15768,16509
37043,Clay County,,NC,520,10648,11168
37045,Cleveland County,,NC,4383,103355,107738
37047,Columbus County,,NC,2275,54419,56694
37049,Craven County,,NC,9270,112806,122076
37051,Cumberland County,,NC,33886,342634,376520
37053,Currituck County,,NC,1606,27774,29380
37055,Dare County,,NC,2126,43597,45723
37057,Davidson County,,NC,7525,182692,190217
37059,Davie County,,NC,2025,47486,49511
37061,Duplin County,,NC,4455,59547,64002
37063,Durham County,,NC,22235,326701,348936
37065,Edgecombe County,,NC,3668,55560,59228
37067,Forsyth County,,NC,17094,408945,426039
37069,Franklin County,,NC,3721,64011,67732
37071,Gaston County,,NC,9580,230460,240040
37073,Gates County,,NC,610,11570,12180
37075,Graham County,,NC,301,8736,9037
37077,Granville County,,NC,3130,61087,64217
37079,Greene County,,NC,1340,19704,21044
37081,Guilford County,,NC,26777,566536,593313
37083,Halifax County,,NC,2623,53788,56411
37085,Harnett County,,NC,11466,126916,138382
37087,Haywood County,,NC,2540,64692,67232
37089,Henderson County,,NC,6100,126546,132646
37091,Hertford County,,NC,1257,21087,22344
37093,Hoke County,,NC,5708,51289,56997
37095,Hyde County,,NC,286,5177,5463
37097,Iredell County,,NC,8921,192505,201426
37099,Jackson County,,NC,2247,35189,37436
37101,Johnston County,,NC,9176,201665,210841
37103,Jones County,,NC,747,10381,11128
37105,Lee County,,NC,6354,65840,72194
37107,Lenoir County,,NC,3197,61881,65078
37109,Lincoln County,,NC,4447,88350,92797
37111,McDowell County,,NC,1654,46595,48249
37113,Macon County,,NC,1582,37231,38813
37115,Madison County,,NC,1138,20915,22053
37117,Martin County,,NC,1084,25737,26821
37119,Mecklenburg County,,NC,62019,1139577,1201596
37121,Mitchell County,,NC,585,15520,16105
37123,Montgomery County,,NC,1419,28778,30197
37125,Moore County,,NC,5065,106299,111364
37127,Nash County,,NC,6365,106682,113047
37129,New Hanover County,,NC,13841,227837,241678
37131,Northampton County,,NC,1022,19718,20740
37133,Onslow County,,NC,26957,189697,216654
37135,Orange County,,NC,10479,143220,153699
37137,Pamlico County,,NC,668,13194,13862
37139,Pasquotank County,,NC,2514,42183,44697
37141,Pender County,,NC,3810,57880,61690
37143,Perquimans County,,NC,757,14415,15172
37145,Person County,,NC,1321,43022,44343
37147,Pitt County,,NC,9378,171377,180755
37149,Polk County,,NC,987,21229,22216
37151,Randolph County,,NC,6233,159858,166091
37153,Richmond County,,NC,2042,46835,48877
37155,Robeson County,,NC,5193,130123,135316
37157,Rockingham County,,NC,3551,100680,104231
37159,Rowan County,,NC,6953,151785,158738
37161,Rutherford County,,NC,2148,65026,67174
37163,Sampson County,,NC,4515,73784,78299
37165,Scotland County,,NC,1739,34385,36124
37167,Stanly County,,NC,2304,65549,67853
37169,Stokes County,,NC,2208,50118,52326
37171,Surry County,,NC,3184,78694,81878
37173,Swain County,,NC,1004,18393,19397
37175,Transylvania County,,NC,1623,33910,35533
37177,Tyrrell County,,NC,190,4005,4195
37179,Union County,,NC,10684,251083,261767
37181,Vance County,,NC,2410,46348,48758
37183,Wake County,,NC,52220,1169475,1221695
37185,Warren County,,NC,1165,18697,19862
37187,Washington County,,NC,667,13002,13669
37189,Watauga County,,NC,2948,42379,45327
37191,Wayne County,,NC,7161,131017,138178
37193,Wilkes County,,NC,2145,71065,73210
37195,Wilson County,,NC,4104,89952,94056
37197,Yadkin County,,NC,1611,41462,43073
37199,Yancey County,,NC,794,18350,19144
38001,Adams County,,ND,69,2705,2774
38003,Barnes County,,ND,544,13276,13820
38005,Benson County,,ND,253,6751,7004
38007,Billings County,,ND,66,1089,1155
38009,Bottineau County,,ND,345,8308,8653
38011,Bowman County,,ND,141,4184,4325
38013,Burke County,,ND,110,3015,3125
38015,Burleigh County,,ND,4773,110573,115346
38017,Cass County,,ND,10189,195994,206183
38019,Cavalier County,,ND,142,5070,5212
38021,Dickey County,,ND,213,6408,6621
38023,Divide County,,ND,223,2942,3165
38025,Dunn County,,ND,629,4857,5486
38027,Eddy County,,ND,101,2846,2947
38029,Emmons County,,ND,129,4053,4182
38031,Foster County,,ND,134,4314,4448
38033,Golden Valley County,,ND,79,2225,2304
38035,Grand Forks County,,ND,4537,76113,80650
38037,Grant County,,ND,70,2784,2854
38039,Griggs County,,ND,51,2918,2969
38041,Hettinger County,,ND,125,3179,3304
38043,Kidder County,,ND,81,2981,3062
38045,LaMoure County,,ND,146,5096,5242
38047,Logan County,,ND,85,2447,2532
38049,McHenry County,,ND,341,7223,7564
38051,McIntosh County,,ND,148,3518,3666
38053,McKenzie County,,ND,1902,9526,11428
38055,McLean County,,ND,603,11811,12414
38057,Mercer County,,ND,568,11035,11603
38059,Morton County,,ND,2302,36127,38429
38061,Mountrail County,,ND,1347,10262,11609
38063,Nelson County,,ND,119,3785,3904
38065,Oliver County,,ND,82,2305,2387
38067,Pembina County,,ND,272,8993,9265
38069,Pierce County,,ND,159,5289,5448
38071,Ramsey County,,ND,646,13970,14616
38073,Ransom County,,ND,165,6879,7044
38075,Renville County,,ND,199,3132,3331
38077,Richland County,,ND,809,19538,20347
38079,Rolette County,,ND,490,14877,15367
38081,Sargent County,,ND,172,5148,5320
38083,Sheridan County,,ND,70,1613,1683
38085,Sioux County,,ND,228,3398,3626
38087,Slope County,,ND,-2,860,858
38089,Stark County,,ND,3456,37373,40829
38091,Steele County,,ND,87,2358,2445
38093,Stutsman County,,ND,947,24872,25819
38095,Towner County,,ND,90,2905,2995
38097,Traill County,,ND,429,9413,9842
38099,Walsh County,,ND,488,13523,14011
38101,Ward County,,ND,7721,81655,89376
38103,Wells County,,ND,186,5339,5525
38105,Williams County,,ND,6443,37773,44216
39001,Adams County,,OH,915,28770,29685
39003,Allen County,,OH,4222,117699,121921
39005,Ashland County,,OH,2342,60699,63041
39007,Ashtabula County,,OH,3433,111436,114869
39009,Athens County,,OH,2603,51119,53722
39011,Auglaize County,,OH,2134,58170,60304
39013,Belmont County,,OH,2491,76421,78912
39015,Brown County,,OH,2411,47653,50064
39017,Butler County,,OH,19108,426274,445382
39019,Carroll County,,OH,1496,32132,33628
39021,Champaign County,,OH,1951,45799,47750
39023,Clark County,,OH,5335,157720,163055
39025,Clermont County,,OH,10543,238466,249009
39027,Clinton County,,OH,2400,47251,49651
39029,Columbiana County,,OH,3843,119468,123311
39031,Coshocton County,,OH,1327,41209,42536
39033,Crawford County,,OH,1935,49914,51849
39035,Cuyahoga County,,OH,44280,1463569,1507849
39037,Darke County,,OH,1875,64140,66015
39039,Defiance County,,OH,1685,47475,49160
39041,Delaware County,,OH,10855,232942,243797
39043,Erie County,,OH,3790,92927,96717
39045,Fairfield County,,OH,7899,173997,181896
39047,Fayette County,,OH,1345,32163,33508
39049,Franklin County,,OH,56704,1439452,1496156
39051,Fulton County,,OH,1942,53041,54983
39053,Gallia County,,OH,1196,31124,32320
39055,Geauga County,,OH,4415,118530,122945
39057,Greene County,,OH,10664,182030,192694
39059,Guernsey County,,OH,1657,44852,46509
39061,Hamilton County,,OH,36352,944191,980543
39063,Hancock County,,OH,3687,90470,94157
39065,Hardin County,,OH,1439,32984,34423
39067,Harrison County,,OH,803,16569,17372
39069,Henry County,,OH,1207,35401,36608
39071,Highland County,,OH,2105,46318,48423
39073,Hocking County,,OH,1393,30978,32371
39075,Holmes County,,OH,1685,48292,49977
39077,Huron County,,OH,3064,70986,74050
39079,Jackson County,,OH,1223,34874,36097
39081,Jefferson County,,OH,2469,74822,77291
39083,Knox County,,OH,2487,68786,71273
39085,Lake County,,OH,10011,291439,301450
39087,Lawrence County,,OH,2363,65051,67414
39089,Licking County,,OH,7779,199923,207702
39091,Logan County,,OH,2286,55095,57381
39093,Lorain County,,OH,11139,360106,371245
39095,Lucas County,,OH,15010,482474,497484
39097,Madison County,,OH,2471,46370,48841
39099,Mahoning County,,OH,8602,268881,277483
39101,Marion County,,OH,2445,69555,72000
39103,Medina County,,OH,8049,223517,231566
39105,Meigs County,,OH,775,23358,24133
39107,Mercer County,,OH,1394,52880,54274
39109,Miami County,,OH,4782,126724,131506
39111,Monroe County,,OH,489,16237,16726
39113,Montgomery County,,OH,23067,611027,634094
39115,Morgan County,,OH,556,15147,15703
39117,Morrow County,,OH,1845,39114,40959
39119,Muskingum County,,OH,3017,98241,101258
39121,Noble County,,OH,463,13661,14124
39123,Ottawa County,,OH,2167,51270,53437
39125,Paulding County,,OH,846,22833,23679
39127,Perry County,,OH,1850,38383,40233
39129,Pickaway County,,OH,2848,60839,63687
39131,Pike County,,OH,1134,28522,29656
39133,Portage County,,OH,8270,178204,186474
39135,Preble County,,OH,1927,48929,50856
39137,Putnam County,,OH,1087,44451,45538
39139,Richland County,,OH,4689,139731,144420
39141,Ross County,,OH,2728,80905,83633
39143,Sandusky County,,OH,2581,73612,76193
39145,Scioto County,,OH,2281,76043,78324
39147,Seneca County,,OH,2557,64756,67313
39149,Shelby County,,OH,2351,59686,62037
39151,Stark County,,OH,12902,450314,463216
39153,Summit County,,OH,21486,639769,661255
39155,Trumbull County,,OH,7292,243116,250408
39157,Tuscarawas County,,OH,3621,114679,118300
39159,Union County,,OH,2920,62404,65324
39161,Van Wert County,,OH,1279,35108,36387
39163,Vinton County,,OH,691,13143,13834
39165,Warren County,,OH,13249,267908,281157
39167,Washington County,,OH,2366,71562,73928
39169,Wayne County,,OH,4484,139097,143581
39171,Williams County,,OH,1602,45529,47131
39173,Wood County,,OH,7538,144386,151924
39175,Wyandot County,,OH,1245,27462,28707
40001,Adair County,,OK,1284,21055,22339
40003,Alfalfa County,,OK,288,5312,5600
40005,Atoka County,,OK,635,13163,13798
40007,Beaver County,,OK,501,6114,6615
40009,Beckham County,,OK,1834,23448,25282
40011,Blaine County,,OK,654,10397,11051
40013,Bryan County,,OK,2367,42030,44397
40015,Caddo County,,OK,1636,28200,29836
40017,Canadian County,,OK,8498,145599,154097
40019,Carter County,,OK,2747,52408,55155
40021,Cherokee County,,OK,2590,44130,46720
40023,Choctaw County,,OK,806,14108,14914
40025,Cimarron County,,OK,123,2929,3052
40027,Cleveland County,,OK,17904,286173,304077
40029,Coal County,,OK,368,5211,5579
40031,Comanche County,,OK,11642,119829,131471
40033,Cotton County,,OK,447,6075,6522
40035,Craig County,,OK,757,13539,14296
40037,Creek County,,OK,5018,73226,78244
40039,Custer County,,OK,2086,29773,31859
40041,Delaware County,,OK,2510,38586,41096
40043,Dewey County,,OK,329,5429,5758
40045,Ellis County,,OK,232,4544,4776
40047,Garfield County,,OK,4196,70084,74280
40049,Garvin County,,OK,1789,28152,29941
40051,Grady County,,OK,3335,54537,57872
40053,Grant County,,OK,249,4857,5106
40055,Greer County,,OK,300,4945,5245
40057,Harmon County,,OK,72,2699,2771
40059,Harper County,,OK,179,4378,4557
40061,Haskell County,,OK,665,12095,12760
40063,Hughes County,,OK,773,12021,12794
40065,Jackson County,,OK,2481,27223,29704
40067,Jefferson County,,OK,322,5773,6095
40069,Johnston County,,OK,847,10427,11274
40071,Kay County,,OK,2375,48286,50661
40073,Kingfisher County,,OK,911,17959,18870
40075,Kiowa County,,OK,616,8998,9614
40077,Latimer County,,OK,712,10738,11450
40079,Le Flore County,,OK,2625,47227,49852
40081,Lincoln County,,OK,2013,35005,37018
40083,Logan County,,OK,3146,45772,48918
40085,Love County,,OK,754,10089,10843
40087,McClain County,,OK,2915,41866,44781
40089,McCurtain County,,OK,1333,32669,34002
40091,McIntosh County,,OK,1525,18408,19933
40093,Major County,,OK,527,8926,9453
40095,Marshall County,,OK,917,15789,16706
40097,Mayes County,,OK,2307,40876,43183
40099,Murray County,,OK,698,14084,14782
40101,Muskogee County,,OK,3873,68626,72499
40103,Noble County,,OK,596,12293,12889
40105,Nowata County,,OK,555,10824,11379
40107,Okfuskee County,,OK,593,10412,11005
40109,Oklahoma County,,OK,43489,827268,870757
40111,Okmulgee County,,OK,2176,38115,40291
40113,Osage County,,OK,3399,43615,47014
40115,Ottawa County,,OK,1897,32465,34362
40117,Pawnee County,,OK,982,16024,17006
40119,Payne County,,OK,4800,68770,73570
40121,Pittsburg County,,OK,2368,45270,47638
40123,Pontotoc County,,OK,2053,40364,42417
40125,Pottawatomie County,,OK,4499,72297,76796
40127,Pushmataha County,,OK,634,10390,11024
40129,Roger Mills County,,OK,176,3992,4168
40131,Rogers County,,OK,6066,99349,105415
40133,Seminole County,,OK,1515,23620,25135
40135,Sequoyah County,,OK,2122,40293,42415
40137,Stephens County,,OK,2252,46863,49115
40139,Texas County,,OK,2353,25884,28237
40141,Tillman County,,OK,456,7563,8019
40143,Tulsa County,,OK,33271,707495,740766
40145,Wagoner County,,OK,5952,79936,85888
40147,Washington County,,OK,2759,58335,61094
40149,Washita County,,OK,896,11813,12709
40151,Woods County,,OK,642,9232,9874
40153,Woodward County,,OK,1405,23474,24879
41001,Baker County,,OR,726,17086,17812
41003,Benton County,,OR,5623,85984,91607
41005,Clackamas County,,OR,25129,457510,482639
41007,Clatsop County,,OR,2198,40770,42968
41009,Columbia County,,OR,2601,54154,56755
41011,Coos County,,OR,2871,64077,66948
41013,Crook County,,OR,1119,22413,23532
41015,Curry County,,OR,1411,23477,24888
41017,Deschutes County,,OR,8599,193786,202385
41019,Douglas County,,OR,4108,110628,114736
41021,Gilliam County,,OR,113,1977,2090
41023,Grant County,,OR,351,7387,7738
41025,Harney County,,OR,300,7477,7777
41027,Hood River County,,OR,1307,29772,31079
41029,Jackson County,,OR,8196,234796,242992
41031,Jefferson County,,OR,1201,22527,23728
41033,Josephine County,,OR,3612,85735,89347
41035,Klamath County,,OR,3075,67020,70095
41037,Lake County,,OR,442,7658,8100
41039,Lane County,,OR,12847,379625,392472
41041,Lincoln County,,OR,2635,48736,51371
41043,Linn County,,OR,6094,127312,133406
41045,Malheur County,,OR,1494,28391,29885
41047,Marion County,,OR,15212,358683,373895
41049,Morrow County,,OR,868,13138,14006
41051,Multnomah County,,OR,49516,867491,917007
41053,Polk County,,OR,5235,83023,88258
41055,Sherman County,,OR,84,1955,2039
41057,Tillamook County,,OR,1402,27681,29083
41059,Umatilla County,,OR,4089,82006,86095
41061,Union County,,OR,1157,27901,29058
41063,Wallowa County,,OR,309,8136,8445
41065,Wasco County,,OR,1273,27257,28530
41067,Washington County,,OR,33682,658375,692057
41069,Wheeler County,,OR,92,1292,1384
41071,Yamhill County,,OR,5774,109439,115213
42001,Adams County,,PA,4396,126201,130597
42003,Allegheny County,,PA,40655,1485329,1525984
42005,Armstrong County,,PA,2460,82004,84464
42007,Beaver County,,PA,5822,210795,216617
42009,Bedford County,,PA,1403,59434,60837
42011,Berks County,,PA,13693,505273,518966
42013,Blair County,,PA,3005,148499,151504
42015,Bradford County,,PA,2402,73772,76174
42017,Bucks County,,PA,26374,806896,833270
42019,Butler County,,PA,7389,233883,241272
42021,Cambria County,,PA,3889,160898,164787
42023,Cameron County,,PA,126,5895,6021
42025,Carbon County,,PA,2921,75249,78170
42027,Centre County,,PA,5113,143672,148785
42029,Chester County,,PA,22835,637288,660123
42031,Clarion County,,PA,1407,43195,44602
42033,Clearfield County,,PA,2496,92010,94506
42035,Clinton County,,PA,1350,43112,44462
42037,Columbia County,,PA,2486,72465,74951
42039,Crawford County,,PA,3029,98686,101715
42041,Cumberland County,,PA,11325,300608,311933
42043,Dauphin County,,PA,13551,332124,345675
42045,Delaware County,,PA,25455,668833,694288
42047,Elk County,,PA,674,40706,41380
42049,Erie County,,PA,7271,321129,328400
42051,Fayette County,,PA,3910,152488,156398
42053,Forest County,,PA,241,5373,5614
42055,Franklin County,,PA,5273,193220,198493
42057,Fulton County,,PA,455,17967,18422
42059,Greene County,,PA,1285,40623,41908
42061,Huntingdon County,,PA,1248,49150,50398
42063,Indiana County,,PA,3029,92584,95613
42065,Jefferson County,,PA,1651,54307,55958
42067,Juniata County,,PA,753,29265,30018
42069,Lackawanna County,,PA,8574,247467,256041
42071,Lancaster County,,PA,15506,669867,685373
42073,Lawrence County,,PA,2902,104348,107250
42075,Lebanon County,,PA,5276,171130,176406
42077,Lehigh County,,PA,17474,432147,449621
42079,Luzerne County,,PA,10165,375147,385312
42081,Lycoming County,,PA,3903,136682,140585
42083,McKean County,,PA,1240,47736,48976
42085,Mercer County,,PA,3822,133346,137168
42087,Mifflin County,,PA,1178,55142,56320
42089,Monroe County,,PA,8981,184054,193035
42091,Montgomery County,,PA,38382,1021131,1059513
42093,Montour County,,PA,1140,22445,23585
42095,Northampton County,,PA,14095,363695,377790
42097,Northumberland County,,PA,3512,108082,111594
42099,Perry County,,PA,1682,57154,58836
42101,Philadelphia County,,PA,69042,1520743,1589785
42103,Pike County,,PA,3651,64388,68039
42105,Potter County,,PA,631,19784,20415
42107,Schuylkill County,,PA,4285,168893,173178
42109,Snyder County,,PA,1289,47060,48349
42111,Somerset County,,PA,2144,88924,91068
42113,Sullivan County,,PA,275,7080,7355
42115,Susquehanna County,,PA,1807,49347,51154
42117,Tioga County,,PA,1506,47859,49365
42119,Union County,,PA,1666,44016,45682
42121,Venango County,,PA,1704,63141,64845
42123,Warren County,,PA,1304,48096,49400
42125,Washington County,,PA,7797,254644,262441
42127,Wayne County,,PA,2715,59093,61808
42129,Westmoreland County,,PA,11298,449727,461025
42131,Wyoming County,,PA,1525,33490,35015
42133,York County,,PA,14886,549155,564041
44001,Bristol County,,RI,2262,57472,59734
44003,Kent County,,RI,9221,203901,213122
44005,Newport County,,RI,5618,97417,103035
44007,Providence County,,RI,25334,708651,733985
44009,Washington County,,RI,5966,149864,155830
45001,Abbeville County,,SC,1204,24886,26090
45003,Aiken County,,SC,7505,180177,187682
45005,Allendale County,,SC,506,7844,8350
45007,Anderson County,,SC,8381,210840,219221
45009,Bamberg County,,SC,828,13328,14156
45011,Barnwell County,,SC,987,22274,23261
45013,Beaufort County,,SC,11634,194812,206446
45015,Berkeley County,,SC,17529,207808,225337
45017,Calhoun County,,SC,865,15454,16319
45019,Charleston County,,SC,26144,406476,432620
45021,Cherokee County,,SC,2323,57594,59917
45023,Chester County,,SC,1549,34464,36013
45025,Chesterfield County,,SC,1791,45374,47165
45027,Clarendon County,,SC,1779,32912,34691
45029,Colleton County,,SC,1767,40542,42309
45031,Darlington County,,SC,3098,70480,73578
45033,Dillon County,,SC,1231,32009,33240
45035,Dorchester County,,SC,13110,162834,175944
45037,Edgefield County,,SC,1418,25732,27150
45039,Fairfield County,,SC,1188,23605,24793
45041,Florence County,,SC,6619,148574,155193
45043,Georgetown County,,SC,3834,69689,73523
45045,Greenville County,,SC,23440,544356,567796
45047,Greenwood County,,SC,3107,75073,78180
45049,Hampton County,,SC,1049,19855,20904
45051,Horry County,,SC,16724,332063,348787
45053,Jasper County,,SC,2000,24904,26904
45055,Kershaw County,,SC,3157,69369,72526
45057,Lancaster County,,SC,3835,89917,93752
45059,Laurens County,,SC,3149,67454,70603
45061,Lee County,,SC,984,17176,18160
45063,Lexington County,,SC,15273,308911,324184
45065,McCormick County,,SC,484,9390,9874
45067,Marion County,,SC,1527,33304,34831
45069,Marlboro County,,SC,1118,26506,27624
45071,Newberry County,,SC,1626,41421,43047
45073,Oconee County,,SC,3194,80046,83240
45075,Orangeburg County,,SC,4133,89984,94117
45077,Pickens County,,SC,6493,119221,125714
45079,Richland County,,SC,26230,410337,436567
45081,Saluda County,,SC,1172,22528,23700
45083,Spartanburg County,,SC,11432,323004,334436
45085,Sumter County,,SC,6935,117838,124773
45087,Union County,,SC,843,27768,28611
45089,Williamsburg County,,SC,1597,32451,34048
45091,York County,,SC,11776,279656,291432
46003,Aurora County,,SD,113,3475,3588
46005,Beadle County,,SD,1107,22114,23221
46007,Bennett County,,SD,85,3041,3126
46009,Bon Homme County,,SD,268,7078,7346
46011,Brookings County,,SD,1665,33428,35093
46013,Brown County,,SD,1865,46104,47969
46015,Brule County,,SD,186,6257,6443
46017,Buffalo County,,SD,98,1963,2061
46019,Butte County,,SD,775,11559,12334
46021,Campbell County,,SD,-2,1871,1869
46023,Charles Mix County,,SD,292,9804,10096
46025,Clark County,,SD,128,4222,4350
46027,Clay County,,SD,921,11890,12811
46029,Codington County,,SD,1412,33973,35385
46031,Corson County,,SD,251,3364,3615
46033,Custer County,,SD,653,9681,10334
46035,Davison County,,SD,1108,23669,24777
46037,Day County,,SD,233,6673,6906
46039,Deuel County,,SD,192,5484,5676
46041,Dewey County,,SD,287,6728,7015
46043,Douglas County,,SD,100,3695,3795
46045,Edmunds County,,SD,147,4487,4634
46047,Fall River County,,SD,472,7878,8350
46049,Faulk County,,SD,63,2433,2496
46051,Grant County,,SD,352,9424,9776
46053,Gregory County,,SD,102,5126,5228
46055,Haakon County,,SD,60,2438,2498
46057,Hamlin County,,SD,245,7030,7275
46059,Hand County,,SD,81,4174,4255
46061,Hanson County,,SD,490,5392,5882
46063,Harding County,,SD,-2,1531,1529
46065,Hughes County,,SD,1127,21748,22875
46067,Hutchinson County,,SD,214,8653,8867
46069,Hyde County,,SD,-2,1653,1651
46071,Jackson County,,SD,99,2863,2962
46073,Jerauld County,,SD,96,2215,2311
46075,Jones County,,SD,-2,1239,1237
46077,Kingsbury County,,SD,409,6558,6967
46079,Lake County,,SD,1026,15739,16765
46081,Lawrence County,,SD,1682,28628,30310
46083,Lincoln County,,SD,4053,64853,68906
46085,Lyman County,,SD,131,4314,4445
46087,McCook County,,SD,301,6832,7133
46089,McPherson County,,SD,87,2447,2534
46091,Marshall County,,SD,219,5089,5308
46093,Meade County,,SD,2701,31300,34001
46095,Mellette County,,SD,69,1807,1876
46097,Miner County,,SD,130,2794,2924
46099,Minnehaha County,,SD,13514,230935,244449
46101,Moody County,,SD,269,7575,7844
46103,Pennington County,,SD,8582,128252,136834
46105,Perkins County,,SD,54,3453,3507
46107,Potter County,,SD,51,3132,3183
46109,Roberts County,,SD,417,11115,11532
46111,Sanborn County,,SD,116,2883,2999
46115,Spink County,,SD,219,7424,7643
46117,Stanley County,,SD,275,3757,4032
46119,Sully County,,SD,71,1829,1900
46121,Todd County,,SD,311,8101,8412
46123,Tripp County,,SD,164,6690,6854
46125,Turner County,,SD,386,10108,10494
46127,Union County,,SD,1131,18780,19911
46129,Walworth County,,SD,300,6597,6897
46135,Yankton County,,SD,1102,26272,27374
46137,Ziebach County,,SD,-2,1341,1339
47001,Anderson County,,TN,4701,82508,87209
47003,Bedford County,,TN,2495,52816,55311
47005,Benton County,,TN,642,16710,17352
47007,Bledsoe County,,TN,506,11524,12030
47009,Blount County,,TN,5731,144681,150412
47011,Bradley County,,TN,5211,114036,119247
47013,Campbell County,,TN,1433,37731,39164
47015,Cannon County,,TN,779,14764,15543
47017,Carroll County,,TN,1560,29468,31028
47019,Carter County,,TN,2782,56062,58844
47021,Cheatham County,,TN,2939,46211,49150
47023,Chester County,,TN,833,17215,18048
47025,Claiborne County,,TN,1377,30988,32365
47027,Clay County,,TN,369,7593,7962
47029,Cocke County,,TN,1594,36087,37681
47031,Coffee County,,TN,3241,59631,62872
47033,Crockett County,,TN,847,15852,16699
47035,Cumberland County,,TN,2553,64733,67286
47037,Davidson County,,TN,50535,756306,806841
47039,Decatur County,,TN,562,11638,12200
47041,DeKalb County,,TN,1127,20067,21194
47043,Dickson County,,TN,2653,56619,59272
47045,Dyer County,,TN,1760,41617,43377
47047,Fayette County,,TN,2589,46157,48746
47049,Fentress County,,TN,603,17528,18131
47051,Franklin County,,TN,1945,45201,47146
47053,Gibson County,,TN,2654,54344,56998
47055,Giles County,,TN,1388,31260,32648
47057,Grainger County,,TN,1221,22980,24201
47059,Greene County,,TN,2420,73506,75926
47061,Grundy County,,TN,570,14537,15107
47063,Hamblen County,,TN,3569,69749,73318
47065,Hamilton County,,TN,15969,394307,410276
47067,Hancock County,,TN,158,6031,6189
47069,Hardeman County,,TN,1230,25265,26495
47071,Hardin County,,TN,1311,26840,28151
47073,Hawkins County,,TN,2738,58882,61620
47075,Haywood County,,TN,1014,20574,21588
47077,Henderson County,,TN,1216,30289,31505
47079,Henry County,,TN,1505,34843,36348
47081,Hickman County,,TN,1336,23376,24712
47083,Houston County,,TN,479,8589,9068
47085,Humphreys County,,TN,824,20289,21113
47087,Jackson County,,TN,604,10962,11566
47089,Jefferson County,,TN,3362,54196,57558
47091,Johnson County,,TN,498,16210,16708
47093,Knox County,,TN,21123,497737,518860
47095,Lake County,,TN,327,5346,5673
47097,Lauderdale County,,TN,1198,25142,26340
47099,Lawrence County,,TN,1444,43774,45218
47101,Lewis County,,TN,526,12158,12684
47103,Lincoln County,,TN,1630,38299,39929
47105,Loudon County,,TN,3364,59399,62763
47107,McMinn County,,TN,2837,55047,57884
47109,McNairy County,,TN,1248,26444,27692
47111,Macon County,,TN,1148,24455,25603
47113,Madison County,,TN,5869,107927,113796
47115,Marion County,,TN,1251,30418,31669
47117,Marshall County,,TN,1680,35250,36930
47119,Maury County,,TN,5388,101027,106415
47121,Meigs County,,TN,880,12176,13056
47123,Monroe County,,TN,2255,47320,49575
47125,Montgomery County,,TN,17887,199916,217803
47127,Moore County,,TN,436,7070,7506
47129,Morgan County,,TN,996,19717,20713
47131,Obion County,,TN,1528,35204,36732
47133,Overton County,,TN,1033,22957,23990
47135,Perry County,,TN,271,7696,7967
47137,Pickett County,,TN,236,5357,5593
47139,Polk County,,TN,1056,17271,18327
47141,Putnam County,,TN,4435,77180,81615
47143,Rhea County,,TN,1794,33909,35703
47145,Roane County,,TN,2890,56413,59303
47147,Robertson County,,TN,4635,82866,87501
47149,Rutherford County,,TN,16956,328652,345608
47151,Scott County,,TN,531,21050,21581
47153,Sequatchie County,,TN,920,15222,16142
47155,Sevier County,,TN,6195,107748,113943
47157,Shelby County,,TN,40506,1093129,1133635
47159,Smith County,,TN,965,21028,21993
47161,Stewart County,,TN,727,13897,14624
47163,Sullivan County,,TN,7146,173313,180459
47165,Sumner County,,TN,10475,199973,210448
47167,Tipton County,,TN,3541,68775,72316
47169,Trousdale County,,TN,668,8702,9370
47171,Unicoi County,,TN,762,18499,19261
47173,Union County,,TN,1067,18560,19627
47175,Van Buren County,,TN,261,5766,6027
47177,Warren County,,TN,1586,43446,45032
47179,Washington County,,TN,7212,133642,140854
47181,Wayne County,,TN,600,14978,15578
47183,Weakley County,,TN,1550,32374,33924
47185,White County,,TN,1208,27361,28569
47187,Williamson County,,TN,13793,250699,264492
47189,Wilson County,,TN,7669,149019,156688
48001,Anderson County,,TX,2836,48602,51438
48003,Andrews County,,TX,1138,20264,21402
48005,Angelina County,,TX,4286,94426,98712
48007,Aransas County,,TX,2550,26143,28693
48009,Archer County,,TX,762,10025,10787
48011,Armstrong County,,TX,129,2204,2333
48013,Atascosa County,,TX,3785,50440,54225
48015,Austin County,,TX,1813,34302,36115
48017,Bailey County,,TX,476,7859,8335
48019,Bandera County,,TX,1299,22029,23328
48021,Bastrop County,,TX,5402,83032,88434
48023,Baylor County,,TX,126,3700,3826
48025,Bee County,,TX,1781,27384,29165
48027,Bell County,,TX,33117,353089,386206
48029,Bexar County,,TX,76993,2071313,2148306
48031,Blanco County,,TX,650,12097,12747
48033,Borden County,,TX,-2,657,655
48035,Bosque County,,TX,1130,18749,19879
48037,Bowie County,,TX,5771,99468,105239
48039,Brazoria County,,TX,20292,373439,393731
48041,Brazos County,,TX,11146,182688,193834
48043,Brewster County,,TX,728,9760,10488
48045,Briscoe County,,TX,91,1627,1718
48047,Brooks County,,TX,449,7854,8303
48049,Brown County,,TX,1876,38842,40718
48051,Burleson County,,TX,985,19480,20465
48053,Burnet County,,TX,3242,50248,53490
48055,Caldwell County,,TX,2993,41426,44419
48057,Calhoun County,,TX,1581,24067,25648
48059,Callahan County,,TX,961,14194,15155
48061,Cameron County,,TX,15977,449180,465157
48063,Camp County,,TX,812,13674,14486
48065,Carson County,,TX,448,6467,6915
48067,Cass County,,TX,1757,31962,33719
48069,Castro County,,TX,526,8290,8816
48071,Chambers County,,TX,3927,45949,49876
48073,Cherokee County,,TX,2531,53455,55986
48075,Childress County,,TX,287,6281,6568
48077,Clay County,,TX,740,11475,12215
48079,Cochran County,,TX,207,3214,3421
48081,Coke County,,TX,214,3483,3697
48083,Coleman County,,TX,495,8587,9082
48085,Collin County,,TX,62882,1034920,1097802
48087,Collingsworth County,,TX,164,3290,3454
48089,Colorado County,,TX,1133,23922,25055
48091,Comal County,,TX,10254,145047,155301
48093,Comanche County,,TX,760,14221,14981
48095,Concho County,,TX,182,2508,2690
48097,Cooke County,,TX,2515,44483,46998
48099,Coryell County,,TX,9048,68162,77210
48101,Cottle County,,TX,79,1499,1578
48103,Crane County,,TX,313,5719,6032
48105,Crockett County,,TX,286,4357,4643
48107,Crosby County,,TX,437,6132,6569
48109,Culberson County,,TX,166,2516,2682
48111,Dallam County,,TX,805,8402,9207
48113,Dallas County,,TX,147298,2852128,2999426
48115,Dawson County,,TX,677,13167,13844
48117,Deaf Smith County,,TX,1250,22776,24026
48119,Delta County,,TX,354,5019,5373
48121,Denton County,,TX,55973,855424,911397
48123,DeWitt County,,TX,1394,21020,22414
48125,Dickens County,,TX,155,1953,2108
48127,Dimmit County,,TX,693,11260,11953
48129,Donley County,,TX,183,3410,3593
48131,Duval County,,TX,765,12285,13050
48133,Eastland County,,TX,1060,18101,19161
48135,Ector County,,TX,11027,175205,186232
48137,Edwards County,,TX,146,1973,2119
48139,Ellis County,,TX,9573,185451,195024
48141,El Paso County,,TX,41586,948329,989915
48143,Erath County,,TX,2232,37260,39492
48145,Falls County,,TX,919,15822,16741
48147,Fannin County,,TX,1856,33173,35029
48149,Fayette County,,TX,1190,28850,30040
48151,Fisher County,,TX,288,3913,4201
48153,Floyd County,,TX,426,6514,6940
48155,Foard County,,TX,56,1277,1333
48157,Fort Bend County,,TX,44235,786976,831211
48159,Franklin County,,TX,818,10447,11265
48161,Freestone County,,TX,1170,20363,21533
48163,Frio County,,TX,1110,16170,17280
48165,Gaines County,,TX,911,21068,21979
48167,Galveston County,,TX,18945,353014,371959
48169,Garza County,,TX,310,4780,5090
48171,Gillespie County,,TX,1363,31217,32580
48173,Glasscock County,,TX,90,1581,1671
48175,Goliad County,,TX,513,8034,8547
48177,Gonzales County,,TX,1191,22397,23588
48179,Gray County,,TX,1357,24323,25680
48181,Grayson County,,TX,6696,136455,143151
48183,Gregg County,,TX,9903,140542,150445
48185,Grimes County,,TX,1927,27399,29326
48187,Guadalupe County,,TX,12143,168987,181130
48189,Hale County,,TX,2185,35687,37872
48191,Hall County,,TX,189,3106,3295
48193,Hamilton County,,TX,682,8597,9279
48195,Hansford County,,TX,250,6465,6715
48197,Hardeman County,,TX,228,4142,4370
48199,Hardin County,,TX,3477,61250,64727
48201,Harris County,,TX,192284,4993902,5186186
48203,Harrison County,,TX,4390,73502,77892
48205,Hartley County,,TX,402,4732,5134
48207,Haskell County,,TX,348,5490,5838
48209,Hays County,,TX,14010,191287,205297
48211,Hemphill County,,TX,244,5032,5276
48213,Henderson County,,TX,5309,79560,84869
48215,Hidalgo County,,TX,22723,853395,876118
48217,Hill County,,TX,2350,36522,38872
48219,Hockley County,,TX,1739,24641,26380
48221,Hood County,,TX,3440,60039,63479
48223,Hopkins County,,TX,1927,38976,40903
48225,Houston County,,TX,1076,20675,21751
48227,Howard County,,TX,2092,33862,35954
48229,Hudspeth County,,TX,242,3440,3682
48231,Hunt County,,TX,6106,91728,97834
48233,Hutchinson County,,TX,1210,24179,25389
48235,Irion County,,TX,180,1863,2043
48237,Jack County,,TX,508,8395,8903
48239,Jackson County,,TX,907,17341,18248
48241,Jasper County,,TX,2147,36492,38639
48243,Jeff Davis County,,TX,144,2359,2503
48245,Jefferson County,,TX,12167,268184,280351
48247,Jim Hogg County,,TX,277,5593,5870
48249,Jim Wells County,,TX,2663,46055,48718
48251,Johnson County,,TX,10698,177626,188324
48253,Jones County,,TX,1121,16242,17363
48255,Karnes County,,TX,835,14350,15185
48257,Kaufman County,,TX,8326,128085,136411
48259,Kendall County,,TX,3040,47693,50733
48261,Kenedy County,,TX,63,386,449
48263,Kent County,,TX,-2,857,855
48265,Kerr County,,TX,3083,57302,60385
48267,Kimble County,,TX,297,4845,5142
48269,King County,,TX,-2,291,289
48271,Kinney County,,TX,169,3267,3436
48273,Kleberg County,,TX,2516,31559,34075
48275,Knox County,,TX,224,3925,4149
48277,Lamar County,,TX,2363,52736,55099
48279,Lamb County,,TX,1115,14332,15447
48281,Lampasas County,,TX,1475,22484,23959
48283,La Salle County,,TX,419,6289,6708
48285,Lavaca County,,TX,1017,23495,24512
48287,Lee County,,TX,928,19434,20362
48289,Leon County,,TX,1174,19188,20362
48291,Liberty County,,TX,5491,78667,84158
48293,Limestone County,,TX,1389,23757,25146
48295,Lipscomb County,,TX,253,4022,4275
48297,Live Oak County,,TX,887,11694,12581
48299,Llano County,,TX,1368,19067,20435
48301,Loving County,,TX,0,71,71
48303,Lubbock County,,TX,13995,303296,317291
48305,Lynn County,,TX,458,6301,6759
48307,McCulloch County,,TX,446,9113,9559
48309,McLennan County,,TX,10465,260778,271243
48311,McMullen County,,TX,72,1055,1127
48313,Madison County,,TX,789,12699,13488
48315,Marion County,,TX,777,9495,10272
48317,Martin County,,TX,443,5901,6344
48319,Mason County,,TX,256,4510,4766
48321,Matagorda County,,TX,1989,40946,42935
48323,Maverick County,,TX,2687,72430,75117
48325,Medina County,,TX,2925,48922,51847
48327,Menard County,,TX,123,2161,2284
48329,Midland County,,TX,13377,179794,193171
48331,Milam County,,TX,1359,26096,27455
48333,Mills County,,TX,269,5213,5482
48335,Mitchell County,,TX,500,7597,8097
48337,Montague County,,TX,1287,21212,22499
48339,Montgomery County,,TX,34356,580554,614910
48341,Moore County,,TX,2136,25882,28018
48343,Morris County,,TX,975,13408,14383
48345,Motley County,,TX,-2,1182,1180
48347,Nacogdoches County,,TX,3599,62476,66075
48349,Navarro County,,TX,2841,52519,55360
48351,Newton County,,TX,978,12391,13369
48353,Nolan County,,TX,1088,16439,17527
48355,Nueces County,,TX,17549,381746,399295
48357,Ochiltree County,,TX,654,12863,13517
48359,Oldham County,,TX,139,2263,2402
48361,Orange County,,TX,4583,93275,97858
48363,Palo Pinto County,,TX,1954,29089,31043
48365,Panola County,,TX,1477,26390,27867
48367,Parker County,,TX,11115,141369,152484
48369,Parmer County,,TX,978,11975,12953
48371,Pecos County,,TX,930,15847,16777
48373,Polk County,,TX,4742,53631,58373
48375,Potter County,,TX,11259,125536,136795
48377,Presidio County,,TX,917,9879,10796
48379,Rains County,,TX,744,10371,11115
48381,Randall County,,TX,10275,144617,154892
48383,Reagan County,,TX,268,4412,4680
48385,Real County,,TX,285,3519,3804
48387,Red River County,,TX,738,13002,13740
48389,Reeves County,,TX,751,12441,13192
48391,Refugio County,,TX,474,8658,9132
48393,Roberts County,,TX,60,992,1052
48395,Robertson County,,TX,1155,18085,19240
48397,Rockwall County,,TX,7130,101623,108753
48399,Runnels County,,TX,529,11565,12094
48401,Rusk County,,TX,3619,54292,57911
48403,Sabine County,,TX,551,10417,10968
48405,San Augustine County,,TX,575,8325,8900
48407,San Jacinto County,,TX,1940,24447,26387
48409,San Patricio County,,TX,6037,77729,83766
48411,San Saba County,,TX,286,6189,6475
48413,Schleicher County,,TX,198,3272,3470
48415,Scurry County,,TX,1024,18377,19401
48417,Shackelford County,,TX,188,3687,3875
48419,Shelby County,,TX,1464,27454,28918
48421,Sherman County,,TX,236,2917,3153
48423,Smith County,,TX,12383,243983,256366
48425,Somervell County,,TX,534,9427,9961
48427,Starr County,,TX,2390,71360,73750
48429,Stephens County,,TX,448,9142,9590
48431,Sterling County,,TX,101,1501,1602
48433,Stonewall County,,TX,68,1574,1642
48435,Sutton County,,TX,287,4778,5065
48437,Swisher County,,TX,438,7534,7972
48439,Tarrant County,,TX,101894,2248737,2350631
48441,Taylor County,,TX,9130,147881,157011
48443,Terrell County,,TX,70,925,995
48445,Terry County,,TX,747,12606,13353
48447,Throckmorton County,,TX,106,1652,1758
48449,Titus County,,TX,1948,36701,38649
48451,Tom Green County,,TX,7961,125980,133941
48453,Travis County,,TX,241517,1264505,1506022
48455,Trinity County,,TX,922,13672,14594
48457,Tyler County,,TX,1181,19096,20277
48459,Upshur County,,TX,3172,40725,43897
48461,Upton County,,TX,248,3906,4154
48463,Uvalde County,,TX,1722,30667,32389
48465,Val Verde County,,TX,3327,56810,60137
48467,Van Zandt County,,TX,3492,55005,58497
48469,Victoria County,,TX,4936,105506,110442
48471,Walker County,,TX,4454,53379,57833
48473,Waller County,,TX,4237,45141,49378
48475,Ward County,,TX,1010,12777,13787
48477,Washington County,,TX,1865,38950,40815
48479,Webb County,,TX,7996,308784,316780
48481,Wharton County,,TX,2058,49248,51306
48483,Wheeler County,,TX,359,6406,6765
48485,Wichita County,,TX,7466,132204,139670
48487,Wilbarger County,,TX,764,14105,14869
48489,Willacy County,,TX,896,20334,21230
48491,Williamson County,,TX,34557,568032,602589
48493,Wilson County,,TX,3039,51488,54527
48495,Winkler County,,TX,554,8675,9229
48497,Wise County,,TX,3937,68616,72553
48499,Wood County,,TX,2774,44566,47340
48501,Yoakum County,,TX,614,10181,10795
48503,Young County,,TX,950,20567,21517
48505,Zapata County,,TX,486,14939,15425
48507,Zavala County,,TX,636,12462,13098
49001,Beaver County,,UT,376,7510,7886
49003,Box Elder County,,UT,2849,60679,63528
49005,Cache County,,UT,6595,129403,135998
49007,Carbon County,,UT,1064,21681,22745
49009,Daggett County,,UT,64,1071,1135
49011,Davis County,,UT,21214,386040,407254
49013,Duchesne County,,UT,1490,23013,24503
49015,Emery County,,UT,651,11542,12193
49017,Garfield County,,UT,334,5467,5801
49019,Grand County,,UT,729,11304,12033
49021,Iron County,,UT,3258,47154,50412
49023,Juab County,,UT,546,11585,12131
49025,Kane County,,UT,516,7429,7945
49027,Millard County,,UT,578,14573,15151
49029,Morgan County,,UT,592,13088,13680
49031,Piute County,,UT,68,1478,1546
49033,Rich County,,UT,87,2510,2597
49035,Salt Lake County,,UT,49621,1287939,1337560
49037,San Juan County,,UT,876,11195,12071
49039,Sanpete County,,UT,1532,26668,28200
49041,Sevier County,,UT,956,22527,23483
49043,Summit County,,UT,3787,51811,55598
49045,Tooele County,,UT,3657,69693,73350
49047,Uintah County,,UT,2502,39452,41954
49049,Utah County,,UT,26550,611514,638064
49051,Wasatch County,,UT,2265,31880,34145
49053,Washington County,,UT,8844,163470,172314
49055,Wayne County,,UT,109,2919,3028
49057,Weber County,,UT,13113,275938,289051
50001,Addison County,,VT,2170,44531,46701
50003,Bennington County,,VT,1692,44064,45756
50005,Caledonia County,,VT,1484,35757,37241
50007,Chittenden County,,VT,8117,194736,202853
50009,Essex County,,VT,295,6846,7141
50011,Franklin County,,VT,2115,60576,62691
50013,Grand Isle County,,VT,565,8973,9538
50015,Lamoille County,,VT,1556,31160,32716
50017,Orange County,,VT,1548,35568,37116
50019,Orleans County,,VT,1041,32864,33905
50021,Rutland County,,VT,2655,73770,76425
50023,Washington County,,VT,3107,73236,76343
50025,Windham County,,VT,2455,52334,54789
50027,Windsor County,,VT,3454,70356,73810
51001,Accomack County,,VA,1718,39732,41450
51003,Albemarle County,,VA,7340,116228,123568
51005,Alleghany County,,VA,734,17420,18154
51007,Amelia County,,VA,745,15231,15976
51009,Amherst County,,VA,1531,35090,36621
51011,Appomattox County,,VA,739,17710,18449
51013,Arlington County,,VA,28772,257411,286183
51015,Augusta County,,VA,3717,86830,90547
51017,Bath County,,VA,251,5426,5677
51019,Bedford County,,VA,4240,90587,94827
51021,Bland County,,VA,217,6570,6787
51023,Botetourt County,,VA,1923,40757,42680
51025,Brunswick County,,VA,718,15954,16672
51027,Buchanan County,,VA,737,21038,21775
51029,Buckingham County,,VA,619,15714,16333
51031,Campbell County,,VA,3612,61969,65581
51033,Caroline County,,VA,2138,33298,35436
51035,Carroll County,,VA,1118,30966,32084
51036,Charles City County,,VA,308,8166,8474
51037,Charlotte County,,VA,614,13132,13746
51041,Chesterfield County,,VA,20534,401409,421943
51043,Clarke County,,VA,956,16727,17683
51045,Craig County,,VA,177,5676,5853
51047,Culpeper County,,VA,2892,56045,58937
51049,Cumberland County,,VA,674,10352,11026
51051,Dickenson County,,VA,437,13673,14110
51053,Dinwiddie County,,VA,1809,31293,33102
51057,Essex County,,VA,580,12895,13475
51059,Fairfax County,,VA,91312,1353964,1445276
51061,Fauquier County,,VA,4320,82921,87241
51063,Floyd County,,VA,638,17276,17914
51065,Fluvanna County,,VA,1523,29765,31288
51067,Franklin County,,VA,2085,60495,62580
51069,Frederick County,,VA,4949,97848,102797
51071,Giles County,,VA,679,18848,19527
51073,Gloucester County,,VA,2184,44648,46832
51075,Goochland County,,VA,1261,26073,27334
51077,Grayson County,,VA,783,15499,16282
51079,Greene County,,VA,1152,22441,23593
51081,Greensville County,,VA,755,8586,9341
51083,Halifax County,,VA,1093,38126,39219
51085,Hanover County,,VA,5519,125727,131246
51087,Henrico County,,VA,24916,380037,404953
51089,Henry County,,VA,2294,55928,58222
51091,Highland County,,VA,-2,2659,2657
51093,Isle of Wight County,,VA,2338,43694,46032
51095,James City County,,VA,5012,87531,92543
51097,King and Queen County,,VA,429,7573,8002
51099,King George County,,VA,2044,28853,30897
51101,King William County,,VA,1023,20089,21112
51103,Lancaster County,,VA,631,13646,14277
51105,Lee County,,VA,647,20635,21282
51107,Loudoun County,,VA,24938,453229,478167
51109,Louisa County,,VA,1904,38280,40184
51111,Lunenburg County,,VA,656,12182,12838
51113,Madison County,,VA,621,15210,15831
51115,Mathews County,,VA,397,10250,10647
51117,Mecklenburg County,,VA,1304,33240,34544
51119,Middlesex County,,VA,674,12267,12941
51121,Montgomery County,,VA,4754,81041,85795
51125,Nelson County,,VA,798,17750,18548
51127,New Kent County,,VA,1280,24138,25418
51131,Northampton County,,VA,623,14005,14628
51133,Northumberland County,,VA,736,14639,15375
51135,Nottoway County,,VA,866,15536,16402
51137,Orange County,,VA,2429,40237,42666
51139,Page County,,VA,763,26766,27529
51141,Patrick County,,VA,673,18776,19449
51143,Pittsylvania County,,VA,2792,69157,71949
51145,Powhatan County,,VA,1336,32833,34169
51147,Prince Edward County,,VA,1130,18534,19664
51149,Prince George County,,VA,3766,37525,41291
51153,Prince William County,,VA,34461,531230,565691
51155,Pulaski County,,VA,1405,35721,37126
51157,Rappahannock County,,VA,426,8579,9005
51159,Richmond County,,VA,464,8457,8921
51161,Roanoke County,,VA,6729,113040,119769
51163,Rockbridge County,,VA,983,24501,25484
51165,Rockingham County,,VA,3761,93781,97542
51167,Russell County,,VA,859,26472,27331
51169,Scott County,,VA,787,21483,22270
51171,Shenandoah County,,VA,2247,50646,52893
51173,Smyth County,,VA,1070,32508,33578
51175,Southampton County,,VA,1034,18767,19801
51177,Spotsylvania County,,VA,8724,151228,159952
51179,Stafford County,,VA,11181,159389,170570
51181,Surry County,,VA,406,7517,7923
51183,Sussex County,,VA,659,10380,11039
51185,Tazewell County,,VA,1565,42415,43980
51187,Warren County,,VA,2436,44928,47364
51191,Washington County,,VA,2504,56957,59461
51193,Westmoreland County,,VA,1137,20024,21161
51195,Wise County,,VA,1514,36003,37517
51197,Wythe County,,VA,1088,31896,32984
51199,York County,,VA,6137,78616,84753
51510,Alexandria city,,VA,22135,173198,195333
51515,Bedford city,,VA,0,0,0
51520,Bristol city,,VA,1445,16499,17944
51530,Buena Vista city,,VA,555,6710,7265
51540,Charlottesville city,,VA,4119,41680,45799
51550,Chesapeake city,,VA,19607,269237,288844
51570,Colonial Heights city,,VA,2093,20336,22429
51580,Covington city,,VA,530,6563,7093
51590,Danville city,,VA,2740,43481,46221
51595,Emporia city,,VA,634,6052,6686
51600,Fairfax city,,VA,2972,27590,30562
51610,Falls Church city,,VA,1601,14834,16435
51620,Franklin city,,VA,743,8949,9692
51630,Fredericksburg city,,VA,4370,25836,30206
51640,Galax city,,VA,674,7270,7944
51650,Hampton city,,VA,14572,145847,160419
51660,Harrisonburg city,,VA,3780,39505,43285
51670,Hopewell city,,VA,2450,23635,26085
51678,Lexington city,,VA,506,5261,5767
51680,Lynchburg city,,VA,5645,71899,77544
51683,Manassas city,,VA,5519,48110,53629
51685,Manassas Park city,,VA,2180,17253,19433
51690,Martinsville city,,VA,1107,14203,15310
51700,Newport News city,,VA,18831,194415,213246
51710,Norfolk city,,VA,27115,224856,251971
51720,Norton city,,VA,514,3910,4424
51730,Petersburg city,,VA,4501,33005,37506
51735,Poquoson city,,VA,718,14864,15582
51740,Portsmouth city,,VA,10017,102186,112203
51750,Radford city,,VA,1138,10926,12064
51760,Richmond city,,VA,20880,201009,221889
51770,Roanoke city,,VA,7893,106102,113995
51775,Salem city,,VA,2124,27658,29782
51790,Staunton city,,VA,2133,26272,28405
51800,Suffolk city,,VA,6600,98378,104978
51810,Virginia Beach city,,VA,36245,520678,556923
51820,Waynesboro city,,VA,1875,24230,26105
51830,Williamsburg city,,VA,1814,10797,12611
51840,Winchester city,,VA,3330,29706,33036
53001,Adams County,,WA,1394,24976,26370
53003,Asotin County,,WA,1429,23477,24906
53005,Benton County,,WA,11007,215919,226926
53007,Chelan County,,WA,4901,92433,97334
53009,Clallam County,,WA,3160,81415,84575
53011,Clark County,,WA,21381,529454,550835
53013,Columbia County,,WA,199,4156,4355
53015,Cowlitz County,,WA,4929,111744,116673
53017,Douglas County,,WA,3050,46039,49089
53019,Ferry County,,WA,339,6680,7019
53021,Franklin County,,WA,6856,102804,109660
53023,Garfield County,,WA,104,2340,2444
53025,Grant County,,WA,5414,112203,117617
53027,Grays Harbor County,,WA,3146,71279,74425
53029,Island County,,WA,6730,92993,99723
53031,Jefferson County,,WA,1733,35342,37075
53033,King County,,WA,104486,2518291,2622777
53035,Kitsap County,,WA,14722,293753,308475
53037,Kittitas County,,WA,2343,41236,43579
53039,Klickitat County,,WA,1394,23757,25151
53041,Lewis County,,WA,3900,82042,85942
53043,Lincoln County,,WA,570,11519,12089
53045,Mason County,,WA,3478,62359,65837
53047,Okanogan County,,WA,1999,46122,48121
53049,Pacific County,,WA,1029,22483,23512
53051,Pend Oreille County,,WA,883,12711,13594
53053,Pierce County,,WA,51275,953029,1004304
53055,San Juan County,,WA,914,19252,20166
53057,Skagit County,,WA,5970,141470,147440
53059,Skamania County,,WA,708,11496,12204
53061,Snohomish County,,WA,38165,894696,932861
53063,Spokane County,,WA,18411,548857,567268
53065,Stevens County,,WA,2467,45818,48285
53067,Thurston County,,WA,17474,309797,327271
53069,Wahkiakum County,,WA,200,4146,4346
53071,Walla Walla County,,WA,2889,64236,67125
53073,Whatcom County,,WA,8324,233752,242076
53075,Whitman County,,WA,2808,37444,40252
53077,Yakima County,,WA,8717,296266,304983
54001,Barbour County,,WV,651,16755,17406
54003,Berkeley County,,WV,5408,128117,133525
54005,Boone County,,WV,857,23318,24175
54007,Braxton County,,WV,473,13887,14360
54009,Brooke County,,WV,1070,26663,27733
54011,Cabell County,,WV,4972,97805,102777
54013,Calhoun County,,WV,267,7058,7325
54015,Clay County,,WV,306,8834,9140
54017,Doddridge County,,WV,308,7379,7687
54019,Fayette County,,WV,2024,43600,45624
54021,Gilmer County,,WV,236,6498,6734
54023,Grant County,,WV,346,13076,13422
54025,Greenbrier County,,WV,1418,37506,38924
54027,Hampshire County,,WV,1079,24598,25677
54029,Hancock County,,WV,1507,36164,37671
54031,Hardy County,,WV,634,16060,16694
54033,Harrison County,,WV,3022,78761,81783
54035,Jackson County,,WV,941,31897,32838
54037,Jefferson County,,WV,3140,63891,67031
54039,Kanawha County,,WV,9652,215907,225559
54041,Lewis County,,WV,769,19688,20457
54043,Lincoln County,,WV,831,20750,21581
54045,Logan County,,WV,1305,33758,35063
54047,McDowell County,,WV,656,16528,17184
54049,Marion County,,WV,2457,64209,66666
54051,Marshall County,,WV,1516,36419,37935
54053,Mason County,,WV,972,26967,27939
54055,Mercer County,,WV,2289,62744,65033
54057,Mineral County,,WV,1164,32000,33164
54059,Mingo County,,WV,1269,23288,24557
54061,Monongalia County,,WV,6400,96486,102886
54063,Monroe County,,WV,652,14209,14861
54065,Morgan County,,WV,869,19007,19876
54067,Nicholas County,,WV,869,26730,27599
54069,Ohio County,,WV,2604,49586,52190
54071,Pendleton County,,WV,203,8498,8701
54073,Pleasants County,,WV,272,8304,8576
54075,Pocahontas County,,WV,310,9282,9592
54077,Preston County,,WV,1155,35714,36869
54079,Putnam County,,WV,3114,66876,69990
54081,Raleigh County,,WV,3065,80212,83277
54083,Randolph County,,WV,1026,30958,31984
54085,Ritchie County,,WV,341,10933,11274
54087,Roane County,,WV,632,14456,15088
54089,Summers County,,WV,510,10989,11499
54091,Taylor County,,WV,781,18398,19179
54093,Tucker County,,WV,229,7917,8146
54095,Tyler County,,WV,355,9898,10253
54097,Upshur County,,WV,932,26010,26942
54099,Wayne County,,WV,1788,40321,42109
54101,Webster County,,WV,171,8184,8355
54103,Wetzel County,,WV,831,17705,18536
54105,Wirt County,,WV,235,6073,6308
54107,Wood County,,WV,2949,98317,101266
54109,Wyoming County,,WV,631,20542,21173
55001,Adams County,,WI,1146,21108,22254
55003,Ashland County,,WI,771,18057,18828
55005,Barron County,,WI,2228,56183,58411
55007,Bayfield County,,WI,677,18812,19489
55009,Brown County,,WI,9157,323957,333114
55011,Buffalo County,,WI,633,16790,17423
55013,Burnett County,,WI,769,18553,19322
55015,Calumet County,,WI,2769,62718,65487
55017,Chippewa County,,WI,3050,76742,79792
55019,Clark County,,WI,1631,41496,43127
55021,Columbia County,,WI,3476,72535,76011
55023,Crawford County,,WI,702,19320,20022
55025,Dane County,,WI,22337,637073,659410
55027,Dodge County,,WI,4287,106326,110613
55029,Door County,,WI,1256,37378,38634
55031,Douglas County,,WI,1993,49757,51750
55033,Dunn County,,WI,2270,46938,49208
55035,Eau Claire County,,WI,5065,115470,120535
55037,Florence County,,WI,232,5365,5597
55039,Fond du Lac County,,WI,4032,126601,130633
55041,Forest County,,WI,318,10570,10888
55043,Grant County,,WI,2056,57846,59902
55045,Green County,,WI,1705,47610,49315
55047,Green Lake County,,WI,1096,23090,24186
55049,Iowa County,,WI,1202,29954,31156
55051,Iron County,,WI,346,7145,7491
55053,Jackson County,,WI,974,23040,24014
55055,Jefferson County,,WI,4314,102173,106487
55057,Juneau County,,WI,1526,29617,31143
55059,Kenosha County,,WI,7975,197962,205937
55061,Kewaunee County,,WI,816,25975,26791
55063,La Crosse County,,WI,4639,135910,140549
55065,Lafayette County,,WI,846,22019,22865
55067,Langlade County,,WI,712,23611,24323
55069,Lincoln County,,WI,1187,35085,36272
55071,Manitowoc County,,WI,2617,101484,104101
55073,Marathon County,,WI,4822,171197,176019
55075,Marinette County,,WI,2030,49426,51456
55077,Marquette County,,WI,838,18411,19249
55078,Menominee County,,WI,253,4417,4670
55079,Milwaukee County,,WI,37113,1090947,1128060
55081,Monroe County,,WI,2461,54650,57111
55083,Oconto County,,WI,1801,46604,48405
55085,Oneida County,,WI,1978,46325,48303
55087,Outagamie County,,WI,10890,231273,242163
55089,Ozaukee County,,WI,4487,114368,118855
55091,Pepin County,,WI,387,8877,9264
55093,Pierce County,,WI,2277,46258,48535
55095,Polk County,,WI,2068,53647,55715
55097,Portage County,,WI,3167,82635,85802
55099,Price County,,WI,562,17320,17882
55101,Racine County,,WI,8312,237884,246196
55103,Richland County,,WI,863,20077,20940
55105,Rock County,,WI,5713,196576,202289
55107,Rusk County,,WI,760,16432,17192
55109,St. Croix County,,WI,4270,109339,113609
55111,Sauk County,,WI,3231,80808,84039
55113,Sawyer County,,WI,854,19956,20810
55115,Shawano County,,WI,2091,49397,51488
55117,Sheboygan County,,WI,3822,147048,150870
55119,Taylor County,,WI,738,23822,24560
55121,Trempealeau County,,WI,1726,39636,41362
55123,Vernon County,,WI,1381,35318,36699
55125,Vilas County,,WI,1390,26559,27949
55127,Walworth County,,WI,5493,120177,125670
55129,Washburn County,,WI,989,19765,20754
55131,Washington County,,WI,5637,173734,179371
55133,Waukesha County,,WI,18967,513406,532373
55135,Waupaca County,,WI,2244,63433,65677
55137,Waushara County,,WI,1292,27858,29150
55139,Winnebago County,,WI,8534,200018,208552
55141,Wood County,,WI,2856,92842,95698
56001,Albany County,,WY,2863,34481,37344
56003,Big Horn County,,WY,606,13303,13909
56005,Campbell County,,WY,2853,57954,60807
56007,Carbon County,,WY,1361,17751,19112
56009,Converse County,,WY,1169,16769,17938
56011,Crook County,,WY,437,8469,8906
56013,Fremont County,,WY,2022,45482,47504
56015,Goshen County,,WY,759,14269,15028
56017,Hot Springs County,,WY,243,5446,5689
56019,Johnson County,,WY,579,10356,10935
56021,Laramie County,,WY,7350,113755,121105
56023,Lincoln County,,WY,1177,21360,22537
56025,Natrona County,,WY,4940,95527,100467
56027,Niobrara County,,WY,99,2757,2856
56029,Park County,,WY,1870,35943,37813
56031,Platte County,,WY,584,10561,11145
56033,Sheridan County,,WY,1878,35631,37509
56035,Sublette County,,WY,788,10880,11668
56037,Sweetwater County,,WY,3123,54442,57565
56039,Teton County,,WY,2333,32421,34754
56041,Uinta County,,WY,1245,25362,26607
56043,Washakie County,,WY,392,9991,10383
56045,Weston County,,WY,385,8412,8797
2270,Kusilvak Census Area,,AK,243,7885,8128
46113,Oglala Lakota County,,SD,3158,8944,12102
