Id,Label,timeset,state,totalmig,totalnonmig,population,indegree,outdegree,Degree,weighted indegree,weighted outdegree,Weighted Degree,Eccentricity,closnesscentrality,harmonicclosnesscentrality,betweenesscentrality,Authority,Hub,modularity_class,pageranks,componentnumber,strongcompnum,clustering,eigencentrality
1001,Autauga County,,AL,4715,50793,55508,12,10,22,2821,2322,5143,6,0.316805,0.334577,408.342345,0.00366,0.002582,0,0.000213,0,28,0.519048,0.026979
1003,Baldwin County,,AL,9033,152298,161331,40,29,69,6351,4299,10650,6,0.348394,0.372629,6424.250335,0.011974,0.0104,0,0.000578,0,28,0.39596,0.086688
1005,Barbour County,,AL,1939,28101,30040,10,11,21,832,939,1771,6,0.296633,0.311868,6100.948347,0.000509,0.000981,0,0.000253,0,28,0.454545,0.003863
1007,Bibb County,,AL,1329,21358,22687,4,5,9,1009,835,1844,6,0.292014,0.305045,106.868011,0.000667,0.00052,0,0.000111,0,28,0.65,0.004155
1009,Blount County,,AL,3154,54246,57400,8,9,17,2990,2132,5122,6,0.292249,0.305934,8.785686,0.000628,0.000615,0,0.000185,0,28,0.6,0.004644
1011,Bullock County,,AL,789,10765,11554,3,4,7,208,453,661,7,0.278075,0.289962,2.119048,0.000293,0.000238,0,0.0001,0,28,0.666667,0.001959
1013,Butler County,,AL,1199,22939,24138,4,5,9,297,458,755,7,0.278395,0.290667,5.217558,0.000293,0.000335,0,0.000117,0,28,0.466667,0.002041
1015,Calhoun County,,AL,7572,131785,139357,20,27,47,3246,3806,7052,6,0.313761,0.333838,10425.477709,0.003868,0.004945,0,0.000395,0,28,0.353175,0.029336
1017,Chambers County,,AL,2412,43723,46135,7,6,13,1321,1465,2786,7,0.284693,0.297561,86.329582,0.000432,0.00035,0,0.000182,0,28,0.547619,0.003274
1019,Cherokee County,,AL,1380,25163,26543,5,5,10,843,794,1637,7,0.239674,0.248997,31.936416,0.000094,0.000087,0,0.000161,0,28,0.55,0.001169
1021,Chilton County,,AL,2081,39932,42013,7,6,13,1335,1120,2455,6,0.293547,0.307241,8.13337,0.000906,0.000728,0,0.00015,0,28,0.714286,0.005977
1023,Choctaw County,,AL,777,16481,17258,3,3,6,144,216,360,7,0.279439,0.291344,11.286144,0.000066,0.000217,49,0.000089,0,28,0.3,0.000473
1025,Clarke County,,AL,1620,32057,33677,5,8,13,621,750,1371,6,0.294857,0.309219,2634.364775,0.000379,0.000872,0,0.000115,0,28,0.517857,0.002567
1027,Clay County,,AL,934,16541,17475,4,6,10,466,525,991,7,0.239063,0.248137,9.668725,0.000069,0.000054,0,0.000124,0,28,0.466667,0.00075
1029,Cleburne County,,AL,930,14185,15115,5,4,9,627,551,1178,7,0.240109,0.249444,6.177867,0.000095,0.000092,0,0.000151,0,28,0.55,0.00122
1031,Coffee County,,AL,4986,45184,50170,17,21,38,2376,2468,4844,6,0.319943,0.339634,1699.693669,0.004528,0.004204,0,0.000266,0,28,0.451087,0.030312
1033,Colbert County,,AL,3262,60043,63305,9,8,17,2063,1925,3988,6,0.304909,0.319745,3384.702598,0.000834,0.001302,0,0.000197,0,28,0.533333,0.006023
1035,Conecuh County,,AL,939,14867,15806,4,6,10,327,479,806,6,0.289859,0.30383,12.336595,0.00031,0.000703,0,0.000109,0,28,0.595238,0.001925
1037,Coosa County,,AL,1219,13792,15011,6,5,11,915,894,1809,6,0.293547,0.307126,216.165046,0.000775,0.000602,0,0.000139,0,28,0.733333,0.004896
1039,Covington County,,AL,2229,38634,40863,11,13,24,852,1060,1912,6,0.295397,0.31106,293.8122,0.001235,0.001639,0,0.00022,0,28,0.423077,0.008591
1041,Crenshaw County,,AL,940,15635,16575,5,5,10,526,491,1017,7,0.278635,0.290856,3.673037,0.000339,0.00028,0,0.000122,0,28,0.75,0.002477
1043,Cullman County,,AL,3928,83757,87685,12,11,23,2197,2140,4337,6,0.293933,0.308474,50.052285,0.00108,0.000922,0,0.000233,0,28,0.521978,0.00788
1045,Dale County,,AL,7588,49359,56947,21,25,46,3447,3945,7392,6,0.335139,0.356679,5771.07266,0.005624,0.007045,0,0.000326,0,28,0.522792,0.038508
1047,Dallas County,,AL,2469,50698,53167,7,13,20,749,1273,2022,6,0.297818,0.313668,262.234645,0.000764,0.001701,0,0.000168,0,28,0.450549,0.005084
1049,DeKalb County,,AL,4146,75391,79537,12,11,23,3086,2621,5707,6,0.295788,0.310601,695.488583,0.0011,0.000922,0,0.000263,0,28,0.410256,0.007971
1051,Elmore County,,AL,5557,70837,76394,12,14,26,3983,3215,7198,6,0.321393,0.338321,395.34605,0.001208,0.002563,0,0.00024,0,28,0.444444,0.008103
1053,Escambia County,,AL,2049,38826,40875,7,7,14,1075,1049,2124,6,0.291108,0.305515,75.456419,0.001393,0.001154,0,0.000143,0,28,0.714286,0.009836
1055,Etowah County,,AL,5532,105822,111354,14,15,29,2856,3296,6152,6,0.30555,0.322629,1163.85654,0.00136,0.001919,0,0.000287,0,28,0.352941,0.009269
1057,Fayette County,,AL,1202,21931,23133,6,4,10,665,573,1238,7,0.265504,0.276117,260.306308,0.000552,0.000067,0,0.000156,0,28,0.666667,0.003626
1059,Franklin County,,AL,1973,32876,34849,7,8,15,920,1115,2035,7,0.242331,0.251861,97.014375,0.000048,0.000052,0,0.0002,0,28,0.410714,0.000878
1061,Geneva County,,AL,2020,25894,27914,7,5,12,1039,1175,2214,7,0.253798,0.264158,42.479602,0.000979,0.000141,0,0.000172,0,28,0.380952,0.008
1063,Greene County,,AL,624,9853,10477,5,2,7,369,318,687,7,0.26514,0.275297,110.790555,0.000554,0.000049,0,0.000119,0,28,0.65,0.003396
1065,Hale County,,AL,1071,18831,19902,3,4,7,628,636,1264,6,0.291985,0.304873,0.333333,0.000107,0.000408,0,0.000101,0,28,0.7,0.000687
1067,Henry County,,AL,1331,17649,18980,3,3,6,710,744,1454,7,0.253709,0.263699,0,0.000128,0.000093,0,0.000095,0,28,1,0.000966
1069,Houston County,,AL,6724,96513,103237,27,29,56,4127,3918,8045,6,0.31861,0.340294,13009.108238,0.00539,0.007859,0,0.000485,0,28,0.390374,0.039571
1071,Jackson County,,AL,2740,58224,60964,6,8,14,1411,1578,2989,6,0.295607,0.309913,133.381204,0.000588,0.000881,0,0.000165,0,28,0.553571,0.004444
1073,Jefferson County,,AL,37708,735609,773317,123,136,259,24519,29982,54501,5,0.411815,0.450006,111778.412806,0.044007,0.055099,0,0.00171,0,28,0.310417,0.314761
1075,Lamar County,,AL,1072,17487,18559,5,6,11,378,553,931,7,0.271454,0.282824,63.367237,0.000045,0.00008,0,0.000156,0,28,0.466667,0.000716
1077,Lauderdale County,,AL,5091,94599,99690,11,20,31,2222,3041,5263,6,0.318227,0.337433,6024.658347,0.000836,0.003363,0,0.000276,0,28,0.376316,0.006301
1079,Lawrence County,,AL,2044,37927,39971,6,7,13,1306,1409,2715,7,0.282096,0.294671,490.829514,0.000394,0.000373,0,0.000146,0,28,0.690476,0.003205
1081,Lee County,,AL,9840,104667,114507,30,27,57,6175,5394,11569,6,0.31861,0.340563,3170.383394,0.0049,0.007013,0,0.000509,0,28,0.344029,0.036477
1083,Limestone County,,AL,3793,72884,76677,8,9,17,2611,2244,4855,6,0.293666,0.30766,252.421064,0.002278,0.000728,0,0.000165,0,28,0.572727,0.015896
1085,Lowndes County,,AL,994,13713,14707,3,4,7,563,695,1258,7,0.278049,0.289904,1.833333,0.000299,0.000242,0,0.000092,0,28,0.583333,0.001958
1087,Macon County,,AL,1510,21534,23044,4,5,9,659,775,1434,7,0.278235,0.290392,4.117858,0.000362,0.000282,0,0.000113,0,28,0.7,0.002398
1089,Madison County,,AL,17601,315922,333523,90,83,173,11258,10772,22030,6,0.391673,0.424991,38236.476064,0.037985,0.040984,0,0.001227,0,28,0.438107,0.277108
1091,Marengo County,,AL,1447,23556,25003,4,11,15,285,710,995,6,0.294947,0.309735,532.203217,0.00011,0.000925,0,0.000137,0,28,0.427273,0.00081
1093,Marion County,,AL,1699,27781,29480,8,8,16,770,877,1647,6,0.292631,0.306341,974.30578,0.000576,0.000432,0,0.000201,0,28,0.464286,0.003905
1095,Marshall County,,AL,5861,79310,85171,11,12,23,3512,3911,7423,6,0.293963,0.308674,42.000669,0.000978,0.00091,0,0.000218,0,28,0.576923,0.007026
1097,Mobile County,,AL,18195,428010,446205,66,76,142,8733,11001,19734,6,0.386158,0.418455,35708.596553,0.023842,0.03474,0,0.000898,0,28,0.404245,0.171843
1099,Monroe County,,AL,1346,25883,27229,5,6,11,403,560,963,6,0.291078,0.305343,5.071089,0.000385,0.000978,0,0.000122,0,28,0.690476,0.002664
1101,Montgomery County,,AL,18436,238213,256649,78,82,160,9946,12426,22372,6,0.38488,0.417957,54824.113955,0.027872,0.035197,0,0.001068,0,28,0.367912,0.202285
1103,Morgan County,,AL,7238,124726,131964,17,19,36,3733,4177,7910,6,0.315088,0.333242,2020.689342,0.003355,0.002637,0,0.000302,0,28,0.400433,0.023715
1105,Perry County,,AL,630,10865,11495,5,4,9,241,309,550,6,0.292014,0.304931,4.140476,0.000125,0.000409,0,0.000126,0,28,0.533333,0.000942
1107,Pickens County,,AL,1138,22828,23966,3,5,8,546,643,1189,6,0.293399,0.306519,56.983655,0.000134,0.000428,0,0.000098,0,28,0.65,0.000843
1109,Pike County,,AL,2157,26369,28526,9,10,19,857,1000,1857,6,0.294828,0.309322,110.273658,0.000905,0.000759,0,0.000184,0,28,0.490909,0.006028
1111,Randolph County,,AL,1135,22744,23879,8,7,15,598,564,1162,7,0.242452,0.253089,86.618612,0.000168,0.00015,0,0.000221,0,28,0.402778,0.002207
1113,Russell County,,AL,5507,51044,56551,5,7,12,3346,3667,7013,6,0.29636,0.310951,35.167086,0.00067,0.000899,0,0.000133,0,28,0.666667,0.004411
1115,St. Clair County,,AL,4211,63343,67554,10,7,17,3651,2790,6441,6,0.29222,0.305647,15.155615,0.000798,0.000614,0,0.000208,0,28,0.563636,0.005823
1117,Shelby County,,AL,13237,149943,163180,45,39,84,12319,8936,21255,6,0.360402,0.386951,7015.395384,0.013562,0.015059,0,0.000694,0,28,0.430334,0.099816
1119,Sumter County,,AL,935,14867,15802,2,5,7,109,400,509,6,0.292543,0.305779,46.307703,0.000104,0.000432,0,0.000074,0,28,0.5,0.000585
1121,Talladega County,,AL,4281,79645,83926,9,10,19,2451,2670,5121,6,0.306646,0.322939,897.769933,0.000925,0.001864,0,0.0002,0,28,0.572727,0.006286
1123,Tallapoosa County,,AL,2507,41839,44346,9,10,19,1185,1469,2654,6,0.305582,0.321764,840.534714,0.000828,0.001574,0,0.000206,0,28,0.490909,0.00553
1125,Tuscaloosa County,,AL,10149,167935,178084,34,38,72,5280,5712,10992,6,0.360625,0.387479,28194.475904,0.00603,0.012034,0,0.000607,0,28,0.293434,0.045094
1127,Walker County,,AL,3214,68547,71761,9,8,17,1797,1860,3657,6,0.29219,0.305705,429.511652,0.001674,0.000539,0,0.000206,0,28,0.511111,0.011804
1129,Washington County,,AL,1163,19049,20212,3,5,8,472,722,1194,7,0.27917,0.291212,720.525431,0.000287,0.000292,0,0.000096,0,28,0.35,0.001682
1131,Wilcox County,,AL,757,13289,14046,2,6,8,147,414,561,6,0.294738,0.30876,0.881494,0.000014,0.00078,0,0.000073,0,28,0.666667,0.000214
1133,Winston County,,AL,1560,25356,26916,6,8,14,809,908,1717,6,0.292337,0.305963,572.005068,0.00048,0.000463,0,0.000157,0,28,0.589286,0.00351
2013,Aleutians East Borough,,AK,472,1443,1915,0,1,1,0,89,89,7,0.28132,0.293899,0,0,0.000295,5,0.00005,0,29,0,0
2016,Aleutians West Census Area,,AK,793,3899,4692,3,3,6,183,298,481,6,0.312144,0.327589,0,0.001867,0.001456,5,0.000085,0,28,1,0.013628
2020,Anchorage Municipality,,AK,24777,274631,299408,115,119,234,15389,15567,30956,6,0.391304,0.429016,74932.900989,0.036702,0.042477,5,0.001824,0,28,0.274303,0.274033
2050,Bethel Census Area,,AK,905,15097,16002,3,4,7,230,417,647,7,0.28314,0.296323,5.578469,0.000492,0.000455,5,0.000113,0,28,0.666667,0.003494
2060,Bristol Bay Borough,,AK,217,1299,1516,0,1,1,0,62,62,7,0.28132,0.293899,0,0,0.000295,5,0.00005,0,30,0,0
2068,Denali Borough,,AK,420,2132,2552,1,2,3,59,111,170,7,0.283085,0.295979,0,0.000148,0.00043,5,0.000063,0,28,1,0.001074
2070,Dillingham Census Area,,AK,424,4387,4811,1,1,2,42,180,222,7,0.281277,0.293829,0,0.000342,0.000295,5,0.000063,0,28,0,0.002313
2090,Fairbanks North Star Borough,,AK,11279,89538,100817,51,52,103,5399,5342,10741,6,0.362514,0.390689,18082.780339,0.016764,0.018459,5,0.000771,0,28,0.371776,0.12079
2100,Haines Borough,,AK,291,2732,3023,0,1,1,0,52,52,7,0.24876,0.256593,0,0,0.000019,5,0.00005,0,31,0,0
2105,Hoonah-Angoon Census Area,,AK,0,0,0,0,0,0,0,0,0,0,0,0,0,0,0,1,0.00005,1,32,0,0
2110,Juneau City and Borough,,AK,2957,33805,36762,11,12,23,945,1076,2021,6,0.331018,0.350361,12250.626502,0.00235,0.003972,5,0.000318,0,28,0.316667,0.019172
2122,Kenai Peninsula Borough,,AK,4092,51861,55953,7,6,13,1410,1420,2830,6,0.330566,0.348985,116.501593,0.001357,0.003009,5,0.000176,0,28,0.680556,0.010547
2130,Ketchikan Gateway Borough,,AK,1577,14530,16107,4,6,10,267,418,685,6,0.31248,0.328374,3004.37184,0.001169,0.00135,5,0.000117,0,28,0.7,0.009007
2150,Kodiak Island Borough,,AK,2076,15028,17104,7,5,12,375,591,966,6,0.31615,0.332347,152.430044,0.00321,0.001926,5,0.000154,0,28,0.486111,0.023679
2164,Lake and Peninsula Borough,,AK,262,1412,1674,0,1,1,0,84,84,7,0.28132,0.293899,0,0,0.000295,5,0.00005,0,33,0,0
2170,Matanuska-Susitna Borough,,AK,4384,59426,63810,10,7,17,3178,1976,5154,6,0.331056,0.349702,302.16238,0.002828,0.00348,5,0.000234,0,28,0.536364,0.023087
2180,Nome Census Area,,AK,623,8414,9037,1,2,3,101,251,352,7,0.283085,0.295979,0,0.000342,0.00043,5,0.000063,0,28,1,0.002313
2185,North Slope Borough,,AK,710,7222,7932,2,2,4,138,275,413,7,0.283085,0.295979,0,0.00049,0.00043,5,0.000076,0,28,1,0.003387
2188,Northwest Arctic Borough,,AK,519,6155,6674,1,2,3,108,279,387,7,0.283085,0.295979,0,0.000342,0.00043,5,0.000063,0,28,1,0.002313
2195,Petersburg Census Area,,AK,0,0,0,0,0,0,0,0,0,0,0,0,0,0,0,2,0.00005,2,34,0,0
2220,Sitka City and Borough,,AK,1193,9421,10614,1,3,4,55,283,338,6,0.311342,0.326706,0,0.000342,0.001204,5,0.000063,0,28,1,0.002313
2240,Southeast Fairbanks Census Area,,AK,1125,6142,7267,1,3,4,84,348,432,7,0.283113,0.296151,0,0.000148,0.000434,5,0.000063,0,28,1,0.001074
2261,Valdez-Cordova Census Area,,AK,1301,10893,12194,3,4,7,313,510,823,7,0.28314,0.296323,0.666667,0.000493,0.000464,5,0.000094,0,28,0.75,0.003482
2270,Wade Hampton Census Area,,AK,403,6225,6628,2,2,4,95,187,282,7,0.281304,0.294001,0,0.000345,0.000299,5,0.000087,0,28,1,0.00243
2282,Yakutat City and Borough,,AK,125,605,730,0,0,0,0,0,0,0,0,0,0,0,0,3,0.00005,3,35,0,0
2290,Yukon-Koyukuk Census Area,,AK,630,5878,6508,2,2,4,199,381,580,7,0.283085,0.295979,0,0.00049,0.00043,5,0.000076,0,28,1,0.003387
4001,Apache County,,AZ,8675,57110,65785,11,14,25,5473,7306,12779,6,0.330341,0.349541,103.243617,0.004258,0.004535,5,0.000182,0,28,0.685714,0.032828
4003,Cochise County,,AZ,13775,110811,124586,48,48,96,6715,7587,14302,6,0.357785,0.384927,1130.932016,0.021714,0.021095,5,0.000619,0,28,0.516636,0.161259
4005,Coconino County,,AZ,14154,117428,131582,32,36,68,8507,9676,18183,6,0.344024,0.367831,593.610347,0.014801,0.015781,5,0.000458,0,28,0.620155,0.112938
4007,Gila County,,AZ,4118,52219,56337,11,9,20,2623,2709,5332,6,0.328475,0.346491,7.354442,0.005026,0.003563,5,0.000201,0,28,0.848485,0.04083
4009,Graham County,,AZ,2085,26581,28666,7,7,14,983,1221,2204,6,0.326813,0.344387,339.564687,0.002078,0.002321,5,0.000164,0,28,0.785714,0.017527
4011,Greenlee County,,AZ,940,8994,9934,3,3,6,225,457,682,6,0.326373,0.343395,0.47619,0.000123,0.001949,5,0.000102,0,28,0.75,0.001467
4012,La Paz County,,AZ,1567,14329,15896,8,6,14,669,711,1380,6,0.328697,0.346021,0,0.005208,0.002877,5,0.00015,0,28,1,0.040761
4013,Maricopa County,,AZ,152544,3155314,3307858,629,491,1120,180437,131193,311630,5,0.484177,0.547546,802447.32527,0.141979,0.127532,5,0.008262,0,28,0.084345,1
4015,Mohave County,,AZ,12534,146508,159042,45,28,73,10205,7187,17392,6,0.341759,0.364196,186.806201,0.019129,0.012311,5,0.000597,0,28,0.648936,0.147428
4017,Navajo County,,AZ,8326,85846,94172,22,17,39,6392,6210,12602,6,0.334638,0.354604,65.436228,0.007697,0.006185,5,0.000334,0,28,0.638528,0.060391
4019,Pima County,,AZ,48517,865548,914065,249,187,436,39815,35191,75006,5,0.426184,0.468169,41406.652224,0.098416,0.082312,5,0.002948,0,28,0.281369,0.689941
4021,Pinal County,,AZ,12051,136351,148402,27,21,48,11325,8134,19459,6,0.347229,0.369235,2259.151486,0.013701,0.009965,5,0.000388,0,28,0.65977,0.106034
4023,Santa Cruz County,,AZ,2526,45107,47633,5,3,8,1275,1732,3007,6,0.326629,0.343642,0,0.003931,0.002107,5,0.000109,0,28,1,0.030781
4025,Yavapai County,,AZ,12443,161596,174039,42,31,73,11110,7260,18370,6,0.348854,0.373076,294.333315,0.020756,0.015339,5,0.000563,0,28,0.685284,0.158466
4027,Yuma County,,AZ,12015,164798,176813,39,34,73,6994,6985,13979,6,0.356075,0.381143,215.606636,0.017784,0.018346,5,0.000497,0,28,0.688889,0.135232
5001,Arkansas County,,AR,1230,22778,24008,5,6,11,423,491,914,7,0.283471,0.296133,5.742857,0.000364,0.000293,50,0.000155,0,28,0.633333,0.002573
5003,Ashley County,,AR,1494,25723,27217,5,6,11,370,529,899,7,0.284888,0.298289,54.675354,0.000121,0.000287,50,0.000151,0,28,0.433333,0.000946
5005,Baxter County,,AR,2906,40924,43830,11,10,21,1087,993,2080,7,0.28934,0.303839,13795.816516,0.002327,0.000526,50,0.000328,0,28,0.288462,0.016584
5007,Benton County,,AR,12663,168568,181231,54,38,92,9160,7000,16160,6,0.35695,0.382926,19144.197577,0.017422,0.013242,50,0.000935,0,28,0.333051,0.128944
5009,Boone County,,AR,2468,36874,39342,10,9,19,1220,1090,2310,7,0.289081,0.303237,9474.832506,0.000723,0.000665,50,0.000343,0,28,0.336364,0.006062
5011,Bradley County,,AR,801,13063,13864,4,4,8,271,301,572,7,0.283416,0.295789,109.051143,0.000039,0.000265,50,0.00016,0,28,0.7,0.00068
5013,Calhoun County,,AR,382,5819,6201,2,3,5,89,169,258,7,0.246022,0.254557,0.726812,0.000021,0.000008,50,0.000088,0,28,0.666667,0.000236
5015,Carroll County,,AR,2059,24819,26878,6,8,14,599,950,1549,7,0.286828,0.301761,156.279042,0.000239,0.000668,50,0.000204,0,28,0.517857,0.002628
5017,Chicot County,,AR,1228,13564,14792,6,7,13,480,643,1123,7,0.284944,0.298197,167.646128,0.000404,0.0003,50,0.000164,0,28,0.452381,0.002654
5019,Clark County,,AR,1823,23209,25032,9,8,17,768,754,1522,6,0.317185,0.335478,2913.536711,0.000366,0.002099,50,0.000263,0,28,0.310606,0.003214
5021,Clay County,,AR,1243,17204,18447,5,5,10,539,611,1150,7,0.244081,0.25332,56.044643,0.000022,0.000029,50,0.000197,0,28,0.6,0.000774
5023,Cleburne County,,AR,2033,29123,31156,8,7,15,1063,1064,2127,7,0.284442,0.29763,3013.827764,0.001063,0.000429,50,0.000244,0,28,0.513889,0.007398
5025,Cleveland County,,AR,672,9921,10593,5,3,8,459,286,745,7,0.253931,0.263252,95.83256,0.000355,0.000034,50,0.000163,0,28,0.7,0.002491
5027,Columbia County,,AR,1647,26521,28168,5,8,13,423,705,1128,6,0.313626,0.331504,4251.422644,0.000345,0.001174,50,0.000141,0,28,0.321429,0.002323
5029,Conway County,,AR,1509,22821,24330,6,6,12,945,874,1819,7,0.28422,0.297085,8.840973,0.000379,0.000369,50,0.000189,0,28,0.595238,0.002701
5031,Craighead County,,AR,5935,83164,89099,27,23,50,3614,3224,6838,6,0.311642,0.329412,19797.242765,0.001497,0.001342,50,0.000655,0,28,0.225287,0.012677
5033,Crawford County,,AR,4145,56461,60606,10,11,21,2951,2652,5603,7,0.296633,0.310988,396.218779,0.000647,0.00075,50,0.000255,0,28,0.50641,0.005385
5035,Crittenden County,,AR,3810,54718,58528,12,9,21,2094,1950,4044,6,0.310047,0.325284,1664.687453,0.002128,0.00095,49,0.000247,0,28,0.467949,0.015281
5037,Cross County,,AR,1404,20840,22244,6,8,14,686,716,1402,6,0.307652,0.322234,799.674893,0.000715,0.000686,49,0.00017,0,28,0.535714,0.005279
5039,Dallas County,,AR,628,8238,8866,4,5,9,234,249,483,7,0.283471,0.29599,502.518028,0.000318,0.000235,50,0.000156,0,28,0.366667,0.002139
5041,Desha County,,AR,1270,16627,17897,5,5,10,484,616,1100,7,0.283527,0.296076,107.543537,0.000356,0.000265,50,0.000146,0,28,0.8,0.002497
5043,Drew County,,AR,1468,17496,18964,7,8,15,800,721,1521,7,0.283637,0.296649,305.933019,0.00036,0.000269,50,0.000205,0,28,0.482143,0.002692
5045,Faulkner County,,AR,7434,90784,98218,27,24,51,5136,4263,9399,6,0.344676,0.367739,5338.92194,0.002288,0.005338,50,0.000631,0,28,0.276344,0.019489
5047,Franklin County,,AR,1203,17176,18379,6,4,10,737,692,1429,7,0.259253,0.268783,7.754381,0.000215,0.000074,50,0.00017,0,28,0.9,0.002112
5049,Fulton County,,AR,1060,11991,13051,5,6,11,375,468,843,7,0.239318,0.248125,212.69265,0.000008,0.000036,50,0.000207,0,28,0.366667,0.000674
5051,Garland County,,AR,5709,97520,103229,28,19,47,3126,2399,5525,6,0.346113,0.368903,19159.745881,0.008862,0.005081,50,0.000549,0,28,0.367742,0.068993
5053,Grant County,,AR,1270,19214,20484,4,5,9,735,702,1437,7,0.283554,0.296133,1.092857,0.000371,0.000345,50,0.000125,0,28,0.85,0.002475
5055,Greene County,,AR,2225,39037,41262,8,7,15,1341,1057,2398,7,0.284442,0.297515,4180.173952,0.001009,0.000251,50,0.000251,0,28,0.5,0.007124
5057,Hempstead County,,AR,1766,24927,26693,8,6,14,660,760,1420,7,0.283831,0.296793,4590.325029,0.00008,0.000291,153,0.000223,0,28,0.288889,0.001263
5059,Hot Spring County,,AR,1766,28062,29828,5,5,10,990,971,1961,7,0.283499,0.296019,2.238095,0.000395,0.000317,50,0.000156,0,28,0.8,0.00292
5061,Howard County,,AR,994,13458,14452,3,5,8,310,397,707,7,0.249378,0.258733,14.979787,0.000004,0.000061,153,0.00013,0,28,0.5,0.000308
5063,Independence County,,AR,2444,37674,40118,9,11,20,1017,1165,2182,7,0.284805,0.298748,5963.529922,0.000392,0.000436,50,0.000291,0,28,0.390909,0.003224
5065,Izard County,,AR,979,11521,12500,5,5,10,364,404,768,8,0.224809,0.232312,215.799702,0.000008,0.000022,50,0.00021,0,28,0.35,0.000651
5067,Jackson County,,AR,1428,18122,19550,6,7,13,419,813,1232,7,0.283748,0.296764,248.573316,0.000354,0.000288,50,0.000175,0,28,0.589286,0.00272
5069,Jefferson County,,AR,5652,84870,90522,17,22,39,2047,3190,5237,6,0.340159,0.363118,14944.842429,0.003874,0.004313,50,0.000407,0,28,0.315217,0.02898
5071,Johnson County,,AR,1541,22481,24022,5,6,11,598,534,1132,7,0.270142,0.281213,25.715068,0.000207,0.000331,50,0.000164,0,28,0.857143,0.00197
5073,Lafayette County,,AR,616,7644,8260,1,3,4,106,227,333,7,0.241145,0.249447,0,0.000009,0.000021,153,0.000065,0,28,0.666667,0.000113
5075,Lawrence County,,AR,1241,17749,18990,6,5,11,716,647,1363,7,0.23785,0.245921,14.360806,0.000024,0.000024,50,0.000219,0,28,0.466667,0.000819
5077,Lee County,,AR,883,10768,11651,4,7,11,343,530,873,6,0.309915,0.324825,47.435152,0.00034,0.000896,49,0.000124,0,28,0.738095,0.002237
5079,Lincoln County,,AR,827,8542,9369,3,4,7,355,446,801,7,0.283416,0.295789,0,0.000039,0.000265,50,0.000113,0,28,1,0.000571
5081,Little River County,,AR,1087,13972,15059,4,4,8,350,476,826,7,0.250495,0.259995,30.876536,0.000083,0.000076,153,0.000142,0,28,0.666667,0.000997
5083,Logan County,,AR,1592,22802,24394,6,9,15,615,908,1523,7,0.270218,0.281729,70.852712,0.000093,0.000342,50,0.000215,0,28,0.583333,0.001335
5085,Lonoke County,,AR,5135,57364,62499,12,12,24,3803,3119,6922,6,0.315807,0.332674,362.944452,0.00128,0.001309,50,0.000295,0,28,0.538462,0.00962
5087,Madison County,,AR,1081,14132,15213,3,3,6,670,677,1347,7,0.269441,0.279911,0,0.000231,0.000245,50,0.000111,0,28,1,0.002194
5089,Marion County,,AR,1371,14995,16366,4,2,6,569,544,1113,8,0.224618,0.231395,7.469138,0.000324,0.000025,50,0.000139,0,28,0.5,0.002294
5091,Miller County,,AR,3736,39793,43529,13,7,20,2715,2359,5074,6,0.317081,0.335191,7121.503072,0.002204,0.002081,153,0.000289,0,28,0.326923,0.017177
5093,Mississippi County,,AR,3652,55083,58735,8,10,18,937,1489,2426,6,0.310245,0.325685,1301.389774,0.001017,0.000969,50,0.000221,0,28,0.488889,0.007275
5095,Monroe County,,AR,890,10202,11092,6,4,10,304,339,643,7,0.283333,0.295617,4.106782,0.00035,0.000242,50,0.000151,0,28,0.533333,0.002458
5097,Montgomery County,,AR,635,8775,9410,2,4,6,157,289,446,7,0.257439,0.266933,1.945455,0.000043,0.000075,50,0.000094,0,28,0.666667,0.000761
5099,Nevada County,,AR,786,10162,10948,1,4,5,215,361,576,7,0.241305,0.249963,2.304654,0.000002,0.000022,153,0.000082,0,28,0.416667,0.00011
5101,Newton County,,AR,681,8025,8706,1,1,2,180,274,454,8,0.224271,0.230558,0,0.000005,0.000006,50,0.000083,0,28,0,0.000151
5103,Ouachita County,,AR,1940,29369,31309,7,8,15,559,783,1342,7,0.283831,0.297022,728.596421,0.000082,0.000343,50,0.000195,0,28,0.319444,0.000995
5105,Perry County,,AR,872,9749,10621,3,3,6,498,472,970,7,0.283306,0.295445,0,0.00036,0.000249,50,0.000114,0,28,1,0.002229
5107,Phillips County,,AR,1747,25799,27546,4,10,14,313,779,1092,6,0.310113,0.325513,124.983563,0.001,0.00099,50,0.000111,0,28,0.522222,0.006606
5109,Pike County,,AR,741,10327,11068,4,4,8,307,266,573,7,0.257439,0.26699,1843.685405,0.000059,0.000075,50,0.000145,0,28,0.4,0.000976
5111,Poinsett County,,AR,1735,24818,26553,5,7,12,804,1002,1806,6,0.309948,0.324882,48.696536,0.000034,0.000891,50,0.000156,0,28,0.589286,0.000867
5113,Polk County,,AR,1410,19709,21119,4,6,10,207,341,548,7,0.270696,0.282119,226.318113,0.000057,0.000257,50,0.000135,0,28,0.3,0.001069
5115,Pope County,,AR,4065,53030,57095,12,13,25,1748,1942,3690,6,0.330641,0.349845,1283.695078,0.001761,0.00179,50,0.000287,0,28,0.505495,0.013724
5117,Prairie County,,AR,594,9629,10223,4,5,9,323,372,695,7,0.283361,0.295789,1.688095,0.000345,0.00027,50,0.00013,0,28,0.7,0.002423
5119,Pulaski County,,AR,28841,398399,427240,103,108,211,17959,20083,38042,6,0.39508,0.43057,164137.693333,0.028328,0.039122,50,0.001831,0,28,0.252475,0.208666
5121,Randolph County,,AR,1124,17839,18963,5,5,10,508,491,999,7,0.237791,0.245761,176.320472,0.000013,0.000021,50,0.000226,0,28,0.5,0.000684
5123,St. Francis County,,AR,2071,26006,28077,7,9,16,769,1189,1958,6,0.321642,0.340024,300.369562,0.00102,0.001904,49,0.000189,0,28,0.527778,0.007118
5125,Saline County,,AR,5366,73796,79162,11,13,24,4081,3474,7555,6,0.318157,0.337599,351.508596,0.001458,0.002431,50,0.000275,0,28,0.552381,0.011546
5127,Scott County,,AR,936,11234,12170,4,2,6,369,247,616,7,0.259206,0.268439,0.648352,0.000086,0.000067,50,0.000124,0,28,0.833333,0.00102
5129,Searcy County,,AR,554,6717,7271,0,3,3,0,161,161,8,0.224469,0.23131,0,0,0.000011,50,0.00005,0,36,0.333333,0
5131,Sebastian County,,AR,9570,118636,128206,27,23,50,5645,6030,11675,6,0.349777,0.373398,18882.081864,0.008209,0.008614,50,0.000544,0,28,0.367742,0.062337
5133,Sevier County,,AR,1191,15029,16220,4,7,11,285,484,769,7,0.250733,0.260883,246.251152,0.000018,0.000078,153,0.000145,0,28,0.47619,0.000512
5135,Sharp County,,AR,1294,12898,14192,5,5,10,506,471,977,7,0.238006,0.246168,63.565563,0.000015,0.000016,50,0.000199,0,28,0.55,0.000666
5137,Stone County,,AR,776,10881,11657,2,2,4,103,97,200,8,0.221671,0.228053,0.840909,0.000004,0.000009,50,0.000108,0,28,0.666667,0.000228
5139,Union County,,AR,2602,49088,51690,8,10,18,832,957,1789,6,0.325933,0.345551,6192.348078,0.000539,0.002319,50,0.0002,0,28,0.354545,0.003695
5141,Van Buren County,,AR,1010,13677,14687,5,4,9,443,406,849,7,0.283333,0.295617,917.50337,0.000364,0.000258,50,0.000158,0,28,0.5,0.002471
5143,Washington County,,AR,13120,147116,160236,48,43,91,8823,8274,17097,6,0.366999,0.394336,26368.795448,0.012856,0.014882,50,0.000906,0,28,0.294857,0.100401
5145,White County,,AR,4260,63203,67463,17,14,31,2523,2156,4679,6,0.322284,0.341572,4285.851049,0.003224,0.002133,50,0.000366,0,28,0.386842,0.024054
5147,Woodruff County,,AR,577,7672,8249,3,4,7,251,267,518,7,0.283389,0.295732,4.598177,0.000025,0.000262,50,0.000112,0,28,0.666667,0.000555
5149,Yell County,,AR,1734,20335,22069,4,6,10,604,895,1499,7,0.28361,0.296363,385.989028,0.001111,0.00033,50,0.000121,0,28,0.642857,0.008235
6001,Alameda County,,CA,122829,1536146,1658975,222,196,418,108912,113188,222100,5,0.419299,0.46349,25260.611109,0.096357,0.085039,5,0.00245,0,28,0.316293,0.667016
6003,Alpine County,,CA,147,1038,1185,0,0,0,0,0,0,0,0,0,0,0,0,4,0.00005,4,37,0,0
6005,Amador County,,CA,2171,34481,36652,14,7,21,2272,1132,3404,6,0.298613,0.313467,0.291209,0.006046,0.002533,5,0.000188,0,28,0.961905,0.045487
6007,Butte County,,CA,12446,195803,208249,50,54,104,10795,9448,20243,6,0.343333,0.369155,1121.502187,0.017051,0.018881,5,0.000637,0,28,0.617183,0.130264
6009,Calaveras County,,CA,3189,41357,44546,14,12,26,3302,1975,5277,6,0.300589,0.316684,11.03846,0.006311,0.004071,5,0.000204,0,28,0.925,0.04874
6011,Colusa County,,CA,1110,20871,21981,6,5,11,402,536,938,7,0.288536,0.302076,1.406667,0.001221,0.000927,5,0.000128,0,28,0.8,0.009398
6013,Contra Costa County,,CA,69029,1030151,1099180,151,151,302,74373,61511,135884,6,0.401575,0.441807,8038.732878,0.073555,0.069173,5,0.001668,0,28,0.421505,0.523726
6015,Del Norte County,,CA,1828,21977,23805,6,10,16,418,791,1209,6,0.327845,0.345855,44.354953,0.002032,0.003003,5,0.000126,0,28,0.744444,0.015656
6017,El Dorado County,,CA,12638,170413,183051,44,40,84,13524,9790,23314,6,0.341518,0.365526,182.798273,0.016325,0.01721,5,0.000544,0,28,0.742908,0.12593
6019,Fresno County,,CA,32516,800573,833089,75,95,170,24989,25990,50979,6,0.383307,0.417911,5090.55742,0.032074,0.039888,5,0.00089,0,28,0.525458,0.242338
6021,Glenn County,,CA,1759,28045,29804,5,4,9,735,974,1709,7,0.288507,0.301904,18.233369,0.00179,0.000772,5,0.000126,0,28,0.8,0.013585
6023,Humboldt County,,CA,7571,123227,130798,43,46,89,4943,4953,9896,6,0.340997,0.365382,1718.880786,0.016408,0.017917,5,0.000532,0,28,0.717551,0.125174
6025,Imperial County,,CA,11441,181103,192544,22,26,48,6691,9186,15877,6,0.350114,0.373472,12.960332,0.01083,0.01387,5,0.000266,0,28,0.900285,0.080542
6027,Inyo County,,CA,1513,20019,21532,8,8,16,859,644,1503,6,0.333295,0.351462,2.664399,0.00477,0.005018,5,0.000136,0,28,0.930556,0.035213
6029,Kern County,,CA,29415,650455,679870,81,89,170,22752,20323,43075,6,0.376165,0.409856,2310.837087,0.03371,0.037417,5,0.000933,0,28,0.469991,0.248271
6031,Kings County,,CA,9118,111616,120734,35,37,72,6074,5843,11917,6,0.349525,0.374315,202.826261,0.01518,0.017488,5,0.000398,0,28,0.679268,0.111231
6033,Lake County,,CA,3525,51583,55108,23,18,41,4130,1927,6057,6,0.337866,0.358044,1.024266,0.010459,0.009351,5,0.000287,0,28,0.971667,0.080075
6035,Lassen County,,CA,2432,25871,28303,16,12,28,1088,1218,2306,6,0.328512,0.346829,1496.641074,0.006384,0.003787,5,0.00025,0,28,0.748366,0.049003
6037,Los Angeles County,,CA,361769,9682175,10043944,445,497,942,253178,340749,593927,5,0.485552,0.549243,476588.259437,0.132523,0.130676,5,0.005388,0,28,0.115268,0.925213
6039,Madera County,,CA,7306,115679,122985,28,27,55,6028,5299,11327,6,0.338496,0.359964,129.320457,0.011978,0.012592,5,0.000317,0,28,0.885057,0.087995
6041,Marin County,,CA,19721,251545,271266,54,53,107,14131,15984,30115,6,0.360357,0.388258,306.652364,0.029826,0.026094,5,0.000616,0,28,0.697917,0.223
6043,Mariposa County,,CA,1661,16305,17966,9,6,15,916,734,1650,7,0.290962,0.304823,0.118056,0.003482,0.001276,5,0.000135,0,28,0.977778,0.02584
6045,Mendocino County,,CA,5056,89251,94307,21,25,46,3140,2963,6103,6,0.338851,0.360222,1.586523,0.010063,0.011276,5,0.000263,0,28,0.960317,0.076607
6047,Merced County,,CA,11714,210911,222625,32,36,68,12363,8543,20906,6,0.345413,0.368914,215.783961,0.013673,0.015449,5,0.000368,0,28,0.85,0.102356
6049,Modoc County,,CA,801,8571,9372,2,3,5,102,157,259,7,0.25462,0.264375,0.534499,0.000099,0.000276,5,0.000083,0,28,0.666667,0.001115
6051,Mono County,,CA,1521,10972,12493,7,7,14,732,651,1383,6,0.33166,0.34949,0.417286,0.004496,0.004042,5,0.000122,0,28,0.916667,0.032712
6053,Monterey County,,CA,30228,415902,446130,79,104,183,18938,22990,41928,6,0.379207,0.414465,2639.465349,0.035875,0.043242,5,0.000886,0,28,0.45836,0.265621
6055,Napa County,,CA,8425,138059,146484,34,34,68,8948,6274,15222,6,0.339642,0.362172,14.949838,0.016025,0.014932,5,0.000393,0,28,0.907557,0.120346
6057,Nevada County,,CA,7386,103220,110606,36,28,64,7042,5315,12357,6,0.338377,0.359936,2975.448858,0.014422,0.012904,5,0.000422,0,28,0.854251,0.10994
6059,Orange County,,CA,169635,3072118,3241753,255,287,542,136406,156077,292483,5,0.439988,0.491761,48156.211682,0.104426,0.106536,5,0.00287,0,28,0.241784,0.729874
6061,Placer County,,CA,20962,270531,291493,64,56,120,30226,17189,47415,6,0.350537,0.378168,963.821136,0.025503,0.022792,5,0.000799,0,28,0.608764,0.196172
6063,Plumas County,,CA,1735,21230,22965,11,6,17,930,696,1626,7,0.289542,0.303567,22.949986,0.0044,0.001424,5,0.00019,0,28,0.795455,0.034199
6065,Riverside County,,CA,89234,1549400,1638634,184,167,351,121621,77532,199153,5,0.41493,0.455911,17898.039791,0.077165,0.069633,5,0.002188,0,28,0.328874,0.559412
6067,Sacramento County,,CA,69077,1278823,1347900,162,158,320,81762,59498,141260,6,0.40527,0.445935,26545.619768,0.068962,0.066893,5,0.002007,0,28,0.370723,0.504556
6069,San Benito County,,CA,5140,58651,63791,13,23,36,4356,3662,8018,6,0.338063,0.358904,3.602482,0.007023,0.010304,5,0.000172,0,28,0.943841,0.052572
6071,San Bernardino County,,CA,111390,1691798,1803188,196,214,410,114650,96188,210838,5,0.43137,0.475754,33128.560608,0.081081,0.082567,5,0.002254,0,28,0.283305,0.575748
6073,San Diego County,,CA,174485,3069555,3244040,447,436,883,152442,147457,299899,5,0.479466,0.537937,314226.916602,0.133403,0.127323,5,0.005367,0,28,0.136263,0.933218
6075,San Francisco County,,CA,82214,837397,919611,158,132,290,63322,75453,138775,5,0.401132,0.439806,6307.595221,0.078443,0.067178,5,0.001681,0,28,0.464476,0.545342
6077,San Joaquin County,,CA,30509,566060,596569,66,79,145,42547,24980,67527,6,0.363239,0.395327,1218.109872,0.028067,0.031477,5,0.000772,0,28,0.545611,0.213324
6079,San Luis Obispo County,,CA,15041,245214,260255,48,50,98,13870,11427,25297,6,0.347187,0.373472,103.211277,0.019203,0.021344,5,0.000555,0,28,0.745791,0.145994
6081,San Mateo County,,CA,73254,783330,856584,125,130,255,51429,67597,119026,6,0.394276,0.433408,4075.696756,0.066846,0.062572,5,0.001352,0,28,0.489674,0.475389
6083,Santa Barbara County,,CA,28130,407869,435999,72,74,146,16807,21061,37868,6,0.371549,0.403486,2911.85367,0.035628,0.03519,5,0.000865,0,28,0.587811,0.268743
6085,Santa Clara County,,CA,153731,1886312,2040043,255,210,465,97763,141914,239677,6,0.416954,0.462923,37459.492159,0.103061,0.086496,5,0.00288,0,28,0.257906,0.709061
6087,Santa Cruz County,,CA,19867,269240,289107,51,69,120,12796,15857,28653,6,0.362108,0.392885,637.657129,0.022758,0.028133,5,0.000588,0,28,0.605176,0.173385
6089,Shasta County,,CA,8676,167456,176132,58,46,104,9328,5789,15117,6,0.340997,0.365411,3491.354361,0.019471,0.017166,5,0.000762,0,28,0.614261,0.150551
6091,Sierra County,,CA,299,3477,3776,1,2,3,67,122,189,7,0.270167,0.282067,0.1,0.000104,0.000355,5,0.000063,0,28,0.666667,0.000954
6093,Siskiyou County,,CA,3066,43618,46684,15,14,29,1330,1416,2746,6,0.337083,0.35661,1.124456,0.007242,0.006472,5,0.000209,0,28,0.894737,0.054418
6095,Solano County,,CA,33503,417128,450631,83,90,173,29274,26134,55408,6,0.375048,0.409024,3483.645434,0.03609,0.036811,5,0.00096,0,28,0.484485,0.266532
6097,Sonoma County,,CA,26638,500163,526801,77,83,160,21588,21261,42849,6,0.365431,0.398097,1985.713142,0.033668,0.033313,5,0.000922,0,28,0.509558,0.25581
6099,Stanislaus County,,CA,23288,462507,485795,56,66,122,29084,18155,47239,6,0.356512,0.385799,933.154085,0.023248,0.026545,5,0.000636,0,28,0.600201,0.173013
6101,Sutter County,,CA,6442,81154,87596,20,24,44,4640,4743,9383,6,0.335178,0.355733,225.565809,0.008582,0.010391,5,0.000278,0,28,0.886154,0.066524
6103,Tehama County,,CA,3212,48883,52095,19,9,28,2270,1508,3778,6,0.336887,0.355636,162.79507,0.008751,0.005261,5,0.000258,0,28,0.902632,0.065878
6105,Trinity County,,CA,950,10970,11920,4,2,6,355,419,774,7,0.254487,0.263905,0,0.001234,0.000288,5,0.000094,0,28,1,0.009798
6107,Tulare County,,CA,17352,361474,378826,42,57,99,11325,12759,24084,6,0.361747,0.39046,1152.652053,0.018416,0.025887,5,0.000478,0,28,0.67066,0.14003
6109,Tuolumne County,,CA,3382,53525,56907,21,20,41,3168,2040,5208,6,0.332761,0.352242,83.461963,0.008794,0.008296,5,0.000256,0,28,0.86166,0.065049
6111,Ventura County,,CA,43984,825664,869648,105,130,235,36793,35272,72065,6,0.397457,0.435243,5222.787656,0.050119,0.057733,5,0.001204,0,28,0.444013,0.369099
6113,Yolo County,,CA,14804,163500,178304,47,42,89,13161,11444,24605,6,0.345496,0.370617,564.335858,0.018924,0.018097,5,0.000544,0,28,0.736802,0.142368
6115,Yuba County,,CA,6775,50730,57505,21,17,38,4083,4012,8095,6,0.341558,0.3622,24.730206,0.009849,0.009792,5,0.000284,0,28,0.837945,0.076179
8001,Adams County,,CO,48695,404728,453423,101,78,179,44599,39681,84280,6,0.379009,0.411495,17280.428852,0.04285,0.035901,98,0.001489,0,28,0.414262,0.32191
8003,Alamosa County,,CO,1762,14336,16098,5,7,12,627,725,1352,6,0.310544,0.324819,8779.910044,0.00077,0.002297,98,0.000216,0,28,0.446429,0.006795
8005,Arapahoe County,,CO,72519,548666,621185,175,148,323,66300,61698,127998,5,0.416894,0.455533,45006.135059,0.076561,0.06927,98,0.002337,0,28,0.360085,0.548791
8007,Archuleta County,,CO,927,9690,10617,1,1,2,124,115,239,7,0.25442,0.262552,0,0.000077,0.000087,98,0.000068,0,28,0,0.000777
8009,Baca County,,CO,293,4813,5106,0,0,0,0,0,0,0,0,0,0,0,0,6,0.00005,5,38,0,0
8011,Bent County,,CO,564,5318,5882,2,3,5,139,198,337,7,0.253643,0.262386,2966,0.000018,0.000104,98,0.000099,0,28,0.666667,0.000287
8013,Boulder County,,CO,35671,319331,355002,155,109,264,28768,27431,56199,6,0.399807,0.434772,20722.974259,0.072691,0.054597,98,0.001899,0,28,0.415298,0.508626
8014,Broomfield County,,CO,0,0,0,0,0,0,0,0,0,0,0,0,0,0,0,7,0.00005,6,39,0,0
8015,Chaffee County,,CO,1555,16647,18202,8,7,15,630,543,1173,6,0.310577,0.324877,90.087357,0.002571,0.002326,98,0.000186,0,28,0.622222,0.021798
8017,Cheyenne County,,CO,213,2469,2682,0,0,0,0,0,0,0,0,0,0,0,0,8,0.00005,7,40,0,0
8019,Clear Creek County,,CO,2904,22369,25273,7,11,18,1559,1587,3146,6,0.327623,0.346021,20.127327,0.002528,0.004615,98,0.000163,0,28,0.854545,0.022082
8021,Conejos County,,CO,589,8155,8744,2,1,3,166,215,381,7,0.236977,0.243106,0,0.000019,0.000006,98,0.000098,0,28,0.5,0.00023
8023,Costilla County,,CO,355,3382,3737,0,2,2,0,105,105,7,0.237039,0.243366,0,0,0.000006,98,0.00005,0,41,1,0
8025,Crowley County,,CO,440,3381,3821,2,2,4,130,170,300,7,0.253599,0.262156,0,0.000546,0.000104,98,0.0001,0,28,1,0.004611
8027,Custer County,,CO,404,3550,3954,1,2,3,64,109,173,7,0.253554,0.26207,0,0.00003,0.000122,98,0.00007,0,28,1,0.000353
8029,Delta County,,CO,2084,27957,30041,12,6,18,1149,812,1961,7,0.286178,0.299155,21.548975,0.004506,0.001076,98,0.000226,0,28,0.697802,0.037192
8031,Denver County,,CO,85802,526864,612666,174,140,314,69746,76559,146305,5,0.416894,0.454036,54044.810984,0.078101,0.066418,98,0.002307,0,28,0.374912,0.550506
8033,Dolores County,,CO,220,1942,2162,1,1,2,45,44,89,7,0.247594,0.254978,0,0.000018,0.000011,5,0.000074,0,28,0,0.000186
8035,Douglas County,,CO,21826,194959,216785,99,66,165,31556,16186,47742,6,0.380996,0.411868,5004.745267,0.048885,0.036587,98,0.001347,0,28,0.545495,0.362035
8037,Eagle County,,CO,6143,42471,48614,23,23,46,2629,2985,5614,6,0.347353,0.369763,2640.671711,0.011282,0.011887,98,0.000394,0,28,0.653941,0.087873
8039,Elbert County,,CO,2132,18343,20475,6,7,13,2079,1147,3226,6,0.311275,0.325708,2966,0.002759,0.003218,98,0.00014,0,28,0.738095,0.023448
8041,El Paso County,,CO,54957,574827,629784,286,231,517,46050,37930,83980,5,0.442803,0.486676,173560.895227,0.096444,0.085354,98,0.003863,0,28,0.21012,0.693864
8043,Fremont County,,CO,3137,39816,42953,11,11,22,1750,1473,3223,6,0.311542,0.326625,3558.866767,0.003902,0.003684,98,0.000251,0,28,0.692308,0.033461
8045,Garfield County,,CO,4511,41183,45694,20,19,39,2385,2358,4743,6,0.337827,0.358405,2512.406949,0.007872,0.00776,98,0.000381,0,28,0.658009,0.06418
8047,Gilpin County,,CO,1457,8084,9541,6,5,11,960,889,1849,6,0.298184,0.311191,0,0.002255,0.002039,98,0.000136,0,28,1,0.019186
8049,Grand County,,CO,1624,12519,14143,7,7,14,548,500,1048,6,0.300279,0.314024,0,0.002535,0.003064,98,0.000158,0,28,0.982143,0.022097
8051,Gunnison County,,CO,1869,12770,14639,7,6,13,397,435,832,6,0.310976,0.325249,2.104659,0.001967,0.002575,98,0.000174,0,28,0.928571,0.017496
8053,Hinsdale County,,CO,93,749,842,0,0,0,0,0,0,0,0,0,0,0,0,9,0.00005,8,42,0,0
8055,Huerfano County,,CO,687,6394,7081,2,2,4,112,212,324,6,0.306969,0.320078,0,0.000758,0.000866,98,0.000092,0,28,1,0.006486
8057,Jackson County,,CO,177,1788,1965,0,0,0,0,0,0,0,0,0,0,0,0,10,0.00005,9,43,0,0
8059,Jefferson County,,CO,59864,540355,600219,132,113,245,48799,50129,98928,6,0.398438,0.434612,35911.952044,0.057411,0.04963,98,0.001883,0,28,0.381971,0.420474
8061,Kiowa County,,CO,226,1856,2082,0,0,0,0,0,0,0,0,0,0,0,0,11,0.00005,10,44,0,0
8063,Kit Carson County,,CO,740,8785,9525,0,1,1,0,46,46,8,0.216321,0.221666,0,0,0.000001,98,0.00005,0,45,0,0
8065,Lake County,,CO,980,6925,7905,2,4,6,177,251,428,7,0.285112,0.297618,0.333333,0.000157,0.00064,98,0.00008,0,28,0.666667,0.001391
8067,La Plata County,,CO,4355,44268,48623,21,19,40,2051,1992,4043,6,0.341197,0.362069,6132.255458,0.010835,0.009529,98,0.000396,0,28,0.691667,0.087888
8069,Larimer County,,CO,23689,271123,294812,102,67,169,18643,15423,34066,6,0.378516,0.409317,25128.087663,0.041651,0.03182,98,0.00158,0,28,0.398998,0.310364
8071,Las Animas County,,CO,1183,15069,16252,7,3,10,373,273,646,6,0.309948,0.323558,1.412678,0.002548,0.001494,98,0.00016,0,28,0.761905,0.021459
8073,Lincoln County,,CO,576,4771,5347,1,1,2,49,87,136,6,0.306969,0.319963,0,0.000026,0.000775,98,0.000067,0,28,1,0.000266
8075,Logan County,,CO,1661,21989,23650,12,11,23,970,836,1806,6,0.312178,0.327273,9177.670416,0.002415,0.003931,98,0.000369,0,28,0.56044,0.021706
8077,Mesa County,,CO,8231,127979,136210,36,28,64,5453,4079,9532,6,0.341719,0.363903,9614.627252,0.011822,0.011423,98,0.000657,0,28,0.443101,0.095154
8079,Mineral County,,CO,124,779,903,0,0,0,0,0,0,0,0,0,0,0,0,12,0.00005,11,46,0,0
8081,Moffat County,,CO,1253,14164,15417,3,4,7,282,348,630,6,0.295547,0.308394,80.016614,0.000115,0.001065,98,0.000118,0,28,0.7,0.001202
8083,Montezuma County,,CO,2109,23858,25967,7,7,14,718,874,1592,6,0.329032,0.34707,5880.720922,0.001328,0.002194,5,0.000194,0,28,0.486111,0.011346
8085,Montrose County,,CO,2730,35528,38258,14,13,27,1389,1278,2667,6,0.329667,0.348532,9598.474896,0.003769,0.00404,98,0.000366,0,28,0.558333,0.032275
8087,Morgan County,,CO,2437,29136,31573,9,8,17,981,1109,2090,6,0.300652,0.314528,10.04053,0.003653,0.003144,98,0.000202,0,28,0.944444,0.030644
8089,Otero County,,CO,1712,21079,22791,7,5,12,594,671,1265,6,0.310113,0.324045,6619.640099,0.001556,0.001499,98,0.00021,0,28,0.452381,0.013754
8091,Ouray County,,CO,400,3254,3654,1,1,2,48,100,148,7,0.247953,0.255557,0,0.000032,0.00003,98,0.000074,0,28,0,0.00035
8093,Park County,,CO,2066,14695,16761,10,8,18,1739,903,2642,6,0.311309,0.32588,2.58965,0.003323,0.003311,98,0.000199,0,28,0.855556,0.028693
8095,Phillips County,,CO,338,3951,4289,0,0,0,0,0,0,0,0,0,0,0,0,13,0.00005,12,47,0,0
8097,Pitkin County,,CO,1856,12522,14378,4,6,10,466,804,1270,6,0.32933,0.347409,0.41045,0.001131,0.003203,98,0.000111,0,28,0.9,0.009855
8099,Prowers County,,CO,1308,14153,15461,1,5,6,46,321,367,7,0.280355,0.2928,78.426748,0.000001,0.000783,98,0.000078,0,28,0.6,0.000091
8101,Pueblo County,,CO,7338,151572,158910,33,21,54,5545,4017,9562,6,0.339563,0.360945,9380.842753,0.011325,0.008944,98,0.000679,0,28,0.389916,0.09045
8103,Rio Blanco County,,CO,750,6268,7018,2,3,5,97,215,312,7,0.254777,0.263607,0.646825,0.000154,0.000159,98,0.000087,0,28,0.666667,0.00145
8105,Rio Grande County,,CO,1525,16440,17965,2,4,6,207,472,679,6,0.310014,0.323787,0,0.000705,0.001501,98,0.000091,0,28,0.916667,0.005815
8107,Routt County,,CO,2273,20216,22489,8,7,15,736,777,1513,6,0.300155,0.313852,339.209057,0.002381,0.00272,98,0.000186,0,28,0.821429,0.020581
8109,Saguache County,,CO,261,2173,2434,2,0,2,88,0,88,0,0,0,0,0.000458,0,98,0.000088,0,1,0,0.004328
8111,San Juan County,,CO,95,552,647,0,0,0,0,0,0,0,0,0,0,0,0,14,0.00005,13,48,0,0
8113,San Miguel County,,CO,952,6110,7062,1,2,3,70,127,197,7,0.254777,0.263492,0,0.000032,0.000125,98,0.000074,0,28,1,0.00035
8115,Sedgwick County,,CO,308,2982,3290,0,1,1,0,40,40,7,0.237971,0.244387,0,0,0.000019,98,0.00005,0,49,0,0
8117,Summit County,,CO,4252,24335,28587,17,17,34,1758,1823,3581,6,0.334946,0.35477,1622.576554,0.008294,0.00763,98,0.0003,0,28,0.71645,0.066915
8119,Teller County,,CO,2929,21088,24017,7,8,15,1491,1492,2983,6,0.329144,0.347242,17.739434,0.003277,0.003255,98,0.000161,0,28,0.888889,0.027889
8121,Washington County,,CO,411,4387,4798,1,1,2,58,70,128,7,0.237928,0.244299,0,0.000032,0.000019,98,0.000079,0,28,0,0.000265
8123,Weld County,,CO,14961,184265,199226,43,28,71,17102,9388,26490,6,0.35041,0.374303,6176.021143,0.019385,0.012092,98,0.000717,0,28,0.55314,0.14864
8125,Yuma County,,CO,853,11063,11916,3,3,6,150,211,361,7,0.275937,0.287118,2907,0.000129,0.00051,98,0.000143,0,28,0.5,0.001614
9001,Fairfield County,,CT,51176,974235,1025411,134,182,316,34528,43389,77917,5,0.412692,0.456043,11150.505986,0.070486,0.084413,99,0.001369,0,28,0.415073,0.4897
9003,Hartford County,,CT,43450,1010082,1053532,131,156,287,32519,35892,68411,5,0.402242,0.443768,10220.344304,0.067111,0.077066,99,0.001325,0,28,0.465256,0.460331
9005,Litchfield County,,CT,10924,218796,229720,21,33,54,8711,7258,15969,6,0.343576,0.367131,34.75487,0.012407,0.017526,99,0.000217,0,28,0.781532,0.079917
9007,Middlesex County,,CT,12001,186454,198455,29,26,55,10117,8401,18518,6,0.343211,0.365835,132.613894,0.016114,0.016031,99,0.000292,0,28,0.834084,0.106491
9009,New Haven County,,CT,40676,931788,972464,127,145,272,31967,33148,65115,6,0.390097,0.431143,6090.847057,0.06581,0.070169,99,0.001266,0,28,0.469993,0.450496
9011,New London County,,CT,19017,298783,317800,62,75,137,11433,12184,23617,6,0.371075,0.403274,1184.830895,0.031472,0.040245,99,0.000626,0,28,0.600821,0.215849
9013,Tolland County,,CT,10304,149487,159791,14,19,33,8480,7291,15771,6,0.332267,0.353205,26.56798,0.005499,0.009471,99,0.000182,0,28,0.770563,0.03706
9015,Windham County,,CT,6638,124822,131460,9,11,20,3985,4146,8131,6,0.298093,0.314935,0.784791,0.002927,0.003914,99,0.000128,0,28,0.897436,0.019577
10001,Kent County,,DE,8997,147961,156958,31,21,52,5166,2588,7754,6,0.341598,0.363857,904.754146,0.01297,0.009275,118,0.000362,0,28,0.5,0.084931
10003,New Castle County,,DE,26994,575921,602915,101,121,222,19536,19461,38997,6,0.388377,0.42643,6065.671361,0.054065,0.064651,118,0.00099,0,28,0.555224,0.364153
10005,Sussex County,,DE,7960,175189,183149,31,19,50,4863,3733,8596,6,0.319802,0.339468,270.955303,0.010735,0.008937,118,0.000373,0,28,0.555556,0.073405
11001,District of Columbia,,DC,62410,554389,616799,168,131,299,45814,52817,98631,5,0.403638,0.442134,9312.664009,0.084793,0.067967,45,0.001781,0,28,0.454453,0.580584
12001,Alachua County,,FL,20689,203362,224051,68,81,149,12925,14631,27556,6,0.383206,0.415692,10906.56078,0.031689,0.043971,99,0.001083,0,28,0.546764,0.250826
12003,Baker County,,FL,1511,22658,24169,5,5,10,928,808,1736,6,0.300807,0.315273,2.65974,0.001028,0.001127,99,0.000131,0,28,0.566667,0.00838
12005,Bay County,,FL,14164,160073,174237,67,68,135,6359,7253,13612,6,0.370366,0.401663,24015.839954,0.028825,0.03387,99,0.001019,0,28,0.487829,0.218498
12007,Bradford County,,FL,1519,21038,22557,6,5,11,1014,833,1847,6,0.301713,0.316145,35.191221,0.001406,0.001341,99,0.000141,0,28,0.766667,0.010643
12009,Brevard County,,FL,30113,534011,564124,203,142,345,27278,19379,46657,5,0.403414,0.443372,12546.861308,0.090754,0.073319,99,0.002321,0,28,0.37572,0.63534
12011,Broward County,,FL,108876,1702379,1811255,288,288,576,115593,96216,211809,5,0.444767,0.495304,75475.481898,0.112878,0.10852,99,0.003235,0,28,0.229095,0.784584
12013,Calhoun County,,FL,812,10457,11269,3,4,7,282,396,678,6,0.284944,0.297334,12.755135,0.000287,0.000517,99,0.000118,0,28,0.666667,0.002147
12015,Charlotte County,,FL,10535,147042,157577,73,22,95,8947,5629,14576,6,0.332533,0.353962,171.77247,0.038237,0.013523,99,0.000828,0,28,0.651981,0.26762
12017,Citrus County,,FL,7662,121530,129192,44,24,68,6027,3750,9777,6,0.316908,0.33675,77.333811,0.022649,0.012493,99,0.00062,0,28,0.736715,0.169818
12019,Clay County,,FL,16824,163671,180495,56,45,101,13723,11279,25002,6,0.352278,0.378443,1813.637506,0.027248,0.023573,99,0.000764,0,28,0.580389,0.205491
12021,Collier County,,FL,18079,264088,282167,135,68,203,17949,10886,28835,5,0.385033,0.416265,2571.999502,0.066099,0.040079,99,0.001415,0,28,0.486999,0.448608
12023,Columbia County,,FL,4150,53327,57477,20,19,39,2436,2184,4620,6,0.31591,0.3346,610.04713,0.008236,0.007875,99,0.000362,0,28,0.564935,0.064555
12027,DeSoto County,,FL,2170,26173,28343,10,10,20,1021,1127,2148,6,0.310776,0.327038,7.798504,0.003395,0.005347,99,0.000226,0,28,0.795455,0.031599
12029,Dixie County,,FL,918,12519,13437,5,4,9,360,336,696,6,0.301681,0.315973,17.71388,0.001978,0.001119,99,0.000143,0,28,0.766667,0.015365
12031,Duval County,,FL,61257,860847,922104,265,223,488,52626,47456,100082,5,0.429712,0.475467,122935.846469,0.099464,0.091564,99,0.003389,0,28,0.248477,0.701051
12033,Escambia County,,FL,32185,304156,336341,120,124,244,16832,21720,38552,5,0.402632,0.440179,18278.7257,0.056213,0.057092,99,0.001507,0,28,0.42164,0.415769
12035,Flagler County,,FL,4104,59893,63997,31,11,42,4446,2020,6466,6,0.314338,0.331762,10.25126,0.017462,0.006639,99,0.000392,0,28,0.795699,0.121007
12037,Franklin County,,FL,648,9378,10026,2,3,5,136,171,307,6,0.284916,0.297162,4.82498,0.000603,0.000498,99,0.000078,0,28,0.666667,0.003928
12039,Gadsden County,,FL,3322,48674,51996,10,8,18,1978,2185,4163,6,0.307034,0.323128,953.882563,0.004284,0.001983,99,0.000223,0,28,0.4,0.03268
12041,Gilchrist County,,FL,1180,12262,13442,6,5,11,697,597,1294,6,0.281768,0.293762,2.171229,0.002142,0.00074,99,0.00016,0,28,0.761905,0.016057
12043,Glades County,,FL,1113,10093,11206,7,4,11,776,554,1330,6,0.284916,0.297523,1.280952,0.002593,0.000836,99,0.00015,0,28,0.880952,0.021746
12045,Gulf County,,FL,1058,12253,13311,1,1,2,288,432,720,7,0.270293,0.281368,0,0.000272,0.000232,99,0.000063,0,28,0,0.001808
12047,Hamilton County,,FL,902,11900,12802,4,4,8,371,350,721,6,0.30165,0.316265,9.731122,0.001035,0.000981,99,0.000117,0,28,0.85,0.008129
12049,Hardee County,,FL,2021,23734,25755,5,5,10,629,837,1466,6,0.306743,0.321076,0,0.001585,0.001991,99,0.000134,0,28,1,0.014233
12051,Hendry County,,FL,3331,33260,36591,7,13,20,1402,1881,3283,6,0.318401,0.336378,126.802566,0.003311,0.006456,99,0.000164,0,28,0.717949,0.026881
12053,Hernando County,,FL,9207,136567,145774,38,22,60,8186,5303,13489,6,0.331849,0.353016,52.941359,0.020297,0.013041,99,0.000499,0,28,0.795547,0.144969
12055,Highlands County,,FL,5620,82181,87801,27,24,51,3346,2608,5954,6,0.316081,0.335374,217.802413,0.010559,0.011725,99,0.000468,0,28,0.701149,0.088713
12057,Hillsborough County,,FL,74707,1088813,1163520,318,248,566,74051,61334,135385,5,0.441726,0.488126,95482.26263,0.115645,0.102283,99,0.003724,0,28,0.21911,0.803448
12059,Holmes County,,FL,1427,19487,20914,7,5,12,854,765,1619,7,0.270494,0.282285,36.601169,0.000748,0.000295,99,0.000187,0,28,0.52381,0.005657
12061,Indian River County,,FL,7419,123443,130862,35,18,53,5232,3391,8623,6,0.316219,0.334887,12.698039,0.019069,0.010872,99,0.000425,0,28,0.779279,0.133501
12063,Jackson County,,FL,2895,43548,46443,9,8,17,1096,1104,2200,6,0.308173,0.323472,362.546877,0.002363,0.001513,99,0.000214,0,28,0.466667,0.017533
12065,Jefferson County,,FL,1197,14865,16062,2,4,6,551,602,1153,6,0.280058,0.29167,0.5,0.00034,0.00028,99,0.000091,0,28,0.666667,0.00224
12067,Lafayette County,,FL,362,4466,4828,1,1,2,77,90,167,7,0.238123,0.24531,0,0.000033,0.000045,99,0.000071,0,28,0,0.000412
12069,Lake County,,FL,16371,236471,252842,96,39,135,20695,9827,30522,6,0.3588,0.385351,816.358476,0.049759,0.023302,99,0.001194,0,28,0.606564,0.357445
12071,Lee County,,FL,26222,465890,492112,220,109,329,32128,15839,47967,5,0.397403,0.43374,16238.514833,0.086904,0.054183,99,0.002431,0,28,0.30663,0.59402
12073,Leon County,,FL,21489,228555,250044,80,82,162,13813,15306,29119,5,0.388688,0.421259,53469.910345,0.032736,0.041127,99,0.001425,0,28,0.443202,0.258348
12075,Levy County,,FL,2960,33174,36134,12,7,19,1911,1419,3330,6,0.30873,0.32412,47.358469,0.005875,0.00265,99,0.000242,0,28,0.757576,0.046136
12077,Liberty County,,FL,358,5558,5916,3,3,6,229,205,434,6,0.280004,0.291469,8.39222,0.000351,0.0003,99,0.000114,0,28,0.5,0.002568
12079,Madison County,,FL,1064,17523,18587,5,6,11,336,467,803,6,0.301932,0.316982,97.992028,0.000485,0.00119,99,0.000183,0,28,0.5,0.003437
12081,Manatee County,,FL,20076,281746,301822,116,60,176,18595,12439,31034,6,0.378368,0.409145,4158.336118,0.058526,0.035579,99,0.001357,0,28,0.544328,0.413396
12083,Marion County,,FL,16148,268190,284338,85,49,134,13011,8909,21920,6,0.363466,0.391738,2067.269726,0.044238,0.027361,99,0.001128,0,28,0.621473,0.326112
12085,Martin County,,FL,11702,140282,151984,46,31,77,9595,7269,16864,6,0.341398,0.365027,257.09889,0.025598,0.016853,99,0.000577,0,28,0.728235,0.18605
12087,Monroe County,,FL,10668,80396,91064,35,36,71,3817,5503,9320,6,0.335643,0.358015,51.818713,0.020103,0.01819,99,0.00046,0,28,0.713435,0.151497
12089,Nassau County,,FL,5016,66679,71695,10,9,19,3018,2644,5662,6,0.311142,0.327302,65.642522,0.004363,0.003664,99,0.000215,0,28,0.651515,0.033986
12091,Okaloosa County,,FL,21624,189913,211537,96,101,197,11261,12782,24043,6,0.39551,0.431057,14772.329486,0.044277,0.04757,99,0.001183,0,28,0.426791,0.319373
12093,Okeechobee County,,FL,2432,30080,32512,9,10,19,1181,958,2139,6,0.313018,0.329561,67.199705,0.003241,0.00477,99,0.000187,0,28,0.795455,0.025577
12095,Orange County,,FL,90130,970878,1061008,284,233,517,87082,76487,163569,5,0.433428,0.479882,64306.132568,0.110605,0.09917,99,0.003365,0,28,0.256773,0.770906
12097,Osceola County,,FL,21053,183878,204931,80,47,127,19304,15002,34306,6,0.362967,0.390683,286.986091,0.042397,0.028423,99,0.000883,0,28,0.664006,0.292989
12099,Palm Beach County,,FL,69275,1201273,1270548,251,226,477,76518,57391,133909,5,0.423514,0.47115,35269.306808,0.102635,0.096811,99,0.002813,0,28,0.283822,0.716667
12101,Pasco County,,FL,24836,343904,368740,123,55,178,29515,16125,45640,6,0.373746,0.403331,1422.399278,0.061556,0.033739,99,0.001324,0,28,0.534496,0.422342
12103,Pinellas County,,FL,61956,989470,1051426,291,230,521,54169,49253,103422,5,0.429458,0.476528,58326.556336,0.111251,0.096389,99,0.003281,0,28,0.24374,0.767624
12105,Polk County,,FL,28854,508179,537033,130,83,213,21573,17199,38772,6,0.390097,0.42314,6951.296621,0.05946,0.042218,99,0.001523,0,28,0.419289,0.416734
12107,Putnam County,,FL,4722,68187,72909,16,14,30,2507,2668,5175,6,0.312446,0.329853,35.256332,0.007922,0.00677,99,0.000297,0,28,0.866013,0.063937
12109,St. Johns County,,FL,11293,129774,141067,57,26,83,10874,6719,17593,6,0.348603,0.372205,412.048073,0.03403,0.016807,99,0.00074,0,28,0.744707,0.249093
12111,St. Lucie County,,FL,13723,205296,219019,66,36,102,12722,8419,21141,6,0.343861,0.368507,364.10948,0.034216,0.020038,99,0.000744,0,28,0.668427,0.237153
12113,Santa Rosa County,,FL,12297,124386,136683,44,40,84,8441,7106,15547,6,0.360536,0.387249,2019.344917,0.022989,0.02181,99,0.000587,0,28,0.638312,0.168874
12115,Sarasota County,,FL,23124,351871,374995,148,78,226,23562,15083,38645,5,0.38356,0.416122,2520.071106,0.072252,0.045738,99,0.001621,0,28,0.481811,0.499504
12117,Seminole County,,FL,43891,389230,433121,149,109,258,38505,35462,73967,5,0.402632,0.438098,4483.656082,0.075203,0.061072,99,0.001772,0,28,0.498242,0.530188
12119,Sumter County,,FL,3283,42620,45903,15,7,22,2252,1716,3968,6,0.308894,0.324028,0,0.008289,0.003415,99,0.000275,0,28,0.985714,0.068053
12121,Suwannee County,,FL,2375,33882,36257,12,11,23,1379,1072,2451,6,0.312513,0.329624,6088.636372,0.005559,0.004119,99,0.000271,0,28,0.57619,0.042141
12123,Taylor County,,FL,1164,19224,20388,5,2,7,272,199,471,6,0.280004,0.291326,30.449851,0.001198,0.000267,99,0.000144,0,28,0.65,0.009249
12125,Union County,,FL,882,9972,10854,3,5,8,497,532,1029,6,0.301744,0.316202,0.983066,0.000428,0.00114,99,0.000102,0,28,0.75,0.002798
12127,Volusia County,,FL,28903,461873,490776,157,104,261,26090,18537,44627,5,0.394812,0.430449,5992.813627,0.073202,0.0558,99,0.001773,0,28,0.432411,0.505749
12129,Wakulla County,,FL,1702,22656,24358,4,1,5,1403,798,2201,6,0.279923,0.291068,0,0.000353,0.000263,99,0.00013,0,28,0.5,0.002684
12131,Walton County,,FL,3012,34578,37590,12,7,19,2732,1430,4162,6,0.293785,0.308325,188.647649,0.004225,0.001502,99,0.000225,0,28,0.551282,0.030488
12133,Washington County,,FL,1523,18434,19957,3,5,8,931,784,1715,6,0.285,0.297563,10.57574,0.000287,0.000554,99,0.000118,0,28,0.8,0.002178
13001,Appling County,,GA,1034,17806,18840,4,3,7,385,281,666,7,0.222605,0.228969,127.502324,0.000008,0.000003,0,0.000177,0,28,0,0.000418
13003,Atkinson County,,GA,605,7700,8305,1,2,3,123,268,391,7,0.23325,0.240497,0,0.000007,0.000008,0,0.000075,0,28,1,0.000111
13005,Bacon County,,GA,775,10854,11629,3,4,7,232,376,608,7,0.233344,0.240985,79.000047,0.000018,0.000009,0,0.000146,0,28,0.333333,0.000361
13007,Baker County,,GA,343,4053,4396,2,1,3,122,96,218,7,0.244142,0.253047,0,0.000071,0.000073,0,0.000096,0,28,1,0.000742
13009,Baldwin County,,GA,2721,43384,46105,10,12,22,1107,1397,2504,6,0.308828,0.32549,7830.042847,0.00168,0.003462,0,0.000293,0,28,0.423077,0.013767
13011,Banks County,,GA,1600,16841,18441,6,8,14,1289,1169,2458,6,0.300776,0.315256,62.346741,0.00075,0.001034,0,0.000212,0,28,0.696429,0.006965
13013,Barrow County,,GA,4356,48943,53299,11,10,21,4454,2782,7236,6,0.307132,0.323105,255.546999,0.00308,0.00361,0,0.00027,0,28,0.689394,0.02517
13015,Bartow County,,GA,7238,92070,99308,23,17,40,6392,4111,10503,6,0.308927,0.326362,975.70607,0.00654,0.003949,0,0.000494,0,28,0.527174,0.054076
13017,Ben Hill County,,GA,1379,19035,20414,3,5,8,354,572,926,6,0.3014,0.316133,3586.553075,0.000007,0.000803,0,0.000156,0,28,0.3,0.000296
13019,Berrien County,,GA,1619,16009,17628,5,4,9,710,686,1396,7,0.260111,0.270326,5.4,0.000121,0.000074,0,0.00019,0,28,0.65,0.00106
13021,Bibb County,,GA,11425,175304,186729,37,39,76,5555,7008,12563,6,0.336342,0.362017,35666.082485,0.009945,0.011458,0,0.00076,0,28,0.350139,0.076634
13023,Bleckley County,,GA,817,13757,14574,5,4,9,398,332,730,7,0.269841,0.281654,92.132596,0.000256,0.000227,0,0.000165,0,28,0.6,0.00222
13025,Brantley County,,GA,1194,17154,18348,4,6,10,811,653,1464,6,0.301368,0.316133,112.033942,0.000136,0.000907,99,0.000141,0,28,0.533333,0.001139
13027,Brooks County,,GA,2248,21267,23515,5,5,10,1143,1037,2180,7,0.260204,0.270613,5.013492,0.000137,0.000084,0,0.000174,0,28,0.6,0.001127
13029,Bryan County,,GA,3138,25840,28978,5,4,9,1751,1350,3101,6,0.285448,0.297632,229.530849,0.000636,0.000561,0,0.000151,0,28,0.7,0.004481
13031,Bulloch County,,GA,3755,44237,47992,16,20,36,1825,1789,3614,6,0.313592,0.33268,11694.032598,0.002401,0.005526,0,0.00037,0,28,0.365613,0.01821
13033,Burke County,,GA,1856,27733,29589,6,6,12,1275,1099,2374,6,0.286263,0.299157,256.185215,0.000429,0.000681,0,0.000159,0,28,0.452381,0.003132
13035,Butts County,,GA,1627,21543,23170,12,5,17,1807,882,2689,7,0.277969,0.28954,27.567529,0.002591,0.000586,0,0.000273,0,28,0.689394,0.022691
13037,Calhoun County,,GA,462,6280,6742,2,2,4,127,200,327,7,0.244245,0.253419,1950.015175,0.000071,0.000073,0,0.000099,0,28,0.5,0.000729
13039,Camden County,,GA,6821,44265,51086,20,21,41,3273,2942,6215,6,0.333639,0.354243,2501.683865,0.007395,0.008706,99,0.000331,0,28,0.505,0.05338
13043,Candler County,,GA,774,9066,9840,2,4,6,219,372,591,7,0.239023,0.247495,43.79435,0.000047,0.000028,0,0.000087,0,28,0.583333,0.000347
13045,Carroll County,,GA,6117,92814,98931,23,19,42,6415,3854,10269,6,0.311175,0.329664,5136.444398,0.005762,0.004981,0,0.000466,0,28,0.481667,0.046891
13047,Catoosa County,,GA,4915,55512,60427,8,8,16,4250,3473,7723,6,0.280085,0.292323,217.028835,0.001031,0.000294,0,0.00023,0,28,0.569444,0.00861
13049,Charlton County,,GA,659,8789,9448,4,3,7,372,324,696,6,0.300869,0.315015,0.607582,0.000845,0.000894,99,0.000119,0,28,0.833333,0.006668
13051,Chatham County,,GA,20549,238440,258989,95,89,184,10342,12659,23001,5,0.393689,0.426792,59059.529376,0.040627,0.040814,0,0.001289,0,28,0.399352,0.294297
13053,Chattahoochee County,,GA,363,3043,3406,1,1,2,163,133,296,7,0.283582,0.295233,0,0.00032,0.000259,0,0.000061,0,28,0,0.001951
13055,Chattooga County,,GA,1251,26483,27734,7,4,11,883,685,1568,7,0.236188,0.244322,70.316603,0.000329,0.000055,0,0.000202,0,28,0.547619,0.003141
13057,Cherokee County,,GA,15104,170646,185750,57,41,98,16551,10092,26643,6,0.359644,0.38698,5740.574479,0.027505,0.019473,0,0.000964,0,28,0.517187,0.210943
13059,Clarke County,,GA,11862,87865,99727,48,40,88,6258,6996,13254,6,0.354945,0.381252,24295.596572,0.013501,0.015309,0,0.000948,0,28,0.350088,0.104624
13061,Clay County,,GA,176,3483,3659,0,0,0,0,0,0,0,0,0,0,0,0,15,0.00005,14,50,0,0
13063,Clayton County,,GA,33700,237389,271089,107,70,177,31424,27579,59003,6,0.384626,0.416036,29178.796343,0.04881,0.030022,0,0.001421,0,28,0.424943,0.341351
13065,Clinch County,,GA,407,6762,7169,2,1,3,90,49,139,7,0.259971,0.269638,0,0.000127,0.00007,0,0.000087,0,28,1,0.00079
13067,Cobb County,,GA,75767,646434,722201,263,219,482,65672,65473,131145,5,0.429712,0.474951,105616.38934,0.102046,0.090213,0,0.003415,0,28,0.258557,0.722013
13069,Coffee County,,GA,2333,35855,38188,8,10,18,892,782,1674,6,0.302277,0.317985,18924.437042,0.000134,0.000917,0,0.000289,0,28,0.218182,0.001347
13071,Colquitt County,,GA,2478,42339,44817,9,10,19,975,1045,2020,6,0.283223,0.296715,305.327842,0.000211,0.000425,0,0.000284,0,28,0.466667,0.002111
13073,Columbia County,,GA,10529,109265,119794,29,31,60,6846,5825,12671,6,0.332875,0.356868,7429.550199,0.010746,0.01324,0,0.000456,0,28,0.514744,0.078948
13075,Cook County,,GA,1199,16909,18108,5,5,10,688,664,1352,7,0.260181,0.270613,3.009957,0.000124,0.000076,0,0.000192,0,28,0.75,0.001084
13077,Coweta County,,GA,7312,98049,105361,23,20,43,6388,4197,10585,6,0.31366,0.33237,4542.42934,0.008994,0.006391,0,0.000408,0,28,0.525862,0.070109
13079,Crawford County,,GA,906,11350,12256,5,3,8,655,484,1139,7,0.269666,0.281167,2910.973157,0.00026,0.000226,0,0.00019,0,28,0.5,0.002249
13081,Crisp County,,GA,1325,22250,23575,6,7,13,501,538,1039,7,0.266722,0.278766,4502.040088,0.000097,0.000223,0,0.000219,0,28,0.238095,0.001151
13083,Dade County,,GA,1136,15235,16371,5,5,10,823,662,1485,6,0.279627,0.291446,4.152921,0.00026,0.000222,0,0.000152,0,28,0.7,0.002195
13085,Dawson County,,GA,1839,16536,18375,8,7,15,1719,1147,2866,6,0.305775,0.320972,0.375,0.003165,0.002171,0,0.000206,0,28,0.875,0.026567
13087,Decatur County,,GA,1873,27688,29561,7,10,17,676,879,1555,6,0.283998,0.297947,5867.357295,0.000367,0.000499,99,0.000235,0,28,0.366667,0.003056
13089,DeKalb County,,GA,95362,666773,762135,213,200,413,72367,86115,158482,5,0.427249,0.471064,74845.527648,0.088822,0.084443,0,0.002674,0,28,0.297315,0.622928
13091,Dodge County,,GA,975,17834,18809,4,4,8,346,326,672,7,0.252059,0.262609,3115.360136,0.000108,0.000084,0,0.00015,0,28,0.5,0.001042
13093,Dooly County,,GA,806,12644,13450,3,3,6,390,343,733,7,0.265819,0.27677,99.126027,0.000151,0.000146,0,0.000113,0,28,0.5,0.00139
13095,Dougherty County,,GA,8555,102885,111440,32,31,63,4042,4942,8984,6,0.322964,0.345551,53879.849859,0.009041,0.008773,0,0.000735,0,28,0.304318,0.067386
13097,Douglas County,,GA,10903,96129,107032,24,20,44,8686,7442,16128,6,0.31366,0.33237,1311.85352,0.009203,0.006332,0,0.000408,0,28,0.535714,0.072058
13099,Early County,,GA,717,12872,13589,3,5,8,151,276,427,7,0.246419,0.257129,280.634979,0.000001,0.000117,0,0.000169,0,28,0.3,0.000284
13101,Echols County,,GA,256,2667,2923,1,1,2,91,99,190,7,0.259971,0.269638,0,0.000117,0.00007,0,0.000067,0,28,0,0.000637
13103,Effingham County,,GA,2736,38410,41146,6,5,11,2442,1403,3845,6,0.285504,0.297861,15.328822,0.00063,0.000565,0,0.000161,0,28,0.571429,0.005187
13105,Elbert County,,GA,973,22349,23322,6,4,10,456,378,834,7,0.263148,0.273892,13.827719,0.000178,0.000202,0,0.000192,0,28,0.433333,0.002195
13107,Emanuel County,,GA,1364,25043,26407,5,7,12,323,512,835,6,0.283278,0.295798,1018.879858,0.000017,0.000352,0,0.000171,0,28,0.196429,0.000522
13109,Evans County,,GA,780,9880,10660,4,3,7,475,257,732,7,0.238788,0.246904,0.75,0.000377,0.00003,0,0.000124,0,28,0.65,0.002882
13111,Fannin County,,GA,1171,20425,21596,7,5,12,599,449,1048,6,0.300963,0.315365,11114.974447,0.002316,0.001092,0,0.000377,0,28,0.47619,0.019132
13113,Fayette County,,GA,9524,101304,110828,32,24,56,6526,5666,12192,6,0.343373,0.365612,1755.819694,0.018117,0.008564,0,0.00046,0,28,0.546951,0.134219
13115,Floyd County,,GA,5266,95167,100433,15,16,31,2522,2936,5458,6,0.308533,0.325909,5213.368089,0.004105,0.003891,0,0.000343,0,28,0.418421,0.033402
13117,Forsyth County,,GA,10759,119642,130401,55,29,84,13905,6527,20432,6,0.352065,0.37643,1884.980541,0.028456,0.015488,0,0.000845,0,28,0.545587,0.216416
13119,Franklin County,,GA,1533,24097,25630,11,10,21,1264,953,2217,6,0.300963,0.31583,333.652017,0.001629,0.001074,0,0.000338,0,28,0.492424,0.014196
13121,Fulton County,,GA,108073,717439,825512,274,228,502,91383,98476,189859,5,0.433234,0.479165,118006.318897,0.103827,0.092676,0,0.003543,0,28,0.245641,0.733089
13123,Gilmer County,,GA,1669,23724,25393,11,7,18,1193,746,1939,6,0.301431,0.316025,267.643698,0.003188,0.001198,0,0.000317,0,28,0.636364,0.027101
13125,Glascock County,,GA,244,2904,3148,2,0,2,107,0,107,0,0,0,0,0.000004,0,0,0.000091,0,5,0,0.000205
13127,Glynn County,,GA,5536,70964,76500,17,15,32,2074,2240,4314,6,0.314679,0.333075,5187.340175,0.004638,0.006068,99,0.000392,0,28,0.406433,0.036369
13129,Gordon County,,GA,3248,49329,52577,11,10,21,2542,1844,4386,6,0.302372,0.317819,1288.255798,0.00228,0.001415,0,0.000292,0,28,0.5,0.018735
13131,Grady County,,GA,2110,27804,29914,7,7,14,1074,1127,2201,6,0.28281,0.295626,158.237368,0.000441,0.000384,0,0.000199,0,28,0.660714,0.003616
13133,Greene County,,GA,895,16180,17075,6,4,10,467,285,752,7,0.26227,0.272631,3.125584,0.002231,0.000161,0,0.00016,0,28,0.738095,0.017524
13135,Gwinnett County,,GA,63480,621027,684507,235,210,445,66778,54319,121097,5,0.428571,0.472773,113660.979723,0.091243,0.082238,0,0.003145,0,28,0.257827,0.640909
13137,Habersham County,,GA,2223,36129,38352,9,7,16,1563,1144,2707,6,0.300714,0.315027,2484.228709,0.002161,0.000898,0,0.000356,0,28,0.544444,0.017945
13139,Hall County,,GA,9794,146612,156406,32,23,55,7640,5887,13527,6,0.341678,0.364224,2450.824893,0.012734,0.007161,0,0.000661,0,28,0.435294,0.100174
13141,Hancock County,,GA,522,9155,9677,1,1,2,133,159,292,7,0.235977,0.243014,0,0.000028,0.000014,0,0.000071,0,28,0,0.000205
13143,Haralson County,,GA,1925,25608,27533,7,7,14,1530,1308,2838,6,0.303603,0.318851,786.12814,0.001612,0.001718,0,0.000187,0,28,0.714286,0.013477
13145,Harris County,,GA,2521,30817,33338,8,6,14,2142,1553,3695,7,0.284637,0.297446,103.976314,0.001865,0.000348,0,0.000179,0,28,0.642857,0.014038
13147,Hart County,,GA,1320,22908,24228,5,5,10,542,661,1203,7,0.263196,0.274122,115.683656,0.001459,0.000198,0,0.00017,0,28,0.666667,0.012024
13149,Heard County,,GA,888,10644,11532,4,4,8,549,511,1060,7,0.240845,0.249876,1.180586,0.000174,0.000149,0,0.000124,0,28,0.75,0.002087
13151,Henry County,,GA,11060,136779,147839,44,25,69,15562,7011,22573,6,0.31854,0.339537,2933.16034,0.016787,0.007987,0,0.000746,0,28,0.456522,0.126698
13153,Houston County,,GA,11402,125873,137275,55,50,105,6344,5562,11906,6,0.361118,0.3896,57163.924633,0.01794,0.018372,0,0.000988,0,28,0.334406,0.135878
13155,Irwin County,,GA,900,9853,10753,3,3,6,491,482,973,7,0.233607,0.241145,13.588329,0.000016,0.000003,0,0.000133,0,28,0.666667,0.000325
13157,Jackson County,,GA,3600,39153,42753,14,11,25,3612,2399,6011,6,0.305261,0.320812,520.94706,0.003536,0.001755,0,0.000341,0,28,0.516667,0.029567
13159,Jasper County,,GA,1122,13936,15058,8,6,14,930,601,1531,6,0.299722,0.314001,1.910931,0.001758,0.000971,0,0.000198,0,28,0.736111,0.015419
13161,Jeff Davis County,,GA,881,14126,15007,4,3,7,301,349,650,7,0.232411,0.239729,80.415743,0.000007,0.000001,0,0.000167,0,28,0.083333,0.000386
13163,Jefferson County,,GA,1104,20295,21399,6,7,13,389,570,959,7,0.276383,0.288603,4744.458246,0.000369,0.000305,0,0.000165,0,28,0.238095,0.002751
13165,Jenkins County,,GA,454,8035,8489,4,3,7,190,140,330,7,0.275833,0.287445,9.304579,0.000056,0.000233,0,0.000127,0,28,0.4,0.000578
13167,Johnson County,,GA,383,8095,8478,3,3,6,253,232,485,7,0.235347,0.242768,3.5,0.000018,0.000003,0,0.000115,0,28,0.5,0.000326
13169,Jones County,,GA,1645,21245,22890,4,3,7,1273,891,2164,7,0.269691,0.281224,23.754096,0.000268,0.000238,0,0.000123,0,28,0.833333,0.0022
13171,Lamar County,,GA,1403,16592,17995,7,9,16,1032,885,1917,6,0.30373,0.31904,49.082651,0.000453,0.001501,0,0.000197,0,28,0.708333,0.005309
13173,Lanier County,,GA,922,6789,7711,2,3,5,347,436,783,7,0.260018,0.269982,0.333333,0.000117,0.000073,0,0.000107,0,28,0.833333,0.00074
13175,Laurens County,,GA,2314,48293,50607,10,12,22,729,867,1596,6,0.307391,0.32365,15278.639662,0.000249,0.001795,0,0.00029,0,28,0.242857,0.002704
13177,Lee County,,GA,2632,21819,24451,4,6,10,1719,1435,3154,6,0.303635,0.318524,427.902463,0.000095,0.000914,0,0.000159,0,28,0.366667,0.000962
13179,Liberty County,,GA,16876,57127,74003,60,67,127,6496,8067,14563,6,0.378516,0.409764,19869.659931,0.026174,0.032135,0,0.000803,0,28,0.522807,0.187759
13181,Lincoln County,,GA,568,8825,9393,3,2,5,271,146,417,7,0.275911,0.287112,34.977721,0.000359,0.000297,0,0.000088,0,28,0.333333,0.002404
13183,Long County,,GA,1448,7480,8928,2,3,5,598,632,1230,7,0.27505,0.286487,0,0.000263,0.00025,0,0.000091,0,28,1,0.001685
13185,Lowndes County,,GA,9065,81042,90107,34,41,75,3781,4527,8308,6,0.351257,0.377245,59173.31862,0.008765,0.014508,0,0.000788,0,28,0.309662,0.066956
13187,Lumpkin County,,GA,1776,18884,20660,9,6,15,1383,933,2316,6,0.30571,0.320743,4.699669,0.003174,0.001949,0,0.000254,0,28,0.875,0.026851
13189,McDuffie County,,GA,1412,23599,25011,4,4,8,654,675,1329,7,0.276095,0.287714,2968.408485,0.000362,0.0003,0,0.000114,0,28,0.583333,0.002524
13191,McIntosh County,,GA,713,10525,11238,2,1,3,376,269,645,7,0.239377,0.246984,0,0.000377,0.000037,99,0.000085,0,28,1,0.002793
13193,Macon County,,GA,857,12159,13016,3,5,8,274,400,674,7,0.265819,0.277028,839.468373,0.000173,0.000152,0,0.000115,0,28,0.35,0.001411
13195,Madison County,,GA,1931,26148,28079,7,8,15,1337,1218,2555,7,0.262317,0.27329,120.233364,0.000824,0.000196,0,0.000244,0,28,0.569444,0.007092
13197,Marion County,,GA,574,6448,7022,3,2,5,181,150,331,7,0.28361,0.295405,301.910154,0.000323,0.000262,0,0.000136,0,28,0.333333,0.00215
13199,Meriwether County,,GA,1892,23527,25419,10,12,22,1139,1314,2453,6,0.30671,0.323025,205.806244,0.001509,0.002736,0,0.000245,0,28,0.560606,0.013479
13201,Miller County,,GA,385,5783,6168,3,2,5,203,133,336,7,0.22125,0.227734,34.723588,0.000005,0.000003,99,0.000123,0,28,0.666667,0.000311
13205,Mitchell County,,GA,1610,23288,24898,6,6,12,732,855,1587,7,0.244388,0.254279,18.476289,0.000104,0.000092,0,0.000182,0,28,0.47619,0.001274
13207,Monroe County,,GA,1461,20034,21495,7,8,15,881,773,1654,7,0.278769,0.291203,51.587274,0.000594,0.000664,0,0.000212,0,28,0.597222,0.006495
13209,Montgomery County,,GA,674,9004,9678,1,4,5,291,311,602,7,0.23569,0.243444,54.246089,0.000003,0.000005,0,0.000068,0,28,0.416667,0.000117
13211,Morgan County,,GA,1099,15432,16531,9,7,16,826,579,1405,6,0.299845,0.314345,71.299121,0.002322,0.000928,0,0.000222,0,28,0.688889,0.018627
13213,Murray County,,GA,3100,36428,39528,9,9,18,2729,2167,4896,6,0.280409,0.292982,444.01893,0.000145,0.000377,0,0.000299,0,28,0.511111,0.00256
13215,Muscogee County,,GA,24471,199110,223581,83,96,179,12376,15573,27949,6,0.395779,0.430346,48810.207808,0.032233,0.039855,0,0.00122,0,28,0.384821,0.23326
13217,Newton County,,GA,4826,69223,74049,12,12,24,6741,3135,9876,6,0.306905,0.323283,111.28787,0.003325,0.003872,0,0.0003,0,28,0.719697,0.028207
13219,Oconee County,,GA,2266,21181,23447,9,6,15,1358,1202,2560,6,0.300279,0.314488,337.798161,0.001525,0.000903,0,0.00027,0,28,0.6,0.012427
13221,Oglethorpe County,,GA,911,13336,14247,4,3,7,702,492,1194,7,0.262057,0.272144,0.142857,0.000146,0.000127,0,0.000161,0,28,0.916667,0.00161
13223,Paulding County,,GA,6765,82830,89595,14,15,29,9014,4565,13579,6,0.307164,0.324086,63.304396,0.004312,0.004379,0,0.000294,0,28,0.679739,0.036364
13225,Peach County,,GA,2423,23577,26000,4,5,9,1412,1302,2714,6,0.307196,0.322469,281.136518,0.000243,0.001795,0,0.000157,0,28,0.6,0.002112
13227,Pickens County,,GA,1682,24054,25736,9,6,15,2003,825,2828,6,0.304016,0.318994,5.28971,0.003144,0.002183,0,0.000234,0,28,0.791667,0.026464
13229,Pierce County,,GA,1301,15694,16995,3,3,6,590,622,1212,6,0.300994,0.315245,757.450127,0.000018,0.000808,0,0.000122,0,28,0.583333,0.000349
13231,Pike County,,GA,1304,15458,16762,6,5,11,1079,803,1882,7,0.277916,0.289425,1.799478,0.000432,0.000561,0,0.000165,0,28,0.8,0.005579
13233,Polk County,,GA,1960,37054,39014,8,7,15,1431,1190,2621,6,0.304207,0.319453,4.399044,0.000968,0.001835,0,0.000196,0,28,0.763889,0.008721
13235,Pulaski County,,GA,645,9771,10416,1,2,3,143,213,356,7,0.265407,0.275979,0,0.000148,0.000146,0,0.000067,0,28,1,0.001183
13237,Putnam County,,GA,1398,19536,20934,11,9,20,830,640,1470,6,0.305903,0.321649,238.010508,0.002701,0.001946,0,0.000265,0,28,0.628205,0.022919
13239,Quitman County,,GA,231,2400,2631,1,1,2,78,113,191,7,0.22879,0.235433,0,0.000008,0.000004,0,0.00007,0,28,0,0.000134
13241,Rabun County,,GA,865,15590,16455,5,2,7,282,186,468,7,0.232003,0.238772,6.307881,0.001407,0.000067,0,0.000251,0,28,0.6,0.011734
13243,Randolph County,,GA,523,7691,8214,0,1,1,0,62,62,7,0.244185,0.253132,0,0,0.000073,0,0.00005,0,51,0,0
13245,Richmond County,,GA,20636,186860,207496,62,70,132,10350,13323,23673,6,0.38005,0.411616,38090.123911,0.026207,0.031255,0,0.000862,0,28,0.465433,0.191154
13247,Rockdale County,,GA,8681,70023,78704,18,19,37,5763,5985,11748,6,0.310212,0.328758,95.226315,0.006519,0.005457,0,0.000336,0,28,0.541502,0.051703
13249,Schley County,,GA,293,3785,4078,2,2,4,157,145,302,7,0.237171,0.244536,3.033333,0.000025,0.000007,0,0.000085,0,28,0.333333,0.000228
13251,Screven County,,GA,925,15329,16254,3,5,8,257,452,709,6,0.282837,0.294766,254.307071,0.000377,0.000355,0,0.000106,0,28,0.55,0.002794
13253,Seminole County,,GA,721,9708,10429,3,4,7,303,325,628,7,0.242371,0.251961,1191.439092,0.000068,0.000046,99,0.000113,0,28,0.5,0.00064
13255,Spalding County,,GA,4827,58020,62847,15,14,29,3577,3375,6952,6,0.307034,0.323742,454.264461,0.003391,0.003896,0,0.000343,0,28,0.585714,0.029248
13257,Stephens County,,GA,1734,26149,27883,6,6,12,656,641,1297,6,0.300745,0.31497,67.17742,0.000859,0.000989,0,0.000208,0,28,0.52381,0.007611
13259,Stewart County,,GA,411,5785,6196,1,1,2,76,75,151,7,0.283582,0.295233,0,0.00032,0.000259,0,0.000061,0,28,0,0.001951
13261,Sumter County,,GA,2080,33571,35651,7,11,18,567,816,1383,6,0.310776,0.327715,5385.619467,0.000493,0.002948,0,0.000203,0,28,0.454545,0.0037
13263,Talbot County,,GA,548,7267,7815,3,3,6,353,270,623,7,0.283693,0.295692,2.042783,0.000345,0.000274,0,0.000136,0,28,0.666667,0.00226
13265,Taliaferro County,,GA,144,1901,2045,0,0,0,0,0,0,0,0,0,0,0,0,16,0.00005,15,52,0,0
13267,Tattnall County,,GA,1347,17653,19000,6,5,11,545,603,1148,6,0.2857,0.298148,486.78129,0.000634,0.000562,0,0.00016,0,28,0.533333,0.004556
13269,Taylor County,,GA,465,8994,9459,1,1,2,51,44,95,8,0.212422,0.217974,0,0.000148,0.000002,0,0.000067,0,28,1,0.001183
13271,Telfair County,,GA,751,11335,12086,2,4,6,143,318,461,7,0.232839,0.240543,44.422311,0.000001,0.000002,0,0.000129,0,28,0.166667,0.000197
13273,Terrell County,,GA,820,11730,12550,2,2,4,315,370,685,7,0.244163,0.253219,0,0.000078,0.000073,0,0.000093,0,28,1,0.000736
13275,Thomas County,,GA,2843,37363,40206,9,10,19,1371,1438,2809,6,0.305614,0.321993,1449.229955,0.001266,0.001965,0,0.000238,0,28,0.527273,0.009621
13277,Tift County,,GA,3029,38856,41885,10,9,19,1273,1220,2493,7,0.269916,0.282756,4673.585555,0.000207,0.000292,0,0.000329,0,28,0.281818,0.002094
13279,Toombs County,,GA,1764,23796,25560,5,7,12,522,661,1183,6,0.283306,0.295826,7584.909308,0.000377,0.000353,0,0.000149,0,28,0.261905,0.002972
13281,Towns County,,GA,605,9372,9977,3,2,5,220,152,372,8,0.188021,0.191847,861.900078,0.000662,0.000023,0,0.000318,0,28,0.333333,0.005524
13283,Treutlen County,,GA,425,6318,6743,3,3,6,146,184,330,7,0.235537,0.243118,10.539714,0.000017,0.000005,0,0.000104,0,28,0.5,0.00033
13285,Troup County,,GA,3862,61919,65781,14,14,28,2334,2009,4343,6,0.309651,0.326797,2098.299806,0.00355,0.003946,0,0.000305,0,28,0.532967,0.028873
13287,Turner County,,GA,608,9751,10359,2,4,6,236,297,533,7,0.244347,0.253935,3.553968,0.000004,0.000076,0,0.000108,0,28,0.833333,0.000226
13289,Twiggs County,,GA,418,7662,8080,2,2,4,197,209,406,7,0.269641,0.280995,23.754096,0.000093,0.000224,0,0.000085,0,28,0.666667,0.000811
13291,Union County,,GA,999,16714,17713,8,2,10,512,168,680,7,0.231431,0.238015,6616.264945,0.002853,0.000024,0,0.000433,0,28,0.375,0.022374
13293,Upson County,,GA,1503,29482,30985,6,9,15,648,664,1312,6,0.306872,0.322583,85.536839,0.000317,0.001757,0,0.000175,0,28,0.611111,0.003716
13295,Walker County,,GA,4644,64282,68926,10,10,20,3859,3318,7177,6,0.280355,0.29304,230.183401,0.000324,0.000311,0,0.000301,0,28,0.463636,0.003334
13297,Walton County,,GA,3670,50374,54044,12,12,24,4202,2288,6490,6,0.306129,0.322268,24.497367,0.003358,0.002703,0,0.000275,0,28,0.642857,0.028122
13299,Ware County,,GA,2329,32441,34770,8,10,18,1042,1204,2246,6,0.303825,0.319797,9984.155295,0.000923,0.001297,0,0.000244,0,28,0.318182,0.00716
13301,Warren County,,GA,441,6601,7042,1,3,4,174,238,412,7,0.275519,0.286912,0.5,0.000002,0.000214,0,0.000075,0,28,0.333333,0.000111
13303,Washington County,,GA,960,21619,22579,4,5,9,265,351,616,7,0.252037,0.262781,772.12527,0.000122,0.000099,0,0.00014,0,28,0.35,0.001131
13305,Wayne County,,GA,1446,25237,26683,5,5,10,440,411,851,6,0.285644,0.298062,4045.835847,0.000316,0.000577,99,0.000179,0,28,0.366667,0.002254
13307,Webster County,,GA,171,2205,2376,0,0,0,0,0,0,0,0,0,0,0,0,17,0.00005,16,53,0,0
13309,Wheeler County,,GA,330,4859,5189,2,0,2,118,0,118,0,0,0,0,0.000014,0,0,0.000098,0,4,0,0.000216
13311,White County,,GA,1537,21026,22563,10,4,14,1363,663,2026,6,0.300558,0.314396,3.137588,0.003041,0.000879,0,0.000277,0,28,0.711111,0.025495
13313,Whitfield County,,GA,7425,97606,105031,19,15,34,3797,4615,8412,6,0.33541,0.355257,3930.92904,0.0073,0.004386,0,0.000381,0,28,0.442029,0.055293
13315,Wilcox County,,GA,376,7598,7974,2,2,4,169,111,280,7,0.233269,0.240314,15.570124,0.000008,0.000001,0,0.000103,0,28,0,0.000199
13317,Wilkes County,,GA,642,11753,12395,0,3,3,0,197,197,7,0.262195,0.272394,0,0,0.000113,0,0.00005,0,54,0.333333,0
13319,Wilkinson County,,GA,596,10774,11370,2,4,6,282,341,623,7,0.251797,0.262093,1,0.00012,0.000096,0,0.000088,0,28,0.666667,0.00092
13321,Worth County,,GA,1483,18690,20173,6,5,11,897,778,1675,7,0.244388,0.254165,16.860354,0.000086,0.000078,0,0.000198,0,28,0.5,0.001172
15001,Hawaii County,,HI,6559,150332,156891,24,20,44,4241,3872,8113,6,0.341638,0.362906,5.837489,0.013315,0.013308,5,0.000328,0,28,0.928571,0.104051
15003,Honolulu County,,HI,63801,971311,1035112,213,223,436,39938,48164,88102,5,0.434399,0.479521,44162.769433,0.08693,0.091071,5,0.00241,0,28,0.301438,0.617756
15005,Kalawao County,,HI,0,0,0,0,0,0,0,0,0,0,0,0,0,0,0,18,0.00005,17,55,0,0
15007,Kauai County,,HI,2729,64748,67477,7,7,14,542,1260,1802,6,0.335101,0.353612,0,0.005475,0.005675,5,0.000124,0,28,0.986111,0.041703
15009,Maui County,,HI,6356,142376,148732,30,21,51,4651,3533,8184,6,0.339801,0.360996,8.74933,0.015783,0.01351,5,0.000388,0,28,0.885417,0.122418
16001,Ada County,,ID,22442,339569,362011,117,91,208,21485,16686,38171,6,0.366768,0.400619,68003.905446,0.032751,0.03131,5,0.001863,0,28,0.294349,0.254451
16003,Adams County,,ID,385,3808,4193,2,2,4,88,96,184,7,0.269042,0.280932,0,0.000255,0.000393,5,0.000094,0,28,1,0.002288
16005,Bannock County,,ID,6803,79833,86636,25,28,53,3347,3972,7319,6,0.341799,0.364551,13432.416657,0.00573,0.008274,5,0.000482,0,28,0.378788,0.044213
16007,Bear Lake County,,ID,490,7100,7590,1,2,3,50,149,199,7,0.255067,0.264283,0,0.000069,0.000094,5,0.000067,0,28,1,0.000487
16009,Benewah County,,ID,924,9769,10693,2,3,5,237,433,670,7,0.269866,0.282273,0,0.000345,0.000374,5,0.000085,0,28,1,0.002982
16011,Bingham County,,ID,3380,48346,51726,11,12,23,1805,2191,3996,6,0.330679,0.350287,1814.577909,0.002513,0.003416,5,0.000227,0,28,0.692308,0.01938
16013,Blaine County,,ID,1725,19941,21666,8,4,12,654,440,1094,6,0.306646,0.322343,1238.18236,0.004055,0.001203,5,0.000163,0,28,0.678571,0.030513
16015,Boise County,,ID,737,6436,7173,2,2,4,461,412,873,7,0.269042,0.280932,0,0.000334,0.000393,5,0.000093,0,28,1,0.003295
16017,Bonner County,,ID,2940,38439,41379,9,8,17,1286,1259,2545,6,0.307099,0.323518,541.62264,0.002388,0.001553,5,0.000226,0,28,0.622222,0.019025
16019,Bonneville County,,ID,6743,90624,97367,22,22,44,3898,4072,7970,6,0.33889,0.360738,5864.341237,0.007021,0.006041,5,0.000378,0,28,0.464387,0.054254
16021,Boundary County,,ID,771,10038,10809,2,2,4,111,190,301,7,0.254598,0.263498,0,0.000104,0.000134,5,0.000095,0,28,1,0.001224
16023,Butte County,,ID,278,3013,3291,0,1,1,0,56,56,7,0.253178,0.261728,0,0,0.000056,5,0.00005,0,56,0,0
16025,Camas County,,ID,109,905,1014,0,0,0,0,0,0,0,0,0,0,0,0,19,0.00005,18,57,0,0
16027,Canyon County,,ID,9407,136652,146059,54,31,85,10143,6165,16308,6,0.343171,0.366443,12641.464869,0.016166,0.010267,5,0.00093,0,28,0.385522,0.126856
16029,Caribou County,,ID,567,8165,8732,1,2,3,104,188,292,7,0.255067,0.264283,0,0.000067,0.000094,5,0.000065,0,28,1,0.000464
16031,Cassia County,,ID,2322,26580,28902,7,11,18,1185,1459,2644,6,0.298675,0.314276,224.959037,0.001066,0.001421,5,0.000161,0,28,0.645455,0.007897
16033,Clark County,,ID,142,958,1100,0,0,0,0,0,0,0,0,0,0,0,0,20,0.00005,19,58,0,0
16035,Clearwater County,,ID,1001,9209,10210,1,6,7,129,478,607,7,0.268595,0.281213,0,0.000021,0.000302,5,0.000069,0,28,0.666667,0.000207
16037,Custer County,,ID,475,4331,4806,0,0,0,0,0,0,0,0,0,0,0,0,21,0.00005,20,59,0,0
16039,Elmore County,,ID,4995,26614,31609,13,12,25,1164,1492,2656,6,0.336887,0.357172,468.455051,0.00563,0.005224,5,0.000242,0,28,0.610294,0.044217
16041,Franklin County,,ID,877,12570,13447,3,3,6,398,423,821,6,0.297665,0.311553,0,0.000755,0.000638,5,0.000092,0,28,1,0.005005
16043,Fremont County,,ID,1421,14144,15565,6,8,14,560,874,1434,6,0.298552,0.313703,0.429297,0.001123,0.001253,5,0.00013,0,28,0.910714,0.007601
16045,Gem County,,ID,1323,15513,16836,3,3,6,664,711,1375,7,0.269067,0.281104,0,0.000338,0.000396,5,0.000125,0,28,1,0.003418
16047,Gooding County,,ID,1376,14479,15855,4,4,8,508,703,1211,7,0.268471,0.280697,62.403023,0.000299,0.000315,5,0.000129,0,28,0.833333,0.002878
16049,Idaho County,,ID,1157,15251,16408,4,4,8,300,387,687,7,0.268545,0.280869,427.714088,0.000275,0.000285,5,0.000143,0,28,0.6,0.002564
16051,Jefferson County,,ID,2069,21506,23575,6,9,15,1035,1242,2277,6,0.328363,0.347093,40.331039,0.000782,0.00237,5,0.000136,0,28,0.888889,0.005623
16053,Jerome County,,ID,2164,19853,22017,6,7,13,1102,1308,2410,7,0.269192,0.281849,73.048304,0.000322,0.000456,5,0.000166,0,28,0.666667,0.003148
16055,Kootenai County,,ID,8062,116007,124069,43,28,71,5777,4592,10369,6,0.341438,0.36415,9058.055453,0.014233,0.011377,5,0.000691,0,28,0.485354,0.110727
16057,Latah County,,ID,4160,33019,37179,15,13,28,1653,1811,3464,6,0.330303,0.349215,593.234044,0.001749,0.004268,5,0.000305,0,28,0.460784,0.015386
16059,Lemhi County,,ID,688,7844,8532,0,1,1,0,65,65,7,0.268414,0.280199,0,0,0.000263,5,0.00005,0,60,0,0
16061,Lewis County,,ID,485,4182,4667,3,2,5,151,167,318,7,0.235461,0.242917,0,0.000026,0.000015,5,0.000109,0,28,0.833333,0.000408
16063,Lincoln County,,ID,518,5015,5533,5,5,10,313,260,573,7,0.249742,0.258762,2.416667,0.00007,0.000089,5,0.000159,0,28,0.6,0.001198
16065,Madison County,,ID,2156,18755,20911,9,10,19,921,1363,2284,6,0.298675,0.314161,474.011458,0.00122,0.001287,5,0.000195,0,28,0.636364,0.008424
16067,Minidoka County,,ID,1848,16747,18595,5,7,12,638,1191,1829,6,0.327549,0.345603,770.010113,0.00031,0.001641,5,0.000141,0,28,0.696429,0.003036
16069,Nez Perce County,,ID,3519,39374,42893,11,13,24,1723,2135,3858,6,0.307912,0.325267,8669.752322,0.001539,0.002632,5,0.000288,0,28,0.519048,0.013565
16071,Oneida County,,ID,288,4345,4633,3,2,5,155,97,252,7,0.254844,0.263825,0.399879,0.000779,0.000058,5,0.000088,0,28,0.833333,0.005206
16073,Owyhee County,,ID,1201,9896,11097,3,3,6,748,748,1496,7,0.269841,0.281998,0,0.000377,0.000439,5,0.000107,0,28,1,0.003775
16075,Payette County,,ID,1922,20770,22692,5,5,10,1064,1081,2145,7,0.269117,0.281448,1.583333,0.00035,0.000402,5,0.000188,0,28,0.8,0.003661
16077,Power County,,ID,626,7278,7904,2,2,4,214,285,499,7,0.254777,0.263653,0,0.000094,0.000066,5,0.000081,0,28,1,0.000717
16079,Shoshone County,,ID,1248,13552,14800,2,3,5,267,509,776,7,0.270067,0.282703,1.737774,0.000345,0.000403,5,0.000085,0,28,0.333333,0.002982
16081,Teton County,,ID,602,6507,7109,2,2,4,246,162,408,7,0.25171,0.260132,1.642191,0.000079,0.00003,5,0.000081,0,28,0.333333,0.000772
16083,Twin Falls County,,ID,5725,68373,74098,19,23,42,2976,3375,6351,6,0.332685,0.354117,6472.069752,0.006052,0.005321,5,0.000378,0,28,0.433846,0.047815
16085,Valley County,,ID,968,8754,9722,2,3,5,341,417,758,7,0.269067,0.281104,0.805828,0.000334,0.000395,5,0.000093,0,28,0.833333,0.003295
16087,Washington County,,ID,914,9820,10734,4,4,8,309,421,730,7,0.269092,0.281276,0,0.000346,0.000399,5,0.000152,0,28,1,0.003547
17001,Adams County,,IL,3346,81326,84672,9,12,21,982,1137,2119,6,0.326739,0.346078,13594.162484,0.001817,0.002523,23,0.000281,0,28,0.326923,0.012912
17003,Alexander County,,IL,723,9145,9868,2,2,4,200,252,452,7,0.253665,0.262064,43.19563,0.000029,0.00002,50,0.000128,0,28,0.5,0.000347
17005,Bond County,,IL,1233,18834,20067,6,7,13,762,690,1452,6,0.307099,0.321437,1341.958129,0.000992,0.000901,50,0.000158,0,28,0.595238,0.006804
17007,Boone County,,IL,3861,51713,55574,9,11,20,3849,2625,6474,6,0.324044,0.342363,2.28714,0.003108,0.002806,23,0.00013,0,28,0.809091,0.020011
17009,Brown County,,IL,360,5989,6349,1,2,3,42,118,160,7,0.246523,0.254784,2.495238,0.000001,0.000024,23,0.000082,0,28,0.5,0.0001
17011,Bureau County,,IL,2624,43164,45788,10,11,21,1260,1409,2669,6,0.324153,0.342535,2467.505576,0.002247,0.001927,23,0.000178,0,28,0.570513,0.015323
17013,Calhoun County,,IL,291,6023,6314,2,3,5,95,147,242,7,0.263482,0.273347,29.474388,0.000095,0.000064,50,0.000092,0,28,0.333333,0.000669
17015,Carroll County,,IL,1236,20703,21939,5,7,12,442,606,1048,6,0.323828,0.341561,4.093458,0.001075,0.001162,23,0.000121,0,28,0.619048,0.00801
17017,Cass County,,IL,1201,16741,17942,4,4,8,426,511,937,7,0.265407,0.275881,3179.004035,0.000106,0.000075,23,0.000148,0,28,0.25,0.000944
17019,Champaign County,,IL,14709,183204,197913,44,63,107,6799,8698,15497,5,0.387084,0.417716,27643.806685,0.012653,0.030643,23,0.000629,0,28,0.405405,0.087887
17021,Christian County,,IL,2408,45671,48079,4,6,10,1185,1214,2399,6,0.324189,0.341991,295.039176,0.000155,0.001165,23,0.000122,0,28,0.566667,0.00108
17023,Clark County,,IL,1031,20163,21194,5,5,10,476,463,939,7,0.256191,0.26625,2054.836495,0.000057,0.000033,22,0.000169,0,28,0.35,0.000733
17025,Clay County,,IL,1043,16835,17878,4,4,8,347,413,760,7,0.23638,0.243868,1690.581193,0.000009,0.000011,22,0.000161,0,28,0.083333,0.000469
17027,Clinton County,,IL,2021,43823,45844,7,7,14,1194,1133,2327,6,0.307164,0.321523,117.51547,0.001012,0.000897,50,0.000167,0,28,0.761905,0.007001
17029,Coles County,,IL,3737,53666,57403,12,15,27,1693,1877,3570,6,0.326923,0.34668,11247.533808,0.001416,0.00263,23,0.000289,0,28,0.370833,0.009897
17031,Cook County,,IL,268617,5917492,6186109,420,470,890,156776,248358,405134,5,0.478125,0.541131,587796.975988,0.123466,0.123468,23,0.005097,0,28,0.115753,0.858377
17033,Crawford County,,IL,1114,23742,24856,4,4,8,262,261,523,7,0.254866,0.2643,2360.21065,0,0.000021,22,0.000188,0,28,0.3,0.000387
17035,Cumberland County,,IL,855,13616,14471,3,4,7,476,472,948,7,0.246816,0.255524,5.189695,0.000022,0.000021,23,0.000123,0,28,0.666667,0.000442
17037,DeKalb County,,IL,8732,98314,107046,16,20,36,6424,5791,12215,6,0.342484,0.363949,189.551266,0.004412,0.007806,23,0.000217,0,28,0.55336,0.030735
17039,De Witt County,,IL,1402,20425,21827,5,5,10,683,722,1405,6,0.279654,0.291291,6.705269,0.000414,0.000219,23,0.000123,0,28,0.75,0.00204
17041,Douglas County,,IL,1551,26261,27812,6,4,10,803,719,1522,6,0.279465,0.290792,78.07698,0.000342,0.000116,23,0.00015,0,28,0.633333,0.001744
17043,DuPage County,,IL,96797,1218325,1315122,197,231,428,78578,85952,164530,5,0.432396,0.478632,61401.738417,0.082012,0.091316,23,0.002281,0,28,0.280915,0.570396
17045,Edgar County,,IL,1160,22733,23893,5,6,11,479,541,1020,6,0.281087,0.293269,68.271117,0.000077,0.000158,22,0.000144,0,28,0.466667,0.000891
17047,Edwards County,,IL,538,8643,9181,4,4,8,220,286,506,8,0.211234,0.217482,144.227965,0.000001,0.000001,22,0.000205,0,28,0.166667,0.000391
17049,Effingham County,,IL,2303,43339,45642,7,7,14,887,856,1743,6,0.280004,0.292059,15033.311681,0.001016,0.000114,23,0.000225,0,28,0.232143,0.007788
17051,Fayette County,,IL,1337,23794,25131,5,6,11,487,550,1037,7,0.263961,0.274568,46.393209,0.000018,0.000079,50,0.000161,0,28,0.333333,0.00064
17053,Ford County,,IL,1224,18019,19243,8,5,13,841,671,1512,6,0.279627,0.291234,2.803021,0.001663,0.000235,23,0.000136,0,28,0.857143,0.010823
17055,Franklin County,,IL,2296,45071,47367,6,5,11,870,986,1856,7,0.278208,0.28946,615.73051,0.001078,0.000243,23,0.000209,0,28,0.619048,0.008047
17057,Fulton County,,IL,2313,45039,47352,6,6,12,1144,1251,2395,7,0.274401,0.285934,234.277737,0.00025,0.000192,23,0.000144,0,28,0.5,0.001369
17059,Gallatin County,,IL,473,7151,7624,2,2,4,141,155,296,8,0.211142,0.216823,25.792473,0.000001,0.000001,23,0.000165,0,28,0.5,0.000206
17061,Greene County,,IL,964,17379,18343,4,6,10,405,610,1015,7,0.267951,0.279195,96.290404,0.000112,0.000156,50,0.00015,0,28,0.6,0.001059
17063,Grundy County,,IL,3467,51014,54481,7,9,16,2815,2163,4978,6,0.336731,0.355968,14.478938,0.002094,0.003096,23,0.000123,0,28,0.791667,0.014064
17065,Hamilton County,,IL,474,8470,8944,1,3,4,75,179,254,7,0.236495,0.243616,6.741111,0.000008,0.000011,50,0.00007,0,28,0.166667,0.000174
17067,Hancock County,,IL,1434,25383,26817,4,5,9,512,641,1153,7,0.248038,0.257221,1766.710482,0.00004,0.000027,23,0.000132,0,28,0.35,0.000577
17069,Hardin County,,IL,281,4732,5013,1,1,2,63,66,129,8,0.198268,0.202569,0,0,0,23,0.00011,0,28,0,0.000102
17071,Henderson County,,IL,599,10027,10626,3,2,5,276,221,497,7,0.225751,0.232065,11.221342,0.00003,0.000003,23,0.000111,0,28,0.333333,0.000382
17073,Henry County,,IL,4187,67455,71642,10,14,24,2231,2487,4718,6,0.339405,0.359729,1224.48167,0.00151,0.003424,23,0.000189,0,28,0.56044,0.010288
17075,Iroquois County,,IL,2346,40155,42501,6,9,15,1047,1327,2374,6,0.324116,0.342249,557.704671,0.001543,0.001424,23,0.000121,0,28,0.652778,0.009995
17077,Jackson County,,IL,6112,53058,59170,18,21,39,2418,3137,5555,6,0.347478,0.370135,5958.573733,0.004018,0.006772,23,0.00038,0,28,0.438333,0.026328
17079,Jasper County,,IL,632,12589,13221,3,3,6,235,263,498,7,0.219927,0.226333,1743.588069,0.000001,0.000008,23,0.000147,0,28,0.166667,0.00035
17081,Jefferson County,,IL,2297,42386,44683,9,11,20,969,1034,2003,6,0.307652,0.322658,12407.328126,0.001227,0.000946,50,0.000251,0,28,0.454545,0.009456
17083,Jersey County,,IL,1622,27773,29395,5,5,10,1088,960,2048,6,0.304973,0.318954,506.920471,0.000803,0.000711,50,0.00015,0,28,0.6,0.005471
17085,Jo Daviess County,,IL,1473,27883,29356,8,5,13,881,672,1553,6,0.324008,0.341589,76.396772,0.002563,0.001052,23,0.000143,0,28,0.482143,0.016969
17087,Johnson County,,IL,914,12591,13505,5,4,9,450,390,840,7,0.252256,0.261701,371.831273,0.000076,0.000045,23,0.00024,0,28,0.366667,0.000899
17089,Kane County,,IL,30798,389802,420600,63,64,127,33518,23651,57169,6,0.380448,0.411507,4229.235395,0.030702,0.032784,23,0.000752,0,28,0.50779,0.220286
17091,Kankakee County,,IL,6224,120070,126294,13,17,30,3592,3191,6783,6,0.342564,0.364499,552.165424,0.003981,0.005825,23,0.000197,0,28,0.614379,0.027179
17093,Kendall County,,IL,5244,63803,69047,9,8,17,6253,3660,9913,6,0.336692,0.355796,1.263768,0.003132,0.003291,23,0.000132,0,28,0.877778,0.020494
17095,Knox County,,IL,3464,63727,67191,9,15,24,1337,1652,2989,6,0.337591,0.35786,6954.882607,0.001288,0.003224,23,0.000189,0,28,0.47619,0.009068
17097,Lake County,,IL,49940,736771,786711,138,163,301,41937,38883,80820,5,0.414103,0.455034,17063.731494,0.067981,0.073826,23,0.001521,0,28,0.374822,0.474632
17099,LaSalle County,,IL,6345,131198,137543,18,23,41,3941,3638,7579,6,0.338772,0.360297,4964.248789,0.00347,0.005326,23,0.000267,0,28,0.45471,0.022531
17101,Lawrence County,,IL,980,17056,18036,4,4,8,396,431,827,7,0.232003,0.239087,1166.453284,0.000007,0.000006,22,0.00018,0,28,0.083333,0.000431
17103,Lee County,,IL,2691,43066,45757,9,10,19,1653,1641,3294,6,0.33677,0.35614,23.362868,0.002327,0.003241,23,0.000142,0,28,0.788889,0.015498
17105,Livingston County,,IL,2443,43136,45579,9,10,19,1255,1358,2613,6,0.324153,0.342421,259.064214,0.001461,0.001501,23,0.000161,0,28,0.645455,0.010352
17107,Logan County,,IL,1970,33741,35711,8,9,17,888,1077,1965,6,0.324333,0.342564,692.984924,0.001281,0.001362,23,0.000168,0,28,0.633333,0.009207
17109,McDonough County,,IL,2405,32043,34448,9,10,19,855,834,1689,6,0.324696,0.343166,11286.72848,0.001218,0.001811,23,0.000224,0,28,0.309091,0.008543
17111,McHenry County,,IL,18621,287711,306332,32,42,74,18529,13031,31560,6,0.363284,0.390603,732.167672,0.016426,0.022139,23,0.000384,0,28,0.570035,0.115364
17113,McLean County,,IL,10998,166169,177167,42,37,79,6575,5870,12445,6,0.357125,0.383156,8256.312794,0.009633,0.012267,23,0.000576,0,28,0.3273,0.065703
17115,Macon County,,IL,6870,134255,141125,17,25,42,2216,3366,5582,6,0.350368,0.374963,9443.260279,0.003419,0.007131,23,0.000302,0,28,0.451667,0.021651
17117,Macoupin County,,IL,3084,55502,58586,10,8,18,1992,1899,3891,6,0.307326,0.321993,926.757859,0.002096,0.000958,50,0.000237,0,28,0.544444,0.014806
17119,Madison County,,IL,14278,307740,322018,37,35,72,9260,8714,17974,6,0.357301,0.382754,20095.490472,0.007165,0.011092,50,0.000664,0,28,0.302326,0.050475
17121,Marion County,,IL,2429,48164,50593,7,10,17,864,1145,2009,6,0.307749,0.322629,3801.482028,0.000301,0.000945,50,0.000197,0,28,0.5,0.002557
17123,Marshall County,,IL,1319,18848,20167,5,6,11,587,690,1277,7,0.27453,0.286094,1.845946,0.000268,0.000218,23,0.000107,0,28,0.766667,0.001448
17125,Mason County,,IL,1530,22099,23629,5,6,11,907,907,1814,7,0.2772,0.288651,20.872567,0.000316,0.00017,23,0.000119,0,28,0.6,0.001693
17127,Massac County,,IL,986,17261,18247,3,4,7,292,448,740,7,0.240228,0.248418,4206.96413,0.000016,0.000019,112,0.000174,0,28,0.083333,0.000428
17129,Menard County,,IL,1127,15341,16468,2,3,5,622,697,1319,7,0.265261,0.275451,1.535714,0.000097,0.000077,23,0.000081,0,28,0.666667,0.000692
17131,Mercer County,,IL,1273,21812,23085,5,6,11,772,728,1500,7,0.270771,0.282044,212.932235,0.000226,0.000169,23,0.000125,0,28,0.566667,0.001584
17133,Monroe County,,IL,1659,35830,37489,6,6,12,1492,985,2477,6,0.306872,0.321018,0.959346,0.001264,0.001106,50,0.00014,0,28,0.866667,0.008375
17135,Montgomery County,,IL,1684,34912,36596,6,6,12,796,845,1641,7,0.26805,0.279327,110.982583,0.00021,0.000149,50,0.000164,0,28,0.466667,0.001682
17137,Morgan County,,IL,2471,40842,43313,10,8,18,1071,1161,2232,6,0.324587,0.342822,9106.989916,0.001209,0.001135,23,0.000309,0,28,0.322222,0.009126
17139,Moultrie County,,IL,1026,15282,16308,5,5,10,600,561,1161,7,0.259809,0.269993,6.411122,0.000081,0.000045,23,0.000158,0,28,0.65,0.000786
17141,Ogle County,,IL,3844,62124,65968,11,10,21,2892,2280,5172,6,0.324008,0.342191,7.481782,0.002512,0.002414,23,0.000162,0,28,0.679487,0.016609
17143,Peoria County,,IL,13517,210587,224104,32,49,81,6903,8766,15669,6,0.376457,0.405045,20410.047503,0.008146,0.021791,23,0.000467,0,28,0.410774,0.056297
17145,Perry County,,IL,1359,23574,24933,6,6,12,760,632,1392,7,0.278182,0.289546,9.605122,0.000281,0.000251,23,0.000187,0,28,0.666667,0.002362
17147,Piatt County,,IL,1335,18601,19936,5,5,10,775,745,1520,6,0.279331,0.290746,71.871204,0.000307,0.000136,23,0.000149,0,28,0.65,0.001428
17149,Pike County,,IL,952,18787,19739,5,4,9,319,328,647,7,0.265576,0.276168,187.530693,0.000038,0.000097,23,0.000201,0,28,0.261905,0.000702
17151,Pope County,,IL,334,4058,4392,1,2,3,41,89,130,8,0.201679,0.20682,3.704762,0,0,112,0.000087,0,28,0,0.000095
17153,Pulaski County,,IL,610,7481,8091,3,3,6,200,210,410,7,0.253864,0.262477,124.155521,0.000001,0.000029,50,0.000191,0,28,0.25,0.000345
17155,Putnam County,,IL,470,6177,6647,2,2,4,216,262,478,7,0.253135,0.26172,0,0.000058,0.000046,23,0.000074,0,28,1,0.000504
17157,Randolph County,,IL,1812,35632,37444,9,8,17,1013,1021,2034,6,0.307164,0.321666,807.261052,0.001082,0.000922,50,0.000228,0,28,0.555556,0.007478
17159,Richland County,,IL,1173,19631,20804,4,6,10,284,384,668,8,0.204517,0.210775,83.347887,0,0,22,0.000208,0,28,0.266667,0.000383
17161,Rock Island County,,IL,9700,172956,182656,19,20,39,4828,5517,10345,6,0.341237,0.362768,2113.955703,0.006546,0.005238,23,0.000273,0,28,0.511858,0.045398
17163,St. Clair County,,IL,18224,292351,310575,64,57,121,10062,11062,21124,6,0.384117,0.413588,29551.423564,0.022564,0.023533,50,0.00093,0,28,0.362807,0.159181
17165,Saline County,,IL,1445,27151,28596,6,5,11,387,404,791,7,0.247278,0.255879,9065.966671,0.000021,0.000027,23,0.000353,0,28,0.125,0.000689
17167,Sangamon County,,IL,10753,230183,240936,36,39,75,6296,6144,12440,6,0.360759,0.387301,29979.499187,0.008143,0.011935,23,0.00063,0,28,0.316046,0.057169
17169,Schuyler County,,IL,497,7984,8481,2,3,5,117,198,315,7,0.245379,0.253509,10.833984,0.000015,0.000013,23,0.000101,0,28,0.333333,0.000268
17171,Scott County,,IL,334,5757,6091,2,2,4,175,168,343,7,0.245296,0.253067,0.625,0.00001,0.00001,23,0.000104,0,28,0.666667,0.000275
17173,Shelby County,,IL,1404,22909,24313,7,7,14,684,807,1491,7,0.267016,0.278398,147.752697,0.00009,0.000115,23,0.000197,0,28,0.375,0.001018
17175,Stark County,,IL,544,7927,8471,3,2,5,312,253,565,7,0.273626,0.284111,0.2,0.000235,0.000078,23,0.00008,0,28,0.666667,0.001013
17177,Stephenson County,,IL,3207,61832,65039,10,11,21,1365,1644,3009,6,0.337161,0.356828,131.149921,0.002404,0.00335,23,0.00017,0,28,0.593407,0.01623
17179,Tazewell County,,IL,9440,158681,168121,15,19,34,5589,5866,11455,6,0.339523,0.360899,2656.965387,0.003221,0.004054,23,0.000231,0,28,0.469048,0.019739
17181,Union County,,IL,1004,19701,20705,6,4,10,424,333,757,7,0.258538,0.26801,3436.511062,0.001097,0.00005,23,0.000232,0,28,0.366667,0.008105
17183,Vermilion County,,IL,4216,93680,97896,12,15,27,1491,1876,3367,6,0.326336,0.346205,4845.494763,0.002924,0.00197,23,0.000222,0,28,0.349265,0.018733
17185,Wabash County,,IL,800,14600,15400,3,4,7,229,243,472,7,0.266575,0.277219,1840.225518,0.000005,0.000053,22,0.000156,0,28,0.166667,0.000333
17187,Warren County,,IL,1290,17305,18595,4,4,8,447,523,970,7,0.252871,0.261606,149.021829,0.000042,0.000022,23,0.000145,0,28,0.416667,0.00054
17189,Washington County,,IL,1016,18288,19304,7,8,15,677,623,1300,6,0.307229,0.321752,48.612561,0.00031,0.000906,50,0.000187,0,28,0.660714,0.002633
17191,Wayne County,,IL,847,18847,19694,4,4,8,280,324,604,7,0.236553,0.24396,1021.632579,0.000008,0.000011,22,0.000177,0,28,0.3,0.000463
17193,White County,,IL,822,17740,18562,6,4,10,334,217,551,7,0.266795,0.27758,8931.243931,0.00008,0.000048,22,0.000256,0,28,0.166667,0.000912
17195,Whiteside County,,IL,3544,72855,76399,12,15,27,1790,1997,3787,6,0.337278,0.35743,87.649439,0.002222,0.003456,23,0.000182,0,28,0.5625,0.014961
17197,Will County,,IL,26592,485523,512115,46,65,111,38409,19736,58145,6,0.379702,0.410928,4196.967485,0.021193,0.029759,23,0.000563,0,28,0.487676,0.153708
17199,Williamson County,,IL,3907,66410,70317,14,13,27,2338,1759,4097,6,0.327586,0.346761,18565.710655,0.002161,0.002598,23,0.000424,0,28,0.3625,0.015618
17201,Winnebago County,,IL,15009,327633,342642,32,47,79,8739,8517,17256,6,0.374083,0.402133,2181.581126,0.010049,0.020952,23,0.00039,0,28,0.471373,0.067587
17203,Woodford County,,IL,2381,36137,38518,6,7,13,1491,1484,2975,7,0.277783,0.289787,10.002195,0.000363,0.000276,23,0.000121,0,28,0.690476,0.002061
18001,Adams County,,IN,1836,41357,43193,4,5,9,650,946,1596,6,0.301056,0.315239,124.421581,0.000291,0.000784,22,0.000104,0,28,0.5,0.001915
18003,Allen County,,IN,19487,400861,420348,74,87,161,10974,12112,23086,5,0.384575,0.418215,57360.482898,0.026142,0.03384,22,0.000934,0,28,0.332071,0.184541
18005,Bartholomew County,,IN,5951,94321,100272,13,18,31,2881,3162,6043,6,0.343576,0.365749,1258.450037,0.002079,0.004417,22,0.000255,0,28,0.423977,0.014105
18007,Benton County,,IN,1028,12329,13357,2,3,5,389,497,886,6,0.273884,0.284967,3.454044,0.000195,0.000069,22,0.00007,0,28,0.25,0.000697
18009,Blackford County,,IN,1284,20024,21308,4,7,11,564,830,1394,6,0.300558,0.31458,6.299351,0.000059,0.00061,22,0.000105,0,28,0.52381,0.000663
18011,Boone County,,IN,4445,61183,65628,9,9,18,3046,2574,5620,6,0.325495,0.344255,109.049247,0.001411,0.002042,22,0.000185,0,28,0.654545,0.009749
18013,Brown County,,IN,2105,23732,25837,6,5,11,1512,1293,2805,6,0.300124,0.313576,0.894023,0.000875,0.000716,22,0.000136,0,28,0.8,0.005702
18015,Carroll County,,IN,2225,31640,33865,7,6,13,1604,1393,2997,6,0.300403,0.314207,8.436798,0.000849,0.000683,22,0.000152,0,28,0.714286,0.005565
18017,Cass County,,IN,2777,47503,50280,10,11,21,1280,1547,2827,6,0.306064,0.32228,568.415427,0.001916,0.001436,22,0.000185,0,28,0.435897,0.013391
18019,Clark County,,IN,8559,113962,122521,13,13,26,5892,5773,11665,6,0.305293,0.321184,613.356912,0.002267,0.00122,112,0.000299,0,28,0.352381,0.016701
18021,Clay County,,IN,2250,35637,37887,9,9,18,1438,1396,2834,6,0.300403,0.314494,8.123272,0.000857,0.000768,22,0.000222,0,28,0.652778,0.006328
18023,Clinton County,,IN,2481,38951,41432,7,7,14,1161,1415,2576,6,0.300434,0.314379,3.86425,0.001093,0.000969,22,0.000153,0,28,0.660714,0.007496
18025,Crawford County,,IN,872,12399,13271,7,6,13,622,549,1171,6,0.293429,0.306983,716.690669,0.000531,0.000502,112,0.000209,0,28,0.404762,0.004309
18027,Daviess County,,IN,1560,34444,36004,7,8,15,600,742,1342,6,0.300963,0.315113,2132.775182,0.000695,0.000716,22,0.000207,0,28,0.482143,0.00516
18029,Dearborn County,,IN,3893,61336,65229,13,10,23,2995,2463,5458,6,0.302907,0.318312,4138.344226,0.001761,0.001379,112,0.000317,0,28,0.435897,0.011748
18031,Decatur County,,IN,2147,34072,36219,7,10,17,1054,1311,2365,6,0.300496,0.314838,518.158921,0.000671,0.000648,22,0.000175,0,28,0.5,0.005043
18033,DeKalb County,,IN,3289,49320,52609,7,7,14,1887,1956,3843,6,0.278102,0.290683,12.286205,0.000305,0.000254,22,0.000172,0,28,0.535714,0.00235
18035,Delaware County,,IN,7354,124815,132169,19,18,37,3984,3828,7812,6,0.34,0.36153,7523.5629,0.003217,0.003674,22,0.000276,0,28,0.447619,0.020745
18037,Dubois County,,IN,2373,54065,56438,10,11,21,1106,1162,2268,6,0.301056,0.315686,1826.598894,0.000109,0.000651,22,0.000305,0,28,0.336364,0.001569
18039,Elkhart County,,IN,11999,218408,230407,20,25,45,6280,6639,12919,6,0.348896,0.372687,1994.036116,0.005433,0.007475,22,0.000269,0,28,0.475385,0.03712
18041,Fayette County,,IN,1786,29711,31497,5,5,10,731,890,1621,6,0.300279,0.313863,810.213413,0.000033,0.000603,22,0.000146,0,28,0.571429,0.000711
18043,Floyd County,,IN,6652,81118,87770,9,8,17,4815,4606,9421,6,0.303603,0.318599,134.61694,0.001134,0.001088,112,0.000233,0,28,0.522222,0.008597
18045,Fountain County,,IN,1658,23182,24840,6,7,13,818,1027,1845,6,0.300838,0.314884,63.545106,0.000218,0.000663,22,0.000158,0,28,0.547619,0.001257
18047,Franklin County,,IN,2550,38028,40578,9,9,18,1669,1571,3240,6,0.302781,0.317968,1100.970518,0.001503,0.00127,112,0.000203,0,28,0.486111,0.009697
18049,Fulton County,,IN,1741,25957,27698,7,8,15,995,935,1930,6,0.300652,0.314895,8.066572,0.000316,0.000781,22,0.000131,0,28,0.569444,0.002092
18051,Gibson County,,IN,2039,39693,41732,8,8,16,1123,1155,2278,6,0.301056,0.315256,3858.028911,0.000699,0.000636,22,0.000228,0,28,0.446429,0.005288
18053,Grant County,,IN,4299,82102,86401,11,14,25,1462,2066,3528,6,0.326482,0.346348,970.194969,0.001261,0.002303,22,0.000193,0,28,0.554945,0.009291
18055,Greene County,,IN,2262,35601,37863,10,9,19,1405,1368,2773,6,0.300527,0.314694,763.73805,0.000884,0.000711,22,0.000245,0,28,0.463636,0.006236
18057,Hamilton County,,IN,17677,217968,235645,88,66,154,21179,12020,33199,5,0.385902,0.416563,18149.850323,0.036909,0.03062,22,0.001115,0,28,0.408485,0.259748
18059,Hancock County,,IN,5242,74523,79765,11,11,22,4544,3558,8102,6,0.329966,0.348842,196.725748,0.001213,0.002172,22,0.000213,0,28,0.551282,0.008787
18061,Harrison County,,IN,2642,42056,44698,5,7,12,1847,1690,3537,6,0.29331,0.306897,21.676359,0.000525,0.000515,112,0.000166,0,28,0.571429,0.004131
18063,Hendricks County,,IN,9812,134441,144253,27,17,44,11040,6775,17815,6,0.339167,0.36024,2140.977899,0.007889,0.003958,22,0.000416,0,28,0.410099,0.055196
18065,Henry County,,IN,3062,60710,63772,8,9,17,1655,1843,3498,6,0.300496,0.314723,434.42996,0.000947,0.000936,22,0.000172,0,28,0.597222,0.007322
18067,Howard County,,IN,5666,106458,112124,17,17,34,3044,3256,6300,6,0.329293,0.350751,499.001942,0.002677,0.004309,22,0.000275,0,28,0.45,0.017008
18069,Huntington County,,IN,2656,48971,51627,6,8,14,1253,1437,2690,6,0.300994,0.315497,36.97456,0.000311,0.000822,22,0.000132,0,28,0.541667,0.002201
18071,Jackson County,,IN,2708,44618,47326,7,12,19,1273,1591,2864,6,0.30373,0.319287,81.05039,0.000662,0.001237,22,0.000191,0,28,0.522727,0.005109
18073,Jasper County,,IN,2615,39096,41711,9,9,18,1862,1622,3484,6,0.325568,0.34437,242.34068,0.001624,0.001878,23,0.00016,0,28,0.644444,0.010234
18075,Jay County,,IN,1416,24814,26230,5,8,13,697,790,1487,6,0.300932,0.315268,37.415462,0.000052,0.00061,22,0.000129,0,28,0.267857,0.000697
18077,Jefferson County,,IN,2092,37903,39995,15,12,27,1331,1070,2401,6,0.303793,0.319401,1502.964338,0.001785,0.001113,22,0.000361,0,28,0.342857,0.012674
18079,Jennings County,,IN,2012,30941,32953,7,7,14,1369,1292,2661,6,0.300341,0.314207,29.186796,0.000671,0.000652,22,0.000171,0,28,0.589286,0.005069
18081,Johnson County,,IN,11509,135346,146855,22,23,45,10148,8183,18331,6,0.34806,0.370869,1926.249091,0.004515,0.007125,22,0.000375,0,28,0.388889,0.032234
18083,Knox County,,IN,2257,41748,44005,9,8,17,803,927,1730,6,0.301244,0.315514,6765.44807,0.000734,0.000738,22,0.00025,0,28,0.455556,0.005564
18085,Kosciusko County,,IN,5243,90332,95575,16,16,32,2986,2847,5833,6,0.326593,0.346749,1307.757079,0.002533,0.002538,22,0.000251,0,28,0.432749,0.016892
18087,LaGrange County,,IN,2414,41837,44251,8,6,14,1508,1486,2994,6,0.278715,0.291171,11.101924,0.000617,0.00028,22,0.000161,0,28,0.553571,0.003785
18089,Lake County,,IN,26446,557344,583790,46,75,121,17349,19371,36720,5,0.387497,0.419401,10221.291576,0.021054,0.035819,23,0.000566,0,28,0.481986,0.14807
18091,LaPorte County,,IN,5968,127905,133873,11,18,29,3745,3302,7047,6,0.343617,0.365457,224.360306,0.003319,0.006387,23,0.000145,0,28,0.643791,0.020293
18093,Lawrence County,,IN,2611,54007,56618,7,7,14,1373,1354,2727,6,0.30031,0.31415,2654.533412,0.000815,0.00068,22,0.000186,0,28,0.410714,0.005543
18095,Madison County,,IN,7907,153506,161413,13,16,29,3444,4594,8038,6,0.333257,0.353721,222.715022,0.001501,0.004134,22,0.000237,0,28,0.506536,0.010276
18097,Marion County,,IN,66377,947771,1014148,207,191,398,49330,56065,105395,5,0.428445,0.470422,240442.867769,0.070717,0.074438,22,0.0028,0,28,0.238075,0.497166
18099,Marshall County,,IN,3396,54233,57629,10,10,20,2474,1954,4428,6,0.325751,0.344771,297.858307,0.001952,0.001856,22,0.000146,0,28,0.704545,0.012281
18101,Martin County,,IN,730,12048,12778,4,4,8,272,345,617,7,0.2318,0.239018,6.746335,0.000017,0.00002,22,0.00015,0,28,0.5,0.000528
18103,Miami County,,IN,2937,39968,42905,9,10,19,1656,1653,3309,6,0.300776,0.315354,113.449548,0.000985,0.001001,22,0.00016,0,28,0.537879,0.006974
18105,Monroe County,,IN,11744,108157,119901,34,43,77,5413,6462,11875,5,0.375533,0.403824,8220.923727,0.010569,0.020533,22,0.000531,0,28,0.429804,0.073865
18107,Montgomery County,,IN,2345,40941,43286,7,10,17,1216,1271,2487,6,0.300683,0.315124,141.351684,0.000846,0.001039,22,0.000172,0,28,0.577778,0.005751
18109,Morgan County,,IN,4770,65753,70523,10,8,18,3342,3400,6742,6,0.300248,0.31415,6.758278,0.001142,0.00107,22,0.000221,0,28,0.611111,0.008635
18111,Newton County,,IN,1257,13387,14644,4,3,7,652,594,1246,6,0.283306,0.295287,9.721577,0.001296,0.000239,23,0.000101,0,28,0.7,0.008655
18113,Noble County,,IN,3400,53713,57113,9,7,16,2211,2239,4450,6,0.278715,0.291285,140.787995,0.000642,0.000287,22,0.000188,0,28,0.458333,0.004826
18115,Ohio County,,IN,640,6630,7270,3,2,5,419,312,731,7,0.232523,0.239307,0,0.000593,0.000019,112,0.000126,0,28,0.833333,0.003606
18117,Orange County,,IN,1216,20541,21757,6,5,11,572,532,1104,7,0.233438,0.241108,1043.686415,0.000621,0.000021,22,0.000186,0,28,0.357143,0.004788
18119,Owen County,,IN,1582,19092,20674,7,8,15,1225,1109,2334,6,0.300341,0.314264,3.310171,0.000821,0.000767,22,0.000184,0,28,0.785714,0.005976
18121,Parke County,,IN,1189,16627,17816,7,7,14,760,790,1550,6,0.300372,0.314207,426.910957,0.00069,0.000611,22,0.000174,0,28,0.625,0.005414
18123,Perry County,,IN,1171,21155,22326,4,6,10,636,655,1291,6,0.300838,0.314809,741.105555,0.000085,0.000587,22,0.000179,0,28,0.428571,0.00076
18125,Pike County,,IN,780,13493,14273,4,5,9,455,454,909,7,0.266551,0.277363,1.861534,0.000095,0.000065,22,0.000136,0,28,0.8,0.000838
18127,Porter County,,IN,10393,160188,170581,17,22,39,7967,6530,14497,6,0.350706,0.374751,408.497385,0.006454,0.009688,23,0.00021,0,28,0.636667,0.043148
18129,Posey County,,IN,2249,35736,37985,3,5,8,1185,1519,2704,7,0.266575,0.277334,5.493819,0.000093,0.00007,22,0.000114,0,28,0.6,0.000769
18131,Pulaski County,,IN,1149,16204,17353,8,9,17,1065,621,1686,6,0.300558,0.314838,17.761973,0.000409,0.000862,22,0.000147,0,28,0.544444,0.002575
18133,Putnam County,,IN,2411,34802,37213,9,8,17,1571,1459,3030,6,0.300372,0.314322,9.554913,0.000756,0.000693,22,0.000213,0,28,0.611111,0.006029
18135,Randolph County,,IN,2088,31517,33605,6,6,12,1142,1296,2438,6,0.30062,0.31458,28.624243,0.000075,0.000619,22,0.000131,0,28,0.52381,0.000935
18137,Ripley County,,IN,1413,18127,19540,7,8,15,1182,1003,2185,6,0.302623,0.317624,890.134009,0.000622,0.001089,112,0.000206,0,28,0.607143,0.004261
18139,Rush County,,IN,1363,18983,20346,7,7,14,768,886,1654,6,0.300248,0.314035,487.510455,0.000652,0.00061,22,0.000171,0,28,0.571429,0.004988
18141,St. Joseph County,,IN,16481,296169,312650,36,59,95,8258,10082,18340,6,0.378762,0.409173,6415.111751,0.015891,0.029521,22,0.000428,0,28,0.530601,0.11248
18143,Scott County,,IN,1570,25885,27455,7,8,15,1090,1005,2095,6,0.293696,0.307642,41.564457,0.000575,0.000543,22,0.000188,0,28,0.607143,0.004562
18145,Shelby County,,IN,3140,45765,48905,8,9,17,1969,2099,4068,6,0.300372,0.314494,11.878928,0.000731,0.001011,22,0.000182,0,28,0.518182,0.005397
18147,Spencer County,,IN,1878,23948,25826,5,5,10,1054,1199,2253,7,0.266697,0.277569,13.074645,0.000114,0.000073,22,0.000164,0,28,0.7,0.00104
18149,Starke County,,IN,4255,25389,29644,8,15,23,1100,3474,4574,6,0.325824,0.345459,281.925826,0.001684,0.002071,22,0.000128,0,28,0.538095,0.010567
18151,Steuben County,,IN,2708,37790,40498,8,8,16,1556,1388,2944,6,0.301119,0.315726,119.618289,0.000337,0.00083,22,0.000179,0,28,0.402778,0.002716
18153,Sullivan County,,IN,1343,22842,24185,5,5,10,779,730,1509,6,0.30031,0.313834,1.65,0.000651,0.000609,22,0.000149,0,28,0.85,0.004811
18155,Switzerland County,,IN,612,7601,8213,5,4,9,444,356,800,7,0.234265,0.242014,11.714839,0.00061,0.000038,112,0.000187,0,28,0.7,0.003937
18157,Tippecanoe County,,IN,13616,139846,153462,38,60,98,6192,8096,14288,5,0.376994,0.407362,19992.454293,0.00702,0.022802,22,0.00058,0,28,0.320746,0.049152
18159,Tipton County,,IN,1224,17754,18978,5,4,9,778,759,1537,6,0.300124,0.313462,0.166667,0.00092,0.000899,22,0.000122,0,28,0.9,0.006855
18161,Union County,,IN,320,4749,5069,1,2,3,106,163,269,7,0.233063,0.240245,0,0.000012,0.000012,22,0.000064,0,28,1,0.000175
18163,Vanderburgh County,,IN,11350,189891,201241,28,32,60,6275,6788,13063,6,0.362785,0.389554,53068.167394,0.005894,0.009799,22,0.000589,0,28,0.308559,0.040739
18165,Vermillion County,,IN,1437,19389,20826,5,6,11,745,827,1572,6,0.300714,0.314511,31.218641,0.000062,0.00062,22,0.000139,0,28,0.566667,0.000853
18167,Vigo County,,IN,7235,109743,116978,20,23,43,2945,3732,6677,6,0.341197,0.363508,14199.880727,0.002539,0.004295,22,0.000431,0,28,0.307692,0.017693
18169,Wabash County,,IN,2203,39290,41493,6,8,14,855,1161,2016,6,0.300963,0.31544,31.169343,0.000328,0.000844,22,0.00013,0,28,0.696429,0.002388
18171,Warren County,,IN,551,8988,9539,4,3,7,499,292,791,6,0.274323,0.285632,4.172476,0.000205,0.000082,22,0.00011,0,28,0.666667,0.000975
18173,Warrick County,,IN,4851,59293,64144,10,9,19,3120,2793,5913,6,0.304143,0.319533,1371.389564,0.001455,0.001106,22,0.000249,0,28,0.477778,0.010934
18175,Washington County,,IN,1603,30612,32215,9,7,16,1205,961,2166,6,0.293399,0.307069,632.014674,0.001139,0.000511,112,0.000229,0,28,0.527778,0.00861
18177,Wayne County,,IN,4007,80175,84182,11,14,25,1616,1858,3474,6,0.303762,0.320147,6732.317026,0.001435,0.00152,22,0.000223,0,28,0.357143,0.009357
18179,Wells County,,IN,1730,29745,31475,5,6,11,1025,1032,2057,6,0.301025,0.315296,198.510579,0.000295,0.000784,22,0.000118,0,28,0.5,0.00201
18181,White County,,IN,1935,25686,27621,8,6,14,1050,1050,2100,6,0.300496,0.314379,122.646906,0.00152,0.000664,22,0.000146,0,28,0.638889,0.00973
18183,Whitley County,,IN,2193,37935,40128,5,6,11,1649,1428,3077,6,0.277942,0.290225,3.842342,0.000308,0.000243,22,0.000123,0,28,0.7,0.0022
19001,Adair County,,IA,729,10975,11704,4,4,8,231,273,504,6,0.286998,0.29871,4.190476,0.000347,0.000232,23,0.000214,0,28,0.7,0.00197
19003,Adams County,,IA,378,5550,5928,0,1,1,0,49,49,7,0.223023,0.228404,0,0,0.000003,23,0.00005,0,61,0,0
19005,Allamakee County,,IA,1222,17042,18264,2,4,6,151,556,707,7,0.255718,0.265441,25.955252,0.000003,0.000044,127,0.000093,0,28,0.166667,0.000207
19007,Appanoose County,,IA,915,14649,15564,5,3,8,263,195,458,6,0.287083,0.298767,3348.788651,0.000348,0.000216,23,0.000228,0,28,0.3,0.002098
19009,Audubon County,,IA,523,8865,9388,1,2,3,61,146,207,6,0.287026,0.298509,0,0.000004,0.000206,23,0.000073,0,28,0.5,0.000114
19011,Benton County,,IA,2027,33371,35398,6,7,13,1613,1284,2897,6,0.289715,0.302574,77.369758,0.000404,0.000426,23,0.000155,0,28,0.571429,0.002256
19013,Black Hawk County,,IA,8268,137799,146067,25,28,53,3265,4369,7634,6,0.353478,0.377279,33875.34978,0.005131,0.007317,23,0.000466,0,28,0.3125,0.036611
19015,Boone County,,IA,2281,37137,39418,6,7,13,1206,1193,2399,6,0.289513,0.30223,160.976074,0.000453,0.000435,23,0.000183,0,28,0.589286,0.002546
19017,Bremer County,,IA,1512,25742,27254,5,6,11,862,757,1619,6,0.288078,0.300677,261.034997,0.000216,0.000333,23,0.00014,0,28,0.466667,0.001476
19019,Buchanan County,,IA,1653,26035,27688,5,6,11,797,912,1709,7,0.270595,0.281889,32.723087,0.000219,0.000136,23,0.000141,0,28,0.6,0.001499
19021,Buena Vista County,,IA,2053,22502,24555,6,8,14,489,632,1121,6,0.331698,0.350195,15265.504721,0.001324,0.001612,127,0.000175,0,28,0.277778,0.010018
19023,Butler County,,IA,1065,18649,19714,3,5,8,385,515,900,7,0.261444,0.271232,118.118584,0.000064,0.000044,23,0.0001,0,28,0.25,0.000618
19025,Calhoun County,,IA,927,13691,14618,2,4,6,240,322,562,6,0.287225,0.299083,225.071433,0.000012,0.000208,23,0.000081,0,28,0.45,0.000205
19027,Carroll County,,IA,1367,26986,28353,5,4,9,353,333,686,6,0.287253,0.299169,1716.045262,0.00035,0.000231,23,0.000156,0,28,0.266667,0.002014
19029,Cass County,,IA,953,16211,17164,4,5,9,274,333,607,6,0.298429,0.311237,2990.207345,0.000474,0.000539,50,0.000131,0,28,0.6,0.002844
19031,Cedar County,,IA,1685,25098,26783,5,4,9,916,860,1776,7,0.277359,0.289314,0.2,0.000488,0.00027,23,0.000118,0,28,0.85,0.002542
19033,Cerro Gordo County,,IA,3216,55997,59213,12,14,26,1087,1417,2504,6,0.306355,0.323271,21797.245298,0.001303,0.00139,23,0.000316,0,28,0.285714,0.008685
19035,Cherokee County,,IA,952,17018,17970,5,5,10,370,297,667,7,0.267483,0.277687,1441.698385,0.000016,0.000039,127,0.000175,0,28,0.3,0.000549
19037,Chickasaw County,,IA,742,15977,16719,5,5,10,364,265,629,7,0.261444,0.271232,4652.083227,0.000065,0.000043,23,0.000154,0,28,0.366667,0.000808
19039,Clarke County,,IA,865,10481,11346,2,4,6,188,387,575,6,0.286998,0.29871,2967,0.000344,0.00021,23,0.000097,0,28,0.583333,0.001723
19041,Clay County,,IA,1521,21079,22600,5,6,11,469,502,971,6,0.289773,0.302442,5386.821091,0.000358,0.000297,127,0.000212,0,28,0.1,0.002106
19043,Clayton County,,IA,1168,23158,24326,7,7,14,569,587,1156,7,0.270847,0.28252,3113.175894,0.000191,0.000159,23,0.000184,0,28,0.375,0.001559
19045,Clinton County,,IA,2994,59721,62715,7,11,18,1291,1508,2799,6,0.330041,0.348882,466.269103,0.001359,0.001731,23,0.000135,0,28,0.557692,0.009484
19047,Crawford County,,IA,1087,18870,19957,4,5,9,232,325,557,6,0.298521,0.311352,48.733976,0.000012,0.000527,50,0.000146,0,28,0.333333,0.000424
19049,Dallas County,,IA,4208,48116,52324,15,9,24,3788,2395,6183,6,0.330303,0.348699,3625.123175,0.002917,0.001846,23,0.000353,0,28,0.448529,0.018224
19051,Davis County,,IA,526,10403,10929,1,1,2,164,156,320,7,0.225471,0.231504,0,0.000004,0.000011,23,0.000079,0,28,0,0.000175
19053,Decatur County,,IA,721,8193,8914,1,2,3,86,158,244,6,0.286941,0.298366,0,0.000002,0.000205,23,0.000071,0,28,1,0.000103
19055,Delaware County,,IA,1200,21308,22508,5,5,10,528,576,1104,7,0.270142,0.281127,5.02996,0.000189,0.000117,23,0.000149,0,28,0.65,0.001354
19057,Des Moines County,,IA,2746,49857,52603,7,9,16,892,987,1879,6,0.291195,0.304581,5218.454368,0.000321,0.000465,23,0.000204,0,28,0.375,0.001931
19059,Dickinson County,,IA,1301,20193,21494,6,4,10,407,340,747,6,0.289542,0.302116,6265.699938,0.000194,0.000283,127,0.000238,0,28,0.309524,0.00145
19061,Dubuque County,,IA,5018,108130,113148,16,16,32,1767,2361,4128,6,0.342887,0.364431,4085.01885,0.003054,0.003702,23,0.00031,0,28,0.4375,0.020099
19063,Emmet County,,IA,673,12571,13244,1,2,3,67,136,203,7,0.235099,0.242177,8.748952,0.000002,0.000002,127,0.000101,0,28,0,0.000109
19065,Fayette County,,IA,1481,23952,25433,5,7,12,596,690,1286,7,0.270696,0.282233,1500.984912,0.000065,0.000135,23,0.000147,0,28,0.47619,0.000833
19067,Floyd County,,IA,1124,18577,19701,4,5,9,317,412,729,6,0.287594,0.299914,336.460198,0.000012,0.000255,23,0.000145,0,28,0.4,0.000467
19069,Franklin County,,IA,858,14636,15494,4,4,8,280,301,581,6,0.287225,0.29914,62.558986,0.000016,0.000219,23,0.000131,0,28,0.4,0.000501
19071,Fremont County,,IA,793,10470,11263,5,5,10,343,357,700,7,0.295848,0.308001,8.184402,0.000478,0.000348,50,0.000159,0,28,0.6,0.003015
19073,Greene County,,IA,800,11785,12585,5,5,10,248,326,574,6,0.287139,0.299054,11.783009,0.000034,0.00024,23,0.000174,0,28,0.5,0.000683
19075,Grundy County,,IA,900,15111,16011,4,6,10,427,503,930,6,0.287367,0.299627,60.257881,0.000077,0.000253,23,0.000114,0,28,0.566667,0.000751
19077,Guthrie County,,IA,861,12057,12918,4,4,8,479,464,943,6,0.286998,0.29871,136.775212,0.000361,0.000229,23,0.000176,0,28,0.583333,0.002096
19079,Hamilton County,,IA,1322,18735,20057,6,6,12,562,664,1226,6,0.287253,0.299427,12.384895,0.000442,0.000244,23,0.000163,0,28,0.566667,0.002425
19081,Hancock County,,IA,900,14086,14986,4,4,8,377,359,736,7,0.237461,0.245737,1301.800857,0.000017,0.000013,23,0.000148,0,28,0.5,0.000482
19083,Hardin County,,IA,1305,19234,20539,6,7,13,416,507,923,6,0.287367,0.299742,467.474712,0.000444,0.000281,23,0.000163,0,28,0.5,0.002403
19085,Harrison County,,IA,1198,18314,19512,3,4,7,545,501,1046,7,0.298062,0.310117,1090.591514,0.000472,0.000445,50,0.000105,0,28,0.583333,0.002738
19087,Henry County,,IA,1461,23364,24825,7,7,14,679,653,1332,6,0.289831,0.302718,1595.224546,0.000324,0.000389,23,0.00019,0,28,0.513889,0.001971
19089,Howard County,,IA,701,13295,13996,2,3,5,127,214,341,7,0.233045,0.240348,2.629714,0.000002,0.000007,23,0.000096,0,28,0.333333,0.000197
19091,Humboldt County,,IA,721,13003,13724,3,3,6,250,187,437,7,0.248355,0.256612,358.705363,0.000016,0.000006,23,0.00012,0,28,0.166667,0.000324
19093,Ida County,,IA,539,9160,9699,2,2,4,82,120,202,7,0.267261,0.276924,56.75437,0,0.000027,127,0.000097,0,28,0.333333,0.000191
19095,Iowa County,,IA,1020,19627,20647,5,5,10,664,551,1215,7,0.275076,0.28682,236.205268,0.000347,0.000183,23,0.000147,0,28,0.45,0.001854
19097,Jackson County,,IA,1188,22823,24011,3,5,8,566,627,1193,7,0.273343,0.284997,5.797385,0.000174,0.000206,23,0.000087,0,28,0.75,0.001108
19099,Jasper County,,IA,2418,44061,46479,6,6,12,1153,1196,2349,6,0.287168,0.299283,5.813624,0.000446,0.000245,23,0.000166,0,28,0.619048,0.002447
19101,Jefferson County,,IA,1162,17836,18998,5,6,11,378,394,772,7,0.272753,0.284114,807.669548,0.000193,0.000109,23,0.000193,0,28,0.466667,0.001268
19103,Johnson County,,IA,11958,111706,123664,44,52,96,6515,7002,13517,6,0.374179,0.403044,43725.631813,0.011077,0.022968,23,0.000794,0,28,0.329017,0.078848
19105,Jones County,,IA,1285,21995,23280,4,4,8,606,665,1271,7,0.27492,0.286419,7.304012,0.000187,0.000203,23,0.000121,0,28,0.65,0.001238
19107,Keokuk County,,IA,763,12981,13744,5,5,10,325,349,674,7,0.272702,0.283913,14.943897,0.00001,0.000112,23,0.000187,0,28,0.433333,0.000633
19109,Kossuth County,,IA,1181,21326,22507,4,5,9,197,284,481,6,0.287679,0.299696,1898.842302,0.000002,0.000203,23,0.000186,0,28,0.1,0.000378
19111,Lee County,,IA,2374,42564,44938,4,7,11,651,967,1618,7,0.27565,0.287927,5676.911756,0.000007,0.000192,23,0.000196,0,28,0.357143,0.000421
19113,Linn County,,IA,12444,223487,235931,47,50,97,7689,7505,15194,6,0.369565,0.397861,49085.453253,0.010914,0.01928,23,0.000852,0,28,0.284615,0.078567
19115,Louisa County,,IA,1012,16766,17778,3,6,9,381,528,909,7,0.276488,0.288402,3.796244,0.000193,0.000193,23,0.000103,0,28,0.633333,0.001052
19117,Lucas County,,IA,663,10130,10793,4,3,7,293,230,523,6,0.286969,0.298538,1.7,0.000348,0.000208,23,0.00017,0,28,0.666667,0.001983
19119,Lyon County,,IA,771,15044,15815,3,3,6,249,287,536,7,0.265601,0.275859,1.761111,0.000097,0.000085,127,0.000177,0,28,0.833333,0.000997
19121,Madison County,,IA,1224,16734,17958,5,5,10,741,664,1405,6,0.287026,0.298882,6.261905,0.000362,0.000236,23,0.00022,0,28,0.533333,0.002228
19123,Mahaska County,,IA,1977,27322,29299,7,8,15,748,961,1709,6,0.287993,0.300791,1550.915436,0.000355,0.000336,23,0.000223,0,28,0.416667,0.002353
19125,Marion County,,IA,2086,35827,37913,7,8,15,1042,965,2007,6,0.288937,0.301582,1220.155786,0.000354,0.000334,23,0.000245,0,28,0.430556,0.002372
19127,Marshall County,,IA,2697,47226,49923,8,13,21,863,1218,2081,6,0.331622,0.350957,589.474679,0.000589,0.001927,23,0.000194,0,28,0.467949,0.003276
19129,Mills County,,IA,1287,16256,17543,4,4,8,692,650,1342,7,0.29794,0.309956,5.295951,0.000628,0.000449,50,0.000121,0,28,0.833333,0.003657
19131,Mitchell County,,IA,582,12491,13073,3,3,6,159,177,336,7,0.250108,0.258917,20.150387,0.000033,0.000018,23,0.000113,0,28,0.333333,0.000425
19133,Monona County,,IA,755,11544,12299,1,3,4,194,284,478,7,0.296059,0.308076,68.439565,0.000096,0.000341,127,0.000065,0,28,0.5,0.000301
19135,Monroe County,,IA,573,9133,9706,3,4,7,178,243,421,7,0.225646,0.232392,1.75,0.000009,0.00002,23,0.000129,0,28,0.583333,0.000409
19137,Montgomery County,,IA,956,13723,14679,4,5,9,206,349,555,6,0.298583,0.311467,12.299263,0.000475,0.000543,50,0.000122,0,28,0.75,0.002876
19139,Muscatine County,,IA,2658,45705,48363,8,7,15,1115,1268,2383,6,0.290962,0.30395,403.698146,0.00151,0.000518,23,0.000166,0,28,0.569444,0.010091
19141,O'Brien County,,IA,1061,17737,18798,5,6,11,289,374,663,7,0.271201,0.282841,1035.51759,0.000018,0.00011,127,0.000195,0,28,0.285714,0.000579
19143,Osceola County,,IA,379,7118,7497,2,2,4,97,93,190,7,0.224809,0.23095,19.935585,0.000009,0.000002,127,0.000112,0,28,0,0.000231
19145,Page County,,IA,1177,16755,17932,6,7,13,456,474,930,7,0.296179,0.308706,2855.375941,0.000484,0.000344,50,0.000164,0,28,0.309524,0.003089
19147,Palo Alto County,,IA,708,11246,11954,2,2,4,111,146,257,7,0.225139,0.231211,199.413146,0.000004,0.000003,127,0.000112,0,28,0,0.000207
19149,Plymouth County,,IA,1514,28661,30175,3,5,8,605,691,1296,6,0.287537,0.299771,130.75222,0.000099,0.000233,127,0.000113,0,28,0.4,0.000506
19151,Pocahontas County,,IA,566,10073,10639,1,2,3,42,89,131,7,0.253731,0.262093,7.177381,0.000012,0.000013,23,0.000064,0,28,0,0.000114
19153,Polk County,,IA,24682,435640,460322,104,106,210,16913,16985,33898,5,0.402242,0.436355,212537.019346,0.025176,0.042536,23,0.002121,0,28,0.238952,0.181812
19155,Pottawattamie County,,IA,6391,99263,105654,14,17,31,3447,3942,7389,6,0.332571,0.352505,1605.736937,0.002342,0.002079,50,0.000329,0,28,0.316993,0.01494
19157,Poweshiek County,,IA,1388,20605,21993,6,8,14,523,660,1183,6,0.289628,0.302574,123.644233,0.000366,0.000394,23,0.000171,0,28,0.482143,0.002207
19159,Ringgold County,,IA,312,5591,5903,0,1,1,0,56,56,7,0.223023,0.228404,0,0,0.000003,23,0.00005,0,62,0,0
19161,Sac County,,IA,789,12940,13729,2,5,7,141,292,433,7,0.249442,0.257878,1762.840597,0.000015,0.000014,127,0.000102,0,28,0.25,0.000283
19163,Scott County,,IA,12035,181888,193923,33,44,77,5761,6686,12447,6,0.370366,0.39836,19512.363606,0.010063,0.016171,23,0.000501,0,28,0.373004,0.069171
19165,Shelby County,,IA,839,15566,16405,3,4,7,254,338,592,6,0.298399,0.311065,1088.310001,0.000472,0.000535,50,0.000105,0,28,0.666667,0.002738
19167,Sioux County,,IA,1736,36834,38570,5,9,14,465,746,1211,6,0.289628,0.302987,424.621277,0.000192,0.000344,127,0.000195,0,28,0.347222,0.001348
19169,Story County,,IA,8273,71990,80263,26,29,55,3236,4169,7405,6,0.357125,0.382255,7303.980795,0.003573,0.009991,23,0.000538,0,28,0.316817,0.025087
19171,Tama County,,IA,1177,18558,19735,5,6,11,492,607,1099,6,0.287964,0.300447,6.644594,0.000083,0.000342,23,0.00013,0,28,0.619048,0.000867
19173,Taylor County,,IA,638,7859,8497,2,4,6,111,230,341,6,0.287509,0.299473,34.348087,0.00001,0.000213,23,0.000088,0,28,0.333333,0.000244
19175,Union County,,IA,1005,13091,14096,6,3,9,328,290,618,6,0.286941,0.298481,5816.432239,0.000347,0.000208,23,0.000254,0,28,0.2,0.002118
19177,Van Buren County,,IA,482,8650,9132,2,2,4,101,140,241,7,0.225559,0.231836,0,0.000005,0.000013,23,0.000106,0,28,1,0.00028
19179,Wapello County,,IA,2453,37574,40027,13,12,25,1023,1186,2209,6,0.291078,0.30481,16327.072713,0.001403,0.00047,23,0.000404,0,28,0.165441,0.008724
19181,Warren County,,IA,3018,41852,44870,7,7,14,1935,1751,3686,6,0.287111,0.299283,22.538909,0.000598,0.000267,23,0.000215,0,28,0.430556,0.003313
19183,Washington County,,IA,1364,23375,24739,7,5,12,829,670,1499,7,0.275076,0.286791,671.323556,0.000688,0.000181,23,0.000192,0,28,0.452381,0.003579
19185,Wayne County,,IA,452,7096,7548,3,3,6,170,199,369,6,0.286941,0.298481,1.5,0.000345,0.000208,23,0.00018,0,28,0.666667,0.001855
19187,Webster County,,IA,2525,43623,46148,6,12,18,622,1224,1846,6,0.329704,0.348635,11496.812081,0.000348,0.001534,23,0.000194,0,28,0.339744,0.002139
19189,Winnebago County,,IA,978,13818,14796,4,6,10,222,407,629,7,0.282096,0.295472,2036.888834,0.000013,0.000267,23,0.000159,0,28,0.233333,0.000459
19191,Winneshiek County,,IA,1033,21583,22616,4,6,10,294,374,668,7,0.275258,0.287279,833.738424,0.000002,0.000184,23,0.000141,0,28,0.166667,0.000385
19193,Woodbury County,,IA,7954,118209,126163,21,30,51,3177,4310,7487,6,0.364331,0.389537,25078.912975,0.003351,0.011883,127,0.000527,0,28,0.310811,0.023179
19195,Worth County,,IA,576,8956,9532,2,3,5,213,247,460,7,0.2375,0.245708,1.210714,0.000013,0.000017,23,0.000092,0,28,0.5,0.000272
19197,Wright County,,IA,1057,15874,16931,6,7,13,406,389,795,6,0.287395,0.299828,3251.09439,0.000357,0.00022,23,0.000203,0,28,0.357143,0.002214
20001,Allen County,,KS,1124,15772,16896,3,5,8,207,375,582,7,0.232411,0.240022,2981.908766,0.00001,0.000016,50,0.000127,0,28,0.133333,0.000307
20003,Anderson County,,KS,647,9997,10644,4,3,7,365,220,585,6,0.295187,0.307459,6162.136105,0.000516,0.000465,50,0.000126,0,28,0.5,0.003826
20005,Atchison County,,KS,1084,19226,20310,4,6,10,317,454,771,6,0.298032,0.311323,61.409857,0.000238,0.000675,50,0.000114,0,28,0.517857,0.001765
20007,Barber County,,KS,427,6142,6569,1,0,1,50,0,50,0,0,0,0,0.000355,0,50,0.000063,0,26,0,0.00193
20009,Barton County,,KS,2090,31233,33323,8,10,18,502,793,1295,6,0.298951,0.313169,10679.82375,0.000384,0.000906,50,0.000321,0,28,0.346154,0.002695
20011,Bourbon County,,KS,1129,17533,18662,4,4,8,315,351,666,6,0.295337,0.30786,441.932828,0.000021,0.00048,50,0.000155,0,28,0.25,0.000531
20013,Brown County,,KS,804,12875,13679,2,6,8,100,342,442,6,0.295878,0.30891,523.25079,0.000001,0.000556,50,0.000118,0,28,0.380952,0.000182
20015,Butler County,,KS,5103,66011,71114,8,10,18,2952,3010,5962,6,0.298644,0.312625,68.571918,0.000439,0.000899,50,0.000194,0,28,0.409091,0.002984
20017,Chase County,,KS,268,3357,3625,1,1,2,40,67,107,7,0.236457,0.243307,0,0.000013,0.000019,50,0.000078,0,28,0,0.000237
20019,Chautauqua County,,KS,480,5367,5847,1,2,3,112,148,260,7,0.233531,0.240555,0.604762,0.00001,0.00001,50,0.000066,0,28,0,0.000146
20021,Cherokee County,,KS,1747,25401,27148,5,6,11,801,950,1751,6,0.295757,0.308835,97.748533,0.000085,0.000542,50,0.000144,0,28,0.533333,0.001129
20023,Cheyenne County,,KS,218,3738,3956,0,0,0,0,0,0,0,0,0,0,0,0,24,0.00005,21,63,0,0
20025,Clark County,,KS,205,2663,2868,1,1,2,63,40,103,7,0.235537,0.242387,0,0.00001,0.000016,50,0.000064,0,28,0,0.000197
20027,Clay County,,KS,779,11455,12234,4,4,8,215,233,448,7,0.271378,0.282067,10.637305,0.000219,0.000124,50,0.000122,0,28,0.55,0.00123
20029,Cloud County,,KS,862,11452,12314,2,5,7,101,300,401,6,0.289455,0.301812,5873.174242,0.000011,0.000293,50,0.000143,0,28,0.4,0.000334
20031,Coffey County,,KS,816,10989,11805,1,3,4,133,247,380,6,0.295547,0.307935,145.739621,0.000013,0.000478,50,0.000078,0,28,0.333333,0.000237
20033,Comanche County,,KS,116,2136,2252,0,0,0,0,0,0,0,0,0,0,0,0,25,0.00005,22,64,0,0
20035,Cowley County,,KS,2672,38717,41389,5,7,12,880,1173,2053,6,0.289888,0.302718,687.593193,0.000384,0.000357,50,0.000143,0,28,0.339286,0.002487
20037,Crawford County,,KS,2725,36029,38754,11,14,25,1194,1344,2538,6,0.302372,0.318169,8387.142879,0.001387,0.001504,50,0.000259,0,28,0.347619,0.009381
20039,Decatur County,,KS,279,4076,4355,0,0,0,0,0,0,0,0,0,0,0,0,26,0.00005,23,65,0,0
20041,Dickinson County,,KS,1878,22520,24398,5,6,11,606,730,1336,6,0.298675,0.31192,85.360391,0.000578,0.00068,50,0.000144,0,28,0.785714,0.003296
20043,Doniphan County,,KS,611,8709,9320,3,2,5,293,247,540,7,0.240447,0.247884,2816.902487,0.000024,0.00001,50,0.000107,0,28,0.5,0.000382
20045,Douglas County,,KS,10232,95209,105441,33,30,63,5520,5850,11370,6,0.361028,0.386418,7938.286883,0.007275,0.013192,50,0.00063,0,28,0.329798,0.052692
20047,Edwards County,,KS,322,3845,4167,0,0,0,0,0,0,0,0,0,0,0,0,27,0.00005,24,66,0,0
20049,Elk County,,KS,273,2883,3156,1,0,1,61,0,61,0,0,0,0,0.000355,0,50,0.000063,0,27,0,0.00193
20051,Ellis County,,KS,2528,29777,32305,12,9,21,779,809,1588,6,0.298828,0.312825,32210.575254,0.000883,0.000836,50,0.000613,0,28,0.17033,0.006543
20053,Ellsworth County,,KS,480,7397,7877,1,2,3,79,105,184,7,0.233438,0.240366,2.55,0.000011,0.000023,50,0.00008,0,28,0.5,0.000246
20055,Finney County,,KS,4545,42955,47500,11,24,35,866,1984,2850,6,0.341317,0.363175,32333.01786,0.002482,0.005209,50,0.000405,0,28,0.26,0.019211
20057,Ford County,,KS,3262,33098,36360,7,13,20,702,1079,1781,6,0.308075,0.324309,10656.268012,0.001965,0.001304,50,0.000209,0,28,0.357143,0.013145
20059,Franklin County,,KS,2017,27306,29323,7,8,15,1135,984,2119,6,0.29932,0.312946,31.687487,0.000806,0.001057,50,0.000196,0,28,0.642857,0.005758
20061,Geary County,,KS,11340,35081,46421,31,46,77,3745,4867,8612,6,0.37098,0.398584,11320.904205,0.011143,0.018567,50,0.000446,0,28,0.593237,0.077509
20063,Gove County,,KS,275,4095,4370,0,1,1,0,43,43,7,0.230136,0.236297,0,0,0.000007,50,0.00005,0,67,0,0
20065,Graham County,,KS,239,3702,3941,0,0,0,0,0,0,0,0,0,0,0,0,28,0.00005,25,68,0,0
20067,Grant County,,KS,899,8877,9776,2,1,3,104,63,167,7,0.254487,0.26293,2907,0.000042,0.00002,50,0.000107,0,28,0,0.000339
20069,Gray County,,KS,618,7192,7810,2,2,4,191,168,359,7,0.254643,0.26336,0,0.000052,0.000036,50,0.000078,0,28,1,0.00045
20071,Greeley County,,KS,151,1753,1904,0,0,0,0,0,0,0,0,0,0,0,0,29,0.00005,26,69,0,0
20073,Greenwood County,,KS,615,8241,8856,3,4,7,287,296,583,6,0.289311,0.301439,5.542857,0.000375,0.00027,50,0.000106,0,28,0.5,0.00229
20075,Hamilton County,,KS,265,2862,3127,0,0,0,0,0,0,0,0,0,0,0,0,30,0.00005,27,70,0,0
20077,Harper County,,KS,506,7063,7569,2,1,3,150,93,243,6,0.289024,0.300591,0,0.000357,0.000244,50,0.000083,0,28,1,0.002037
20079,Harvey County,,KS,2844,39264,42108,7,7,14,1388,1515,2903,6,0.298307,0.311748,164.47263,0.001335,0.000778,50,0.000175,0,28,0.589286,0.008619
20081,Haskell County,,KS,466,4284,4750,1,1,2,40,60,100,7,0.254487,0.26293,0,0.000042,0.00002,50,0.000065,0,28,0,0.000253
20083,Hodgeman County,,KS,150,2388,2538,1,0,1,47,0,47,0,0,0,0,0.00001,0,50,0.000064,0,14,0,0.000197
20085,Jackson County,,KS,1068,15989,17057,4,4,8,528,577,1105,7,0.266648,0.276718,3122.471752,0.000125,0.000089,50,0.000125,0,28,0.333333,0.001022
20087,Jefferson County,,KS,1529,20185,21714,6,4,10,1068,864,1932,6,0.297513,0.310263,60.87823,0.000404,0.000719,50,0.000157,0,28,0.666667,0.003062
20089,Jewell County,,KS,312,4598,4910,0,0,0,0,0,0,0,0,0,0,0,0,31,0.00005,28,71,0,0
20091,Johnson County,,KS,39869,532369,572238,154,142,296,35390,30701,66091,5,0.418334,0.455722,147393.648749,0.05703,0.062069,50,0.002398,0,28,0.290613,0.41784
20093,Kearny County,,KS,365,4704,5069,1,1,2,114,101,215,7,0.254487,0.26293,0,0.000042,0.00002,50,0.000065,0,28,0,0.000253
20095,Kingman County,,KS,732,10790,11522,2,2,4,277,310,587,6,0.28911,0.300877,0,0.000374,0.000252,50,0.000082,0,28,1,0.002092
20097,Kiowa County,,KS,367,3657,4024,0,0,0,0,0,0,0,0,0,0,0,0,32,0.00005,29,72,0,0
20099,Labette County,,KS,1587,25059,26646,4,7,11,355,674,1029,6,0.298859,0.312693,28.470291,0.000029,0.000778,50,0.000122,0,28,0.642857,0.000523
20101,Lane County,,KS,185,2646,2831,0,0,0,0,0,0,0,0,0,0,0,0,33,0.00005,30,73,0,0
20103,Leavenworth County,,KS,9598,70526,80124,39,39,78,5815,5256,11071,6,0.356818,0.382221,4822.256986,0.014749,0.01343,50,0.00055,0,28,0.497687,0.105981
20105,Lincoln County,,KS,288,4523,4811,1,1,2,59,70,129,7,0.233325,0.239964,0,0.000011,0.00002,50,0.00008,0,28,0,0.000246
20107,Linn County,,KS,813,9544,10357,4,3,7,499,335,834,6,0.295097,0.307316,754.294647,0.00058,0.000467,50,0.000131,0,28,0.583333,0.004319
20109,Logan County,,KS,362,3578,3940,0,0,0,0,0,0,0,0,0,0,0,0,34,0.00005,31,74,0,0
20111,Lyon County,,KS,3213,37800,41013,13,12,25,953,1291,2244,6,0.309651,0.325892,13723.587886,0.002408,0.001635,50,0.000385,0,28,0.3,0.016919
20113,McPherson County,,KS,2096,33773,35869,6,8,14,629,874,1503,6,0.298644,0.312367,613.145948,0.000395,0.000827,50,0.00018,0,28,0.553571,0.0027
20115,Marion County,,KS,812,14231,15043,3,3,6,347,314,661,6,0.28911,0.300992,0,0.000368,0.000258,50,0.000103,0,28,1,0.00221
20117,Marshall County,,KS,662,13425,14087,1,2,3,43,108,151,7,0.259345,0.268577,2967,0.000008,0.000027,50,0.00007,0,28,0.333333,0.000113
20119,Meade County,,KS,433,5147,5580,1,1,2,59,67,126,7,0.23663,0.243448,0,0.000009,0.000014,50,0.000076,0,28,0,0.000197
20121,Miami County,,KS,2124,27109,29233,6,8,14,1380,1341,2721,6,0.299136,0.312699,45.99288,0.001047,0.001,50,0.000173,0,28,0.589286,0.007385
20123,Mitchell County,,KS,482,8165,8647,0,0,0,0,0,0,0,0,0,0,0,0,35,0.00005,32,75,0,0
20125,Montgomery County,,KS,2888,38234,41122,9,12,21,919,1310,2229,6,0.304239,0.319734,6375.163278,0.000867,0.001249,50,0.000227,0,28,0.314103,0.005881
20127,Morris County,,KS,470,7462,7932,2,1,3,85,45,130,7,0.236457,0.243307,0,0.000075,0.000019,50,0.000096,0,28,1,0.000541
20129,Morton County,,KS,470,4024,4494,0,1,1,0,45,45,7,0.234952,0.241633,0,0,0.000009,50,0.00005,0,76,0,0
20131,Nemaha County,,KS,722,11829,12551,1,3,4,48,178,226,7,0.266722,0.276718,150.976379,0.000001,0.000085,50,0.000077,0,28,0.666667,0.000101
20133,Neosho County,,KS,1187,17550,18737,4,6,10,378,428,806,6,0.289571,0.302156,400.154743,0.00002,0.000265,50,0.000137,0,28,0.533333,0.000477
20135,Ness County,,KS,290,4193,4483,0,1,1,0,45,45,7,0.230136,0.236297,0,0,0.000007,50,0.00005,0,77,0,0
20137,Norton County,,KS,441,6069,6510,1,1,2,48,43,91,8,0.187134,0.190549,0,0,0,50,0.000112,0,78,0,0.000088
20139,Osage County,,KS,1654,19570,21224,5,5,10,871,943,1814,6,0.295727,0.308439,2.674927,0.000742,0.000626,50,0.00015,0,28,0.85,0.0051
20141,Osborne County,,KS,340,5059,5399,0,0,0,0,0,0,0,0,0,0,0,0,36,0.00005,33,79,0,0
20143,Ottawa County,,KS,764,9380,10144,1,1,2,261,273,534,7,0.233325,0.239964,0,0.000011,0.00002,50,0.00008,0,28,0,0.000246
20145,Pawnee County,,KS,593,7366,7959,1,2,3,91,129,220,7,0.266746,0.276603,0,0.000007,0.000087,50,0.000078,0,28,0.5,0.000121
20147,Phillips County,,KS,496,7378,7874,1,2,3,43,95,138,7,0.230197,0.23656,2908,0,0.000007,50,0.000146,0,78,0,0.000088
20149,Pottawatomie County,,KS,2369,25124,27493,6,8,14,1011,1141,2152,6,0.301275,0.315187,6239.508009,0.000328,0.000962,50,0.000187,0,28,0.411111,0.002054
20151,Pratt County,,KS,834,10743,11577,1,1,2,42,111,153,6,0.289024,0.300591,0,0.000355,0.000244,50,0.000063,0,28,0,0.00193
20153,Rawlins County,,KS,184,3451,3635,0,0,0,0,0,0,0,0,0,0,0,0,37,0.00005,34,80,0,0
20155,Reno County,,KS,3960,71304,75264,13,14,27,1575,1782,3357,6,0.331395,0.350975,8417.431953,0.000952,0.002336,50,0.000319,0,28,0.334559,0.006988
20157,Republic County,,KS,414,6624,7038,1,1,2,78,44,122,7,0.224496,0.230119,0,0.000002,0,50,0.000075,0,28,0,0.000092
20159,Rice County,,KS,843,10800,11643,2,4,6,186,334,520,6,0.289225,0.301336,1,0.000025,0.000258,50,0.000089,0,28,0.833333,0.00028
20161,Riley County,,KS,7921,41122,49043,21,22,43,2710,3954,6664,6,0.349946,0.373415,10123.114842,0.003387,0.007699,50,0.000481,0,28,0.346237,0.024324
20163,Rooks County,,KS,426,6413,6839,1,1,2,67,95,162,7,0.230093,0.236207,0,0.000007,0.000007,50,0.000108,0,28,0,0.000157
20165,Rush County,,KS,279,4230,4509,1,1,2,48,59,107,7,0.230166,0.23635,0,0.000007,0.000003,50,0.000078,0,28,0,0.000121
20167,Russell County,,KS,652,7564,8216,1,1,2,70,131,201,7,0.230093,0.236207,0,0.000007,0.000007,50,0.000108,0,28,0,0.000157
20169,Saline County,,KS,4058,58544,62602,18,15,33,1896,1881,3777,6,0.304302,0.320015,23054.66469,0.002437,0.001347,50,0.000516,0,28,0.315789,0.016788
20171,Scott County,,KS,475,5754,6229,1,1,2,84,41,125,1,1,1,2968,0.000042,0,50,0.000065,0,16,0,0.000253
20173,Sedgwick County,,KS,27272,507309,534581,94,114,208,15428,17791,33219,5,0.40646,0.441756,129790.341565,0.030353,0.044151,50,0.001641,0,28,0.29771,0.225715
20175,Seward County,,KS,2841,21822,24663,9,10,19,813,916,1729,6,0.309948,0.326018,16470.552331,0.001716,0.001152,50,0.000305,0,28,0.30303,0.012713
20177,Shawnee County,,KS,10234,189854,200088,40,35,75,5753,6024,11777,6,0.363148,0.3889,35594.524553,0.010392,0.014288,50,0.000809,0,28,0.318262,0.076548
20179,Sheridan County,,KS,209,3341,3550,0,0,0,0,0,0,0,0,0,0,0,0,38,0.00005,35,81,0,0
20181,Sherman County,,KS,732,6863,7595,0,0,0,0,0,0,0,0,0,0,0,0,39,0.00005,36,82,0,0
20183,Smith County,,KS,303,4794,5097,0,0,0,0,0,0,0,0,0,0,0,0,40,0.00005,37,83,0,0
20185,Stafford County,,KS,339,5148,5487,1,2,3,43,98,141,7,0.249164,0.25734,0,0.000019,0.000011,50,0.00007,0,28,1,0.000162
20187,Stanton County,,KS,205,2620,2825,0,1,1,0,44,44,8,0.202917,0.207248,0,0,0,50,0.00005,0,84,0,0
20189,Stevens County,,KS,610,5777,6387,1,1,2,45,46,91,7,0.23663,0.243448,0,0.000009,0.000014,50,0.000076,0,28,0,0.000197
20191,Sumner County,,KS,1999,25585,27584,3,4,7,866,1155,2021,6,0.28911,0.301107,1.333333,0.000365,0.000254,50,0.000096,0,28,0.666667,0.002167
20193,Thomas County,,KS,732,8624,9356,0,1,1,0,64,64,7,0.230136,0.236297,0,0,0.000007,50,0.00005,0,85,0,0
20195,Trego County,,KS,280,3494,3774,1,1,2,44,53,97,7,0.230093,0.236207,0,0.000007,0.000007,50,0.000108,0,28,0,0.000157
20197,Wabaunsee County,,KS,586,6925,7511,2,2,4,195,226,421,7,0.266502,0.276202,0,0.000123,0.000086,50,0.00009,0,28,1,0.000849
20199,Wallace County,,KS,154,2050,2204,0,0,0,0,0,0,0,0,0,0,0,0,41,0.00005,38,86,0,0
20201,Washington County,,KS,454,7055,7509,1,0,1,41,0,41,0,0,0,0,0,0,50,0.00008,0,6,0,0.000088
20203,Wichita County,,KS,246,2832,3078,1,0,1,41,0,41,0,0,0,0,0,0,50,0.000105,0,15,0,0.000089
20205,Wilson County,,KS,783,10219,11002,4,3,7,362,266,628,6,0.28934,0.301353,430.70779,0.000369,0.000251,50,0.000121,0,28,0.5,0.002281
20207,Woodson County,,KS,248,3625,3873,1,0,1,49,0,49,0,0,0,0,0,0,50,0.000072,0,7,0,0.000093
20209,Wyandotte County,,KS,12911,153409,166320,23,23,46,8042,9796,17838,6,0.355596,0.379847,2610.31286,0.009367,0.008619,50,0.000397,0,28,0.491379,0.066833
21001,Adair County,,KY,878,17442,18320,5,3,8,349,242,591,7,0.229675,0.236781,861.685402,0.00051,0.000012,112,0.000228,0,28,0.35,0.003928
21003,Allen County,,KY,1647,25080,26727,9,6,15,1115,857,1972,7,0.257873,0.268212,390.410174,0.000723,0.000091,49,0.000296,0,28,0.291667,0.006192
21005,Anderson County,,KY,1642,28634,30276,6,7,13,1199,885,2084,6,0.295217,0.309397,75.246627,0.000824,0.000695,112,0.00017,0,28,0.571429,0.005625
21007,Ballard County,,KY,632,9762,10394,1,2,3,182,292,474,7,0.239594,0.247168,0,0.000016,0.000019,112,0.000086,0,28,1,0.000238
21009,Barren County,,KY,2158,44362,46520,9,9,18,1416,1144,2560,6,0.295607,0.309861,10534.512961,0.000646,0.000588,49,0.000329,0,28,0.291667,0.005083
21011,Bath County,,KY,766,13051,13817,4,3,7,489,352,841,7,0.228376,0.23538,1.630952,0.000316,0.000012,112,0.000203,0,28,0.916667,0.002073
21013,Bell County,,KY,1630,25878,27508,4,6,10,583,828,1411,6,0.283582,0.296388,67.768759,0.000316,0.000237,49,0.000138,0,28,0.566667,0.002017
21015,Boone County,,KY,10629,107990,118619,24,19,43,8992,7367,16359,6,0.340997,0.362527,9441.315752,0.007356,0.005073,112,0.000465,0,28,0.433862,0.050017
21017,Bourbon County,,KY,1748,23129,24877,6,7,13,1065,1049,2114,6,0.283306,0.296096,1488.779012,0.00032,0.000231,112,0.000243,0,28,0.47619,0.002339
21019,Boyd County,,KY,3366,55268,58634,9,10,19,1670,1765,3435,6,0.306646,0.324739,3436.907596,0.001112,0.001509,112,0.000324,0,28,0.4,0.007936
21021,Boyle County,,KY,2477,29809,32286,7,8,15,1101,1434,2535,6,0.295337,0.309741,1327.648989,0.000324,0.000689,112,0.00025,0,28,0.444444,0.002421
21023,Bracken County,,KY,656,10396,11052,6,3,9,478,366,844,7,0.231339,0.238981,893.872249,0.000696,0.000022,112,0.00017,0,28,0.633333,0.004657
21025,Breathitt County,,KY,737,15797,16534,2,5,7,114,284,398,6,0.283333,0.295895,4358.492362,0.000002,0.000221,112,0.000133,0,28,0.4,0.000201
21027,Breckinridge County,,KY,1381,24272,25653,5,6,11,991,794,1785,6,0.295457,0.309259,835.049046,0.000635,0.000575,112,0.000133,0,28,0.380952,0.004503
21029,Bullitt County,,KY,5506,76627,82133,8,9,17,4878,4031,8909,6,0.295337,0.309374,22.155254,0.000657,0.000607,112,0.000219,0,28,0.472222,0.005059
21031,Butler County,,KY,766,13934,14700,5,5,10,444,414,858,7,0.235996,0.244074,23.526398,0.000029,0.000024,49,0.00017,0,28,0.433333,0.000693
21033,Caldwell County,,KY,860,14647,15507,4,4,8,336,326,662,7,0.278262,0.289523,5104.634262,0.000213,0.000152,112,0.000154,0,28,0.333333,0.001442
21035,Calloway County,,KY,2265,33455,35720,7,7,14,902,769,1671,6,0.305518,0.321133,2925.777696,0.001309,0.00131,112,0.000222,0,28,0.482143,0.00958
21037,Campbell County,,KY,7040,97741,104781,12,13,25,4966,5275,10241,6,0.300496,0.31693,3190.979501,0.002021,0.001686,112,0.000296,0,28,0.538462,0.012889
21039,Carlisle County,,KY,435,6612,7047,4,2,6,265,178,443,7,0.239713,0.247386,48.961355,0.000021,0.000019,112,0.000182,0,28,0.416667,0.000521
21041,Carroll County,,KY,979,11893,12872,7,7,14,462,524,986,6,0.293577,0.307373,220.20185,0.000116,0.000551,112,0.000229,0,28,0.392857,0.001615
21043,Carter County,,KY,1229,29334,30563,5,6,11,461,582,1043,6,0.283693,0.296451,3777.192935,0.000326,0.000234,112,0.000207,0,28,0.333333,0.002192
21045,Casey County,,KY,824,17968,18792,3,4,7,398,302,700,7,0.231155,0.238809,4.442857,0.000017,0.000017,112,0.000142,0,28,0.583333,0.000414
21047,Christian County,,KY,18176,77681,95857,46,63,109,8209,9610,17819,6,0.38427,0.41435,29576.03828,0.018603,0.024075,49,0.000635,0,28,0.439685,0.130831
21049,Clark County,,KY,2708,38227,40935,13,8,21,1730,1445,3175,6,0.283333,0.296268,1302.966458,0.000838,0.000237,112,0.000473,0,28,0.333333,0.006431
21051,Clay County,,KY,670,18315,18985,1,2,3,141,289,430,7,0.230021,0.236928,0,0.000008,0.000017,112,0.000089,0,28,1,0.000219
21053,Clinton County,,KY,425,10417,10842,2,2,4,134,128,262,8,0.187742,0.1918,5872,0,0,112,0.000279,0,28,0,0.000179
21055,Crittenden County,,KY,621,9352,9973,3,3,6,134,158,292,8,0.219165,0.22541,18.408778,0.000002,0.000011,112,0.000161,0,28,0,0.000292
21057,Cumberland County,,KY,308,7255,7563,1,1,2,52,41,93,9,0.158075,0.160515,0,0,0,112,0.000169,0,28,0,0.000091
21059,Daviess County,,KY,4771,106487,111258,16,15,31,2115,2291,4406,6,0.313187,0.330782,15565.692064,0.001537,0.002021,22,0.00045,0,28,0.27451,0.01066
21061,Edmonson County,,KY,758,13583,14341,4,5,9,479,396,875,6,0.29331,0.306696,436.293656,0.000522,0.000491,49,0.000138,0,28,0.6,0.003932
21063,Elliott County,,KY,304,5527,5831,1,2,3,68,125,193,7,0.228466,0.23522,0,0.000002,0.000005,112,0.00008,0,28,1,0.000112
21065,Estill County,,KY,920,18799,19719,4,4,8,490,532,1022,6,0.283168,0.295465,1.5,0.000321,0.000227,112,0.000189,0,28,0.833333,0.002127
21067,Fayette County,,KY,23061,269880,292941,95,99,194,13726,15593,29319,5,0.394705,0.429779,240060.168928,0.02606,0.03814,112,0.002035,0,28,0.235622,0.191298
21069,Fleming County,,KY,720,15412,16132,3,4,7,342,324,666,6,0.283416,0.295895,1209.132521,0.000008,0.000212,112,0.000149,0,28,0.416667,0.000313
21071,Floyd County,,KY,1922,39586,41508,6,6,12,770,807,1577,6,0.283554,0.29644,5934.941928,0.000323,0.000222,112,0.000226,0,28,0.333333,0.002267
21073,Franklin County,,KY,3453,52524,55977,9,9,18,1765,1904,3669,6,0.295337,0.309856,257.687259,0.000843,0.000707,112,0.000259,0,28,0.488889,0.006086
21075,Fulton County,,KY,689,7925,8614,4,4,8,434,415,849,7,0.237481,0.244924,3013.390282,0.000026,0.000016,49,0.000149,0,28,0.416667,0.000498
21077,Gallatin County,,KY,660,5476,6136,4,4,8,399,363,762,7,0.260671,0.270125,1.846703,0.000108,0.000116,112,0.000134,0,28,0.75,0.001182
21079,Garrard County,,KY,1566,19477,21043,7,6,13,1242,1004,2246,6,0.283278,0.295924,406.623814,0.000329,0.000226,112,0.000252,0,28,0.642857,0.002436
21081,Grant County,,KY,2019,23239,25258,8,9,17,1788,1315,3103,6,0.296391,0.311186,509.828359,0.000697,0.000811,112,0.00023,0,28,0.541667,0.004893
21083,Graves County,,KY,2188,40359,42547,7,7,14,1018,1013,2031,6,0.300589,0.314362,4482.189792,0.000037,0.000641,112,0.0003,0,28,0.321429,0.000925
21085,Grayson County,,KY,1189,22001,23190,4,7,11,586,756,1342,6,0.295487,0.309431,1705.747042,0.000626,0.000578,112,0.000124,0,28,0.47619,0.004378
21087,Green County,,KY,692,13823,14515,4,4,8,415,371,786,6,0.269117,0.279744,5.028866,0.000632,0.000103,112,0.000133,0,28,0.6,0.004413
21089,Greenup County,,KY,2309,37643,39952,7,5,12,1432,1184,2616,6,0.28372,0.296451,1137.534328,0.000815,0.000238,112,0.00022,0,28,0.482143,0.006087
21091,Hancock County,,KY,677,9047,9724,4,2,6,439,307,746,7,0.238611,0.246184,10.286952,0.000026,0.000013,22,0.000145,0,28,0.333333,0.000521
21093,Hardin County,,KY,12983,105098,118081,39,48,87,6585,6666,13251,5,0.367788,0.395626,16054.788918,0.010892,0.015307,112,0.000658,0,28,0.398672,0.075691
21095,Harlan County,,KY,1401,27349,28750,4,7,11,220,487,707,6,0.290845,0.304822,1088.287066,0.000313,0.000551,112,0.000132,0,28,0.428571,0.002004
21097,Harrison County,,KY,1265,19192,20457,5,6,11,599,705,1304,6,0.283333,0.29601,1545.990602,0.000322,0.00023,112,0.000176,0,28,0.333333,0.002212
21099,Hart County,,KY,1090,16010,17100,5,5,10,475,649,1124,6,0.295397,0.30903,5.993925,0.000635,0.000579,49,0.000158,0,28,0.733333,0.00454
21101,Henderson County,,KY,2533,51704,54237,8,8,16,1402,1277,2679,6,0.296723,0.31157,3368.288435,0.000622,0.000749,22,0.000209,0,28,0.486111,0.004663
21103,Henry County,,KY,1396,16268,17664,5,6,11,901,897,1798,6,0.293251,0.306696,69.050164,0.00052,0.000487,112,0.000156,0,28,0.566667,0.003965
21105,Hickman County,,KY,352,4526,4878,1,3,4,53,193,246,7,0.231228,0.237688,0.7,0,0.000001,112,0.000082,0,28,0.666667,0.000097
21107,Hopkins County,,KY,2744,50324,53068,8,15,23,999,1433,2432,6,0.31502,0.333941,2981.229202,0.000302,0.002332,22,0.000242,0,28,0.361905,0.002312
21109,Jackson County,,KY,424,12895,13319,3,2,5,243,175,418,7,0.232709,0.240466,7.151648,0.000019,0.000025,112,0.000159,0,28,0.666667,0.000492
21111,Jefferson County,,KY,38176,797439,835615,154,152,306,25013,29042,54055,5,0.41428,0.45387,227532.381067,0.057789,0.061969,112,0.002481,0,28,0.28946,0.417912
21113,Jessamine County,,KY,4126,40117,44243,9,9,18,2487,2140,4627,6,0.283389,0.296497,32.579243,0.000353,0.000244,112,0.000296,0,28,0.472727,0.002795
21115,Johnson County,,KY,1119,20732,21851,6,3,9,552,354,906,6,0.283223,0.295436,1845.995371,0.000312,0.000218,112,0.000229,0,28,0.366667,0.002262
21117,Kenton County,,KY,15093,165750,180843,19,23,42,10541,11400,21941,6,0.342524,0.365044,7208.62853,0.006261,0.007051,112,0.000363,0,28,0.403077,0.042593
21119,Knott County,,KY,835,15086,15921,3,4,7,320,358,678,6,0.283278,0.295666,5.454762,0.000005,0.000215,112,0.00012,0,28,0.583333,0.000321
21121,Knox County,,KY,2046,31929,33975,4,5,9,787,1169,1956,6,0.283306,0.295838,2.566667,0.000319,0.000239,112,0.000157,0,28,0.75,0.002115
21123,Larue County,,KY,984,13197,14181,5,5,10,587,708,1295,6,0.295217,0.308686,46.078162,0.000633,0.00057,112,0.000164,0,28,0.65,0.004558
21125,Laurel County,,KY,2738,54312,57050,15,10,25,1767,1363,3130,6,0.298675,0.314219,14967.429535,0.002086,0.00101,112,0.000452,0,28,0.258333,0.014276
21127,Lawrence County,,KY,767,13844,14611,6,3,9,420,216,636,7,0.234871,0.243013,67.690376,0.000768,0.000018,112,0.000246,0,28,0.3,0.005895
21129,Lee County,,KY,294,6010,6304,0,0,0,0,0,0,0,0,0,0,0,0,42,0.00005,39,87,0,0
21131,Leslie County,,KY,544,11304,11848,1,2,3,72,201,273,7,0.230221,0.237375,0,0.000002,0.000019,112,0.00007,0,28,0.5,0.000111
21133,Letcher County,,KY,1037,23701,24738,4,6,10,257,342,599,6,0.283582,0.296468,29.508592,0.00001,0.000225,112,0.000123,0,28,0.466667,0.000424
21135,Lewis County,,KY,699,13581,14280,2,3,5,125,245,370,7,0.221368,0.227923,3.956944,0.000004,0.000007,112,0.00011,0,28,0.333333,0.000194
21137,Lincoln County,,KY,1449,22999,24448,9,8,17,1117,960,2077,6,0.283471,0.296485,1100.338614,0.000338,0.000237,112,0.000316,0,28,0.513889,0.002697
21139,Livingston County,,KY,723,9800,10523,4,3,7,439,372,811,7,0.239693,0.24754,470.463101,0.000016,0.000019,112,0.000203,0,28,0.416667,0.000526
21141,Logan County,,KY,1622,29294,30916,7,7,14,794,835,1629,6,0.30031,0.314041,914.910548,0.000225,0.000646,49,0.000241,0,28,0.410714,0.002037
21143,Lyon County,,KY,669,7379,8048,4,4,8,288,290,578,7,0.244594,0.253333,55.899986,0.000036,0.000023,112,0.000168,0,28,0.45,0.000558
21145,McCracken County,,KY,5081,70999,76080,16,13,29,2195,2208,4403,6,0.31502,0.33288,38215.027517,0.002324,0.001929,112,0.000548,0,28,0.183824,0.016435
21147,McCreary County,,KY,696,14734,15430,2,2,4,146,235,381,7,0.232541,0.240024,18.40815,0.000012,0.000014,49,0.000131,0,28,0,0.000286
21149,McLean County,,KY,721,10659,11380,4,2,6,371,403,774,7,0.239259,0.246809,0.25,0.00004,0.000013,22,0.000139,0,28,0.75,0.000516
21151,Madison County,,KY,5388,63887,69275,20,17,37,3123,2629,5752,6,0.300589,0.317664,5351.923628,0.000977,0.001309,112,0.000642,0,28,0.202899,0.007958
21153,Magoffin County,,KY,531,10514,11045,1,3,4,60,221,281,7,0.221149,0.227573,5.427778,0.000002,0.000005,112,0.000082,0,28,0.333333,0.000114
21155,Marion County,,KY,829,19604,20433,5,5,10,456,470,926,6,0.295157,0.309053,20.619995,0.000522,0.000691,112,0.000191,0,28,0.6,0.003953
21157,Marshall County,,KY,1970,31690,33660,4,5,9,970,980,1950,7,0.239911,0.248217,16.055398,0.000031,0.00003,112,0.000207,0,28,0.55,0.00061
21159,Martin County,,KY,570,10290,10860,3,3,6,163,168,331,6,0.283195,0.295379,66.753951,0.000758,0.000218,112,0.000088,0,28,0.466667,0.005479
21161,Mason County,,KY,1281,17625,18906,5,6,11,645,611,1256,6,0.283554,0.29644,4199.981205,0.000025,0.000243,112,0.000194,0,28,0.166667,0.00068
21163,Meade County,,KY,2045,25363,27408,5,4,9,1489,1198,2687,6,0.295187,0.308514,4.62809,0.000635,0.000563,112,0.000136,0,28,0.6,0.004541
21165,Menifee County,,KY,441,6012,6453,2,3,5,157,180,337,7,0.228376,0.23538,2.301875,0.000004,0.000012,112,0.000107,0,28,0.5,0.000228
21167,Mercer County,,KY,1393,22514,23907,5,6,11,706,812,1518,6,0.283251,0.295866,6.444048,0.000325,0.000227,112,0.000169,0,28,0.5,0.002168
21169,Metcalfe County,,KY,464,8391,8855,1,2,3,158,245,403,7,0.235843,0.243329,0,0.000005,0.000021,49,0.000081,0,28,1,0.00014
21171,Monroe County,,KY,433,10176,10609,1,2,3,90,133,223,7,0.228592,0.235291,0,0.000005,0.000011,49,0.000081,0,28,1,0.00014
21173,Montgomery County,,KY,1516,22302,23818,7,6,13,861,780,1641,6,0.283361,0.29601,2594.361435,0.000318,0.000224,112,0.000315,0,28,0.47619,0.00238
21175,Morgan County,,KY,576,12185,12761,3,2,5,253,117,370,7,0.228251,0.234921,1532.148426,0.000006,0.000003,112,0.000177,0,28,0,0.000301
21177,Muhlenberg County,,KY,1295,34708,36003,6,8,14,500,626,1126,6,0.296845,0.311209,1192.986173,0.000055,0.000648,49,0.000234,0,28,0.444444,0.00086
21179,Nelson County,,KY,2212,45770,47982,10,7,17,1766,1236,3002,6,0.297361,0.311788,99.157525,0.000968,0.000779,112,0.000274,0,28,0.444444,0.006826
21181,Nicholas County,,KY,332,5278,5610,2,0,2,182,0,182,0,0,0,0,0.000004,0,112,0.000105,0,9,1,0.000227
21183,Ohio County,,KY,1189,24386,25575,4,5,9,683,589,1272,7,0.239575,0.247984,24.767113,0.000026,0.000029,22,0.000145,0,28,0.428571,0.000526
21185,Oldham County,,KY,4014,47425,51439,6,8,14,2832,2393,5225,6,0.295277,0.309626,41.646212,0.000526,0.000722,112,0.00018,0,28,0.464286,0.0042
21187,Owen County,,KY,700,9746,10446,7,5,12,480,337,817,7,0.254821,0.2643,55.033981,0.000426,0.000079,112,0.000204,0,28,0.47619,0.003157
21189,Owsley County,,KY,198,3495,3693,0,0,0,0,0,0,0,0,0,0,0,0,43,0.00005,40,88,0,0
21191,Pendleton County,,KY,1050,15395,16445,7,6,13,854,760,1614,7,0.260741,0.270526,113.663963,0.000701,0.00014,112,0.000208,0,28,0.642857,0.004802
21193,Perry County,,KY,1265,26306,27571,5,7,12,449,573,1022,6,0.283444,0.296354,10376.181405,0.000312,0.000234,112,0.000163,0,28,0.309524,0.002045
21195,Pike County,,KY,2873,59928,62801,5,11,16,752,1192,1944,6,0.284721,0.29859,4650.164337,0.000317,0.000261,112,0.000154,0,28,0.159091,0.002117
21197,Powell County,,KY,880,12746,13626,4,4,8,346,447,793,6,0.28314,0.295408,2.283333,0.000312,0.000221,112,0.000181,0,28,0.6,0.002035
21199,Pulaski County,,KY,2682,56935,59617,10,12,22,1005,1063,2068,6,0.300372,0.316661,31271.857057,0.001407,0.001171,112,0.000441,0,28,0.295455,0.009292
21201,Robertson County,,KY,157,1942,2099,0,0,0,0,0,0,0,0,0,0,0,0,44,0.00005,41,89,0,0
21203,Rockcastle County,,KY,753,14833,15586,4,4,8,335,424,759,7,0.232802,0.240982,2.566667,0.000022,0.00003,112,0.00019,0,28,0.666667,0.000645
21205,Rowan County,,KY,1533,17246,18779,9,8,17,673,637,1310,6,0.295607,0.310171,16241.204451,0.000314,0.000689,112,0.000382,0,28,0.227273,0.002491
21207,Russell County,,KY,740,15517,16257,3,2,5,269,190,459,7,0.231136,0.238436,16.655688,0.00001,0.000015,112,0.000176,0,28,0.333333,0.000392
21209,Scott County,,KY,2557,32496,35053,10,10,20,1870,1386,3256,6,0.295487,0.310257,371.697842,0.000835,0.00071,112,0.000326,0,28,0.466667,0.006186
21211,Shelby County,,KY,2747,35380,38127,8,9,17,1879,1795,3674,6,0.295307,0.309798,75.380601,0.000835,0.000713,112,0.000211,0,28,0.5,0.005904
21213,Simpson County,,KY,1322,18282,19604,8,5,13,939,679,1618,7,0.257029,0.266653,615.267773,0.001154,0.000073,49,0.000271,0,28,0.464286,0.008995
21215,Spencer County,,KY,904,11420,12324,3,4,7,1311,645,1956,6,0.293074,0.306123,0,0.000509,0.000484,112,0.000105,0,28,0.916667,0.003716
21217,Taylor County,,KY,1337,21692,23029,5,6,11,512,574,1086,6,0.297361,0.311673,1851.164961,0.000811,0.000775,112,0.000207,0,28,0.466667,0.005482
21219,Todd County,,KY,839,10805,11644,3,3,6,488,427,915,7,0.281468,0.293049,12.550817,0.000408,0.00034,49,0.0001,0,28,0.5,0.002697
21221,Trigg County,,KY,935,13537,14472,2,2,4,308,313,621,7,0.281332,0.292676,0,0.000403,0.000339,49,0.000071,0,28,1,0.002583
21223,Trimble County,,KY,558,8821,9379,5,4,9,572,307,879,6,0.29331,0.306582,67.503862,0.000521,0.000484,112,0.000159,0,28,0.65,0.004004
21225,Union County,,KY,977,16078,17055,2,4,6,309,461,770,7,0.266526,0.277133,62.11916,0.000006,0.000053,22,0.000099,0,28,0.5,0.000235
21227,Warren County,,KY,6901,89096,95997,20,16,36,3094,3342,6436,6,0.308402,0.325542,10360.331793,0.002023,0.001818,49,0.000516,0,28,0.266234,0.014842
21229,Washington County,,KY,581,10903,11484,5,4,9,341,258,599,6,0.295127,0.308881,20.188932,0.000326,0.000686,112,0.000178,0,28,0.633333,0.002206
21231,Wayne County,,KY,764,18748,19512,2,2,4,204,298,502,7,0.231081,0.238321,11740,0.000009,0.000011,112,0.0002,0,28,0,0.000264
21233,Webster County,,KY,1155,15414,16569,4,4,8,608,653,1261,7,0.268322,0.278911,190.320768,0.000104,0.000055,22,0.000123,0,28,0.75,0.000788
21235,Whitley County,,KY,2013,28964,30977,5,5,10,1217,1045,2262,6,0.283361,0.295952,70.784845,0.000321,0.00024,112,0.000186,0,28,0.533333,0.002228
21237,Wolfe County,,KY,417,3644,4061,2,2,4,89,176,265,7,0.220897,0.226937,7.083333,0.000002,0,112,0.000148,0,28,0,0.000184
21239,Woodford County,,KY,2103,24257,26360,5,7,12,1053,1254,2307,6,0.295217,0.309397,14.813922,0.000326,0.0007,112,0.000169,0,28,0.642857,0.002238
22001,Acadia Parish,,LA,3304,66297,69601,9,9,18,1935,2171,4106,6,0.321927,0.339909,62.937165,0.001225,0.001381,49,0.000181,0,28,0.7,0.009421
22003,Allen Parish,,LA,1546,23106,24652,6,8,14,738,869,1607,6,0.321003,0.338631,11.396273,0.000279,0.001199,153,0.000136,0,28,0.680556,0.002248
22005,Ascension Parish,,LA,5083,87704,92787,18,15,33,4635,3041,7676,6,0.325059,0.344766,717.922646,0.002526,0.003007,49,0.000298,0,28,0.517544,0.017025
22007,Assumption Parish,,LA,1763,30563,32326,6,6,12,891,1120,2011,7,0.284303,0.296925,0.541667,0.000775,0.000338,49,0.00012,0,28,0.904762,0.004831
22009,Avoyelles Parish,,LA,1792,42445,44237,6,7,13,763,900,1663,6,0.321856,0.339565,210.154764,0.001452,0.001323,153,0.000123,0,28,0.738095,0.010138
22011,Beauregard Parish,,LA,2595,31083,33678,4,5,9,1360,1264,2624,6,0.322212,0.339737,113.481671,0.001158,0.001369,153,0.000098,0,28,0.75,0.008784
22013,Bienville Parish,,LA,1246,17036,18282,7,8,15,631,795,1426,7,0.269142,0.280576,51.7385,0.000281,0.000223,153,0.000184,0,28,0.535714,0.002338
22015,Bossier Parish,,LA,12316,106741,119057,32,28,60,7672,7074,14746,6,0.354512,0.378873,6700.325327,0.009644,0.010545,153,0.00049,0,28,0.424359,0.068721
22017,Caddo Parish,,LA,16954,262439,279393,41,47,88,9725,11578,21303,6,0.362831,0.390695,18733.795931,0.013017,0.016755,153,0.000651,0,28,0.397059,0.098397
22019,Calcasieu Parish,,LA,10108,204378,214486,32,38,70,4930,6225,11155,6,0.344024,0.368828,9331.289795,0.008303,0.009596,153,0.000515,0,28,0.371951,0.061712
22021,Caldwell Parish,,LA,809,10894,11703,3,3,6,328,350,678,7,0.258354,0.26846,9.117931,0.000098,0.000043,153,0.000111,0,28,0.5,0.000623
22023,Cameron Parish,,LA,599,8773,9372,1,1,2,215,281,496,7,0.255988,0.265338,0,0.000077,0.000067,153,0.000062,0,28,0,0.000609
22025,Catahoula Parish,,LA,675,10990,11665,3,5,8,261,354,615,7,0.259114,0.269856,16.716772,0.00001,0.000083,153,0.000121,0,28,0.4,0.000307
22027,Claiborne Parish,,LA,828,15763,16591,5,4,9,316,351,667,7,0.266453,0.277165,0.309524,0.000254,0.000129,153,0.000137,0,28,0.95,0.002038
22029,Concordia Parish,,LA,1286,20557,21843,4,4,8,521,464,985,7,0.284414,0.296867,5476.3515,0.000364,0.000205,49,0.000109,0,28,0.25,0.002188
22031,De Soto Parish,,LA,1851,27837,29688,5,6,11,1130,1137,2267,6,0.323575,0.341767,89.406015,0.000258,0.002105,153,0.000125,0,28,0.619048,0.002038
22033,East Baton Rouge Parish,,LA,28184,421141,449325,80,100,180,15883,21443,37326,6,0.396698,0.43178,82034.88484,0.025039,0.03816,49,0.001216,0,28,0.306922,0.184718
22035,East Carroll Parish,,LA,647,8336,8983,2,4,6,198,316,514,6,0.311209,0.327118,297.587065,0.000001,0.000922,153,0.000104,0,28,0.5,0.00025
22037,East Feliciana Parish,,LA,1376,20057,21433,3,4,7,845,926,1771,7,0.284136,0.296351,1.5,0.000325,0.000245,49,0.000137,0,28,0.666667,0.001956
22039,Evangeline Parish,,LA,1657,32163,33820,8,10,18,956,1162,2118,6,0.32207,0.340253,26.319459,0.00061,0.001508,49,0.000155,0,28,0.681818,0.003844
22041,Franklin Parish,,LA,1267,22082,23349,4,5,9,352,623,975,6,0.312044,0.328838,608.959558,0.000099,0.000956,153,0.000139,0,28,0.35,0.000715
22043,Grant Parish,,LA,1756,21138,22894,4,4,8,1021,1025,2046,7,0.249079,0.258389,17.4418,0.000067,0.000052,153,0.000129,0,28,0.5,0.000775
22045,Iberia Parish,,LA,4146,82387,86533,10,10,20,2354,2563,4917,6,0.324877,0.343906,27.200634,0.001928,0.002487,49,0.000173,0,28,0.692308,0.013367
22047,Iberville Parish,,LA,1964,34917,36881,5,6,11,1112,1391,2503,6,0.321713,0.339221,103.403987,0.000352,0.001246,49,0.00013,0,28,0.733333,0.002313
22049,Jackson Parish,,LA,1772,24109,25881,5,6,11,959,933,1892,6,0.312178,0.329211,371.776628,0.000117,0.001074,153,0.00015,0,28,0.5,0.000929
22051,Jefferson Parish,,LA,34997,491734,526731,66,98,164,22531,28626,51157,5,0.398765,0.433414,21164.509821,0.027749,0.045087,49,0.000843,0,28,0.433719,0.200272
22053,Jefferson Davis Parish,,LA,1933,31451,33384,7,6,13,941,1166,2107,6,0.320719,0.338,113.083865,0.001194,0.00115,153,0.000147,0,28,0.809524,0.009043
22055,Lafayette Parish,,LA,14683,205908,220591,36,44,80,9361,10520,19881,6,0.35625,0.382794,3817.112461,0.007887,0.01575,49,0.000523,0,28,0.377647,0.058134
22057,Lafourche Parish,,LA,5211,106140,111351,12,13,25,3506,3558,7064,6,0.32207,0.340597,171.593953,0.002399,0.002047,49,0.000192,0,28,0.730769,0.015679
22059,La Salle Parish,,LA,782,14030,14812,4,5,9,265,363,628,7,0.259022,0.269713,241.285467,0.000048,0.000081,153,0.000143,0,28,0.4,0.000667
22061,Lincoln Parish,,LA,3033,30460,33493,11,10,21,1264,1506,2770,6,0.325386,0.34472,2233.215841,0.001538,0.003012,153,0.000239,0,28,0.544872,0.011222
22063,Livingston Parish,,LA,6193,101816,108009,18,13,31,6753,3992,10745,6,0.322248,0.340884,659.998726,0.002595,0.002076,49,0.000311,0,28,0.473856,0.017119
22065,Madison Parish,,LA,905,13173,14078,4,4,8,237,371,608,7,0.258607,0.268976,3624.257895,0.00095,0.000048,153,0.000116,0,28,0.25,0.00769
22067,Morehouse Parish,,LA,1794,33146,34940,6,5,11,678,823,1501,6,0.31201,0.32881,1638.772473,0.000956,0.000957,153,0.000174,0,28,0.4,0.007485
22069,Natchitoches Parish,,LA,2840,37300,40140,12,13,25,1120,1463,2583,6,0.325532,0.345224,6067.497925,0.00174,0.002382,153,0.000251,0,28,0.423077,0.012549
22071,Orleans Parish,,LA,33687,456913,490600,80,103,183,18110,27423,45533,6,0.400634,0.435627,29549.593064,0.040101,0.04921,49,0.000967,0,28,0.44955,0.288551
22073,Ouachita Parish,,LA,9763,154203,163966,30,42,72,4503,5801,10304,6,0.348102,0.374103,38118.489837,0.005168,0.011166,153,0.000635,0,28,0.253932,0.037759
22075,Plaquemines Parish,,LA,2421,28438,30859,5,5,10,1511,1145,2656,6,0.291108,0.303618,4.725855,0.001253,0.000704,49,0.000097,0,28,0.866667,0.006869
22077,Pointe Coupee Parish,,LA,1411,23544,24955,4,7,11,667,936,1603,7,0.284331,0.297096,4.306685,0.000329,0.000305,49,0.000113,0,28,0.5,0.001996
22079,Rapides Parish,,LA,7584,135835,143419,23,24,47,3611,4110,7721,6,0.331244,0.353004,10847.529418,0.004682,0.005779,153,0.00037,0,28,0.39418,0.033118
22081,Red River Parish,,LA,516,9078,9594,3,3,6,242,199,441,7,0.268893,0.279487,0,0.000156,0.000196,153,0.000098,0,28,1,0.001219
22083,Richland Parish,,LA,1327,20241,21568,4,5,9,663,659,1322,6,0.321144,0.338488,466.725214,0.000098,0.001049,153,0.000141,0,28,0.4,0.000775
22085,Sabine Parish,,LA,1285,23166,24451,5,6,11,446,535,981,7,0.276515,0.288981,11.926827,0.000371,0.000325,153,0.000118,0,28,0.666667,0.002625
22087,St. Bernard Parish,,LA,3563,73693,77256,5,9,14,2022,2335,4357,6,0.321963,0.339967,43.985122,0.000947,0.001936,49,0.000108,0,28,0.711111,0.005444
22089,St. Charles Parish,,LA,4227,58751,62978,10,14,24,3075,2791,5866,6,0.324913,0.344422,68.729142,0.001332,0.002977,49,0.000161,0,28,0.704762,0.007834
22091,St. Helena Parish,,LA,1102,14655,15757,4,3,7,631,656,1287,7,0.284192,0.296294,0,0.000745,0.000241,49,0.000103,0,28,1,0.004429
22093,St. James Parish,,LA,1090,26326,27416,7,6,13,607,687,1294,6,0.288221,0.301233,0.634524,0.001145,0.000484,49,0.000125,0,28,0.904762,0.00641
22095,St. John the Baptist Parish,,LA,2754,42820,45574,6,10,16,2077,1741,3818,6,0.321963,0.340081,31.323575,0.001118,0.001964,49,0.000117,0,28,0.866667,0.006173
22097,St. Landry Parish,,LA,3989,81884,85873,11,12,23,2348,2605,4953,6,0.324986,0.344307,82.273051,0.001933,0.002622,49,0.000191,0,28,0.666667,0.012983
22099,St. Martin Parish,,LA,2696,51211,53907,8,8,16,2188,1994,4182,6,0.321891,0.339737,7.642515,0.001458,0.00138,49,0.000159,0,28,0.777778,0.010391
22101,St. Mary Parish,,LA,3534,57230,60764,8,10,18,1268,1860,3128,6,0.321963,0.340081,84.635916,0.0018,0.00188,49,0.000144,0,28,0.744444,0.011914
22103,St. Tammany Parish,,LA,13598,206935,220533,48,49,97,11430,8070,19500,6,0.364697,0.393114,5756.496112,0.017393,0.021478,49,0.000634,0,28,0.453728,0.125395
22105,Tangipahoa Parish,,LA,5482,91778,97260,15,16,31,3579,3341,6920,6,0.326299,0.346503,496.59155,0.00233,0.003176,49,0.000263,0,28,0.520468,0.015818
22107,Tensas Parish,,LA,492,6128,6620,1,1,2,47,66,113,7,0.258285,0.26803,3.766384,0.000002,0.000042,153,0.000073,0,28,0,0.00011
22109,Terrebonne Parish,,LA,5548,104846,110394,10,14,24,3230,3474,6704,6,0.322212,0.340941,111.268549,0.002371,0.00212,49,0.00016,0,28,0.71978,0.015292
22111,Union Parish,,LA,1376,21924,23300,4,5,9,836,759,1595,7,0.25886,0.269498,14.870172,0.00014,0.000067,153,0.00013,0,28,0.45,0.000901
22113,Vermilion Parish,,LA,2618,57858,60476,7,7,14,1377,1520,2897,6,0.320755,0.338172,1.980237,0.001203,0.001175,49,0.000153,0,28,0.809524,0.009183
22115,Vernon Parish,,LA,10987,49409,60396,38,40,78,4224,4649,8873,6,0.365109,0.392122,5317.281297,0.012479,0.015261,153,0.000473,0,28,0.527926,0.08729
22117,Washington Parish,,LA,2052,41961,44013,9,9,18,1112,1091,2203,6,0.29331,0.306897,3043.798774,0.001297,0.000939,49,0.000194,0,28,0.527778,0.007594
22119,Webster Parish,,LA,2558,41711,44269,7,7,14,1213,1412,2625,6,0.31201,0.32901,624.909294,0.00127,0.001114,153,0.000165,0,28,0.597222,0.009581
22121,West Baton Rouge Parish,,LA,1940,23885,25825,4,5,9,1327,1382,2709,7,0.284164,0.296523,0.533333,0.000343,0.000248,49,0.00011,0,28,0.85,0.002069
22123,West Carroll Parish,,LA,946,12739,13685,4,4,8,304,457,761,7,0.258331,0.268518,110.957305,0.000113,0.00005,153,0.000139,0,28,0.5,0.00077
22125,West Feliciana Parish,,LA,850,10347,11197,4,2,6,461,346,807,7,0.284081,0.296007,0.833333,0.000313,0.000204,49,0.000131,0,28,0.5,0.001917
22127,Winn Parish,,LA,949,13670,14619,3,4,7,259,337,596,7,0.258469,0.268862,18.372631,0.000028,0.000057,153,0.000115,0,28,0.5,0.000405
23001,Androscoggin County,,ME,6153,114216,120369,14,16,30,3992,3969,7961,6,0.305678,0.323873,263.375646,0.002592,0.003608,100,0.000249,0,28,0.596491,0.019765
23003,Aroostook County,,ME,3544,81275,84819,8,16,24,857,1895,2752,6,0.296572,0.313754,84.32285,0.001108,0.002417,100,0.00016,0,28,0.604167,0.008109
23005,Cumberland County,,ME,20335,306994,327329,80,72,152,14412,15202,29614,6,0.362333,0.392707,26868.521598,0.036579,0.031463,100,0.000975,0,28,0.468218,0.26196
23007,Franklin County,,ME,2006,31365,33371,8,7,15,980,1069,2049,7,0.266184,0.277865,0.491667,0.000508,0.000545,100,0.00017,0,28,0.910714,0.004691
23009,Hancock County,,ME,3338,57383,60721,10,9,19,1432,1451,2883,6,0.308337,0.325376,290.317701,0.001236,0.002039,100,0.000198,0,28,0.663636,0.010236
23011,Kennebec County,,ME,6655,139201,145856,24,19,43,4813,4119,8932,6,0.305775,0.324389,993.833403,0.004592,0.003585,100,0.000386,0,28,0.478333,0.033867
23013,Knox County,,ME,2357,44822,47179,10,7,17,1166,1131,2297,7,0.266184,0.277865,4.917653,0.001771,0.000534,100,0.00019,0,28,0.744444,0.013105
23015,Lincoln County,,ME,2258,39413,41671,10,9,19,1423,1306,2729,6,0.294201,0.310366,43.744773,0.001818,0.001375,100,0.000197,0,28,0.744444,0.013908
23017,Oxford County,,ME,3167,59918,63085,12,7,19,2301,1693,3994,7,0.266233,0.277951,23.064979,0.002249,0.000555,100,0.000199,0,28,0.734848,0.016361
23019,Penobscot County,,ME,8024,159940,167964,28,27,55,4963,4818,9781,6,0.336147,0.357728,3609.771039,0.00675,0.007925,100,0.000419,0,28,0.449198,0.046847
23021,Piscataquis County,,ME,1205,18734,19939,4,6,10,457,700,1157,7,0.26616,0.277693,0.166667,0.000202,0.000516,100,0.000113,0,28,0.933333,0.001915
23023,Sagadahoc County,,ME,3908,39436,43344,7,8,15,2196,2238,4434,6,0.305005,0.321368,96.298369,0.002187,0.001985,100,0.000147,0,28,0.638889,0.017205
23025,Somerset County,,ME,2902,48780,51682,9,8,17,1601,1833,3434,7,0.266209,0.278037,121.277166,0.001232,0.000536,100,0.000183,0,28,0.788889,0.010057
23027,Waldo County,,ME,2379,40122,42501,13,9,22,1960,1503,3463,7,0.266233,0.278209,11.166271,0.001746,0.000553,100,0.000237,0,28,0.692308,0.013594
23029,Washington County,,ME,2048,37102,39150,4,7,11,485,837,1322,7,0.266184,0.277865,0.166667,0.000352,0.000529,100,0.000102,0,28,0.97619,0.002949
23031,York County,,ME,11671,216005,227676,45,41,86,11844,8271,20115,6,0.332419,0.355779,6904.043165,0.013754,0.013067,100,0.000613,0,28,0.450204,0.099329
24001,Allegany County,,MD,3267,77734,81001,10,11,21,1337,1475,2812,6,0.298307,0.314047,3102.788797,0.002712,0.001956,45,0.000234,0,28,0.423077,0.019499
24003,Anne Arundel County,,MD,44475,576119,620594,160,154,314,37215,34670,71885,6,0.397511,0.438837,27314.188956,0.075157,0.070845,45,0.001797,0,28,0.386685,0.524497
24005,Baltimore County,,MD,61497,895913,957410,144,145,289,56801,54001,110802,5,0.397348,0.437714,27952.304039,0.067653,0.071346,45,0.001549,0,28,0.437579,0.462142
24009,Calvert County,,MD,4972,87698,92670,12,11,23,5091,2773,7864,6,0.313931,0.331453,0.112901,0.006629,0.00587,45,0.000172,0,28,0.950549,0.048439
24011,Caroline County,,MD,2256,34719,36975,10,10,20,1750,1626,3376,6,0.292102,0.307293,8.527356,0.002319,0.001836,45,0.000188,0,28,0.736364,0.017173
24013,Carroll County,,MD,10417,198730,209147,15,19,34,9742,6795,16537,6,0.321856,0.339737,81.083789,0.005587,0.006222,45,0.000217,0,28,0.614719,0.039114
24015,Cecil County,,MD,5617,98523,104140,16,13,29,4959,3429,8388,6,0.294917,0.311868,19.945224,0.005428,0.004047,118,0.000201,0,28,0.6875,0.03495
24017,Charles County,,MD,10206,147140,157346,22,24,46,9323,6459,15782,6,0.330792,0.351152,115.567806,0.011122,0.011352,45,0.000296,0,28,0.694253,0.080877
24019,Dorchester County,,MD,1609,33803,35412,6,6,12,907,956,1863,6,0.29041,0.304942,0.253968,0.0013,0.001314,45,0.000129,0,28,0.933333,0.009374
24021,Frederick County,,MD,14091,230716,244807,42,41,83,12814,8803,21617,6,0.355814,0.381636,1963.394987,0.019523,0.021454,45,0.000557,0,28,0.571978,0.139855
24023,Garrett County,,MD,1348,32960,34308,5,4,9,387,429,816,7,0.233325,0.241343,1120.627737,0.0008,0.000062,45,0.000186,0,28,0.433333,0.005909
24025,Harford County,,MD,15928,260614,276542,41,43,84,12346,10102,22448,6,0.353822,0.379905,863.248513,0.021837,0.022609,45,0.000456,0,28,0.632774,0.150499
24027,Howard County,,MD,26660,272370,299030,86,84,170,22881,20639,43520,6,0.379553,0.413376,3648.643103,0.048594,0.048149,45,0.00093,0,28,0.603022,0.342089
24029,Kent County,,MD,1375,25515,26890,9,7,16,778,648,1426,6,0.292455,0.307522,3.672152,0.002221,0.001788,45,0.00016,0,28,0.708333,0.01547
24031,Montgomery County,,MD,74381,1009625,1084006,214,203,417,60100,64543,124643,5,0.422898,0.467509,56743.556502,0.0951,0.092412,45,0.00238,0,28,0.335191,0.653477
24033,Prince George's County,,MD,69700,881887,951587,164,158,322,61533,60167,121700,5,0.413161,0.453773,21490.590639,0.078948,0.075328,45,0.001748,0,28,0.400112,0.540085
24035,Queen Anne's County,,MD,3055,42120,45175,13,11,24,2474,1951,4425,6,0.302183,0.318157,35.835098,0.004777,0.003562,45,0.000203,0,28,0.741758,0.033684
24037,St. Mary's County,,MD,7833,96710,104543,24,26,50,4294,4037,8331,6,0.340159,0.361684,64.815065,0.011011,0.012978,45,0.000293,0,28,0.65914,0.07809
24039,Somerset County,,MD,1388,21339,22727,4,3,7,827,787,1614,6,0.284498,0.29793,0.700248,0.000679,0.000623,45,0.000101,0,28,0.833333,0.004593
24041,Talbot County,,MD,2521,39004,41525,10,10,20,1484,1383,2867,6,0.299753,0.315509,20.736483,0.003333,0.002489,45,0.000171,0,28,0.75,0.023762
24043,Washington County,,MD,7149,148870,156019,19,15,34,4620,4053,8673,6,0.302529,0.31939,6320.368664,0.004869,0.003816,45,0.000413,0,28,0.5,0.036943
24045,Wicomico County,,MD,5778,91224,97002,17,19,36,3368,3536,6904,6,0.316184,0.3353,241.017307,0.004232,0.006215,45,0.000273,0,28,0.552381,0.030024
24047,Worcester County,,MD,3929,56300,60229,16,11,27,3112,2295,5407,6,0.304111,0.320714,108.335402,0.005583,0.003931,45,0.00023,0,28,0.672794,0.038242
24510,Baltimore city,,MD,48638,592755,641393,89,81,170,30918,42827,73745,6,0.379553,0.413204,5971.46978,0.046037,0.043501,45,0.00099,0,28,0.578231,0.321196
25001,Barnstable County,,MA,12680,261146,273826,52,51,103,11496,8238,19734,6,0.351299,0.377996,4830.077142,0.025885,0.025464,100,0.000559,0,28,0.599519,0.178615
25003,Berkshire County,,MA,6096,153312,159408,23,27,50,2323,2885,5208,6,0.341398,0.364362,640.011348,0.011103,0.012376,100,0.00025,0,28,0.7,0.072358
25005,Bristol County,,MA,23755,606477,630232,46,60,106,20892,18997,39889,6,0.364149,0.393143,813.307903,0.024805,0.03202,100,0.000493,0,28,0.656936,0.171981
25007,Dukes County,,MA,1030,17327,18357,5,4,9,339,237,576,6,0.295607,0.310899,0,0.002321,0.001848,100,0.000096,0,28,1,0.016331
25009,Essex County,,MA,39664,822351,862015,96,113,209,34281,33391,67672,6,0.383358,0.42072,5740.679647,0.052029,0.056944,100,0.000993,0,28,0.521884,0.359074
25011,Franklin County,,MA,4810,80145,84955,12,14,26,3005,2949,5954,6,0.296633,0.313639,3.800491,0.004206,0.00474,100,0.000158,0,28,0.813187,0.028232
25013,Hampden County,,MA,18242,506865,525107,56,66,122,11008,13018,24026,6,0.368534,0.398395,1321.519098,0.029032,0.035551,100,0.000586,0,28,0.623509,0.200425
25015,Hampshire County,,MA,11673,155594,167267,25,32,57,7273,8152,15425,6,0.350833,0.375158,522.348788,0.011436,0.018265,100,0.000279,0,28,0.731231,0.078019
25017,Middlesex County,,MA,115120,1664689,1779809,248,222,470,90540,105150,195690,5,0.41588,0.464081,85801.824938,0.101079,0.09319,100,0.002686,0,28,0.279801,0.694211
25019,Nantucket County,,MA,973,10242,11215,1,2,3,51,175,226,7,0.264754,0.27568,0,0.000205,0.000424,100,0.00006,0,28,1,0.001469
25021,Norfolk County,,MA,55817,734326,790143,124,123,247,46953,50161,97114,5,0.38994,0.428231,6249.585079,0.064593,0.064077,100,0.001269,0,28,0.524473,0.444692
25023,Plymouth County,,MA,26482,550062,576544,50,63,113,24278,21483,45761,6,0.358005,0.386854,2556.182961,0.026861,0.033009,100,0.000551,0,28,0.580901,0.186895
25025,Suffolk County,,MA,74700,669698,744398,166,144,310,57250,68195,125445,5,0.401575,0.441589,15120.396753,0.078067,0.073009,100,0.001703,0,28,0.44163,0.530374
25027,Worcester County,,MA,34845,864490,899335,118,122,240,31556,27714,59270,6,0.383408,0.421936,8008.893915,0.060667,0.061212,100,0.001205,0,28,0.483645,0.417652
26001,Alcona County,,MI,1124,15381,16505,7,5,12,704,436,1140,6,0.304494,0.319797,2906.883333,0.001998,0.001459,113,0.000176,0,28,0.690476,0.012902
26003,Alger County,,MI,678,10731,11409,1,2,3,134,212,346,7,0.249335,0.258221,0,0.000036,0.000035,113,0.000067,0,28,1,0.000293
26005,Allegan County,,MI,8649,139372,148021,19,17,36,7686,6250,13936,6,0.342242,0.363771,171.945608,0.004944,0.005,113,0.000236,0,28,0.608225,0.032074
26007,Alpena County,,MI,1753,39265,41018,7,8,15,553,637,1190,6,0.304717,0.320542,1840.551944,0.001974,0.002057,113,0.000203,0,28,0.611111,0.012892
26009,Antrim County,,MI,2482,34182,36664,12,9,21,1588,1276,2864,6,0.304749,0.320714,883.968484,0.002712,0.002025,113,0.000284,0,28,0.641026,0.017569
26011,Arenac County,,MI,1367,22527,23894,8,7,15,904,700,1604,6,0.304557,0.320141,0.125,0.001778,0.001537,113,0.000135,0,28,0.964286,0.01167
26013,Baraga County,,MI,505,9793,10298,2,2,4,142,191,333,7,0.249314,0.258163,0,0.000055,0.000042,113,0.000085,0,28,1,0.000478
26015,Barry County,,MI,4469,74005,78474,10,10,20,3601,3136,6737,6,0.301275,0.316999,21.391319,0.002433,0.001451,113,0.000149,0,28,0.854545,0.01551
26017,Bay County,,MI,6303,137546,143849,16,19,35,3400,4067,7467,6,0.305325,0.322807,24.761592,0.002856,0.00292,113,0.000226,0,28,0.628947,0.018252
26019,Benzie County,,MI,1485,21979,23464,7,4,11,1143,805,1948,6,0.285476,0.297821,102.109259,0.001829,0.000389,113,0.000221,0,28,0.809524,0.012719
26021,Berrien County,,MI,10269,187179,197448,23,32,55,4151,5466,9617,6,0.362604,0.388705,447.868395,0.007063,0.014401,22,0.000267,0,28,0.565434,0.044833
26023,Branch County,,MI,3627,54215,57842,10,11,21,1855,2107,3962,6,0.306097,0.323025,170.032943,0.002301,0.002065,113,0.000158,0,28,0.583333,0.015175
26025,Calhoun County,,MI,8552,152523,161075,20,24,44,4711,5102,9813,6,0.341277,0.363897,245.354964,0.004748,0.006522,113,0.000254,0,28,0.589231,0.030468
26027,Cass County,,MI,3911,59479,63390,7,8,15,2813,2640,5453,6,0.324986,0.343453,1.371825,0.001628,0.001677,22,0.000113,0,28,0.875,0.010312
26029,Charlevoix County,,MI,1801,26107,27908,9,5,14,994,833,1827,7,0.254108,0.263515,8.536846,0.002522,0.000137,113,0.000243,0,28,0.680556,0.017175
26031,Cheboygan County,,MI,1927,35679,37606,12,9,21,1325,816,2141,6,0.304781,0.320772,356.459591,0.002303,0.001714,113,0.000304,0,28,0.589744,0.015115
26033,Chippewa County,,MI,2370,38104,40474,9,12,21,641,858,1499,6,0.305325,0.321947,4655.436861,0.00261,0.002606,113,0.000223,0,28,0.621212,0.016153
26035,Clare County,,MI,2835,40148,42983,16,15,31,1878,1660,3538,6,0.304973,0.321804,16.775563,0.002923,0.002376,113,0.000215,0,28,0.676471,0.018735
26037,Clinton County,,MI,7005,101680,108685,19,20,39,5855,5120,10975,6,0.326776,0.347397,195.931858,0.003573,0.00395,113,0.000242,0,28,0.701299,0.022557
26039,Crawford County,,MI,1342,18283,19625,7,5,12,784,424,1208,6,0.299938,0.314517,3.114762,0.002046,0.000764,113,0.000137,0,28,0.791667,0.013359
26041,Delta County,,MI,1959,45665,47624,8,7,15,606,602,1208,7,0.278182,0.291799,6408.752331,0.000827,0.000285,113,0.00026,0,28,0.333333,0.006528
26043,Dickinson County,,MI,1686,32415,34101,7,8,15,547,682,1229,7,0.263817,0.275389,5928.183354,0.000125,0.000186,113,0.000267,0,28,0.446429,0.001681
26045,Eaton County,,MI,10865,124432,135297,22,24,46,8319,8006,16325,6,0.33992,0.362034,491.689138,0.005734,0.005766,113,0.000281,0,28,0.661667,0.039197
26047,Emmet County,,MI,2104,32622,34726,11,4,15,1239,715,1954,6,0.300372,0.315056,125.99889,0.002673,0.000749,113,0.00025,0,28,0.809091,0.017093
26049,Genesee County,,MI,21973,524108,546081,51,89,140,14713,15643,30356,5,0.378023,0.411553,12486.246546,0.014886,0.030844,113,0.000669,0,28,0.299205,0.109489
26051,Gladwin County,,MI,1643,25260,26903,9,11,20,1322,929,2251,6,0.304717,0.320886,1.414827,0.00213,0.001904,113,0.000142,0,28,0.863636,0.013921
26053,Gogebic County,,MI,1014,17357,18371,4,3,7,263,198,461,7,0.23997,0.247882,8787.816464,0.000055,0.000032,113,0.000384,0,28,0.2,0.000661
26055,Grand Traverse County,,MI,6434,98634,105068,35,25,60,4956,3693,8649,6,0.340239,0.36255,8914.805015,0.006629,0.005178,113,0.000713,0,28,0.392857,0.046572
26057,Gratiot County,,MI,3533,56641,60174,14,16,30,2079,2306,4385,6,0.301337,0.317888,37.434619,0.00253,0.001561,113,0.000198,0,28,0.713235,0.016077
26059,Hillsdale County,,MI,3098,54312,57410,11,10,21,1987,1767,3754,6,0.301462,0.317641,126.643095,0.001909,0.001645,113,0.000169,0,28,0.583333,0.011371
26061,Houghton County,,MI,2255,34546,36801,6,9,15,474,663,1137,6,0.313728,0.331258,9919.728558,0.0018,0.002352,113,0.00019,0,28,0.377778,0.012051
26063,Huron County,,MI,2035,47226,49261,10,10,20,1040,1198,2238,6,0.304653,0.320657,1.160714,0.002154,0.001869,113,0.000148,0,28,0.9,0.014049
26065,Ingham County,,MI,24769,269147,293916,54,79,133,15845,18881,34726,6,0.382048,0.414941,14625.853524,0.015545,0.031309,113,0.000689,0,28,0.339776,0.111973
26067,Ionia County,,MI,3908,64651,68559,9,11,20,2971,2726,5697,6,0.301119,0.316913,9.10708,0.000847,0.001351,113,0.000153,0,28,0.8,0.005613
26069,Iosco County,,MI,2115,29735,31850,10,11,21,1235,982,2217,6,0.330454,0.349742,118.750363,0.002144,0.003099,113,0.000173,0,28,0.75,0.014031
26071,Iron County,,MI,729,13972,14701,2,2,4,89,127,216,7,0.249378,0.258335,0,0.000078,0.000029,113,0.000094,0,28,1,0.000833
26073,Isabella County,,MI,5000,58718,63718,21,21,42,3218,3017,6235,6,0.339801,0.361518,349.77175,0.003499,0.0051,113,0.00028,0,28,0.668478,0.022735
26075,Jackson County,,MI,7838,180076,187914,20,23,43,5411,4679,10090,6,0.340877,0.363267,349.922758,0.005984,0.006041,113,0.000243,0,28,0.646667,0.039235
26077,Kalamazoo County,,MI,17284,262371,279655,46,55,101,10211,11832,22043,6,0.370838,0.40012,3308.059783,0.014879,0.022419,113,0.000523,0,28,0.419147,0.101748
26079,Kalkaska County,,MI,1152,12971,14123,6,2,8,703,498,1201,7,0.253909,0.262684,0,0.002015,0.000075,113,0.000136,0,28,0.966667,0.013109
26081,Kent County,,MI,34161,668133,702294,107,111,218,24255,26626,50881,5,0.399149,0.43487,44450.462758,0.037765,0.047279,113,0.001409,0,28,0.332062,0.271195
26083,Keweenaw County,,MI,196,2080,2276,1,1,2,90,86,176,7,0.238827,0.246187,0,0.000019,0.000014,113,0.000068,0,28,0,0.000185
26085,Lake County,,MI,1188,13368,14556,9,7,16,811,602,1413,6,0.285476,0.298165,6.821264,0.001924,0.000404,113,0.000181,0,28,0.681818,0.013491
26087,Lapeer County,,MI,6712,109280,115992,9,11,20,5680,4621,10301,6,0.304813,0.321058,1.672571,0.002127,0.002275,113,0.000139,0,28,0.863636,0.013803
26089,Leelanau County,,MI,1270,18222,19492,5,2,7,676,599,1275,7,0.253909,0.262684,0,0.001809,0.000068,113,0.000151,0,28,0.9,0.01227
26091,Lenawee County,,MI,5610,109513,115123,13,14,27,3651,3176,6827,6,0.331471,0.351462,181.22014,0.003038,0.003993,113,0.000177,0,28,0.716667,0.018667
26093,Livingston County,,MI,11989,195752,207741,25,26,51,13517,7942,21459,6,0.343414,0.366105,493.31106,0.008148,0.007834,113,0.000287,0,28,0.554839,0.055035
26095,Luce County,,MI,402,6637,7039,2,1,3,116,44,160,7,0.233926,0.240991,0,0.000029,0.000021,113,0.000085,0,28,1,0.00039
26097,Mackinac County,,MI,1229,14261,15490,4,5,9,304,412,716,6,0.305325,0.32084,1254.812156,0.001553,0.000952,113,0.000113,0,28,0.5,0.010588
26099,Macomb County,,MI,43397,967008,1010405,86,99,185,40935,35431,76366,6,0.385851,0.4208,18627.746648,0.035147,0.04044,113,0.00105,0,28,0.371701,0.249321
26101,Manistee County,,MI,1708,28120,29828,11,7,18,929,740,1669,6,0.304685,0.32037,80.408733,0.002196,0.001712,113,0.000247,0,28,0.672727,0.014953
26103,Marquette County,,MI,3644,69425,73069,17,20,37,1388,1424,2812,6,0.332001,0.35387,22777.167181,0.003465,0.004472,113,0.000383,0,28,0.302536,0.023493
26105,Mason County,,MI,1811,32283,34094,9,8,17,877,708,1585,6,0.286094,0.299186,15.816861,0.001499,0.000601,113,0.000193,0,28,0.666667,0.009765
26107,Mecosta County,,MI,3925,45506,49431,17,17,34,2541,2445,4986,6,0.305197,0.322348,107.841894,0.002975,0.002474,113,0.00027,0,28,0.578947,0.019221
26109,Menominee County,,MI,1438,28247,29685,4,5,9,701,814,1515,7,0.263673,0.274701,2.83047,0.00009,0.000134,23,0.000147,0,28,0.8,0.001213
26111,Midland County,,MI,5439,89531,94970,16,19,35,3020,2882,5902,6,0.343698,0.366477,332.14735,0.004462,0.006014,113,0.000208,0,28,0.695906,0.029128
26113,Missaukee County,,MI,1230,16546,17776,8,5,13,755,558,1313,6,0.285588,0.298165,3.152461,0.002063,0.000413,113,0.000159,0,28,0.708333,0.013472
26115,Monroe County,,MI,9332,182432,191764,14,16,30,7311,6165,13476,6,0.335875,0.356886,93.558467,0.00329,0.005472,113,0.00018,0,28,0.642105,0.019647
26117,Montcalm County,,MI,4115,49536,53651,11,9,20,3263,2970,6233,6,0.286122,0.299358,15.117544,0.001551,0.000632,113,0.000178,0,28,0.709091,0.01036
26119,Montmorency County,,MI,712,10822,11534,6,2,8,458,176,634,7,0.233719,0.240962,0.571429,0.001985,0.000037,113,0.000132,0,28,0.833333,0.012799
26121,Muskegon County,,MI,7682,195691,203373,18,17,35,4699,4582,9281,6,0.326666,0.346881,331.204413,0.004615,0.003831,113,0.000252,0,28,0.607143,0.029431
26123,Newaygo County,,MI,3139,52291,55430,9,8,17,2508,2135,4643,6,0.300403,0.315577,51.458437,0.001203,0.00113,113,0.000186,0,28,0.680556,0.00889
26125,Oakland County,,MI,90825,1400940,1491765,211,236,447,71719,80400,152119,5,0.429014,0.476356,121170.318539,0.08174,0.089208,113,0.002604,0,28,0.253795,0.579295
26127,Oceana County,,MI,1599,22540,24139,6,6,12,955,966,1921,6,0.293163,0.307092,42.456225,0.000782,0.000698,113,0.000137,0,28,0.8,0.005666
26129,Ogemaw County,,MI,1436,21201,22637,10,9,19,990,636,1626,6,0.304621,0.320485,1.593827,0.002115,0.001834,113,0.000163,0,28,0.855556,0.013936
26131,Ontonagon County,,MI,503,8536,9039,3,1,4,128,67,195,8,0.193542,0.19764,0,0.000055,0,113,0.000193,0,28,0.666667,0.000576
26133,Osceola County,,MI,1710,20367,22077,8,7,15,949,968,1917,6,0.300963,0.316168,28.859035,0.001818,0.001063,113,0.000177,0,28,0.714286,0.012733
26135,Oscoda County,,MI,441,7020,7461,2,1,3,102,51,153,7,0.233456,0.240159,0,0.000965,0.000016,113,0.000066,0,28,1,0.005689
26137,Otsego County,,MI,1733,24943,26676,12,10,22,1075,688,1763,6,0.30115,0.316827,1307.432758,0.002668,0.001411,113,0.000303,0,28,0.621795,0.017244
26139,Ottawa County,,MI,15423,270120,285543,35,35,70,12239,11198,23437,6,0.357521,0.383138,3637.676279,0.010662,0.010879,113,0.000456,0,28,0.452564,0.074312
26141,Presque Isle County,,MI,801,14145,14946,4,3,7,352,252,604,6,0.300341,0.314884,0.681685,0.000945,0.000692,113,0.000116,0,28,0.8,0.006015
26143,Roscommon County,,MI,1704,23614,25318,9,8,17,1084,698,1782,6,0.304589,0.320313,40.146049,0.002308,0.001812,113,0.000161,0,28,0.666667,0.014512
26145,Saginaw County,,MI,10809,240999,251808,33,36,69,5816,7178,12994,6,0.349483,0.374407,2029.243146,0.006705,0.008454,113,0.000426,0,28,0.436572,0.047587
26147,St. Clair County,,MI,8975,195741,204716,12,21,33,6975,5963,12938,6,0.340877,0.362951,284.934239,0.004186,0.007139,113,0.000171,0,28,0.652381,0.027853
26149,St. Joseph County,,MI,4085,68550,72635,11,13,24,2030,2352,4382,6,0.326629,0.346365,389.716782,0.001998,0.00241,113,0.000173,0,28,0.554945,0.013157
26151,Sanilac County,,MI,3009,51883,54892,8,9,17,2203,1923,4126,6,0.304621,0.320485,0.25,0.002062,0.001847,113,0.000128,0,28,0.972222,0.013302
26153,Schoolcraft County,,MI,484,9413,9897,1,1,2,41,71,112,8,0.217655,0.223886,0,0.000002,0.000007,113,0.000082,0,28,0,0.000149
26155,Shiawassee County,,MI,4188,71468,75656,10,14,24,2911,2734,5645,6,0.304941,0.321632,2.473121,0.00243,0.00275,113,0.000142,0,28,0.846154,0.015384
26157,Tuscola County,,MI,3392,59714,63106,9,9,18,2238,2184,4422,6,0.304621,0.320485,0.688492,0.002096,0.001836,113,0.00014,0,28,0.930556,0.013737
26159,Van Buren County,,MI,5106,68023,73129,9,10,19,3466,3414,6880,6,0.337905,0.357746,26.006885,0.002132,0.002807,113,0.000141,0,28,0.763636,0.014369
26161,Washtenaw County,,MI,30013,309842,339855,96,105,201,21667,23118,44785,5,0.399698,0.434686,9981.96951,0.044359,0.05672,113,0.001077,0,28,0.485587,0.308737
26163,Wayne County,,MI,96050,2109563,2205613,210,226,436,57126,84093,141219,5,0.42813,0.474493,123554.931807,0.080695,0.082891,113,0.002516,0,28,0.239673,0.566793
26165,Wexford County,,MI,2518,32614,35132,12,9,21,1342,1187,2529,6,0.301025,0.316512,35.931218,0.002839,0.001117,113,0.000236,0,28,0.60989,0.017913
27001,Aitkin County,,MN,1152,16838,17990,6,5,11,611,486,1097,6,0.301963,0.316311,0.166667,0.001418,0.001066,127,0.00015,0,28,0.928571,0.010507
27003,Anoka County,,MN,25975,367546,393521,48,50,98,23797,21397,45194,6,0.355205,0.381963,8354.820916,0.012844,0.01237,127,0.000904,0,28,0.277323,0.093913
27005,Becker County,,MN,2056,38338,40394,10,7,17,1271,977,2248,6,0.303255,0.318123,5896.974619,0.000913,0.000995,127,0.000317,0,28,0.472727,0.007308
27007,Beltrami County,,MN,2647,43783,46430,13,12,25,1452,1221,2673,6,0.302529,0.318048,4680.755516,0.001258,0.001419,127,0.000355,0,28,0.441667,0.009901
27009,Benton County,,MN,5078,51608,56686,17,12,29,4716,3725,8441,6,0.30234,0.317704,26.194299,0.001661,0.001456,127,0.000381,0,28,0.628676,0.013206
27011,Big Stone County,,MN,366,7200,7566,0,0,0,0,0,0,0,0,0,0,0,0,46,0.00005,42,90,0,0
27013,Blue Earth County,,MN,5380,60374,65754,18,20,38,2999,3607,6606,6,0.330566,0.350957,8074.919076,0.001681,0.002799,127,0.000418,0,28,0.383399,0.013384
27015,Brown County,,MN,1778,33739,35517,5,6,11,483,699,1182,6,0.302246,0.316885,327.062294,0.000047,0.000964,127,0.000144,0,28,0.52381,0.000767
27017,Carlton County,,MN,1976,38230,40206,7,5,12,1311,1077,2388,6,0.30212,0.3165,1.059524,0.001455,0.001001,127,0.000178,0,28,0.857143,0.010919
27019,Carver County,,MN,6956,89909,96865,16,14,30,5979,4661,10640,6,0.332457,0.352431,313.231937,0.004684,0.003593,127,0.000314,0,28,0.604575,0.035624
27021,Cass County,,MN,2937,38042,40979,13,13,26,2284,1835,4119,6,0.302403,0.317934,17.283162,0.001533,0.001444,127,0.000304,0,28,0.62381,0.012108
27023,Chippewa County,,MN,1080,18165,19245,4,5,9,304,401,705,6,0.302309,0.31677,3484.98779,0.000677,0.000687,127,0.000136,0,28,0.45,0.00522
27025,Chisago County,,MN,3614,58413,62027,11,12,23,4387,2640,7027,6,0.30234,0.317704,7.55285,0.001585,0.001535,127,0.000255,0,28,0.75,0.012273
27027,Clay County,,MN,3906,53337,57243,8,12,20,2312,2350,4662,6,0.333142,0.353056,1683.861626,0.000803,0.002832,127,0.000252,0,28,0.494505,0.006344
27029,Clearwater County,,MN,530,8326,8856,2,1,3,188,195,383,7,0.232281,0.238914,0,0.00002,0.00001,127,0.000095,0,28,1,0.000333
27031,Cook County,,MN,450,5868,6318,2,2,4,128,119,247,6,0.302026,0.315984,0,0.000707,0.0007,127,0.000085,0,28,1,0.005307
27033,Cottonwood County,,MN,856,15324,16180,2,3,5,97,179,276,6,0.302214,0.316426,1312.630617,0,0.000664,127,0.000133,0,28,0.25,0.000202
27035,Crow Wing County,,MN,3651,56325,59976,16,17,33,2612,2374,4986,6,0.330153,0.35004,213.442946,0.001666,0.002637,127,0.000364,0,28,0.539474,0.013368
27037,Dakota County,,MN,35734,444118,479852,112,99,211,31010,29057,60067,6,0.386621,0.420898,55371.020872,0.034488,0.03589,127,0.001884,0,28,0.25322,0.255649
27039,Dodge County,,MN,1523,25859,27382,5,5,10,1053,827,1880,6,0.302057,0.316483,2.405866,0.000149,0.000753,127,0.000148,0,28,0.733333,0.001295
27041,Douglas County,,MN,2184,39820,42004,12,12,24,1244,1126,2370,6,0.303191,0.318725,718.095142,0.001558,0.001495,127,0.000309,0,28,0.576923,0.01188
27043,Faribault County,,MN,1133,20372,21505,3,4,7,309,377,686,6,0.302152,0.316483,4.342002,0.000038,0.00068,127,0.000122,0,28,0.666667,0.000463
27045,Fillmore County,,MN,1334,26142,27476,7,5,12,850,720,1570,6,0.30212,0.316598,2229.90738,0.00079,0.000742,127,0.000197,0,28,0.404762,0.006068
27047,Freeborn County,,MN,1805,37959,39764,7,8,15,567,713,1280,6,0.30234,0.317286,2197.6053,0.000785,0.001308,127,0.000197,0,28,0.477778,0.006046
27049,Goodhue County,,MN,2700,51610,54310,10,10,20,1740,1625,3365,6,0.302214,0.317343,191.722632,0.001538,0.001443,127,0.000236,0,28,0.618182,0.011373
27051,Grant County,,MN,489,7868,8357,2,3,5,174,254,428,6,0.301963,0.316082,0,0.000032,0.000693,127,0.000096,0,28,1,0.000474
27053,Hennepin County,,MN,95327,1265345,1360672,269,234,503,73940,84525,158465,5,0.432268,0.478397,406708.128274,0.082079,0.081926,127,0.004263,0,28,0.189087,0.584379
27055,Houston County,,MN,1256,24298,25554,5,5,10,866,626,1492,7,0.279842,0.292567,98.963213,0.000151,0.000399,127,0.000159,0,28,0.566667,0.001432
27057,Hubbard County,,MN,1228,15967,17195,6,6,12,514,526,1040,6,0.302057,0.316598,5.680152,0.000984,0.000799,127,0.000185,0,28,0.666667,0.007731
27059,Isanti County,,MN,2750,38288,41038,12,13,25,3122,1992,5114,6,0.302214,0.317687,4.943651,0.001583,0.001521,127,0.000267,0,28,0.747253,0.012545
27061,Itasca County,,MN,2404,49563,51967,10,8,18,1090,1038,2128,6,0.302246,0.317074,3.442381,0.001492,0.001396,127,0.000233,0,28,0.736364,0.011414
27063,Jackson County,,MN,706,12472,13178,3,2,5,210,126,336,7,0.233325,0.240113,40.471571,0.000019,0.000004,127,0.000155,0,28,0.166667,0.000319
27065,Kanabec County,,MN,1204,16928,18132,9,8,17,1005,752,1757,6,0.302057,0.316827,0.877778,0.001529,0.001106,127,0.000203,0,28,0.877778,0.011633
27067,Kandiyohi County,,MN,3046,51625,54671,10,14,24,1190,1570,2760,6,0.30873,0.325651,2266.810418,0.001347,0.001581,127,0.000232,0,28,0.42381,0.010137
27069,Kittson County,,MN,328,6185,6513,0,0,0,0,0,0,0,0,0,0,0,0,47,0.00005,43,91,0,0
27071,Koochiching County,,MN,907,16713,17620,1,5,6,44,288,332,6,0.302309,0.316816,3424.933615,0.000048,0.000722,127,0.00007,0,28,0.65,0.000451
27073,Lac qui Parle County,,MN,449,9215,9664,0,0,0,0,0,0,0,0,0,0,0,0,48,0.00005,44,92,0,0
27075,Lake County,,MN,749,13959,14708,2,2,4,297,293,590,6,0.302026,0.315984,0,0.000707,0.0007,127,0.000085,0,28,1,0.005307
27077,Lake of the Woods County,,MN,328,4645,4973,1,1,2,43,48,91,7,0.232653,0.239029,0,0.000005,0,127,0.000077,0,28,0,0.000093
27079,Le Sueur County,,MN,2210,34496,36706,10,9,19,1621,1288,2909,6,0.302277,0.317286,7.302352,0.001396,0.001305,127,0.000237,0,28,0.7,0.010898
27081,Lincoln County,,MN,402,7015,7417,1,1,2,80,60,140,7,0.23355,0.240428,0,0.000011,0.000005,127,0.000064,0,28,0,0.000134
27083,Lyon County,,MN,2158,30392,32550,5,13,18,417,1012,1429,6,0.304685,0.320915,12923.709012,0.000667,0.001382,127,0.000217,0,28,0.307692,0.005259
27085,McLeod County,,MN,2804,44230,47034,14,13,27,1751,1619,3370,6,0.302655,0.318249,176.264937,0.001727,0.001506,127,0.000295,0,28,0.471429,0.013723
27087,Mahnomen County,,MN,330,5245,5575,1,1,2,88,83,171,7,0.232709,0.239155,0,0.000008,0.000007,127,0.000089,0,28,0,0.000161
27089,Marshall County,,MN,719,12896,13615,4,4,8,258,305,563,7,0.255628,0.265149,2582.252451,0.000062,0.000038,127,0.000134,0,28,0.5,0.000692
27091,Martin County,,MN,1441,26817,28258,4,4,8,250,348,598,6,0.302246,0.316627,2076.610965,0.000028,0.000674,127,0.000154,0,28,0.233333,0.000513
27093,Meeker County,,MN,1651,27067,28718,6,6,12,989,892,1881,6,0.302246,0.316799,1.031846,0.001025,0.000736,127,0.000156,0,28,0.880952,0.008007
27095,Mille Lacs County,,MN,1567,23740,25307,12,12,24,1471,1042,2513,6,0.302183,0.317515,4.640873,0.001516,0.001422,127,0.000279,0,28,0.75641,0.011888
27097,Morrison County,,MN,1825,36115,37940,10,9,19,1309,1146,2455,6,0.302089,0.316999,1.307937,0.001481,0.001292,127,0.000244,0,28,0.872727,0.011385
27099,Mower County,,MN,2676,45756,48432,8,11,19,926,1359,2285,6,0.329928,0.349106,3539.40367,0.000874,0.002456,127,0.000248,0,28,0.492424,0.006851
27101,Murray County,,MN,629,11764,12393,2,2,4,172,172,344,7,0.233757,0.240973,7.653367,0.000019,0.00001,127,0.000099,0,28,0,0.000266
27103,Nicollet County,,MN,2957,29529,32486,7,8,15,1921,1805,3726,6,0.302246,0.317114,904.255641,0.000714,0.001291,127,0.000185,0,28,0.588889,0.005791
27105,Nobles County,,MN,1607,23934,25541,7,7,14,481,521,1002,6,0.304239,0.319499,10332.2262,0.000532,0.001016,127,0.000284,0,28,0.166667,0.004364
27107,Norman County,,MN,532,9210,9742,3,3,6,161,235,396,7,0.262034,0.272023,0.811111,0.000098,0.000036,127,0.000119,0,28,0.833333,0.000657
27109,Olmsted County,,MN,9756,149602,159358,34,32,66,5028,5572,10600,6,0.353607,0.378305,8238.473226,0.007666,0.01099,127,0.000667,0,28,0.335656,0.054995
27111,Otter Tail County,,MN,3376,63747,67123,16,14,30,1797,1787,3584,6,0.330491,0.350143,6191.785269,0.0026,0.002476,127,0.000387,0,28,0.448529,0.020665
27113,Pennington County,,MN,1147,15213,16360,4,8,12,322,541,863,6,0.303825,0.319017,1643.388766,0.000014,0.001008,127,0.000162,0,28,0.472222,0.000431
27115,Pine County,,MN,1770,25939,27709,10,10,20,1519,1090,2609,6,0.302277,0.31736,4.221501,0.001573,0.001235,127,0.000235,0,28,0.8,0.012061
27117,Pipestone County,,MN,684,10507,11191,3,1,4,256,107,363,7,0.265431,0.275297,0,0.000105,0.000078,127,0.000131,0,28,0.5,0.000983
27119,Polk County,,MN,2264,33620,35884,8,11,19,848,1167,2015,6,0.304111,0.319734,10095.379242,0.000786,0.001009,127,0.000258,0,28,0.363636,0.00614
27121,Pope County,,MN,730,12729,13459,4,3,7,277,268,545,6,0.301932,0.316025,1.333333,0.000708,0.000688,127,0.000133,0,28,0.583333,0.005417
27123,Ramsey County,,MN,51493,555320,606813,115,109,224,37723,44641,82364,6,0.401797,0.436705,59958.433195,0.034461,0.042131,127,0.001924,0,28,0.284725,0.252412
27125,Red Lake County,,MN,280,4583,4863,2,2,4,149,125,274,7,0.23325,0.240113,0,0.000016,0.000006,127,0.000088,0,28,1,0.000244
27127,Redwood County,,MN,1153,20923,22076,4,6,10,297,484,781,6,0.302434,0.317114,544.324631,0.000685,0.000961,127,0.000119,0,28,0.433333,0.005203
27129,Renville County,,MN,1262,20025,21287,4,5,9,399,454,853,6,0.307359,0.322864,42.904061,0.000303,0.00094,127,0.000112,0,28,0.55,0.002526
27131,Rice County,,MN,3470,58655,62125,11,12,23,2117,1982,4099,6,0.302592,0.318106,11.046068,0.001559,0.001505,127,0.000253,0,28,0.698718,0.012023
27133,Rock County,,MN,694,12054,12748,2,3,5,252,246,498,7,0.265576,0.275842,2.070641,0.000102,0.000083,127,0.000118,0,28,0.666667,0.000884
27135,Roseau County,,MN,985,20086,21071,3,5,8,136,277,413,6,0.30316,0.317767,6066.448226,0.000006,0.000683,127,0.000156,0,28,0.233333,0.000278
27137,St. Louis County,,MN,9969,218820,228789,32,30,62,5444,5966,11410,6,0.344268,0.36759,14139.002045,0.004986,0.005991,127,0.000692,0,28,0.307255,0.039873
27139,Scott County,,MN,7024,101478,108502,24,16,40,10635,4734,15369,6,0.330303,0.350097,830.712216,0.005357,0.002734,127,0.000459,0,28,0.48,0.03878
27141,Sherburne County,,MN,5629,67581,73210,13,14,27,5878,4149,10027,6,0.302403,0.318048,22.510408,0.001672,0.001592,127,0.00031,0,28,0.733333,0.013001
27143,Sibley County,,MN,1021,15293,16314,7,7,14,485,544,1029,6,0.302152,0.316856,699.526696,0.001031,0.000772,127,0.000187,0,28,0.660714,0.008401
27145,Stearns County,,MN,10025,137316,147341,32,25,57,7079,7420,14499,6,0.341077,0.363301,1698.568468,0.001946,0.003914,127,0.000702,0,28,0.340476,0.016845
27147,Steele County,,MN,2412,39451,41863,10,10,20,1208,1303,2511,6,0.302403,0.31763,196.37992,0.001453,0.001324,127,0.000234,0,28,0.633333,0.010752
27149,Stevens County,,MN,706,10353,11059,0,2,2,0,119,119,6,0.30191,0.315859,0,0,0.000666,127,0.00005,0,93,1,0
27151,Swift County,,MN,984,11763,12747,2,4,6,167,331,498,6,0.302403,0.316799,11.848563,0.000018,0.000681,127,0.000087,0,28,0.5,0.000313
27153,Todd County,,MN,1684,26542,28226,11,10,21,948,1054,2002,6,0.302183,0.317286,8.044614,0.001221,0.001043,127,0.000273,0,28,0.690909,0.009621
27155,Traverse County,,MN,353,4497,4850,0,1,1,0,50,50,8,0.189274,0.192985,0,0,0,127,0.00005,0,94,0,0
27157,Wabasha County,,MN,1426,25510,26936,5,5,10,768,695,1463,6,0.302089,0.316541,0.316883,0.001066,0.001024,127,0.00014,0,28,0.95,0.008001
27159,Wadena County,,MN,892,12155,13047,5,7,12,425,430,855,6,0.30212,0.316827,3.452846,0.000705,0.000732,127,0.000159,0,28,0.642857,0.005669
27161,Waseca County,,MN,1552,22090,23642,6,7,13,544,705,1249,6,0.302246,0.316999,31.824435,0.000984,0.000992,127,0.000155,0,28,0.642857,0.007645
27163,Washington County,,MN,17854,222946,240800,36,35,71,16193,13609,29802,6,0.352877,0.377881,3014.370501,0.011114,0.012187,127,0.000631,0,28,0.381129,0.07905
27165,Watonwan County,,MN,918,13479,14397,3,5,8,167,357,524,7,0.248802,0.257696,3736.43428,0.0003,0.00002,127,0.0001,0,28,0.266667,0.00232
27167,Wilkin County,,MN,679,8678,9357,2,4,6,197,329,526,7,0.261986,0.272092,1.601387,0.000026,0.000051,127,0.000095,0,28,0.75,0.000369
27169,Winona County,,MN,3359,51924,55283,12,13,25,1267,1903,3170,6,0.328252,0.347689,2113.480934,0.001551,0.002341,127,0.000311,0,28,0.419048,0.011866
27171,Wright County,,MN,6429,100440,106869,17,19,36,6916,4865,11781,6,0.330266,0.350441,398.514451,0.002728,0.002728,127,0.000366,0,28,0.578571,0.022322
27173,Yellow Medicine County,,MN,680,10936,11616,2,2,4,201,135,336,7,0.233644,0.24076,2.75,0.000017,0.000011,127,0.000088,0,28,0,0.000267
28001,Adams County,,MS,2097,35733,37830,5,9,14,504,844,1348,6,0.315122,0.333391,8012.373898,0.000448,0.001296,49,0.000151,0,28,0.277778,0.002684
28003,Alcorn County,,MS,2133,37734,39867,8,8,16,1060,1079,2139,6,0.307619,0.322176,3602.23719,0.00076,0.000696,49,0.00025,0,28,0.410714,0.005782
28005,Amite County,,MS,1229,16377,17606,5,4,9,595,586,1181,7,0.284387,0.29681,389.911606,0.000018,0.000216,49,0.000175,0,28,0.4,0.000591
28007,Attala County,,MS,1232,21731,22963,7,5,12,531,426,957,7,0.271024,0.282825,307.598569,0.000729,0.000189,49,0.000191,0,28,0.339286,0.004791
28009,Benton County,,MS,840,8299,9139,5,5,10,476,579,1055,6,0.307132,0.321058,398.867681,0.000735,0.000687,49,0.000157,0,28,0.7,0.005395
28011,Bolivar County,,MS,2655,40265,42920,6,8,14,936,1203,2139,6,0.328995,0.347787,154.561881,0.001731,0.001803,49,0.000135,0,28,0.660714,0.012325
28013,Calhoun County,,MS,1001,18759,19760,3,7,10,336,541,877,7,0.239851,0.248547,31.669909,0,0.000024,49,0.000123,0,28,0.333333,0.0003
28015,Carroll County,,MS,1130,13691,14821,4,3,7,668,586,1254,7,0.236054,0.243095,1513.435113,0.000015,0.000007,49,0.000149,0,28,0.5,0.000508
28017,Chickasaw County,,MS,1293,23289,24582,5,5,10,804,804,1608,7,0.249807,0.259132,644.497559,0.000016,0.000019,49,0.000154,0,28,0.566667,0.00059
28019,Choctaw County,,MS,608,7488,8096,2,4,6,98,254,352,7,0.248844,0.25763,5.611111,0.000021,0.000015,49,0.000093,0,28,0.416667,0.000273
28021,Claiborne County,,MS,615,11025,11640,3,4,7,260,328,588,7,0.270444,0.281873,693.416436,0.000164,0.000099,49,0.000108,0,28,0.416667,0.001028
28023,Clarke County,,MS,1782,28216,29998,5,6,11,840,928,1768,7,0.260414,0.271301,182.004922,0.000067,0.000067,49,0.000152,0,28,0.380952,0.000711
28025,Clay County,,MS,1282,23726,25008,4,5,9,432,615,1047,7,0.262507,0.272515,109.873254,0.000059,0.00004,49,0.000128,0,28,0.6,0.000637
28027,Coahoma County,,MS,2122,33278,35400,8,8,16,782,1012,1794,6,0.307229,0.321603,2037.384084,0.001755,0.000712,49,0.000191,0,28,0.422222,0.012779
28029,Copiah County,,MS,1872,33212,35084,7,4,11,1079,1014,2093,7,0.270494,0.282102,7.511436,0.000274,0.000147,49,0.000204,0,28,0.5,0.002084
28031,Covington County,,MS,1301,19690,20991,7,8,15,821,881,1702,7,0.282206,0.295655,83.236102,0.000104,0.000382,49,0.000186,0,28,0.625,0.001467
28033,DeSoto County,,MS,9760,130220,139980,34,24,58,10234,5447,15681,6,0.350875,0.374487,9105.136293,0.00614,0.006443,49,0.000672,0,28,0.230769,0.046534
28035,Forrest County,,MS,8397,90096,98493,35,27,62,4872,4769,9641,6,0.332761,0.355447,22001.979777,0.004463,0.004302,49,0.000643,0,28,0.245614,0.030628
28037,Franklin County,,MS,488,7429,7917,2,3,5,112,211,323,7,0.239792,0.247968,1.758333,0.000012,0.000006,49,0.000094,0,28,0.5,0.000234
28039,George County,,MS,1312,23368,24680,4,5,9,883,743,1626,7,0.28528,0.298504,11.583039,0.000693,0.000579,49,0.000109,0,28,0.85,0.004253
28041,Greene County,,MS,624,8997,9621,6,5,11,376,336,712,7,0.279358,0.291613,1035.534467,0.000438,0.000234,49,0.000167,0,28,0.466667,0.002977
28043,Grenada County,,MS,1715,25387,27102,6,9,15,588,780,1368,6,0.308173,0.323036,6647.866993,0.000013,0.000785,49,0.00023,0,28,0.333333,0.000707
28045,Hancock County,,MS,3571,45021,48592,8,9,17,2342,1893,4235,6,0.297087,0.311318,14.964041,0.00145,0.00128,49,0.000154,0,28,0.755556,0.008851
28047,Harrison County,,MS,20639,191304,211943,72,87,159,9914,12050,21964,6,0.383105,0.416644,31626.928409,0.030368,0.036555,49,0.000967,0,28,0.390701,0.222236
28049,Hinds County,,MS,17422,261753,279175,53,51,104,10427,12583,23010,6,0.369989,0.399908,60062.361365,0.011281,0.017326,49,0.000964,0,28,0.253472,0.081045
28051,Holmes County,,MS,1345,19107,20452,7,8,15,572,771,1343,7,0.271175,0.283513,4055.861575,0.001224,0.000193,49,0.000181,0,28,0.416667,0.008741
28053,Humphreys County,,MS,880,12771,13651,4,4,8,269,267,536,7,0.270343,0.281787,3.946199,0.000064,0.000117,49,0.000114,0,28,0.55,0.000677
28055,Issaquena County,,MS,152,1626,1778,0,1,1,0,52,52,7,0.248632,0.256871,0,0,0.000006,49,0.00005,0,95,0,0
28057,Itawamba County,,MS,1754,26601,28355,6,5,11,1224,1135,2359,7,0.239713,0.247974,71.372474,0.000016,0.00001,49,0.000203,0,28,0.4,0.000749
28059,Jackson County,,MS,10488,134698,145186,33,35,68,5759,5767,11526,6,0.356337,0.381854,9002.112163,0.012897,0.014721,49,0.000455,0,28,0.448505,0.089708
28061,Jasper County,,MS,992,17795,18787,4,5,9,660,554,1214,7,0.25,0.259803,8.086938,0.000006,0.000043,49,0.000134,0,28,0.45,0.000454
28063,Jefferson County,,MS,432,7329,7761,2,3,5,152,183,335,7,0.249228,0.258112,4.150433,0.000011,0.000011,49,0.000088,0,28,0.333333,0.000215
28065,Jefferson Davis County,,MS,920,14874,15794,3,7,10,276,532,808,7,0.282151,0.295426,25.432808,0.000039,0.000376,49,0.000129,0,28,0.547619,0.00061
28067,Jones County,,MS,3516,61886,65402,12,12,24,1550,1817,3367,7,0.282425,0.296544,5324.909659,0.000651,0.000533,49,0.000291,0,28,0.371212,0.005072
28069,Kemper County,,MS,781,12368,13149,2,2,4,357,372,729,7,0.25509,0.263968,0,0.000062,0.000025,49,0.000081,0,28,1,0.000378
28071,Lafayette County,,MS,3444,33025,36469,14,12,26,1357,1382,2739,6,0.308664,0.324126,4494.251241,0.001015,0.000886,49,0.000356,0,28,0.366667,0.007614
28073,Lamar County,,MS,2259,27435,29694,8,7,15,1587,1259,2846,7,0.279197,0.292186,74.429663,0.000413,0.000352,49,0.000195,0,28,0.5,0.003383
28075,Lauderdale County,,MS,5513,76512,82025,14,26,40,1968,2707,4675,6,0.342201,0.364545,21779.358557,0.003094,0.007524,49,0.00029,0,28,0.353175,0.022088
28077,Lawrence County,,MS,957,16921,17878,9,6,15,600,473,1073,7,0.270419,0.282246,368.394579,0.000187,0.000105,49,0.000273,0,28,0.458333,0.001982
28079,Leake County,,MS,1309,21930,23239,7,6,13,825,720,1545,7,0.271226,0.283243,116.769321,0.00028,0.000186,49,0.000193,0,28,0.571429,0.002092
28081,Lee County,,MS,5591,89856,95447,20,18,38,3658,3338,6996,6,0.314713,0.332393,20763.176845,0.001115,0.001863,49,0.00047,0,28,0.274704,0.008432
28083,Leflore County,,MS,2495,34802,37297,8,10,18,932,1316,2248,6,0.3085,0.323638,4410.913053,0.000853,0.00085,49,0.000213,0,28,0.427273,0.006145
28085,Lincoln County,,MS,1890,32836,34726,8,8,16,1110,960,2070,7,0.270796,0.283249,1489.765576,0.000239,0.000194,49,0.000277,0,28,0.428571,0.002263
28087,Lowndes County,,MS,5431,61720,67151,13,20,33,1578,2053,3631,6,0.348645,0.370605,18794.043874,0.002663,0.004604,49,0.000274,0,28,0.322511,0.019883
28089,Madison County,,MS,7782,78084,85866,21,29,50,5710,4888,10598,6,0.351937,0.376975,6824.149567,0.004165,0.009144,49,0.000398,0,28,0.375947,0.028857
28091,Marion County,,MS,1525,30447,31972,6,7,13,417,658,1075,7,0.270645,0.282876,354.940247,0.000167,0.000152,49,0.000172,0,28,0.388889,0.001667
28093,Marshall County,,MS,1999,27061,29060,6,8,14,1361,1397,2758,6,0.307261,0.321632,404.757492,0.000743,0.000708,49,0.000194,0,28,0.607143,0.005562
28095,Monroe County,,MS,2626,45551,48177,7,8,15,1475,1441,2916,7,0.262673,0.273261,327.617284,0.000053,0.000041,49,0.000211,0,28,0.410714,0.000951
28097,Montgomery County,,MS,775,12517,13292,3,3,6,315,250,565,7,0.235939,0.242877,14.189261,0.000006,0,49,0.000138,0,28,0.333333,0.000296
28099,Neshoba County,,MS,1693,27763,29456,6,8,14,707,924,1631,7,0.274504,0.287032,273.762459,0.00007,0.000171,49,0.000196,0,28,0.303571,0.000793
28101,Newton County,,MS,1350,25224,26574,5,6,11,749,664,1413,7,0.261939,0.273095,125.445751,0.00007,0.000083,49,0.000147,0,28,0.428571,0.000691
28103,Noxubee County,,MS,613,13353,13966,1,2,3,101,190,291,7,0.26128,0.270469,0,0.000037,0.000031,49,0.000062,0,28,1,0.000257
28105,Oktibbeha County,,MS,3822,34381,38203,15,15,30,1237,1370,2607,6,0.330717,0.35086,23362.15288,0.001153,0.002638,49,0.000333,0,28,0.30117,0.008247
28107,Panola County,,MS,2219,38942,41161,11,8,19,1472,1275,2747,6,0.307229,0.321574,1224.232685,0.000771,0.000701,49,0.000321,0,28,0.472727,0.006224
28109,Pearl River County,,MS,2674,47865,50539,11,9,20,2093,1239,3332,6,0.323144,0.341234,177.762675,0.00142,0.001989,49,0.000201,0,28,0.590909,0.008907
28111,Perry County,,MS,804,12798,13602,3,3,6,453,458,911,7,0.24985,0.259201,1,0.000041,0.000045,49,0.00012,0,28,0.666667,0.000647
28113,Pike County,,MS,2460,36213,38673,11,9,20,1164,1189,2353,7,0.289975,0.304836,4333.977074,0.00127,0.000594,49,0.000286,0,28,0.416667,0.007583
28115,Pontotoc County,,MS,1662,22884,24546,6,7,13,1023,1038,2061,7,0.239812,0.248432,1716.17905,0.000023,0.000029,49,0.000186,0,28,0.47619,0.000803
28117,Prentiss County,,MS,1220,20816,22036,6,5,11,778,802,1580,7,0.239674,0.24783,13.871228,0.000026,0.000021,49,0.000212,0,28,0.6,0.000819
28119,Quitman County,,MS,682,9528,10210,3,4,7,259,348,607,6,0.307034,0.3208,0.727778,0.000017,0.000646,49,0.000126,0,28,0.833333,0.000485
28121,Rankin County,,MS,10059,124568,134627,37,33,70,8475,6146,14621,6,0.341598,0.366632,21830.489421,0.006563,0.007033,49,0.000696,0,28,0.262685,0.04605
28123,Scott County,,MS,1699,26257,27956,7,7,14,880,955,1835,6,0.307294,0.322641,676.555875,0.000274,0.000935,49,0.000186,0,28,0.375,0.002064
28125,Sharkey County,,MS,552,6376,6928,1,3,4,81,246,327,7,0.270544,0.281959,0,0.00004,0.000112,49,0.000059,0,28,1,0.000207
28127,Simpson County,,MS,1683,20847,22530,5,7,12,900,1091,1991,7,0.270696,0.282905,31.128658,0.000203,0.000184,49,0.000141,0,28,0.553571,0.001608
28129,Smith County,,MS,1024,16294,17318,6,7,13,573,703,1276,7,0.25644,0.267795,247.9685,0.000073,0.000099,49,0.000171,0,28,0.5,0.001081
28131,Stone County,,MS,706,8236,8942,2,4,6,481,413,894,7,0.27773,0.290019,0,0.000328,0.000387,49,0.00008,0,28,0.833333,0.002236
28133,Sunflower County,,MS,2035,30331,32366,7,8,15,792,984,1776,6,0.328995,0.347787,1574.286645,0.001732,0.001746,49,0.000158,0,28,0.553571,0.01236
28135,Tallahatchie County,,MS,1095,16498,17593,6,8,14,385,613,998,6,0.307294,0.321718,2365.499753,0.000704,0.000667,49,0.000204,0,28,0.446429,0.005155
28137,Tate County,,MS,2172,25920,28092,6,5,11,1507,1430,2937,6,0.307067,0.320972,0.977778,0.000748,0.00069,49,0.000189,0,28,0.833333,0.005568
28139,Tippah County,,MS,1225,22436,23661,7,7,14,627,682,1309,6,0.307424,0.321718,2115.732669,0.000699,0.000653,49,0.00022,0,28,0.428571,0.005292
28141,Tishomingo County,,MS,1118,18919,20037,5,6,11,461,553,1014,7,0.240149,0.248622,48.374832,0.000017,0.000023,49,0.00019,0,28,0.466667,0.000604
28143,Tunica County,,MS,807,9919,10726,4,5,9,435,523,958,6,0.307002,0.320886,0.4,0.000735,0.000696,49,0.00014,0,28,0.85,0.005323
28145,Union County,,MS,1672,25671,27343,8,8,16,1071,1077,2148,7,0.239792,0.248518,3390.333406,0.000763,0.000035,49,0.000229,0,28,0.477778,0.005848
28147,Walthall County,,MS,691,10419,11110,4,4,8,324,350,674,7,0.229675,0.236932,4.640909,0.000014,0.000023,49,0.000155,0,28,0.5,0.00055
28149,Warren County,,MS,3677,57055,60732,12,14,26,1179,1404,2583,6,0.330792,0.351175,6437.365879,0.000704,0.003002,49,0.000278,0,28,0.356725,0.004756
28151,Washington County,,MS,4266,66714,70980,10,20,30,1009,2046,3055,6,0.343942,0.366707,5799.737621,0.001941,0.004965,49,0.000201,0,28,0.395238,0.013598
28153,Wayne County,,MS,857,19315,20172,4,5,9,385,352,737,7,0.250129,0.259981,18.070201,0.000009,0.000047,49,0.000137,0,28,0.35,0.000471
28155,Webster County,,MS,821,13061,13882,4,5,9,304,331,635,7,0.248887,0.257946,1160.689054,0.000022,0.00001,49,0.000143,0,28,0.2,0.000455
28157,Wilkinson County,,MS,425,8447,8872,2,3,5,132,162,294,7,0.284164,0.296294,360.808501,0.000309,0.000204,49,0.000098,0,28,0.5,0.0017
28159,Winston County,,MS,974,20229,21203,3,3,6,220,229,449,7,0.24893,0.257659,21.187315,0.000023,0.000016,49,0.00011,0,28,0.25,0.000371
28161,Yalobusha County,,MS,950,14226,15176,7,4,11,665,438,1103,7,0.236188,0.243582,1319.386025,0.000749,0.00002,49,0.000203,0,28,0.547619,0.005628
28163,Yazoo County,,MS,1664,27084,28748,6,7,13,550,843,1393,6,0.313592,0.330851,269.894261,0.000296,0.001105,49,0.000156,0,28,0.619048,0.002047
29001,Adair County,,MO,1979,22672,24651,5,7,12,397,566,963,6,0.306226,0.320921,11964.559002,0.000128,0.000834,50,0.000251,0,28,0.190476,0.001135
29003,Andrew County,,MO,1811,21210,23021,4,5,9,1383,1144,2527,7,0.261256,0.271278,381.855611,0.000148,0.000106,50,0.000135,0,28,0.52381,0.001341
29005,Atchison County,,MO,488,6909,7397,2,0,2,146,0,146,0,0,0,0,0.00001,0,50,0.000088,0,8,1,0.000244
29007,Audrain County,,MO,1918,29704,31622,7,9,16,763,975,1738,6,0.305357,0.320015,1798.599139,0.000856,0.000766,50,0.000208,0,28,0.388889,0.00595
29009,Barry County,,MO,2935,38314,41249,10,10,20,1452,1644,3096,7,0.275885,0.288787,71.272954,0.000469,0.000517,50,0.000268,0,28,0.544444,0.00499
29011,Barton County,,MO,1055,16143,17198,5,5,10,629,552,1181,7,0.273394,0.285009,9.421139,0.000081,0.000231,50,0.000162,0,28,0.6,0.001088
29013,Bates County,,MO,1371,19347,20718,5,5,10,781,635,1416,6,0.294231,0.306381,16.57092,0.000974,0.00041,50,0.000142,0,28,0.633333,0.00677
29015,Benton County,,MO,1465,17705,19170,7,7,14,831,704,1535,6,0.295067,0.307958,10.334916,0.001146,0.000702,50,0.000172,0,28,0.805556,0.008016
29017,Bollinger County,,MO,711,12762,13473,5,4,9,515,381,896,7,0.25382,0.262666,7.405492,0.000057,0.000033,50,0.000172,0,28,0.4,0.000769
29019,Boone County,,MO,11708,137117,148825,48,44,92,6298,6207,12505,6,0.368534,0.395505,55181.081908,0.010309,0.015474,50,0.000971,0,28,0.264209,0.075389
29021,Buchanan County,,MO,6142,92011,98153,14,19,33,2676,3775,6451,6,0.316219,0.333769,20127.061164,0.001291,0.002366,50,0.000391,0,28,0.289474,0.01011
29023,Butler County,,MO,2987,43278,46265,12,11,23,1361,1287,2648,6,0.307261,0.32271,13751.366399,0.000806,0.000844,50,0.000392,0,28,0.320513,0.006268
29025,Caldwell County,,MO,862,10882,11744,6,6,12,513,446,959,6,0.29441,0.306782,65.071192,0.000581,0.000493,50,0.000206,0,28,0.7,0.004216
29027,Callaway County,,MO,3155,42760,45915,6,9,15,1855,1748,3603,6,0.305357,0.320015,1243.127811,0.000865,0.001157,50,0.000175,0,28,0.486111,0.005943
29029,Camden County,,MO,3840,38535,42375,19,14,33,2055,1776,3831,6,0.333908,0.353578,921.59388,0.003912,0.003299,50,0.00039,0,28,0.480952,0.027597
29031,Cape Girardeau County,,MO,5020,74372,79392,20,19,39,2605,2593,5198,6,0.339762,0.360779,19951.756869,0.002507,0.003525,50,0.000535,0,28,0.25,0.017486
29033,Carroll County,,MO,591,11655,12246,4,5,9,212,249,461,6,0.29429,0.306496,1328.810622,0.000463,0.000386,50,0.00013,0,28,0.4,0.00313
29035,Carter County,,MO,574,6106,6680,1,1,2,125,128,253,7,0.235061,0.241641,0,0.000007,0.000006,50,0.000081,0,28,0,0.000155
29037,Cass County,,MO,7261,95606,102867,19,14,33,6483,4713,11196,6,0.330491,0.349811,597.518194,0.003624,0.00247,50,0.000369,0,28,0.419913,0.025084
29039,Cedar County,,MO,1035,13808,14843,5,5,10,501,415,916,6,0.294977,0.307556,90.399299,0.000666,0.00053,50,0.000165,0,28,0.7,0.004871
29041,Chariton County,,MO,561,9962,10523,3,4,7,154,243,397,7,0.273652,0.284888,9.520056,0.000011,0.000198,50,0.000126,0,28,0.3,0.000342
29043,Christian County,,MO,6653,67867,74520,20,16,36,5952,4374,10326,6,0.311142,0.327554,3216.058693,0.00449,0.001718,50,0.000484,0,28,0.352814,0.032275
29045,Clark County,,MO,448,8694,9142,4,2,6,255,120,375,8,0.216536,0.222627,2921.087989,0.000002,0,23,0.00019,0,28,0.166667,0.000374
29047,Clay County,,MO,18623,223505,242128,49,42,91,15371,13387,28758,6,0.367835,0.395287,28754.056291,0.013722,0.014995,50,0.000956,0,28,0.323622,0.100661
29049,Clinton County,,MO,1899,20031,21930,10,7,17,1374,1110,2484,6,0.294559,0.307155,889.303672,0.000715,0.000579,50,0.00028,0,28,0.5,0.00581
29051,Cole County,,MO,5661,80484,86145,22,17,39,3135,3322,6457,6,0.329854,0.350401,7918.168308,0.002904,0.003358,50,0.000476,0,28,0.343333,0.021072
29053,Cooper County,,MO,1275,17339,18614,5,6,11,655,599,1254,7,0.269716,0.280559,39.439917,0.000145,0.000126,50,0.000177,0,28,0.433333,0.001272
29055,Crawford County,,MO,1847,26038,27885,9,10,19,1062,1071,2133,6,0.306032,0.321104,96.612342,0.001252,0.001277,50,0.00021,0,28,0.575758,0.008714
29057,Dade County,,MO,741,8860,9601,4,5,9,330,431,761,7,0.273189,0.284648,23.646734,0.000215,0.00022,50,0.000136,0,28,0.55,0.00208
29059,Dallas County,,MO,1366,16449,17815,8,6,14,829,835,1664,7,0.273009,0.284419,36.635757,0.000657,0.000206,50,0.00027,0,28,0.589286,0.005257
29061,Daviess County,,MO,822,9803,10625,8,6,14,408,360,768,7,0.269241,0.280198,6165.527336,0.000595,0.000126,50,0.00027,0,28,0.4,0.004414
29063,DeKalb County,,MO,659,7776,8435,3,4,7,282,350,632,7,0.269366,0.280072,3.574801,0.000025,0.000128,50,0.00014,0,28,0.75,0.00047
29065,Dent County,,MO,963,14200,15163,5,3,8,340,279,619,7,0.27306,0.284189,207.445496,0.000745,0.000176,50,0.000128,0,28,0.633333,0.005168
29067,Douglas County,,MO,990,14237,15227,5,5,10,462,423,885,7,0.273112,0.284505,430.690924,0.00017,0.0002,50,0.000191,0,28,0.633333,0.002045
29069,Dunklin County,,MO,2227,33000,35227,10,11,21,1173,1320,2493,7,0.284693,0.299393,1892.623588,0.000316,0.000323,50,0.000296,0,28,0.327273,0.003319
29071,Franklin County,,MO,5708,112768,118476,13,16,29,4099,3670,7769,6,0.310047,0.32643,152.584036,0.001809,0.001913,50,0.000278,0,28,0.496324,0.012703
29073,Gasconade County,,MO,1130,17384,18514,7,6,13,661,521,1182,6,0.304813,0.31888,1101.984622,0.000964,0.000685,50,0.000183,0,28,0.486111,0.006863
29075,Gentry County,,MO,538,8221,8759,3,4,7,172,247,419,7,0.240486,0.248343,336.985408,0.000027,0.000019,50,0.000135,0,28,0.416667,0.000403
29077,Greene County,,MO,20058,256961,277019,78,67,145,13548,13354,26902,6,0.375242,0.405619,81733.660019,0.019407,0.018978,50,0.001604,0,28,0.236374,0.145792
29079,Grundy County,,MO,788,11042,11830,2,3,5,128,182,310,7,0.269142,0.279625,2.707257,0.000007,0.00012,50,0.000095,0,28,0.416667,0.000242
29081,Harrison County,,MO,642,9142,9784,2,2,4,114,124,238,8,0.212438,0.21803,1.981818,0.000001,0.000005,50,0.000117,0,28,0.5,0.000228
29083,Henry County,,MO,1667,24839,26506,9,8,17,1115,863,1978,6,0.29441,0.307012,26.57189,0.001155,0.000555,50,0.000214,0,28,0.666667,0.008273
29085,Hickory County,,MO,674,8575,9249,4,4,8,274,297,571,6,0.294887,0.30727,22.386274,0.000605,0.000529,50,0.000158,0,28,0.916667,0.00434
29087,Holt County,,MO,473,6480,6953,2,2,4,124,133,257,7,0.240367,0.247798,0,0.000027,0.000014,50,0.000085,0,28,1,0.000312
29089,Howard County,,MO,819,10997,11816,3,3,6,390,432,822,7,0.269441,0.279613,1.642857,0.000129,0.000085,50,0.000124,0,28,0.666667,0.000955
29091,Howell County,,MO,2946,42681,45627,10,11,21,997,1143,2140,7,0.273626,0.286167,10860.838707,0.000614,0.000226,50,0.000368,0,28,0.219697,0.006271
29093,Iron County,,MO,850,11134,11984,4,6,10,330,418,748,6,0.304653,0.318593,890.68428,0.000752,0.000705,50,0.000109,0,28,0.52381,0.005169
29095,Jackson County,,MO,45460,719792,765252,128,129,257,32100,36157,68257,5,0.416476,0.452419,137749.276588,0.045128,0.055486,50,0.002095,0,28,0.316535,0.327891
29097,Jasper County,,MO,8162,113272,121434,27,31,58,4510,4623,9133,6,0.34566,0.36986,12491.196441,0.007008,0.007221,50,0.000549,0,28,0.342017,0.052623
29099,Jefferson County,,MO,13279,236782,250061,22,27,49,11589,9944,21533,6,0.344758,0.367871,2959.73849,0.004323,0.004571,50,0.000431,0,28,0.325397,0.031928
29101,Johnson County,,MO,5950,48598,54548,15,17,32,2481,2601,5082,6,0.337043,0.357528,1137.960241,0.0033,0.005053,50,0.000308,0,28,0.454545,0.023397
29103,Knox County,,MO,349,5139,5488,1,1,2,58,76,134,7,0.234454,0.240815,0,0.000007,0.000001,50,0.000081,0,28,0,0.000104
29105,Laclede County,,MO,2361,35660,38021,7,9,16,993,1123,2116,6,0.307554,0.322606,227.102077,0.000282,0.000931,50,0.000249,0,28,0.511111,0.003102
29107,Lafayette County,,MO,2473,34490,36963,6,9,15,1486,1516,3002,6,0.298951,0.312653,35.831822,0.000619,0.001015,50,0.000163,0,28,0.555556,0.004393
29109,Lawrence County,,MO,2794,34289,37083,7,8,15,1688,1626,3314,7,0.273291,0.285221,7.166549,0.000237,0.000286,50,0.000211,0,28,0.625,0.002798
29111,Lewis County,,MO,743,10696,11439,3,3,6,311,307,618,7,0.246753,0.255254,1681.749428,0.000028,0.000022,23,0.000178,0,28,0.333333,0.000438
29113,Lincoln County,,MO,2654,46150,48804,7,7,14,3045,1710,4755,6,0.305133,0.319384,8.374442,0.00124,0.00099,50,0.000168,0,28,0.666667,0.00843
29115,Linn County,,MO,927,16272,17199,5,6,11,339,344,683,6,0.295157,0.307849,1554.264437,0.000455,0.000562,50,0.000167,0,28,0.357143,0.00318
29117,Livingston County,,MO,1064,15305,16369,7,6,13,401,411,812,6,0.294439,0.306811,1868.428685,0.00058,0.000485,50,0.000223,0,28,0.428571,0.004262
29119,McDonald County,,MO,2036,20517,22553,6,7,13,999,1159,2158,7,0.284832,0.299066,71.744996,0.000452,0.000575,50,0.000167,0,28,0.642857,0.00419
29121,Macon County,,MO,1193,17945,19138,5,5,10,363,484,847,7,0.269641,0.280244,4423.573937,0.000139,0.000089,50,0.000189,0,28,0.25,0.001161
29123,Madison County,,MO,852,12755,13607,3,4,7,310,366,676,6,0.304653,0.318364,423.452694,0.000752,0.000682,50,0.000095,0,28,0.5,0.005083
29125,Maries County,,MO,712,8301,9013,4,5,9,243,358,601,7,0.264923,0.275263,99.048514,0.000105,0.00013,50,0.000137,0,28,0.6,0.001147
29127,Marion County,,MO,2206,32511,34717,7,10,17,866,1028,1894,6,0.305614,0.320445,7100.400783,0.000857,0.000961,23,0.000322,0,28,0.322222,0.005908
29129,Mercer County,,MO,284,3924,4208,0,0,0,0,0,0,0,0,0,0,0,0,51,0.00005,45,96,0,0
29131,Miller County,,MO,1605,23791,25396,6,6,12,1035,829,1864,7,0.275206,0.2867,350.275093,0.000971,0.00024,50,0.000165,0,28,0.690476,0.006784
29133,Mississippi County,,MO,940,14021,14961,2,3,5,290,454,744,7,0.253753,0.262408,0,0.000012,0.000026,50,0.000091,0,28,0.833333,0.000242
29135,Moniteau County,,MO,978,15227,16205,5,4,9,477,418,895,7,0.269566,0.279986,3.844631,0.000043,0.000121,50,0.000165,0,28,0.6,0.000866
29137,Monroe County,,MO,777,11069,11846,5,5,10,362,381,743,7,0.269666,0.280261,1613.534115,0.000142,0.000098,50,0.000181,0,28,0.366667,0.001224
29139,Montgomery County,,MO,970,13747,14717,6,6,12,544,549,1093,7,0.281141,0.292811,9.24492,0.000967,0.000326,50,0.000154,0,28,0.553571,0.00675
29141,Morgan County,,MO,1571,19179,20750,8,7,15,855,729,1584,6,0.295157,0.307992,792.053165,0.001721,0.000514,50,0.00021,0,28,0.638889,0.01171
29143,New Madrid County,,MO,1480,20078,21558,5,7,12,733,848,1581,7,0.255516,0.265212,101.3461,0.00002,0.000047,50,0.000174,0,28,0.571429,0.000642
29145,Newton County,,MO,3895,49568,53463,11,9,20,2356,2309,4665,6,0.295397,0.308818,384.552075,0.001258,0.000602,50,0.000264,0,28,0.509091,0.009565
29147,Nodaway County,,MO,1462,20240,21702,7,10,17,423,594,1017,6,0.299351,0.313485,6186.918203,0.000471,0.000948,50,0.000208,0,28,0.244444,0.003428
29149,Oregon County,,MO,719,9297,10016,2,3,5,202,275,477,7,0.273291,0.284505,162.521297,0.000002,0.000161,50,0.000108,0,28,0.666667,0.000251
29151,Osage County,,MO,758,14508,15266,4,4,8,388,396,784,7,0.248249,0.257106,7.816707,0.000043,0.000039,50,0.00014,0,28,0.5,0.000678
29153,Ozark County,,MO,746,8930,9676,2,3,5,189,248,437,8,0.224687,0.231808,3.453846,0.000006,0.000025,50,0.000107,0,28,0.5,0.000382
29155,Pemiscot County,,MO,1475,20253,21728,5,5,10,567,625,1192,7,0.242634,0.25174,1027.387172,0.000693,0.000034,50,0.000147,0,28,0.466667,0.005037
29157,Perry County,,MO,1114,20233,21347,4,5,9,437,507,944,6,0.305165,0.319086,224.693491,0.000042,0.000672,50,0.000157,0,28,0.45,0.000656
29159,Pettis County,,MO,3049,44111,47160,9,14,23,1298,1610,2908,6,0.311175,0.327256,348.646093,0.000667,0.001931,50,0.000233,0,28,0.52381,0.005279
29161,Phelps County,,MO,3549,41084,44633,14,15,29,1399,1521,2920,6,0.309651,0.325995,1064.864723,0.001288,0.001848,50,0.000345,0,28,0.431373,0.009768
29163,Pike County,,MO,1199,18120,19319,6,5,11,588,490,1078,6,0.304845,0.318765,119.308318,0.000957,0.000871,50,0.000185,0,28,0.433333,0.006692
29165,Platte County,,MO,10655,81306,91961,30,18,48,8073,7314,15387,6,0.350199,0.373283,4600.748595,0.010688,0.00598,50,0.000539,0,28,0.520833,0.077567
29167,Polk County,,MO,2076,24005,26081,8,6,14,1150,1048,2198,6,0.294977,0.307671,48.282371,0.000629,0.00057,50,0.000252,0,28,0.464286,0.005049
29169,Pulaski County,,MO,7642,37008,44650,32,35,67,3132,3118,6250,6,0.350917,0.375238,9738.053994,0.010913,0.01053,50,0.000488,0,28,0.519048,0.076883
29171,Putnam County,,MO,333,5747,6080,1,1,2,41,47,88,7,0.223135,0.228568,1.35,0.000003,0.000003,23,0.000063,0,28,0,0.000112
29173,Ralls County,,MO,669,10023,10692,3,1,4,363,265,628,7,0.234096,0.240466,0.67619,0.000015,0.000007,23,0.000128,0,28,0.833333,0.00039
29175,Randolph County,,MO,1545,22304,23849,6,6,12,673,636,1309,6,0.295037,0.307677,497.344445,0.000134,0.000449,50,0.000214,0,28,0.309524,0.001287
29177,Ray County,,MO,1631,21304,22935,5,7,12,1022,1030,2052,6,0.29441,0.306897,5.02916,0.000627,0.000578,50,0.000154,0,28,0.619048,0.004659
29179,Reynolds County,,MO,581,5957,6538,0,3,3,0,169,169,7,0.235142,0.242286,0,0,0.000024,50,0.00005,0,97,0.333333,0
29181,Ripley County,,MO,933,13018,13951,2,2,4,284,315,599,7,0.235518,0.242512,25.499916,0.000007,0.000007,50,0.000119,0,28,0,0.000256
29183,St. Charles County,,MO,20111,346073,366184,62,59,121,21173,13867,35040,6,0.388325,0.417532,16324.915007,0.026373,0.028667,50,0.000953,0,28,0.459207,0.191039
29185,St. Clair County,,MO,818,9086,9904,4,6,10,343,446,789,6,0.294947,0.307614,6.847932,0.000474,0.00057,50,0.000133,0,28,0.666667,0.003357
29186,Ste. Genevieve County,,MO,1362,21884,23246,5,5,10,863,803,1666,6,0.305101,0.318971,560.120939,0.000995,0.000702,50,0.000133,0,28,0.766667,0.006586
29187,St. Francois County,,MO,3557,56964,60521,13,12,25,2709,2050,4759,6,0.307099,0.322704,1922.614133,0.001466,0.001363,50,0.000282,0,28,0.414286,0.010506
29189,St. Louis County,,MO,78504,1214994,1293498,211,223,434,61167,68223,129390,5,0.437735,0.481992,234071.490348,0.078995,0.087609,50,0.002945,0,28,0.255995,0.554468
29195,Saline County,,MO,1789,24034,25823,7,6,13,490,688,1178,6,0.294977,0.307562,451.70392,0.001649,0.000484,50,0.000169,0,28,0.482143,0.011607
29197,Schuyler County,,MO,252,4464,4716,1,1,2,66,84,150,7,0.234454,0.240815,0,0.000007,0.000001,50,0.000081,0,28,0,0.000104
29199,Scotland County,,MO,268,5039,5307,0,1,1,0,49,49,9,0.178044,0.181482,0,0,0,23,0.00005,0,98,0,0
29201,Scott County,,MO,2973,44728,47701,8,11,19,1630,1787,3417,6,0.314372,0.33143,6177.953207,0.000748,0.001482,50,0.000253,0,28,0.436364,0.005504
29203,Shannon County,,MO,499,7896,8395,1,1,2,155,146,301,8,0.214856,0.220575,0,0.000002,0.000005,50,0.000079,0,28,0,0.000151
29205,Shelby County,,MO,439,7666,8105,1,2,3,58,127,185,8,0.212609,0.218051,0.533333,0.000001,0.000002,50,0.000082,0,28,0,0.000104
29207,Stoddard County,,MO,1939,31807,33746,9,7,16,1035,956,1991,6,0.305903,0.320256,1780.651882,0.000797,0.000671,50,0.000255,0,28,0.541667,0.005908
29209,Stone County,,MO,3019,27199,30218,7,6,13,1222,1578,2800,7,0.273549,0.285066,145.140198,0.000902,0.000214,50,0.0002,0,28,0.595238,0.006795
29211,Sullivan County,,MO,676,6597,7273,2,6,8,100,319,419,6,0.295577,0.308296,4493.66163,0.000514,0.000379,50,0.00009,0,28,0.095238,0.003056
29213,Taney County,,MO,4403,39420,43823,11,9,20,1528,1710,3238,6,0.3239,0.341406,691.859002,0.001785,0.00243,50,0.000275,0,28,0.509524,0.01305
29215,Texas County,,MO,1565,19513,21078,6,5,11,567,595,1162,7,0.278956,0.290896,40.700675,0.000263,0.000261,50,0.00019,0,28,0.666667,0.002612
29217,Vernon County,,MO,1425,20141,21566,7,6,13,569,555,1124,6,0.295157,0.308015,836.12027,0.00067,0.000581,50,0.000212,0,28,0.404762,0.005072
29219,Warren County,,MO,1977,25774,27751,7,6,13,1976,1331,3307,6,0.304653,0.318593,23.833643,0.001235,0.001068,50,0.000157,0,28,0.761905,0.00843
29221,Washington County,,MO,1283,20690,21973,6,5,11,837,820,1657,6,0.304621,0.318421,2.241374,0.000862,0.000706,50,0.000141,0,28,0.714286,0.005953
29223,Wayne County,,MO,827,11130,11957,4,4,8,307,313,620,6,0.305261,0.319115,4.371834,0.000754,0.000668,50,0.000121,0,28,0.733333,0.005182
29225,Webster County,,MO,2157,28560,30717,7,5,12,1472,1335,2807,7,0.272983,0.284247,2.875,0.000198,0.000201,50,0.000253,0,28,0.619048,0.002379
29227,Worth County,,MO,143,2315,2458,0,0,0,0,0,0,0,0,0,0,0,0,52,0.00005,46,99,0,0
29229,Wright County,,MO,1559,18151,19710,7,6,13,793,915,1708,7,0.273137,0.284677,8.678557,0.000181,0.000168,50,0.000256,0,28,0.642857,0.002304
29510,St. Louis city,,MO,37163,325573,362736,49,55,104,24595,31848,56443,6,0.388896,0.418249,10277.688987,0.023432,0.029527,50,0.000712,0,28,0.545913,0.165933
30001,Beaverhead County,,MT,905,8950,9855,2,3,5,112,165,277,7,0.257484,0.266961,0,0.000105,0.000104,5,0.000091,0,28,1,0.000831
30003,Big Horn County,,MT,742,12467,13209,2,2,4,236,262,498,7,0.261915,0.272189,0,0.000114,0.000083,5,0.000103,0,28,1,0.000878
30005,Blaine County,,MT,548,6978,7526,1,1,2,68,128,196,8,0.211065,0.216631,0,0.000003,0.000001,5,0.000068,0,28,0,0.000095
30007,Broadwater County,,MT,361,4459,4820,1,1,2,91,79,170,7,0.248972,0.257065,0,0.000028,0.000025,5,0.000072,0,28,0,0.000306
30009,Carbon County,,MT,886,10230,11116,2,1,3,367,285,652,7,0.261892,0.272017,0,0.000115,0.000083,5,0.000108,0,28,1,0.000883
30011,Carter County,,MT,85,1275,1360,0,0,0,0,0,0,0,0,0,0,0,0,53,0.00005,47,100,0,0
30013,Cascade County,,MT,7859,89551,97410,26,32,58,2728,3303,6031,6,0.346525,0.370726,33089.394727,0.00923,0.010193,5,0.000571,0,28,0.412698,0.07235
30015,Chouteau County,,MT,461,5355,5816,1,1,2,49,139,188,7,0.257371,0.266542,0,0.000082,0.000074,5,0.000065,0,28,0,0.000673
30017,Custer County,,MT,1091,12743,13834,2,2,4,140,252,392,7,0.262365,0.272865,1.97201,0.000114,0.000158,5,0.000103,0,28,0.666667,0.000878
30019,Daniels County,,MT,133,2580,2713,0,0,0,0,0,0,0,0,0,0,0,0,54,0.00005,48,101,0,0
30021,Dawson County,,MT,736,10332,11068,0,1,1,0,78,78,7,0.261935,0.272095,0,0,0.000083,5,0.00005,0,102,0,0
30023,Deer Lodge County,,MT,756,9906,10662,1,2,3,122,147,269,7,0.261939,0.271742,0,0.000022,0.000076,5,0.000068,0,28,1,0.000129
30025,Fallon County,,MT,242,3382,3624,0,0,0,0,0,0,0,0,0,0,0,0,55,0.00005,49,103,0,0
30027,Fergus County,,MT,936,13250,14186,2,3,5,165,218,383,7,0.263602,0.274511,0,0.000195,0.000182,5,0.000086,0,28,1,0.001455
30029,Flathead County,,MT,5514,85169,90683,28,24,52,2793,2342,5135,6,0.342847,0.365382,4820.056643,0.00906,0.009174,5,0.000508,0,28,0.550575,0.071007
30031,Gallatin County,,MT,6920,70582,77502,34,26,60,3503,2852,6355,6,0.346443,0.370032,20354.386269,0.009382,0.010367,5,0.000706,0,28,0.400135,0.074615
30033,Garfield County,,MT,116,1373,1489,0,0,0,0,0,0,0,0,0,0,0,0,56,0.00005,50,104,0,0
30035,Glacier County,,MT,1050,13850,14900,5,5,10,310,424,734,7,0.263817,0.274403,2925.750028,0.00021,0.000237,5,0.000189,0,28,0.433333,0.001766
30037,Golden Valley County,,MT,133,1067,1200,1,0,1,50,0,50,0,0,0,0,0.000113,0,5,0.00007,0,20,0,0.000782
30039,Granite County,,MT,378,2919,3297,1,1,2,158,95,253,7,0.261845,0.271398,0,0.000115,0.000073,5,0.000067,0,28,0,0.000683
30041,Hill County,,MT,1468,18491,19959,2,6,8,225,539,764,7,0.267507,0.279332,5872,0.000082,0.000378,5,0.000123,0,28,0.666667,0.000761
30043,Jefferson County,,MT,1049,11337,12386,4,4,8,550,489,1039,7,0.262175,0.272488,0,0.000215,0.000177,5,0.000127,0,28,1,0.00181
30045,Judith Basin County,,MT,204,2480,2684,0,0,0,0,0,0,0,0,0,0,0,0,57,0.00005,51,105,0,0
30047,Lake County,,MT,1891,24911,26802,7,7,14,732,751,1483,6,0.3284,0.346749,1142.124052,0.002093,0.001619,5,0.000185,0,28,0.708333,0.017134
30049,Lewis and Clark County,,MT,4381,63312,67693,16,16,32,1991,1947,3938,6,0.331471,0.351749,11030.90862,0.003128,0.003521,5,0.0004,0,28,0.467836,0.025197
30051,Liberty County,,MT,188,2352,2540,0,0,0,0,0,0,0,0,0,0,0,0,58,0.00005,52,106,0,0
30053,Lincoln County,,MT,1494,18675,20169,3,5,8,217,438,655,7,0.270142,0.283105,103.821686,0.000982,0.000508,5,0.000097,0,28,0.8,0.007704
30055,McCone County,,MT,177,1783,1960,0,0,0,0,0,0,0,0,0,0,0,0,59,0.00005,53,107,0,0
30057,Madison County,,MT,571,6730,7301,1,1,2,105,105,210,7,0.257325,0.266359,0,0.000083,0.000075,5,0.000073,0,28,0,0.000702
30059,Meagher County,,MT,193,2271,2464,0,0,0,0,0,0,0,0,0,0,0,0,60,0.00005,54,108,0,0
30061,Mineral County,,MT,554,4304,4858,1,1,2,111,164,275,7,0.261845,0.271398,0,0.000115,0.000073,5,0.000067,0,28,0,0.000683
30063,Missoula County,,MT,9147,98280,107427,33,37,70,4673,4921,9594,6,0.354685,0.380329,29116.994028,0.009068,0.014268,5,0.00072,0,28,0.424419,0.072187
30065,Musselshell County,,MT,450,4538,4988,1,1,2,81,126,207,7,0.261892,0.272017,0,0.000113,0.000083,5,0.00007,0,28,0,0.000782
30067,Park County,,MT,1732,16031,17763,2,3,5,314,541,855,7,0.266599,0.277756,0,0.000197,0.000231,5,0.000093,0,28,1,0.001484
30069,Petroleum County,,MT,0,0,0,0,0,0,0,0,0,0,0,0,0,0,0,61,0.00005,55,109,0,0
30071,Phillips County,,MT,387,4991,5378,0,1,1,0,54,54,7,0.261935,0.272095,0,0,0.000083,5,0.00005,0,110,0,0
30073,Pondera County,,MT,504,7741,8245,2,2,4,119,121,240,7,0.257393,0.266714,0,0.000084,0.000076,5,0.000098,0,28,1,0.000781
30075,Powder River County,,MT,143,1652,1795,0,0,0,0,0,0,0,0,0,0,0,0,62,0.00005,56,111,0,0
30077,Powell County,,MT,607,6278,6885,1,3,4,41,183,224,7,0.26201,0.272029,0,0.000028,0.000101,5,0.000072,0,28,1,0.000306
30079,Prairie County,,MT,83,1416,1499,0,0,0,0,0,0,0,0,0,0,0,0,63,0.00005,57,112,0,0
30081,Ravalli County,,MT,2758,35521,38279,11,6,17,1128,891,2019,6,0.306484,0.322314,6.917471,0.004237,0.001383,5,0.000224,0,28,0.954545,0.032395
30083,Richland County,,MT,756,11681,12437,1,2,3,46,151,197,7,0.263029,0.273479,46.967157,0.000113,0.000084,127,0.00007,0,28,0,0.000782
30085,Roosevelt County,,MT,760,11965,12725,2,2,4,106,163,269,7,0.261915,0.272189,0,0.000114,0.000083,5,0.000122,0,28,1,0.000878
30087,Rosebud County,,MT,963,10872,11835,2,3,5,160,301,461,7,0.261939,0.272361,0.5,0.000114,0.000084,5,0.000114,0,28,0.666667,0.000878
30089,Sanders County,,MT,808,10025,10833,4,4,8,224,259,483,7,0.262104,0.272316,1.778064,0.000206,0.000238,5,0.000124,0,28,0.7,0.001727
30091,Sheridan County,,MT,310,4834,5144,0,0,0,0,0,0,0,0,0,0,0,0,64,0.00005,58,113,0,0
30093,Silver Bow County,,MT,2921,36730,39651,9,12,21,694,1270,1964,6,0.330566,0.349943,4386.57615,0.000425,0.002683,5,0.000248,0,28,0.544872,0.003527
30095,Stillwater County,,MT,975,9230,10205,3,3,6,354,367,721,7,0.262365,0.273221,2918.264733,0.000166,0.000127,5,0.000133,0,28,0.166667,0.001318
30097,Sweet Grass County,,MT,391,3730,4121,0,1,1,0,42,42,8,0.207892,0.213205,0,0,0.000001,5,0.00005,0,114,0,0
30099,Teton County,,MT,524,7572,8096,1,1,2,117,132,249,7,0.257371,0.266542,0,0.000082,0.000074,5,0.000065,0,28,0,0.000673
30101,Toole County,,MT,403,5589,5992,0,1,1,0,52,52,8,0.208803,0.21394,0,0,0.000002,5,0.00005,0,115,0,0
30103,Treasure County,,MT,0,0,0,0,0,0,0,0,0,0,0,0,0,0,0,65,0.00005,59,116,0,0
30105,Valley County,,MT,619,8834,9453,2,2,4,90,86,176,7,0.261915,0.272189,0,0.000114,0.000083,5,0.000122,0,28,1,0.000878
30107,Wheatland County,,MT,253,2313,2566,0,1,1,0,49,49,7,0.261935,0.272095,0,0,0.000083,5,0.00005,0,117,0,0
30109,Wibaux County,,MT,99,1180,1279,0,0,0,0,0,0,0,0,0,0,0,0,66,0.00005,60,118,0,0
30111,Yellowstone County,,MT,9333,146060,155393,43,48,91,4840,5111,9951,6,0.354772,0.382319,85290.89198,0.010264,0.014115,5,0.001134,0,28,0.265664,0.082468
31001,Adams County,,NE,2250,34335,36585,8,8,16,876,1028,1904,6,0.297361,0.310251,10332.666487,0.000703,0.000465,50,0.000271,0,28,0.322222,0.004244
31003,Antelope County,,NE,579,8854,9433,2,2,4,131,168,299,7,0.276567,0.287757,0,0.00001,0.000143,50,0.00009,0,28,0.666667,0.000323
31005,Arthur County,,NE,0,0,0,0,0,0,0,0,0,0,0,0,0,0,0,67,0.00005,61,119,0,0
31007,Banner County,,NE,100,1009,1109,0,0,0,0,0,0,0,0,0,0,0,0,68,0.00005,62,120,0,0
31009,Blaine County,,NE,0,0,0,0,0,0,0,0,0,0,0,0,0,0,0,69,0.00005,63,121,0,0
31011,Boone County,,NE,436,7649,8085,2,2,4,87,115,202,7,0.233456,0.240586,0,0.00001,0.000024,50,0.000117,0,28,1,0.000381
31013,Box Butte County,,NE,1144,15033,16177,3,3,6,189,194,383,7,0.275911,0.287132,2331.071956,0.000029,0.000137,50,0.000156,0,28,0.416667,0.000366
31015,Boyd County,,NE,145,2829,2974,0,0,0,0,0,0,0,0,0,0,0,0,70,0.00005,64,122,0,0
31017,Brown County,,NE,260,4102,4362,0,0,0,0,0,0,0,0,0,0,0,0,71,0.00005,65,123,0,0
31019,Buffalo County,,NE,3666,46692,50358,17,13,30,1655,1530,3185,6,0.301493,0.315784,15158.360217,0.000755,0.000932,50,0.000608,0,28,0.2,0.00544
31021,Burt County,,NE,718,9515,10233,4,5,9,266,359,625,6,0.296814,0.309059,4.323181,0.000472,0.000454,50,0.000132,0,28,0.75,0.002797
31023,Butler County,,NE,744,12344,13088,4,3,7,371,343,714,6,0.296845,0.308887,25.210417,0.000224,0.000444,50,0.000165,0,28,0.6,0.001516
31025,Cass County,,NE,2526,29178,31704,6,5,11,1701,1409,3110,6,0.299136,0.311472,3.927493,0.000849,0.000576,50,0.00017,0,28,0.766667,0.004914
31027,Cedar County,,NE,761,13219,13980,2,4,6,165,285,450,6,0.297239,0.309632,45.526827,0.000008,0.000458,50,0.000115,0,28,0.583333,0.000348
31029,Chase County,,NE,349,5031,5380,0,0,0,0,0,0,0,0,0,0,0,0,72,0.00005,66,124,0,0
31031,Cherry County,,NE,537,7119,7656,0,0,0,0,0,0,0,0,0,0,0,0,73,0.00005,67,125,0,0
31033,Cheyenne County,,NE,797,11654,12451,1,0,1,45,0,45,0,0,0,0,0.000029,0,50,0.000069,0,18,0,0.000184
31035,Clay County,,NE,720,8698,9418,1,3,4,194,291,485,7,0.276147,0.287436,0,0.000004,0.000144,50,0.000079,0,28,1,0.000133
31037,Colfax County,,NE,1134,14797,15931,5,6,11,294,668,962,6,0.297178,0.309833,323.528455,0.001079,0.000471,50,0.000165,0,28,0.625,0.008269
31039,Cuming County,,NE,888,13136,14024,3,6,9,189,453,642,6,0.297118,0.309718,8.961243,0.000469,0.000476,50,0.000109,0,28,0.733333,0.002676
31041,Custer County,,NE,916,14186,15102,2,4,6,111,343,454,7,0.275937,0.287304,0,0.000012,0.000149,50,0.000119,0,28,1,0.000298
31043,Dakota County,,NE,2668,23672,26340,5,7,12,1241,1494,2735,6,0.336926,0.35575,3472.351651,0.00115,0.002675,127,0.000157,0,28,0.410714,0.00822
31045,Dawes County,,NE,897,9002,9899,3,2,5,177,110,287,7,0.248695,0.256692,136.889287,0.00003,0.000012,50,0.00014,0,28,0.5,0.000366
31047,Dawson County,,NE,2322,28597,30919,8,10,18,656,1004,1660,6,0.330679,0.349318,7025.99505,0.001585,0.001552,50,0.000267,0,28,0.348485,0.011608
31049,Deuel County,,NE,233,2379,2612,0,0,0,0,0,0,0,0,0,0,0,0,74,0.00005,68,126,0,0
31051,Dixon County,,NE,575,7137,7712,2,3,5,130,189,319,7,0.254553,0.263194,53.27685,0.000117,0.000028,127,0.000084,0,28,0.333333,0.000458
31053,Dodge County,,NE,2871,42032,44903,10,10,20,1322,1622,2944,6,0.329667,0.348097,461.360967,0.000853,0.001726,50,0.000277,0,28,0.454545,0.005442
31055,Douglas County,,NE,35199,552973,588172,115,133,248,23121,26184,49305,6,0.419481,0.455487,181610.735806,0.039033,0.056098,50,0.002021,0,28,0.299132,0.286902
31057,Dundy County,,NE,213,2496,2709,0,0,0,0,0,0,0,0,0,0,0,0,75,0.00005,69,127,0,0
31059,Fillmore County,,NE,509,8794,9303,2,2,4,101,157,258,7,0.275806,0.286788,0.833333,0.000005,0.000126,50,0.000089,0,28,0.5,0.000187
31061,Franklin County,,NE,262,4353,4615,0,1,1,0,42,42,7,0.231713,0.237887,0,0,0.000006,50,0.00005,0,128,0,0
31063,Frontier County,,NE,353,3608,3961,0,1,1,0,60,60,7,0.229845,0.235744,0,0,0.000006,50,0.00005,0,129,0,0
31065,Furnas County,,NE,527,6043,6570,1,2,3,50,90,140,7,0.275859,0.286903,0,0.000001,0.000131,50,0.000073,0,28,0.833333,0.000099
31067,Gage County,,NE,1453,26877,28330,5,4,9,794,633,1427,6,0.296754,0.308829,106.238253,0.00022,0.000442,50,0.000238,0,28,0.3,0.001505
31069,Garden County,,NE,221,2390,2611,0,0,0,0,0,0,0,0,0,0,0,0,76,0.00005,70,130,0,0
31071,Garfield County,,NE,112,2548,2660,0,0,0,0,0,0,0,0,0,0,0,0,77,0.00005,71,131,0,0
31073,Gosper County,,NE,271,2426,2697,1,1,2,55,71,126,7,0.248525,0.256077,0,0.000012,0.000013,50,0.000073,0,28,0,0.000188
31075,Grant County,,NE,142,1218,1360,0,0,0,0,0,0,0,0,0,0,0,0,78,0.00005,72,132,0,0
31077,Greeley County,,NE,213,3655,3868,0,0,0,0,0,0,0,0,0,0,0,0,79,0.00005,73,133,0,0
31079,Hall County,,NE,4723,61445,66168,12,15,27,1742,2327,4069,6,0.338181,0.358416,13662.35687,0.001756,0.002829,50,0.000356,0,28,0.283088,0.012284
31081,Hamilton County,,NE,852,11574,12426,2,6,8,303,474,777,6,0.29727,0.30985,370.494174,0.000023,0.000465,50,0.000107,0,28,0.733333,0.000293
31083,Harlan County,,NE,313,4109,4422,1,0,1,40,0,40,0,0,0,0,0.000001,0,50,0.000088,0,2,0,0.000103
31085,Hayes County,,NE,69,1289,1358,0,0,0,0,0,0,0,0,0,0,0,0,80,0.00005,74,134,0,0
31087,Hitchcock County,,NE,249,3513,3762,1,1,2,74,70,144,8,0.216311,0.221719,0,0.000001,0.000002,50,0.000073,0,28,0,0.000099
31089,Holt County,,NE,773,13122,13895,0,4,4,0,267,267,6,0.297098,0.309439,0,0,0.000457,50,0.00005,0,135,0.75,0
31091,Hooker County,,NE,122,1076,1198,0,0,0,0,0,0,0,0,0,0,0,0,81,0.00005,75,136,0,0
31093,Howard County,,NE,586,7338,7924,1,2,3,209,253,462,7,0.276042,0.287092,0,0.000023,0.000139,50,0.00007,0,28,1,0.000201
31095,Jefferson County,,NE,548,9801,10349,3,2,5,184,203,387,7,0.275754,0.286673,0.5,0.00022,0.000126,50,0.000137,0,28,0.5,0.001306
31097,Johnson County,,NE,408,5331,5739,1,2,3,46,144,190,7,0.275754,0.286673,0,0.000216,0.000126,50,0.000072,0,28,1,0.001114
31099,Kearney County,,NE,498,7180,7678,2,1,3,187,102,289,7,0.23167,0.237797,0,0.000011,0.000006,50,0.000119,0,28,1,0.000292
31101,Keith County,,NE,896,9754,10650,1,3,4,77,216,293,7,0.275885,0.287075,0,0.000005,0.000137,50,0.000079,0,28,1,0.000139
31103,Keya Paha County,,NE,125,1176,1301,0,0,0,0,0,0,0,0,0,0,0,0,82,0.00005,76,137,0,0
31105,Kimball County,,NE,354,4451,4805,0,0,0,0,0,0,0,0,0,0,0,0,83,0.00005,77,138,0,0
31107,Knox County,,NE,574,9567,10141,1,4,5,47,257,304,6,0.297239,0.309632,0,0.000006,0.000458,50,0.00008,0,28,0.583333,0.000237
31109,Lancaster County,,NE,16849,284304,301153,71,68,139,10064,9950,20014,6,0.380647,0.411467,134534.290557,0.015505,0.026816,50,0.001724,0,28,0.228323,0.119974
31111,Lincoln County,,NE,2577,40615,43192,10,9,19,751,824,1575,6,0.298337,0.31169,7507.271676,0.000723,0.000566,50,0.000308,0,28,0.340909,0.004558
31113,Logan County,,NE,99,915,1014,0,0,0,0,0,0,0,0,0,0,0,0,84,0.00005,78,139,0,0
31115,Loup County,,NE,38,814,852,0,0,0,0,0,0,0,0,0,0,0,0,85,0.00005,79,140,0,0
31117,McPherson County,,NE,0,0,0,0,0,0,0,0,0,0,0,0,0,0,0,86,0.00005,80,141,0,0
31119,Madison County,,NE,3189,44368,47557,18,16,34,1631,1655,3286,6,0.304048,0.320175,29952.205941,0.002288,0.000795,50,0.00055,0,28,0.171937,0.015729
31121,Merrick County,,NE,781,8517,9298,2,2,4,213,270,483,7,0.252761,0.260906,0,0.000026,0.000014,50,0.000086,0,28,1,0.000293
31123,Morrill County,,NE,491,5695,6186,1,1,2,116,123,239,7,0.248674,0.25652,0,0.000029,0.000012,50,0.000069,0,28,0,0.000184
31125,Nance County,,NE,353,4715,5068,1,1,2,85,95,180,7,0.229367,0.235188,0,0.000004,0.000006,50,0.000088,0,28,0,0.000143
31127,Nemaha County,,NE,712,9168,9880,2,2,4,127,203,330,7,0.275806,0.286788,0.75,0.000005,0.000131,50,0.000106,0,28,0.5,0.000218
31129,Nuckolls County,,NE,348,6003,6351,0,2,2,0,92,92,7,0.275875,0.286919,0,0,0.00013,50,0.00005,0,142,1,0
31131,Otoe County,,NE,1153,17624,18777,6,5,11,694,596,1290,6,0.296814,0.309059,3005.845669,0.000832,0.000449,50,0.000199,0,28,0.5,0.004771
31133,Pawnee County,,NE,236,3233,3469,0,2,2,0,99,99,7,0.275797,0.286747,0,0,0.000126,50,0.00005,0,143,1,0
31135,Perkins County,,NE,306,3461,3767,0,0,0,0,0,0,0,0,0,0,0,0,87,0.00005,81,144,0,0
31137,Phelps County,,NE,789,11550,12339,3,3,6,165,180,345,7,0.275885,0.287075,2967,0.000236,0.000131,50,0.000134,0,28,0.5,0.00146
31139,Pierce County,,NE,532,8439,8971,1,1,2,165,173,338,7,0.233176,0.239972,0,0.000006,0.000018,50,0.00008,0,28,0,0.000237
31141,Platte County,,NE,2455,37592,40047,11,10,21,1040,1232,2272,6,0.297604,0.31091,9962.626036,0.000726,0.000489,50,0.000439,0,28,0.327273,0.004808
31143,Polk County,,NE,459,6301,6760,2,2,4,93,142,235,7,0.275859,0.286903,0.966667,0.000007,0.00013,50,0.000112,0,28,0.666667,0.000245
31145,Red Willow County,,NE,954,12841,13795,2,5,7,136,304,440,7,0.27599,0.287533,8837,0.000216,0.000137,50,0.000134,0,28,0.4,0.001202
31147,Richardson County,,NE,623,10397,11020,0,2,2,0,162,162,7,0.275823,0.286804,0,0,0.000125,50,0.00005,0,145,0.5,0
31149,Rock County,,NE,119,1777,1896,0,0,0,0,0,0,0,0,0,0,0,0,88,0.00005,82,146,0,0
31151,Saline County,,NE,1239,14328,15567,5,3,8,578,564,1142,7,0.27578,0.286845,4.8,0.000255,0.000128,50,0.000198,0,28,0.5,0.00171
31153,Sarpy County,,NE,15775,121641,137416,39,42,81,11272,9715,20987,6,0.373027,0.400143,12349.555068,0.013939,0.019554,50,0.000685,0,28,0.405324,0.09901
31155,Saunders County,,NE,1335,20093,21428,4,5,9,783,818,1601,6,0.299136,0.311472,0.25,0.000838,0.000564,50,0.000122,0,28,0.9,0.004574
31157,Scotts Bluff County,,NE,2934,40411,43345,10,16,26,741,1214,1955,6,0.330943,0.350579,18899.356757,0.001463,0.003589,50,0.00035,0,28,0.35,0.010836
31159,Seward County,,NE,1438,18382,19820,3,4,7,552,627,1179,7,0.275859,0.287132,2.833333,0.00022,0.00013,50,0.000152,0,28,0.5,0.001323
31161,Sheridan County,,NE,644,6775,7419,1,3,4,53,191,244,8,0.218047,0.223961,13.276033,0,0.000001,50,0.000096,0,28,0.333333,0.000094
31163,Sherman County,,NE,261,4148,4409,1,1,2,41,54,95,7,0.23167,0.237797,0,0.000007,0.000006,50,0.00009,0,28,0,0.000159
31165,Sioux County,,NE,70,987,1057,0,0,0,0,0,0,0,0,0,0,0,0,89,0.00005,83,147,0,0
31167,Stanton County,,NE,331,3658,3989,1,1,2,116,129,245,7,0.233176,0.239972,0,0.000006,0.000018,50,0.00008,0,28,0,0.000237
31169,Thayer County,,NE,510,7018,7528,0,3,3,0,163,163,7,0.275849,0.286976,0,0,0.000126,50,0.00005,0,148,0.5,0
31171,Thomas County,,NE,110,982,1092,0,0,0,0,0,0,0,0,0,0,0,0,90,0.00005,84,149,0,0
31173,Thurston County,,NE,526,7307,7833,0,3,3,0,176,176,7,0.29601,0.307998,0,0,0.00035,127,0.00005,0,150,0.833333,0
31175,Valley County,,NE,267,4735,5002,0,0,0,0,0,0,0,0,0,0,0,0,91,0.00005,85,151,0,0
31177,Washington County,,NE,1525,20892,22417,5,4,9,1004,815,1819,7,0.29797,0.310014,5.448166,0.000642,0.000437,50,0.000139,0,28,0.7,0.0038
31179,Wayne County,,NE,794,8189,8983,2,3,5,146,230,376,6,0.297027,0.309202,262.890097,0.000007,0.000457,50,0.000103,0,28,0.583333,0.00033
31181,Webster County,,NE,352,4541,4893,1,1,2,61,62,123,7,0.229223,0.234913,0,0.000004,0.000006,50,0.000079,0,28,0,0.000133
31183,Wheeler County,,NE,71,852,923,0,0,0,0,0,0,0,0,0,0,0,0,92,0.00005,86,152,0,0
31185,York County,,NE,1222,16293,17515,3,5,8,267,453,720,6,0.296845,0.309116,3533.067455,0.000218,0.00044,50,0.000142,0,28,0.3,0.001306
32001,Churchill County,,NV,3130,24723,27853,13,11,24,1321,1200,2521,6,0.334522,0.353383,719.189518,0.004247,0.005002,5,0.000238,0,28,0.5125,0.033317
32003,Clark County,,NV,78702,1469592,1548294,401,303,704,109763,61949,171712,5,0.449722,0.500579,198291.513229,0.12206,0.103132,5,0.004974,0,28,0.155675,0.85341
32005,Douglas County,,NV,5139,46630,51769,21,12,33,4086,3191,7277,6,0.338535,0.35833,22.650813,0.010706,0.007767,5,0.000308,0,28,0.863636,0.082635
32007,Elko County,,NV,5229,49143,54372,22,18,40,2182,2316,4498,6,0.338063,0.358743,6858.272149,0.005357,0.006487,5,0.000424,0,28,0.378462,0.043684
32009,Esmeralda County,,NV,99,882,981,0,0,0,0,0,0,0,0,0,0,0,0,93,0.00005,87,153,0,0
32011,Eureka County,,NV,170,1685,1855,0,0,0,0,0,0,0,0,0,0,0,0,94,0.00005,88,154,0,0
32013,Humboldt County,,NV,2419,18700,21119,4,8,12,369,918,1287,6,0.329256,0.347649,390.753888,0.00034,0.0029,5,0.000122,0,28,0.569444,0.003171
32015,Lander County,,NV,855,6403,7258,2,3,5,108,202,310,7,0.270343,0.282554,0,0.000075,0.000365,5,0.000083,0,28,1,0.000567
32017,Lincoln County,,NV,362,3818,4180,1,1,2,151,132,283,6,0.310245,0.324808,0,0.000829,0.000981,5,0.000064,0,28,0,0.007028
32019,Lyon County,,NV,4163,37757,41920,22,10,32,3880,2560,6440,6,0.329517,0.347976,629.086631,0.008111,0.004083,5,0.000357,0,28,0.559783,0.063219
32021,Mineral County,,NV,573,5227,5800,1,3,4,58,245,303,7,0.270897,0.282944,0,0.000282,0.000419,5,0.000065,0,28,1,0.002521
32023,Nye County,,NV,3714,32213,35927,10,10,20,2703,1841,4544,6,0.337278,0.356381,15.281388,0.006691,0.005528,5,0.000168,0,28,0.769231,0.051698
32027,Pershing County,,NV,553,4555,5108,1,4,5,43,240,283,7,0.270948,0.283174,0,0.000282,0.000422,5,0.000065,0,28,0.75,0.002521
32029,Storey County,,NV,924,9282,10206,4,3,7,664,555,1219,7,0.270167,0.282182,0,0.001077,0.00047,5,0.000127,0,28,0.916667,0.009541
32031,Washoe County,,NV,23588,371347,394935,113,91,204,23141,16983,40124,6,0.370036,0.403904,25745.598527,0.03973,0.035077,5,0.001522,0,28,0.393347,0.304353
32033,White Pine County,,NV,1002,8921,9923,2,3,5,125,313,438,6,0.310809,0.325955,0,0.000881,0.001344,5,0.000084,0,28,1,0.007479
32510,Carson City,,NV,6046,54995,61041,23,15,38,4373,3902,8275,6,0.337591,0.357413,622.182111,0.010658,0.008347,5,0.000368,0,28,0.687747,0.08165
33001,Belknap County,,NH,4783,70347,75130,17,11,28,4639,3076,7715,6,0.295998,0.312447,6.23635,0.004721,0.00287,100,0.000242,0,28,0.845588,0.033786
33003,Carroll County,,NH,3609,49984,53593,15,12,27,2517,2117,4634,6,0.294469,0.311226,38.721874,0.004212,0.002559,100,0.000237,0,28,0.808333,0.030525
33005,Cheshire County,,NH,4957,83554,88511,15,16,31,2874,2615,5489,6,0.296542,0.313966,40.467078,0.004589,0.003571,100,0.000207,0,28,0.689474,0.031553
33007,Coos County,,NH,2244,39494,41738,9,9,18,935,1100,2035,6,0.294112,0.310194,3884.144449,0.001668,0.001738,100,0.000194,0,28,0.788889,0.012512
33009,Grafton County,,NH,7668,90302,97970,28,21,49,4617,4572,9189,6,0.327845,0.347787,1396.902351,0.009611,0.007055,100,0.000395,0,28,0.594253,0.067299
33011,Hillsborough County,,NH,28411,454029,482440,107,91,198,25445,21821,47266,6,0.375776,0.409781,12530.550335,0.053731,0.047534,100,0.001159,0,28,0.501967,0.374743
33013,Merrimack County,,NH,10469,151425,161894,27,20,47,9391,6907,16298,6,0.334253,0.355154,878.985424,0.00945,0.006628,100,0.000358,0,28,0.657407,0.068095
33015,Rockingham County,,NH,24186,338348,362534,56,58,114,22552,18985,41537,6,0.357038,0.385466,2975.475005,0.0281,0.03146,100,0.000647,0,28,0.598983,0.199949
33017,Strafford County,,NH,9111,124865,133976,20,20,40,7379,6046,13425,6,0.336809,0.357642,397.467295,0.005299,0.006718,100,0.000287,0,28,0.63587,0.038611
33019,Sullivan County,,NH,2838,46664,49502,6,9,15,1684,1500,3184,6,0.294141,0.310251,1.730636,0.00056,0.001725,100,0.000132,0,28,0.708333,0.005172
34001,Atlantic County,,NJ,13122,309070,322192,35,50,85,9856,9239,19095,6,0.354426,0.381539,413.590905,0.018718,0.027546,118,0.000316,0,28,0.784766,0.116892
34003,Bergen County,,NJ,57993,1026605,1084598,90,137,227,45394,51910,97304,6,0.391199,0.431332,3684.988403,0.051417,0.069305,99,0.000846,0,28,0.538095,0.342956
34005,Burlington County,,NJ,30327,507522,537849,93,103,196,27817,22431,50248,6,0.385237,0.420909,4033.107541,0.049779,0.054492,118,0.000888,0,28,0.548554,0.33434
34007,Camden County,,NJ,32017,576843,608860,59,82,141,23694,26810,50504,6,0.371834,0.404581,1228.232582,0.033392,0.046,118,0.000539,0,28,0.70978,0.217555
34009,Cape May County,,NJ,6792,114560,121352,22,18,40,4744,4096,8840,6,0.312984,0.331315,31.615252,0.009947,0.007827,118,0.000215,0,28,0.828063,0.062025
34011,Cumberland County,,NJ,6333,157604,163937,9,13,22,3081,3768,6849,6,0.307554,0.325106,6.821696,0.002915,0.005156,118,0.000114,0,28,0.884615,0.016498
34013,Essex County,,NJ,51697,813859,865556,85,119,204,36732,46074,82806,6,0.388844,0.426929,1884.839584,0.04933,0.061985,99,0.0008,0,28,0.602755,0.329353
34015,Gloucester County,,NJ,15033,294111,309144,25,33,58,13899,11359,25258,6,0.344799,0.368025,194.540078,0.011783,0.017641,118,0.000232,0,28,0.794294,0.070656
34017,Hudson County,,NJ,54237,627026,681263,103,117,220,39738,49036,88774,6,0.390097,0.427623,2247.5642,0.056766,0.063353,99,0.000982,0,28,0.598837,0.380709
34019,Hunterdon County,,NJ,10059,146930,156989,28,33,61,7994,6472,14466,6,0.350452,0.375897,86.780184,0.013646,0.017694,99,0.000246,0,28,0.845479,0.079568
34021,Mercer County,,NJ,24095,394814,418909,71,82,153,17906,19054,36960,6,0.371122,0.403658,674.707683,0.041511,0.047841,99,0.000655,0,28,0.713651,0.27477
34023,Middlesex County,,NJ,61620,869513,931133,110,133,243,49626,54978,104604,6,0.39141,0.430736,2947.899776,0.060396,0.070126,99,0.001047,0,28,0.553904,0.405313
34025,Monmouth County,,NJ,36901,701377,738278,75,121,196,31133,30541,61674,5,0.386569,0.423971,1039.476569,0.04277,0.064289,99,0.000684,0,28,0.576308,0.281211
34027,Morris County,,NJ,38664,563586,602250,90,128,218,28837,33000,61837,6,0.386518,0.425697,2513.889646,0.051855,0.067549,99,0.000861,0,28,0.587757,0.348877
34029,Ocean County,,NJ,23717,587602,611319,63,87,150,31787,18496,50283,6,0.355988,0.387708,629.463627,0.032625,0.042388,99,0.000622,0,28,0.608425,0.220046
34031,Passaic County,,NJ,32002,550275,582277,48,87,135,21546,27285,48831,6,0.372884,0.406771,358.197959,0.02733,0.048129,99,0.000412,0,28,0.714211,0.171199
34033,Salem County,,NJ,3771,75726,79497,8,11,19,2413,2332,4745,6,0.289859,0.305515,1.118106,0.002771,0.002885,118,0.000104,0,28,0.854545,0.015653
34035,Somerset County,,NJ,27444,331124,358568,72,79,151,24563,22770,47333,6,0.373314,0.405934,597.44193,0.042427,0.045797,99,0.000664,0,28,0.734923,0.27897
34037,Sussex County,,NJ,9889,171878,181767,24,31,55,8715,6509,15224,6,0.341558,0.364706,89.75966,0.010879,0.015209,99,0.000218,0,28,0.810924,0.062332
34039,Union County,,NJ,39709,588778,628487,64,100,164,30264,34915,65179,6,0.377631,0.413313,649.850264,0.037549,0.055221,99,0.000587,0,28,0.671902,0.24753
34041,Warren County,,NJ,7246,114312,121558,22,18,40,7600,4687,12287,6,0.299413,0.316649,0.825407,0.009529,0.005758,99,0.000186,0,28,0.913333,0.051521
35001,Bernalillo County,,NM,41589,535247,576836,147,160,307,30213,32161,62374,5,0.416237,0.455957,77330.348409,0.058047,0.066759,98,0.002001,0,28,0.339056,0.425962
35003,Catron County,,NM,374,2830,3204,0,0,0,0,0,0,0,0,0,0,0,0,95,0.00005,89,155,0,0
35005,Chaves County,,NM,4644,57033,61677,14,21,35,1344,2379,3723,6,0.341558,0.363834,444.576095,0.005612,0.007204,98,0.000221,0,28,0.62253,0.041245
35006,Cibola County,,NM,2040,21868,23908,6,6,12,996,1153,2149,6,0.327845,0.345316,0.299423,0.001825,0.001849,98,0.000128,0,28,0.933333,0.014215
35007,Colfax County,,NM,1193,14869,16062,1,5,6,83,342,425,6,0.310146,0.324166,1309.068622,0.000537,0.001354,98,0.000061,0,28,0.55,0.00347
35009,Curry County,,NM,5998,44119,50117,18,22,40,1657,2024,3681,6,0.342645,0.365273,6692.983272,0.005918,0.008299,98,0.000298,0,28,0.522792,0.042509
35011,De Baca County,,NM,226,2211,2437,0,0,0,0,0,0,0,0,0,0,0,0,96,0.00005,90,156,0,0
35013,Dona Ana County,,NM,13802,166867,180669,36,47,83,7854,9258,17112,6,0.35421,0.381378,2388.47161,0.01487,0.022227,153,0.000543,0,28,0.526361,0.115766
35015,Eddy County,,NM,3692,49209,52901,9,16,25,1023,1714,2737,6,0.342807,0.364477,47.790436,0.002732,0.00622,98,0.000156,0,28,0.75,0.019082
35017,Grant County,,NM,2498,31231,33729,8,8,16,698,1039,1737,6,0.329779,0.347644,580.629784,0.00378,0.002971,5,0.00015,0,28,0.611111,0.028922
35019,Guadalupe County,,NM,401,4243,4644,1,2,3,48,95,143,6,0.293993,0.306668,0,0.000537,0.000472,98,0.000061,0,28,1,0.00347
35021,Harding County,,NM,37,711,748,0,0,0,0,0,0,0,0,0,0,0,0,97,0.00005,91,157,0,0
35023,Hidalgo County,,NM,676,5239,5915,0,5,5,0,324,324,6,0.326778,0.344097,0,0,0.002163,5,0.00005,0,158,0.85,0
35025,Lea County,,NM,4108,56372,60480,17,16,33,1389,1820,3209,6,0.341598,0.363255,3124.17448,0.004597,0.006097,153,0.000281,0,28,0.532164,0.034002
35027,Lincoln County,,NM,1905,16328,18233,7,6,13,656,575,1231,6,0.329144,0.346789,2.088462,0.001597,0.00281,153,0.000122,0,28,0.930556,0.009665
35028,Los Alamos County,,NM,2027,17828,19855,3,4,7,347,561,908,6,0.294022,0.306954,0,0.000694,0.000731,98,0.000094,0,28,1,0.004794
35029,Luna County,,NM,2253,24567,26820,8,6,14,695,905,1600,6,0.329704,0.3473,7.758085,0.003121,0.00294,5,0.000143,0,28,0.75,0.023295
35031,McKinley County,,NM,9640,85092,94732,11,15,26,7169,7947,15116,6,0.330303,0.349599,115.983864,0.003464,0.004638,5,0.000198,0,28,0.652381,0.027097
35033,Mora County,,NM,319,4518,4837,2,2,4,124,153,277,6,0.293993,0.306668,0.5,0.000025,0.000472,98,0.000084,0,28,0.666667,0.00024
35035,Otero County,,NM,7261,52375,59636,17,25,42,1746,2631,4377,6,0.352577,0.376591,238.403184,0.006918,0.013997,153,0.000246,0,28,0.707672,0.050983
35037,Quay County,,NM,933,9418,10351,1,2,3,65,189,254,6,0.29432,0.307069,0,0.000067,0.000514,98,0.000062,0,28,1,0.000437
35039,Rio Arriba County,,NM,2748,39894,42642,6,6,12,1197,1712,2909,6,0.29429,0.307585,4.616923,0.000891,0.000799,98,0.000141,0,28,0.7,0.006433
35041,Roosevelt County,,NM,1773,16330,18103,4,5,9,431,576,1007,6,0.295818,0.309729,1.732837,0.00074,0.000715,98,0.000092,0,28,0.766667,0.004915
35043,Sandoval County,,NM,9558,85900,95458,32,26,58,7682,6662,14344,6,0.349904,0.374028,2237.201313,0.013996,0.014115,98,0.000488,0,28,0.492176,0.107355
35045,San Juan County,,NM,11953,123041,134994,24,28,52,9159,8466,17625,6,0.346154,0.369774,1364.365215,0.007967,0.00974,5,0.000362,0,28,0.444086,0.060797
35047,San Miguel County,,NM,1864,24728,26592,4,5,9,512,905,1417,6,0.312178,0.327692,1710.481467,0.000695,0.001705,98,0.000136,0,28,0.5,0.004854
35049,Santa Fe County,,NM,9667,110869,120536,35,33,68,5263,5778,11041,6,0.355901,0.381086,4851.926752,0.01796,0.018774,98,0.000516,0,28,0.611585,0.139628
35051,Sierra County,,NM,1050,10328,11378,3,2,5,323,261,584,6,0.293993,0.306668,0,0.001223,0.000586,153,0.00008,0,28,1,0.007433
35053,Socorro County,,NM,1465,14681,16146,4,4,8,432,567,999,6,0.294052,0.307012,0,0.000786,0.000735,98,0.000097,0,28,0.95,0.005151
35055,Taos County,,NM,1993,28033,30026,3,4,7,433,615,1048,6,0.294022,0.306954,0,0.000694,0.000731,98,0.000094,0,28,1,0.004794
35057,Torrance County,,NM,1476,12008,13484,3,3,6,721,674,1395,6,0.293993,0.306782,0,0.000721,0.000724,98,0.000089,0,28,1,0.005012
35059,Union County,,NM,460,4341,4801,0,1,1,0,41,41,8,0.207982,0.21309,0,0,0.000001,153,0.00005,0,159,0,0
35061,Valencia County,,NM,5298,61678,66976,12,12,24,3231,3398,6629,6,0.332647,0.351456,359.051702,0.004474,0.004186,98,0.000212,0,28,0.598901,0.033724
36001,Albany County,,NY,22413,332910,355323,62,84,146,16102,17747,33849,6,0.374083,0.407539,23726.024473,0.024174,0.041104,100,0.000668,0,28,0.523077,0.155146
36003,Allegany County,,NY,3186,54802,57988,8,9,17,1571,1667,3238,6,0.291662,0.307132,2304.317822,0.001309,0.000976,100,0.000181,0,28,0.472222,0.007087
36005,Bronx County,,NY,77009,1177089,1254098,88,147,235,55184,70626,125810,5,0.396589,0.437754,3249.043753,0.049151,0.069275,99,0.000831,0,28,0.487911,0.325655
36007,Broome County,,NY,10276,230761,241037,34,47,81,4602,5397,9999,6,0.350114,0.376557,6467.370247,0.011663,0.021292,100,0.000386,0,28,0.491704,0.07249
36009,Cattaraugus County,,NY,5129,90446,95575,7,8,15,2681,2862,5543,6,0.329181,0.347483,223.691408,0.001429,0.00236,100,0.000137,0,28,0.555556,0.007294
36011,Cayuga County,,NY,4599,91417,96016,12,11,23,2403,2596,4999,6,0.292278,0.308394,36.66846,0.002372,0.00163,100,0.000168,0,28,0.620879,0.011906
36013,Chautauqua County,,NY,5920,149659,155579,9,11,20,2113,2368,4481,6,0.337083,0.35645,242.097298,0.003068,0.005775,100,0.000143,0,28,0.598901,0.017008
36015,Chemung County,,NY,5208,103595,108803,10,14,24,2189,2406,4595,6,0.312513,0.330581,1246.049921,0.002084,0.003198,100,0.000179,0,28,0.461538,0.010449
36017,Chenango County,,NY,2926,54505,57431,7,7,14,1314,1444,2758,7,0.279385,0.293227,8.808728,0.001046,0.000523,100,0.000113,0,28,0.660714,0.005119
36019,Clinton County,,NY,3208,89160,92368,9,10,19,1100,1085,2185,7,0.287338,0.303053,91.131803,0.001312,0.00114,100,0.000167,0,28,0.484848,0.006929
36021,Columbia County,,NY,3689,71626,75315,14,10,24,2362,2036,4398,6,0.296572,0.312573,2.954903,0.005305,0.002155,99,0.00016,0,28,0.824176,0.030017
36023,Cortland County,,NY,3159,51504,54663,6,8,14,1433,1645,3078,6,0.2907,0.305739,8.470984,0.000827,0.001021,100,0.000108,0,28,0.732143,0.003952
36025,Delaware County,,NY,3242,49956,53198,14,10,24,1753,1638,3391,7,0.277863,0.292481,98.175372,0.005369,0.000828,100,0.000163,0,28,0.584559,0.030182
36027,Dutchess County,,NY,15407,308638,324045,48,67,115,12964,10631,23595,6,0.364194,0.394462,1474.809082,0.025142,0.035527,99,0.000463,0,28,0.64004,0.16345
36029,Erie County,,NY,33383,1067893,1101276,100,157,257,16973,25418,42391,5,0.403246,0.444714,26974.973449,0.051655,0.074577,100,0.001108,0,28,0.445135,0.361389
36031,Essex County,,NY,2383,38625,41008,8,8,16,867,1150,2017,7,0.277359,0.291122,42.287092,0.000782,0.000625,100,0.000171,0,28,0.5,0.004734
36033,Franklin County,,NY,2205,50038,52243,5,5,10,831,916,1747,7,0.279385,0.293055,15.264037,0.001014,0.000509,100,0.000106,0,28,0.733333,0.005038
36035,Fulton County,,NY,2680,59461,62141,7,6,13,1496,1498,2994,7,0.273729,0.286427,1455.060408,0.000745,0.000508,100,0.000131,0,28,0.595238,0.003772
36037,Genesee County,,NY,3813,76386,80199,6,6,12,1939,2187,4126,6,0.291224,0.306054,2.083333,0.001384,0.000976,100,0.000124,0,28,0.766667,0.007084
36039,Greene County,,NY,2740,49196,51936,15,9,24,1964,1431,3395,6,0.294589,0.310744,29.886234,0.00549,0.001433,99,0.000167,0,28,0.716667,0.030734
36041,Hamilton County,,NY,422,5665,6087,0,2,2,0,113,113,8,0.215057,0.221316,0,0,0.000031,100,0.00005,0,160,0,0
36043,Herkimer County,,NY,3456,71433,74889,7,9,16,1719,1948,3667,6,0.291137,0.306628,37.780051,0.000965,0.001236,100,0.000122,0,28,0.652778,0.004392
36045,Jefferson County,,NY,15717,118634,134351,53,66,119,5776,7512,13288,6,0.374372,0.405189,7220.773824,0.021498,0.028976,100,0.000587,0,28,0.485376,0.145051
36047,Kings County,,NY,138895,2252292,2391187,175,206,381,85729,129918,215647,5,0.418755,0.464568,21986.623264,0.085353,0.090031,99,0.001776,0,28,0.372807,0.582887
36049,Lewis County,,NY,1470,28533,30003,3,4,7,510,653,1163,7,0.284888,0.298673,0,0.000398,0.000545,100,0.000074,0,28,1,0.001956
36051,Livingston County,,NY,4249,72930,77179,9,8,17,2850,2830,5680,6,0.291545,0.306817,12.299021,0.001784,0.000969,100,0.000164,0,28,0.638889,0.009131
36053,Madison County,,NY,4803,78375,83178,8,11,19,2971,2914,5885,6,0.290904,0.306484,14.753954,0.000834,0.001121,100,0.000127,0,28,0.618182,0.004002
36055,Monroe County,,NY,34482,861591,896073,121,172,293,19756,27149,46905,5,0.407771,0.450734,52218.122616,0.058088,0.080938,100,0.001347,0,28,0.416912,0.404663
36057,Montgomery County,,NY,3408,62797,66205,8,8,16,1992,2031,4023,7,0.273909,0.287058,5.601825,0.000764,0.000591,100,0.000141,0,28,0.694444,0.004016
36059,Nassau County,,NY,76536,1595419,1671955,92,163,255,56003,69643,125646,6,0.396373,0.439714,4477.718785,0.052797,0.07857,99,0.0009,0,28,0.474637,0.36014
36061,New York County,,NY,147364,1470774,1618138,220,192,412,123891,134164,258055,5,0.417792,0.462218,29253.354125,0.095866,0.087056,99,0.002283,0,28,0.344569,0.650745
36063,Niagara County,,NY,10350,255860,266210,11,25,36,5490,6237,11727,6,0.347977,0.370915,1294.255674,0.007042,0.013742,100,0.000178,0,28,0.596923,0.050324
36065,Oneida County,,NY,10270,256167,266437,26,38,64,4482,5855,10337,6,0.342847,0.367831,2704.899137,0.009224,0.01827,100,0.000286,0,28,0.546512,0.055372
36067,Onondaga County,,NY,23585,516613,540198,77,115,192,13252,16697,29949,6,0.386672,0.424321,29098.286611,0.034985,0.056394,100,0.000828,0,28,0.481127,0.238342
36069,Ontario County,,NY,6929,119807,126736,10,13,23,4680,4212,8892,6,0.332419,0.351668,355.721443,0.00194,0.003642,100,0.000177,0,28,0.557692,0.010025
36071,Orange County,,NY,21163,387608,408771,60,95,155,18189,14339,32528,6,0.376994,0.411501,4192.440786,0.032059,0.047429,99,0.000566,0,28,0.554653,0.20845
36073,Orleans County,,NY,2555,46912,49467,4,4,8,1510,1469,2979,6,0.291166,0.30571,0,0.001369,0.00095,100,0.000087,0,28,1,0.006771
36075,Oswego County,,NY,6839,134877,141716,11,12,23,3670,4015,7685,6,0.305775,0.323185,406.443947,0.003168,0.00295,100,0.000156,0,28,0.571429,0.019222
36077,Otsego County,,NY,3741,63234,66975,11,14,25,1736,1674,3410,6,0.293814,0.311432,99.332414,0.002201,0.001988,100,0.000157,0,28,0.547619,0.011344
36079,Putnam County,,NY,7825,109688,117513,17,18,35,6759,5520,12279,6,0.315738,0.334606,1.809395,0.008961,0.009334,99,0.000154,0,28,0.921429,0.050357
36081,Queens County,,NY,145355,2207110,2352465,141,210,351,87008,136735,223743,5,0.415939,0.462917,13107.506001,0.073796,0.092453,99,0.001417,0,28,0.386055,0.506172
36083,Rensselaer County,,NY,10853,172884,183737,24,27,51,7420,7676,15096,6,0.33299,0.355378,1841.908036,0.007577,0.009703,100,0.000296,0,28,0.531183,0.043228
36085,Richmond County,,NY,21869,476684,498553,32,65,97,19939,18051,37990,6,0.369471,0.399667,282.826121,0.019955,0.033856,99,0.000293,0,28,0.693939,0.125037
36087,Rockland County,,NY,16947,329743,346690,32,64,96,10434,13308,23742,6,0.364789,0.394743,150.607082,0.017504,0.036689,99,0.000268,0,28,0.771154,0.102802
36089,St. Lawrence County,,NY,5283,113111,118394,10,13,23,1433,1787,3220,6,0.298583,0.316225,102.039343,0.002065,0.002296,100,0.000152,0,28,0.49359,0.010196
36091,Saratoga County,,NY,16303,237001,253304,58,59,117,13802,11175,24977,6,0.355814,0.384669,14389.95534,0.022699,0.026042,100,0.000636,0,28,0.465563,0.145393
36093,Schenectady County,,NY,9982,158472,168454,22,31,53,6274,6665,12939,6,0.338614,0.362097,2505.576309,0.006976,0.013943,100,0.000283,0,28,0.552381,0.040482
36095,Schoharie County,,NY,1699,29778,31477,7,6,13,890,876,1766,7,0.273806,0.286599,13.10103,0.001159,0.0005,100,0.000125,0,28,0.678571,0.006555
36097,Schuyler County,,NY,1394,21478,22872,5,5,10,753,810,1563,7,0.266844,0.277512,2.207849,0.000231,0.000182,100,0.000124,0,28,0.6,0.001571
36099,Seneca County,,NY,2461,36527,38988,10,8,18,1374,1204,2578,6,0.290497,0.305395,115.653313,0.001964,0.000925,100,0.000171,0,28,0.655556,0.00991
36101,Steuben County,,NY,5662,109757,115419,14,14,28,2800,2771,5571,6,0.299475,0.317773,977.999147,0.002955,0.002236,100,0.000233,0,28,0.334559,0.016904
36103,Suffolk County,,NY,59919,1695927,1755846,135,196,331,55747,51532,107279,6,0.402297,0.448727,13706.856782,0.069262,0.084242,99,0.001443,0,28,0.380696,0.485515
36105,Sullivan County,,NY,4551,74590,79141,17,18,35,3016,2535,5551,6,0.312077,0.330765,66.434557,0.008863,0.007094,99,0.000166,0,28,0.794737,0.050804
36107,Tioga County,,NY,3929,59005,62934,7,7,14,2120,2299,4419,6,0.291049,0.30614,55.290824,0.000852,0.000999,100,0.000134,0,28,0.642857,0.004231
36109,Tompkins County,,NY,8373,84456,92829,31,39,70,3780,4333,8113,6,0.361567,0.388275,8709.711574,0.01489,0.021896,100,0.000357,0,28,0.625436,0.098416
36111,Ulster County,,NY,8904,179280,188184,26,29,55,6046,5394,11440,6,0.339484,0.362447,475.326659,0.011414,0.013334,99,0.000252,0,28,0.709447,0.065002
36113,Warren County,,NY,4806,72956,77762,13,6,19,3165,2497,5662,7,0.273755,0.286484,1493.160755,0.003121,0.000506,100,0.000192,0,28,0.480769,0.015901
36115,Washington County,,NY,3560,61390,64950,8,7,15,2537,2427,4964,7,0.27378,0.286754,14.476806,0.000759,0.000497,100,0.000159,0,28,0.589286,0.004145
36117,Wayne County,,NY,5701,109480,115181,8,8,16,3670,3564,7234,6,0.291867,0.307247,4.162945,0.001785,0.001254,100,0.00014,0,28,0.785714,0.00907
36119,Westchester County,,NY,54895,1016842,1071737,101,152,253,41508,48037,89545,6,0.394973,0.43698,5075.397392,0.057554,0.07399,99,0.000989,0,28,0.483912,0.392726
36121,Wyoming County,,NY,2577,42598,45175,7,6,13,1442,1769,3211,6,0.291341,0.306215,3.071191,0.001403,0.00093,100,0.000136,0,28,0.738095,0.007242
36123,Yates County,,NY,1399,23488,24887,6,5,11,760,816,1576,6,0.289946,0.30426,58.716055,0.000733,0.000524,100,0.000133,0,28,0.7,0.004121
37001,Alamance County,,NC,7861,162500,170361,20,17,37,5042,4573,9615,6,0.310378,0.328477,313.886051,0.00543,0.004155,101,0.000334,0,28,0.583333,0.041622
37003,Alexander County,,NC,2476,39258,41734,6,5,11,1789,1562,3351,7,0.241485,0.250991,0.540278,0.000875,0.000194,101,0.000164,0,28,0.933333,0.007846
37005,Alleghany County,,NC,620,11750,12370,3,4,7,169,259,428,7,0.232672,0.240778,193.06785,0.000022,0.000016,101,0.000138,0,28,0.416667,0.000386
37007,Anson County,,NC,1338,27762,29100,5,5,10,769,716,1485,6,0.29794,0.312911,1.186294,0.00082,0.000919,101,0.000123,0,28,0.8,0.006967
37009,Ashe County,,NC,989,26200,27189,4,3,7,435,285,720,7,0.232616,0.240606,201.060914,0.000045,0.000038,101,0.000149,0,28,0.5,0.000709
37011,Avery County,,NC,1318,18143,19461,5,4,9,498,477,975,7,0.23865,0.247331,76.503236,0.000243,0.000046,101,0.000193,0,28,0.35,0.002616
37013,Beaufort County,,NC,2922,54570,57492,9,9,18,1391,1444,2835,6,0.298307,0.314207,5451.111482,0.001294,0.001888,101,0.000241,0,28,0.433333,0.010946
37015,Bertie County,,NC,1202,23072,24274,6,4,10,665,504,1169,6,0.296029,0.310458,1918.012987,0.000761,0.000885,101,0.00017,0,28,0.4,0.006744
37017,Bladen County,,NC,2873,44562,47435,10,12,22,2010,1817,3827,6,0.309387,0.32658,47.037047,0.002373,0.003039,101,0.000192,0,28,0.608974,0.018679
37019,Brunswick County,,NC,4936,74882,79818,27,12,39,3895,2348,6243,6,0.31248,0.329842,113.102305,0.007813,0.004268,101,0.000387,0,28,0.462963,0.055184
37021,Buncombe County,,NC,14723,235468,250191,76,60,136,8877,8411,17288,6,0.363557,0.39273,40131.46081,0.028318,0.023289,101,0.001423,0,28,0.372969,0.220943
37023,Burke County,,NC,5805,104944,110749,13,16,29,3215,3599,6814,6,0.302623,0.320359,1535.003427,0.001561,0.002957,101,0.000339,0,28,0.547794,0.013868
37025,Cabarrus County,,NC,13315,180736,194051,37,25,62,11035,8559,19594,6,0.321535,0.343017,1444.039137,0.015727,0.00788,101,0.000552,0,28,0.519164,0.11805
37027,Caldwell County,,NC,4553,92288,96841,10,11,21,2683,2786,5469,6,0.302089,0.318897,336.737937,0.001557,0.002395,101,0.000245,0,28,0.712121,0.01378
37029,Camden County,,NC,799,9610,10409,4,2,6,538,263,801,7,0.232821,0.240176,683.487404,0.000991,0.000018,45,0.000108,0,28,0.7,0.006513
37031,Carteret County,,NC,4588,65322,69910,13,9,22,1983,1671,3654,6,0.32933,0.347598,24.169437,0.003587,0.004455,5,0.00021,0,28,0.795238,0.026116
37033,Caswell County,,NC,2111,30818,32929,7,7,14,1480,1591,3071,6,0.285168,0.298819,9.168144,0.00066,0.000669,101,0.000167,0,28,0.595238,0.005408
37035,Catawba County,,NC,11624,187051,198675,40,26,66,8569,7493,16062,6,0.317323,0.338499,2640.823636,0.011748,0.006653,101,0.000673,0,28,0.37763,0.088833
37037,Chatham County,,NC,6543,82201,88744,17,14,31,5081,3724,8805,6,0.313592,0.331986,54.280562,0.00533,0.004579,101,0.00029,0,28,0.70915,0.042641
37039,Cherokee County,,NC,1367,24369,25736,6,4,10,373,254,627,8,0.194722,0.199681,8177.075748,0.001938,0.000025,0,0.000305,0,28,0.190476,0.015612
37041,Chowan County,,NC,922,15627,16549,3,5,8,224,317,541,7,0.243101,0.253032,59.159303,0.000022,0.00007,45,0.000164,0,28,0.3,0.000407
37043,Clay County,,NC,570,8517,9087,2,3,5,174,227,401,8,0.188155,0.192306,7.475408,0,0.000044,0,0.00025,0,28,0.5,0.00034
37045,Cleveland County,,NC,6493,122532,129025,15,16,31,4421,4257,8678,6,0.303097,0.321093,80.885985,0.002122,0.003587,101,0.000316,0,28,0.643382,0.019316
37047,Columbus County,,NC,2399,53466,55865,6,8,14,999,1232,2231,6,0.30919,0.32557,1.463626,0.00114,0.002787,101,0.000139,0,28,0.928571,0.008417
37049,Craven County,,NC,12326,100866,113192,39,42,81,5271,5339,10610,6,0.361073,0.388258,8502.751205,0.017544,0.021063,5,0.000527,0,28,0.54638,0.125924
37051,Cumberland County,,NC,50387,313029,363416,178,196,374,27096,33338,60434,5,0.421732,0.46603,50690.280403,0.071249,0.077455,101,0.002077,0,28,0.294199,0.500023
37053,Currituck County,,NC,1508,18124,19632,5,6,11,1128,763,1891,6,0.296936,0.311581,1.704053,0.001414,0.001297,45,0.000123,0,28,0.733333,0.009188
37055,Dare County,,NC,2527,32729,35256,12,7,19,992,630,1622,6,0.302939,0.319304,106.138911,0.004092,0.00197,45,0.000205,0,28,0.628205,0.029656
37057,Davidson County,,NC,11597,203550,215147,21,24,45,8773,8214,16987,6,0.308894,0.328064,705.559322,0.004382,0.004454,101,0.000394,0,28,0.502849,0.036175
37059,Davie County,,NC,2284,38739,41023,9,8,17,1935,1366,3301,6,0.301901,0.31818,55.72545,0.00155,0.002548,101,0.000208,0,28,0.766667,0.013171
37061,Duplin County,,NC,3189,52171,55360,9,13,22,1709,2061,3770,6,0.309948,0.327038,16.272461,0.001625,0.003015,101,0.000168,0,28,0.711538,0.011618
37063,Durham County,,NC,22702,235407,258109,112,90,202,16309,16860,33169,5,0.391885,0.42576,23214.132937,0.050855,0.043803,101,0.001404,0,28,0.437678,0.359457
37065,Edgecombe County,,NC,5278,66492,71770,8,11,19,3330,4023,7353,6,0.30212,0.31904,67.474998,0.001895,0.002672,101,0.000179,0,28,0.690909,0.01591
37067,Forsyth County,,NC,21292,324453,345745,90,73,163,14725,14946,29671,5,0.382651,0.414528,30644.158368,0.038048,0.033157,101,0.001284,0,28,0.387012,0.279252
37069,Franklin County,,NC,4329,60273,64602,11,9,20,3750,2658,6408,6,0.296512,0.311633,35.422624,0.002224,0.001364,101,0.000227,0,28,0.621212,0.017809
37071,Gaston County,,NC,13363,222282,235645,30,31,61,8757,9371,18128,6,0.319943,0.341968,536.828118,0.008039,0.007816,101,0.000511,0,28,0.481231,0.063159
37073,Gates County,,NC,600,10367,10967,5,2,7,311,142,453,7,0.234663,0.242733,1205.551465,0.001095,0.000045,45,0.000119,0,28,0.6,0.007046
37075,Graham County,,NC,399,8235,8634,1,1,2,47,50,97,9,0.162994,0.165787,0,0,0.000016,0,0.000115,0,28,0,0.000209
37077,Granville County,,NC,3417,50404,53821,7,9,16,2595,2236,4831,6,0.297818,0.313376,36.307795,0.00122,0.001929,101,0.000176,0,28,0.533333,0.010671
37079,Greene County,,NC,1885,24257,26142,5,6,11,1442,1283,2725,6,0.296421,0.311117,0.672619,0.00024,0.000996,101,0.000113,0,28,0.9,0.001717
37081,Guilford County,,NC,32172,455145,487317,151,126,277,23479,24086,47565,5,0.397131,0.435254,74487.457964,0.056118,0.053058,101,0.002015,0,28,0.307849,0.391666
37083,Halifax County,,NC,3350,61195,64545,8,11,19,1235,1848,3083,6,0.298215,0.314264,6695.994838,0.001103,0.001816,101,0.0002,0,28,0.490909,0.009872
37085,Harnett County,,NC,9426,106911,116337,19,17,36,7154,5491,12645,6,0.309882,0.327812,109.462739,0.004844,0.003613,101,0.000296,0,28,0.511858,0.036232
37087,Haywood County,,NC,2814,59090,61904,12,6,18,1322,957,2279,6,0.298307,0.313617,3474.229763,0.005699,0.001106,101,0.000287,0,28,0.516484,0.047032
37089,Henderson County,,NC,5494,88851,94345,15,11,26,2804,2386,5190,6,0.302403,0.319453,763.15972,0.006673,0.002751,101,0.000297,0,28,0.551471,0.052384
37091,Hertford County,,NC,1915,22857,24772,3,7,10,469,797,1266,6,0.297726,0.313204,1079.957585,0.000014,0.00144,101,0.000153,0,28,0.380952,0.000386
37093,Hoke County,,NC,4846,36067,40913,9,10,19,3141,2666,5807,6,0.313795,0.331516,54.854972,0.002028,0.003509,101,0.000153,0,28,0.564103,0.013865
37095,Hyde County,,NC,361,5104,5465,1,2,3,49,91,140,7,0.242796,0.252052,0,0.000015,0.000057,101,0.000073,0,28,1,0.000183
37097,Iredell County,,NC,8417,141124,149541,29,22,51,6296,4914,11210,6,0.303603,0.322371,13745.542132,0.008048,0.003643,101,0.000515,0,28,0.417339,0.06148
37099,Jackson County,,NC,2409,28808,31217,6,4,10,847,727,1574,7,0.266771,0.277721,91.938865,0.000228,0.000323,101,0.00031,0,28,0.5,0.003466
37101,Johnston County,,NC,8832,135255,144087,23,21,44,8304,5518,13822,6,0.315088,0.334388,1155.866354,0.005167,0.005137,101,0.000367,0,28,0.490769,0.039428
37103,Jones County,,NC,852,12037,12889,3,3,6,474,438,912,6,0.291955,0.305223,0,0.000737,0.000534,5,0.000077,0,28,1,0.003968
37105,Lee County,,NC,3798,47862,51660,6,8,14,1609,2215,3824,6,0.30671,0.322761,0.104361,0.001741,0.002561,101,0.000136,0,28,0.982143,0.013975
37107,Lenoir County,,NC,3946,64142,68088,8,15,23,1835,2430,4265,6,0.312077,0.329916,280.727381,0.001549,0.00397,101,0.000157,0,28,0.704762,0.010933
37109,Lincoln County,,NC,2861,36386,39247,6,6,12,2161,2019,4180,6,0.298276,0.313341,0.385218,0.000965,0.001075,101,0.000156,0,28,0.928571,0.009116
37111,McDowell County,,NC,2085,40494,42579,7,6,13,1278,1069,2347,6,0.298276,0.313559,2616.596671,0.000971,0.001167,101,0.000245,0,28,0.553571,0.008491
37113,Macon County,,NC,1795,31568,33363,12,3,15,773,312,1085,7,0.266771,0.277607,709.061882,0.006153,0.000241,101,0.000383,0,28,0.575758,0.048375
37115,Madison County,,NC,1316,19695,21011,2,2,4,827,644,1471,7,0.266673,0.277263,0.5,0.000196,0.000229,101,0.000111,0,28,0.666667,0.002291
37117,Martin County,,NC,1559,26408,27967,6,6,12,593,850,1443,6,0.296149,0.310888,1210.71512,0.000786,0.000911,101,0.000184,0,28,0.633333,0.006957
37119,Mecklenburg County,,NC,60315,741449,801764,300,228,528,58790,50821,109611,5,0.423946,0.471242,189642.000699,0.102186,0.090496,101,0.003826,0,28,0.217836,0.715735
37121,Mitchell County,,NC,759,16688,17447,4,3,7,355,288,643,7,0.23013,0.237364,3.65,0.000199,0.000011,101,0.000195,0,28,0.5,0.002223
37123,Montgomery County,,NC,1774,30203,31977,6,7,13,822,1024,1846,6,0.301525,0.31775,2.886545,0.001259,0.002197,101,0.000135,0,28,0.785714,0.010152
37125,Moore County,,NC,4662,79253,83915,17,15,32,2442,2096,4538,6,0.310279,0.32795,79.425659,0.004183,0.00372,101,0.000272,0,28,0.565359,0.031851
37127,Nash County,,NC,8226,99599,107825,13,14,27,5407,5241,10648,6,0.309882,0.32744,70.872543,0.003247,0.003503,101,0.000234,0,28,0.725275,0.025386
37129,New Hanover County,,NC,14081,164083,178164,63,56,119,9052,8434,17486,6,0.362153,0.391211,5466.39313,0.022313,0.02397,101,0.000871,0,28,0.397838,0.158866
37131,Northampton County,,NC,1451,22423,23874,3,6,9,531,835,1366,6,0.29633,0.311203,68.305476,0.000029,0.000854,101,0.000113,0,28,0.366667,0.00037
37133,Onslow County,,NC,33380,145960,179340,105,154,259,12505,18410,30915,5,0.411815,0.452156,20675.673412,0.047282,0.066678,5,0.001211,0,28,0.366907,0.334574
37135,Orange County,,NC,11714,79946,91660,34,32,66,6382,7818,14200,6,0.357257,0.382915,2458.715331,0.018168,0.018657,101,0.000482,0,28,0.650641,0.136239
37137,Pamlico County,,NC,874,12999,13873,2,2,4,264,347,611,7,0.265431,0.275669,0,0.000185,0.000151,5,0.000084,0,28,1,0.001259
37139,Pasquotank County,,NC,2932,33309,36241,9,10,19,1086,1228,2314,6,0.303413,0.320221,11442.325005,0.002185,0.00184,45,0.000266,0,28,0.363636,0.015645
37141,Pender County,,NC,3028,37094,40122,7,6,13,2092,1752,3844,6,0.303097,0.318461,2.831796,0.002105,0.001877,101,0.000147,0,28,0.857143,0.014945
37143,Perquimans County,,NC,810,11706,12516,3,2,5,415,342,757,7,0.232877,0.240319,1.416667,0.000016,0.000018,45,0.000147,0,28,0.666667,0.000449
37145,Person County,,NC,2020,37165,39185,8,8,16,1460,1204,2664,6,0.297879,0.313347,807.750945,0.001653,0.001903,101,0.000186,0,28,0.607143,0.014009
37147,Pitt County,,NC,9827,124969,134796,32,32,64,5423,5639,11062,6,0.320437,0.343195,6543.217554,0.005738,0.008037,101,0.000589,0,28,0.304487,0.043336
37149,Polk County,,NC,1525,22964,24489,5,6,11,987,869,1856,6,0.28486,0.297804,1.669564,0.000648,0.000804,101,0.000141,0,28,0.866667,0.0062
37151,Randolph County,,NC,7796,127469,135265,15,17,32,4915,5148,10063,6,0.307684,0.32576,151.398848,0.004195,0.003685,101,0.000267,0,28,0.592857,0.033144
37153,Richmond County,,NC,2543,50215,52758,10,15,25,1010,1368,2378,6,0.309453,0.327067,180.295183,0.001959,0.002937,101,0.000195,0,28,0.466667,0.016367
37155,Robeson County,,NC,5168,116899,122067,12,18,30,2295,3353,5648,6,0.310511,0.328598,636.818548,0.00353,0.004176,101,0.000207,0,28,0.526316,0.027218
37157,Rockingham County,,NC,4469,91855,96324,9,14,23,2750,2869,5619,6,0.302812,0.320227,90.444677,0.000826,0.003229,101,0.000201,0,28,0.505495,0.007262
37159,Rowan County,,NC,7070,122136,129206,15,14,29,4666,4288,8954,6,0.302529,0.319774,123.48508,0.003741,0.003216,101,0.000292,0,28,0.633987,0.031936
37161,Rutherford County,,NC,2854,59924,62778,10,11,21,1544,1792,3336,6,0.298552,0.314649,39.333842,0.001163,0.001422,101,0.000246,0,28,0.609091,0.01061
37163,Sampson County,,NC,2676,50479,53155,7,9,16,1294,1551,2845,6,0.305807,0.321643,2.936679,0.001484,0.002151,101,0.000139,0,28,0.833333,0.011556
37165,Scotland County,,NC,2440,39190,41630,7,11,18,1088,1318,2406,6,0.309684,0.32678,74.804898,0.001471,0.003368,101,0.000137,0,28,0.7,0.011115
37167,Stanly County,,NC,3071,61191,64262,9,10,19,1901,1820,3721,6,0.301713,0.318301,18.219947,0.000997,0.002685,101,0.000195,0,28,0.674242,0.009312
37169,Stokes County,,NC,4352,59818,64170,8,10,18,3224,3312,6536,6,0.29794,0.313714,1990.122353,0.000773,0.00166,101,0.000218,0,28,0.533333,0.006585
37171,Surry County,,NC,4341,64668,69009,9,10,19,2875,2884,5759,6,0.299197,0.315428,3220.089314,0.000768,0.001734,101,0.000253,0,28,0.472727,0.006714
37173,Swain County,,NC,1039,17088,18127,2,3,5,258,417,675,7,0.266746,0.277549,0.47619,0.000011,0.000279,101,0.000157,0,28,0.833333,0.000571
37175,Transylvania County,,NC,1928,31848,33776,3,4,7,518,710,1228,6,0.284777,0.297403,8.866516,0.000553,0.000673,101,0.000106,0,28,0.75,0.005134
37177,Tyrrell County,,NC,306,4060,4366,0,1,1,0,53,53,7,0.228544,0.235084,0,0,0,101,0.00005,0,161,0,0
37179,Union County,,NC,7883,129474,137357,21,16,37,8027,4726,12753,6,0.305903,0.323982,530.402442,0.008098,0.004148,101,0.000333,0,28,0.55,0.060131
37181,Vance County,,NC,2446,45110,47556,6,6,12,1554,1299,2853,6,0.297696,0.312802,5.679636,0.001074,0.001729,101,0.00016,0,28,0.809524,0.00951
37183,Wake County,,NC,51070,651354,702424,303,203,506,54091,41449,95540,5,0.419844,0.46478,170603.297929,0.103586,0.083342,101,0.003815,0,28,0.217187,0.716908
37185,Warren County,,NC,991,14084,15075,6,5,11,559,551,1110,6,0.29636,0.310888,2.090909,0.001077,0.001277,101,0.000156,0,28,0.9,0.00951
37187,Washington County,,NC,809,14451,15260,4,5,9,237,370,607,6,0.296149,0.310773,3087.989757,0.000023,0.000896,101,0.00017,0,28,0.433333,0.000511
37189,Watauga County,,NC,3349,34534,37883,15,13,28,1384,1509,2893,6,0.302372,0.319763,7180.862031,0.003525,0.002951,101,0.000374,0,28,0.519048,0.029034
37191,Wayne County,,NC,9359,107368,116727,21,28,49,3350,4362,7712,6,0.343049,0.366185,1858.174117,0.005548,0.008999,101,0.000307,0,28,0.43871,0.039974
37193,Wilkes County,,NC,2973,73302,76275,13,14,27,1669,1700,3369,6,0.302309,0.319585,7378.04277,0.001199,0.002644,101,0.000342,0,28,0.5,0.01132
37195,Wilson County,,NC,4432,71461,75893,11,13,24,2225,2729,4954,6,0.309915,0.327273,317.348235,0.002318,0.003748,101,0.000207,0,28,0.736264,0.018182
37197,Yadkin County,,NC,2285,39055,41340,8,7,15,1596,1480,3076,6,0.277438,0.289714,8.555877,0.000827,0.00044,101,0.000196,0,28,0.785714,0.007186
37199,Yancey County,,NC,917,18799,19716,3,3,6,319,359,678,7,0.266697,0.277435,346.989227,0.000189,0.000237,101,0.000173,0,28,0.583333,0.002056
38001,Adams County,,ND,190,2862,3052,0,0,0,0,0,0,0,0,0,0,0,0,102,0.00005,92,162,0,0
38003,Barnes County,,ND,856,13406,14262,2,3,5,186,373,559,7,0.260998,0.270722,0.5,0.000068,0.000024,127,0.000118,0,28,0.666667,0.00046
38005,Benson County,,ND,515,7822,8337,1,4,5,154,275,429,7,0.26128,0.271398,2967.535714,0.000001,0.000039,127,0.000089,0,28,0.416667,0.000102
38007,Billings County,,ND,0,0,0,0,0,0,0,0,0,0,0,0,0,0,0,103,0.00005,93,163,0,0
38009,Bottineau County,,ND,521,8396,8917,1,1,2,96,146,242,7,0.257188,0.26629,0,0.000062,0.000032,127,0.000071,0,28,0,0.000359
38011,Bowman County,,ND,288,4034,4322,0,0,0,0,0,0,0,0,0,0,0,0,104,0.00005,94,164,0,0
38013,Burke County,,ND,169,3066,3235,0,1,1,0,49,49,7,0.257231,0.26637,0,0,0.000032,127,0.00005,0,165,0,0
38015,Burleigh County,,ND,5455,81641,87096,21,16,37,3368,2714,6082,6,0.332723,0.352855,47937.659629,0.001936,0.00249,127,0.000695,0,28,0.133333,0.016325
38017,Cass County,,ND,11003,141060,152063,44,37,81,7097,6369,13466,6,0.353048,0.378317,78237.489509,0.00283,0.008359,127,0.001334,0,28,0.136591,0.024732
38019,Cavalier County,,ND,383,6168,6551,0,3,3,0,129,129,7,0.263167,0.273546,0,0,0.000055,127,0.00005,0,166,0.833333,0
38021,Dickey County,,ND,511,6536,7047,0,1,1,0,44,44,7,0.234459,0.241394,0,0,0.000001,127,0.00005,0,167,0,0
38023,Divide County,,ND,157,2705,2862,0,0,0,0,0,0,0,0,0,0,0,0,105,0.00005,95,168,0,0
38025,Dunn County,,ND,237,3896,4133,1,1,2,66,63,129,8,0.208447,0.213605,0,0.000001,0,127,0.000098,0,28,0,0.0001
38027,Eddy County,,ND,227,2978,3205,0,0,0,0,0,0,0,0,0,0,0,0,106,0.00005,96,169,0,0
38029,Emmons County,,ND,250,4872,5122,0,1,1,0,85,85,7,0.249721,0.257773,0,0,0.000016,127,0.00005,0,170,0,0
38031,Foster County,,ND,308,4366,4674,0,1,1,0,54,54,7,0.260994,0.270457,0,0,0.000023,127,0.00005,0,171,0,0
38033,Golden Valley County,,ND,164,2174,2338,0,0,0,0,0,0,0,0,0,0,0,0,107,0.00005,97,172,0,0
38035,Grand Forks County,,ND,7917,69529,77446,25,28,53,2637,3196,5833,6,0.342968,0.366093,33040.793235,0.003888,0.005006,127,0.00066,0,28,0.209459,0.029783
38037,Grant County,,ND,185,3386,3571,0,1,1,0,53,53,7,0.249721,0.257773,0,0,0.000016,127,0.00005,0,173,0,0
38039,Griggs County,,ND,207,3308,3515,0,1,1,0,50,50,7,0.260994,0.270457,0,0,0.000023,127,0.00005,0,174,0,0
38041,Hettinger County,,ND,178,3368,3546,0,1,1,0,45,45,8,0.208489,0.213704,0,0,0,127,0.00005,0,175,0,0
38043,Kidder County,,ND,206,3199,3405,0,1,1,0,76,76,7,0.249721,0.257773,0,0,0.000016,127,0.00005,0,176,0,0
38045,LaMoure County,,ND,287,5608,5895,0,2,2,0,85,85,7,0.261018,0.270629,0,0,0.000023,127,0.00005,0,177,1,0
38047,Logan County,,ND,142,2718,2860,0,0,0,0,0,0,0,0,0,0,0,0,108,0.00005,98,178,0,0
38049,McHenry County,,ND,520,6908,7428,1,1,2,169,158,327,7,0.257188,0.26629,0,0.000062,0.000032,127,0.000071,0,28,0,0.000359
38051,McIntosh County,,ND,180,4039,4219,0,0,0,0,0,0,0,0,0,0,0,0,109,0.00005,99,179,0,0
38053,McKenzie County,,ND,359,5295,5654,0,1,1,0,43,43,8,0.210435,0.215883,0,0,0.000001,127,0.00005,0,180,0,0
38055,McLean County,,ND,761,11287,12048,2,3,5,218,358,576,7,0.265334,0.276065,0,0.000082,0.00007,127,0.000108,0,28,1,0.000611
38057,Mercer County,,ND,634,10692,11326,1,3,4,68,206,274,7,0.261186,0.271083,0,0.00002,0.000039,127,0.000087,0,28,1,0.000252
38059,Morton County,,ND,2433,29466,31899,5,5,10,1155,1403,2558,6,0.304557,0.319293,922.994413,0.000088,0.00073,127,0.000215,0,28,0.452381,0.000891
38061,Mountrail County,,ND,474,7991,8465,1,2,3,76,160,236,7,0.257484,0.266984,0,0.000062,0.000047,127,0.000071,0,28,1,0.000359
38063,Nelson County,,ND,282,4302,4584,1,2,3,54,103,157,7,0.255538,0.264622,23.836129,0.00004,0.000032,127,0.00007,0,28,0.5,0.000355
38065,Oliver County,,ND,193,2770,2963,0,1,1,0,61,61,7,0.249721,0.257773,0,0,0.000016,127,0.00005,0,181,0,0
38067,Pembina County,,ND,670,10686,11356,2,3,5,140,229,369,7,0.263077,0.273382,0,0.000041,0.000054,127,0.000098,0,28,0.833333,0.000448
38069,Pierce County,,ND,343,5488,5831,1,1,2,44,56,100,7,0.257257,0.266393,10.564372,0,0.000032,127,0.000069,0,28,0,0.000088
38071,Ramsey County,,ND,1061,13772,14833,5,4,9,312,429,741,7,0.266306,0.277458,5991.520481,0.000088,0.000086,127,0.000181,0,28,0.428571,0.000876
38073,Ransom County,,ND,424,6579,7003,2,1,3,110,117,227,7,0.260952,0.270378,0,0.000067,0.000023,127,0.000114,0,28,1,0.000454
38075,Renville County,,ND,228,3201,3429,1,1,2,92,74,166,7,0.257188,0.26629,0,0.000062,0.000032,127,0.000071,0,28,0,0.000359
38077,Richland County,,ND,1671,20157,21828,2,4,6,382,678,1060,6,0.302939,0.317349,110.947206,0.000068,0.000704,127,0.000101,0,28,0.75,0.000453
38079,Rolette County,,ND,685,14465,15150,3,3,6,177,241,418,7,0.266209,0.277143,0,0.000122,0.000086,127,0.000128,0,28,1,0.000966
38081,Sargent County,,ND,302,5441,5743,0,1,1,0,65,65,7,0.260994,0.270457,0,0,0.000023,127,0.00005,0,182,0,0
38083,Sheridan County,,ND,170,2049,2219,0,1,1,0,40,40,7,0.249721,0.257773,0,0,0.000016,127,0.00005,0,183,0,0
38085,Sioux County,,ND,311,3425,3736,1,3,4,42,168,210,7,0.249785,0.258177,5930,0.00002,0.000016,127,0.000087,0,28,0.333333,0.000252
38087,Slope County,,ND,0,0,0,0,0,0,0,0,0,0,0,0,0,0,0,110,0.00005,100,184,0,0
38089,Stark County,,ND,1731,26462,28193,5,5,10,359,510,869,7,0.263315,0.274087,8780.45231,0.000027,0.00007,127,0.000279,0,28,0.333333,0.000628
38091,Steele County,,ND,197,3092,3289,0,1,1,0,40,40,7,0.260994,0.270457,0,0,0.000023,127,0.00005,0,185,0,0
38093,Stutsman County,,ND,1568,24804,26372,4,4,8,304,572,876,7,0.263268,0.273858,27.626304,0.000088,0.00007,127,0.000173,0,28,0.45,0.000791
38095,Towner County,,ND,238,3477,3715,0,0,0,0,0,0,0,0,0,0,0,0,111,0.00005,101,186,0,0
38097,Traill County,,ND,601,9260,9861,2,2,4,221,236,457,7,0.263053,0.27321,0,0.000107,0.000054,127,0.000101,0,28,1,0.000715
38099,Walsh County,,ND,945,14752,15697,2,3,5,244,401,645,7,0.263077,0.273382,0,0.000041,0.000054,127,0.000098,0,28,0.833333,0.000448
38101,Ward County,,ND,7358,66586,73944,21,29,50,1863,2677,4540,6,0.346195,0.370078,39897.603598,0.003972,0.00772,127,0.000704,0,28,0.22521,0.03112
38103,Wells County,,ND,416,6079,6495,0,2,2,0,104,104,7,0.261205,0.27099,0,0,0.000038,127,0.00005,0,187,1,0
38105,Williams County,,ND,1336,23164,24500,4,5,9,254,463,717,7,0.266428,0.277791,3049.680979,0.00013,0.000102,127,0.000174,0,28,0.380952,0.000898
39001,Adams County,,OH,1950,36674,38624,11,11,22,1518,1318,2836,6,0.304877,0.322085,3812.819024,0.002298,0.001944,112,0.000206,0,28,0.572727,0.014498
39003,Allen County,,OH,6248,132937,139185,16,21,37,2796,3412,6208,6,0.332913,0.35547,803.670462,0.003959,0.005518,112,0.00024,0,28,0.478571,0.024993
39005,Ashland County,,OH,3569,66010,69579,12,12,24,2494,2192,4686,6,0.304845,0.321838,50.850099,0.002404,0.002026,112,0.00018,0,28,0.636364,0.015015
39007,Ashtabula County,,OH,5587,123924,129511,12,15,27,3007,3106,6113,6,0.339682,0.360085,86.663121,0.002722,0.005912,112,0.000154,0,28,0.709559,0.015552
39009,Athens County,,OH,4603,58451,63054,18,18,36,2033,2118,4151,6,0.330266,0.351072,1188.011338,0.003251,0.00382,112,0.000355,0,28,0.373684,0.021254
39011,Auglaize County,,OH,3117,58284,61401,10,10,20,1971,1935,3906,6,0.304813,0.321884,73.312112,0.001364,0.001668,112,0.000174,0,28,0.575758,0.009264
39013,Belmont County,,OH,3545,84508,88053,9,13,22,1705,1993,3698,6,0.307782,0.325995,6624.565163,0.001593,0.002539,112,0.00018,0,28,0.403846,0.011127
39015,Brown County,,OH,3531,47709,51240,8,8,16,2848,2627,5475,6,0.294141,0.308004,1275.179862,0.001162,0.000926,112,0.00016,0,28,0.75,0.007062
39017,Butler County,,OH,26421,390541,416962,55,71,126,19686,19298,38984,5,0.390463,0.421511,10436.602554,0.024363,0.034284,112,0.000694,0,28,0.481046,0.168527
39019,Carroll County,,OH,2402,39149,41551,7,7,14,1977,1748,3725,6,0.28542,0.298521,53.749967,0.001405,0.000529,112,0.000128,0,28,0.696429,0.008222
39021,Champaign County,,OH,3785,56702,60487,10,11,21,2744,2718,5462,6,0.304239,0.320892,18.226204,0.001692,0.001507,112,0.000176,0,28,0.618182,0.011403
39023,Clark County,,OH,8541,164319,172860,11,15,26,4474,5114,9588,6,0.332761,0.352591,190.328732,0.002363,0.00366,112,0.000174,0,28,0.569853,0.014565
39025,Clermont County,,OH,18455,253740,272195,30,40,70,14017,13604,27621,5,0.372931,0.399937,2927.974186,0.014787,0.020056,112,0.00041,0,28,0.628788,0.102693
39027,Clinton County,,OH,3858,55817,59675,11,12,23,2756,2653,5409,6,0.30555,0.322761,37.450006,0.002576,0.002147,112,0.000176,0,28,0.75,0.01574
39029,Columbiana County,,OH,5876,130954,136830,12,12,24,3146,3399,6545,6,0.307521,0.325519,115.74361,0.002504,0.002674,112,0.000168,0,28,0.589744,0.015118
39031,Coshocton County,,OH,2375,50568,52943,10,8,18,1646,1388,3034,6,0.301838,0.317957,28.603401,0.001488,0.00109,112,0.000183,0,28,0.644444,0.009598
39033,Crawford County,,OH,3623,66892,70515,9,10,19,1932,2214,4146,6,0.301838,0.318186,495.595886,0.001029,0.001048,112,0.000173,0,28,0.577778,0.008061
39035,Cuyahoga County,,OH,66580,1587201,1653781,182,203,385,39048,56464,95512,5,0.428004,0.471626,64482.291034,0.080923,0.089479,112,0.001956,0,28,0.33831,0.554955
39037,Darke County,,OH,3212,68029,71241,8,12,20,1589,2135,3724,6,0.305807,0.32322,293.427311,0.000566,0.001934,112,0.000159,0,28,0.55303,0.003771
39039,Defiance County,,OH,3042,52389,55431,8,10,18,1598,1702,3300,6,0.303318,0.320583,141.875423,0.000636,0.001221,113,0.000169,0,28,0.522222,0.00382
39041,Delaware County,,OH,17012,190427,207439,68,48,116,22126,11988,34114,5,0.377336,0.405911,11570.964193,0.026684,0.021638,112,0.000834,0,28,0.410774,0.186006
39043,Erie County,,OH,5446,100812,106258,11,13,24,3077,3204,6281,6,0.309981,0.328529,26.668338,0.002516,0.002781,112,0.000159,0,28,0.711538,0.015181
39045,Fairfield County,,OH,11999,168914,180913,28,22,50,11901,8339,20240,5,0.345701,0.368008,2527.235403,0.005824,0.006824,112,0.000441,0,28,0.34375,0.038911
39047,Fayette County,,OH,2293,33607,35900,8,10,18,1294,1536,2830,6,0.304207,0.32072,17.855583,0.001477,0.001299,112,0.000152,0,28,0.577778,0.009637
39049,Franklin County,,OH,79889,1175184,1255073,270,265,535,63423,69281,132704,5,0.431562,0.482135,323767.637484,0.091955,0.093268,112,0.003358,0,28,0.207766,0.63891
39051,Fulton County,,OH,3095,53880,56975,6,8,14,1860,2039,3899,6,0.30212,0.318473,10.473684,0.000452,0.001049,113,0.000126,0,28,0.607143,0.002503
39053,Gallia County,,OH,1949,36061,38010,7,6,13,898,924,1822,6,0.301713,0.317498,13.347572,0.00082,0.000773,112,0.000198,0,28,0.5,0.00613
39055,Geauga County,,OH,6425,111378,117803,8,10,18,4494,4212,8706,6,0.329554,0.349461,8.804914,0.00237,0.004398,112,0.000112,0,28,0.845455,0.013676
39057,Greene County,,OH,16230,167427,183657,31,50,81,9804,11155,20959,5,0.374324,0.402649,3360.632138,0.012989,0.023965,112,0.000382,0,28,0.475,0.091331
39059,Guernsey County,,OH,2372,49771,52143,10,10,20,1352,1285,2637,6,0.304941,0.321712,4106.047843,0.002154,0.001863,112,0.000209,0,28,0.463636,0.013619
39061,Hamilton County,,OH,53442,939428,992870,129,153,282,31531,44104,75635,5,0.415167,0.454673,73964.720372,0.057671,0.072323,112,0.001606,0,28,0.370787,0.405269
39063,Hancock County,,OH,4957,88235,93192,14,14,28,2719,2429,5148,6,0.311709,0.330908,1394.948405,0.002723,0.003179,113,0.00022,0,28,0.455882,0.017159
39065,Hardin County,,OH,2422,35827,38249,7,9,16,1117,1498,2615,6,0.302026,0.318387,386.448124,0.000861,0.00088,112,0.000155,0,28,0.541667,0.006398
39067,Harrison County,,OH,1219,18695,19914,5,6,11,750,777,1527,6,0.28542,0.298337,6.004683,0.000276,0.000462,112,0.000112,0,28,0.633333,0.001816
39069,Henry County,,OH,2053,36294,38347,7,7,14,1222,1205,2427,6,0.30212,0.318358,5.256538,0.000454,0.001008,113,0.000141,0,28,0.696429,0.002649
39071,Highland County,,OH,2903,41266,44169,14,12,26,2426,2117,4543,6,0.304845,0.322142,67.365544,0.002625,0.00204,112,0.000218,0,28,0.620879,0.016274
39073,Hocking County,,OH,2113,31457,33570,7,8,15,1597,1563,3160,6,0.301713,0.317727,3.35,0.000867,0.000851,112,0.000172,0,28,0.75,0.00656
39075,Holmes County,,OH,1624,41102,42726,7,7,14,1190,1081,2271,6,0.301775,0.317727,2.570238,0.000702,0.000954,112,0.00014,0,28,0.767857,0.004028
39077,Huron County,,OH,4796,79896,84692,11,14,25,2613,3069,5682,6,0.305197,0.322698,16.886525,0.002069,0.002313,112,0.000169,0,28,0.664835,0.013218
39079,Jackson County,,OH,2050,37251,39301,10,9,19,1243,1158,2401,6,0.301744,0.317899,11.553571,0.000839,0.000861,112,0.000235,0,28,0.563636,0.006734
39081,Jefferson County,,OH,3497,78765,82262,10,13,23,1414,1875,3289,6,0.307684,0.325851,342.517955,0.002316,0.00263,112,0.000181,0,28,0.512821,0.015672
39083,Knox County,,OH,3503,65689,69192,13,11,24,2605,1941,4546,6,0.301869,0.318358,47.135207,0.001517,0.001102,112,0.00024,0,28,0.50641,0.01085
39085,Lake County,,OH,13057,281785,294842,20,31,51,9020,9198,18218,5,0.361792,0.386865,388.805706,0.008429,0.01649,112,0.000228,0,28,0.668347,0.055578
39087,Lawrence County,,OH,3443,66363,69806,7,7,14,1898,1801,3699,6,0.302152,0.31802,266.941365,0.000815,0.000786,112,0.000235,0,28,0.571429,0.00617
39089,Licking County,,OH,9260,165345,174605,14,14,28,6521,5990,12511,6,0.307978,0.326419,83.617002,0.002509,0.00355,112,0.000249,0,28,0.48366,0.016933
39091,Logan County,,OH,3261,51669,54930,12,12,24,2019,2085,4104,6,0.309453,0.327801,87.806647,0.001558,0.002243,112,0.000209,0,28,0.519231,0.011193
39093,Lorain County,,OH,15127,338885,354012,27,39,66,10004,9861,19865,5,0.362378,0.388757,1282.615174,0.010675,0.0177,112,0.00032,0,28,0.541812,0.07191
39095,Lucas County,,OH,24856,521088,545944,65,87,152,14291,17719,32010,5,0.38621,0.420101,18207.580645,0.024792,0.040477,113,0.00076,0,28,0.428157,0.17347
39097,Madison County,,OH,3427,40691,44118,8,9,17,2242,2544,4786,6,0.301744,0.317899,10.520137,0.001464,0.001081,112,0.000159,0,28,0.577778,0.010331
39099,Mahoning County,,OH,12765,293695,306460,24,30,54,6708,8403,15111,5,0.358491,0.383167,1593.685778,0.008605,0.013486,112,0.000289,0,28,0.562185,0.058787
39101,Marion County,,OH,3820,77083,80903,11,11,22,2002,2173,4175,6,0.301901,0.318415,505.919443,0.001035,0.001052,112,0.000219,0,28,0.484848,0.008351
39103,Medina County,,OH,11043,188061,199104,22,21,43,9767,7273,17040,6,0.348478,0.371586,448.514788,0.00816,0.007685,112,0.000247,0,28,0.612434,0.051752
39105,Meigs County,,OH,1098,22046,23144,4,7,11,484,640,1124,6,0.302214,0.318278,8.261988,0.000793,0.0008,112,0.00013,0,28,0.571429,0.005799
39107,Mercer County,,OH,2377,50558,52935,8,8,16,1044,1224,2268,6,0.30354,0.31994,74.200175,0.000597,0.001178,112,0.000147,0,28,0.583333,0.003836
39109,Miami County,,OH,7077,120258,127335,14,15,29,4541,4409,8950,6,0.309684,0.328621,132.825724,0.002519,0.002932,112,0.000207,0,28,0.545833,0.015543
39111,Monroe County,,OH,845,16968,17813,3,5,8,283,429,712,6,0.301869,0.317601,922.829775,0.000027,0.000776,112,0.000103,0,28,0.4,0.000419
39113,Montgomery County,,OH,38032,647761,685793,102,130,232,22455,28646,51101,5,0.407771,0.445763,38660.540337,0.044502,0.058877,112,0.001262,0,28,0.397563,0.320453
39115,Morgan County,,OH,1078,20327,21405,6,6,12,675,701,1376,6,0.301744,0.317555,4.063492,0.000833,0.000835,112,0.000151,0,28,0.785714,0.0062
39117,Morrow County,,OH,2230,28732,30962,6,6,12,2105,1587,3692,6,0.301713,0.317498,0.166667,0.000983,0.001002,112,0.000135,0,28,0.966667,0.007573
39119,Muskingum County,,OH,4286,95728,100014,9,11,20,2466,2717,5183,6,0.301932,0.318473,12.685543,0.001095,0.001235,112,0.000198,0,28,0.581818,0.007805
39121,Noble County,,OH,585,10186,10771,3,2,5,262,259,521,7,0.234115,0.241738,1.166667,0.000028,0.000024,112,0.000108,0,28,0.5,0.000443
39123,Ottawa County,,OH,2833,50553,53386,10,10,20,1824,1770,3594,6,0.331887,0.351072,89.943157,0.002481,0.002937,113,0.000148,0,28,0.719697,0.014952
39125,Paulding County,,OH,1279,23295,24574,3,4,7,560,727,1287,6,0.277996,0.29011,3.168865,0.00029,0.000227,113,0.000088,0,28,0.666667,0.001834
39127,Perry County,,OH,1825,29483,31308,7,7,14,1454,1415,2869,6,0.301681,0.317555,2.461111,0.000887,0.000855,112,0.000165,0,28,0.761905,0.006626
39129,Pickaway County,,OH,4065,51584,55649,8,9,17,2854,3044,5898,6,0.301744,0.317899,6.992857,0.000856,0.000867,112,0.000182,0,28,0.625,0.006644
39131,Pike County,,OH,2550,38673,41223,8,8,16,1709,1670,3379,6,0.301838,0.317899,10.25619,0.000825,0.000861,112,0.00018,0,28,0.625,0.006508
39133,Portage County,,OH,11883,168585,180468,15,20,35,8519,8110,16629,6,0.346401,0.368433,166.791815,0.003564,0.008025,112,0.000184,0,28,0.671429,0.021235
39135,Preble County,,OH,2780,48562,51342,8,8,16,1888,1790,3678,6,0.304909,0.321798,39.555292,0.001666,0.00188,112,0.000131,0,28,0.763889,0.009369
39137,Putnam County,,OH,1696,44770,46466,8,8,16,827,1044,1871,6,0.302246,0.318673,190.049485,0.001173,0.00105,112,0.000157,0,28,0.541667,0.007725
39139,Richland County,,OH,6889,135779,142668,14,21,35,3401,4077,7478,6,0.33341,0.354311,301.495339,0.002449,0.004212,112,0.000221,0,28,0.535714,0.016331
39141,Ross County,,OH,3660,72055,75715,12,13,25,2431,2312,4743,6,0.303571,0.3206,38.909416,0.001377,0.001462,112,0.000251,0,28,0.512821,0.009881
39143,Sandusky County,,OH,3661,71648,75309,9,9,18,2154,2165,4319,6,0.305005,0.321781,1.94812,0.001388,0.001724,113,0.000144,0,28,0.844444,0.008815
39145,Scioto County,,OH,3545,68998,72543,9,10,19,1630,2106,3736,6,0.302372,0.318708,113.936775,0.001328,0.000859,112,0.000226,0,28,0.436364,0.009273
39147,Seneca County,,OH,3360,67851,71211,9,11,20,1717,2162,3879,6,0.305069,0.322125,469.370045,0.001237,0.001734,113,0.000158,0,28,0.663636,0.008204
39149,Shelby County,,OH,2887,56899,59786,9,11,20,1698,1800,3498,6,0.305485,0.32256,60.459284,0.00136,0.001764,112,0.000161,0,28,0.681818,0.009193
39151,Stark County,,OH,17878,456249,474127,44,61,105,11056,12233,23289,5,0.373075,0.402901,9974.604528,0.016512,0.02676,112,0.00054,0,28,0.435198,0.118295
39153,Summit County,,OH,31071,630961,662032,81,105,186,22339,23563,45902,5,0.397511,0.432846,18115.180838,0.033421,0.05083,112,0.000938,0,28,0.419284,0.23599
39155,Trumbull County,,OH,10709,264347,275056,15,29,44,5940,6624,12564,5,0.349819,0.373357,421.346869,0.004405,0.013039,112,0.000194,0,28,0.601149,0.029279
39157,Tuscarawas County,,OH,4557,107147,111704,11,11,22,2696,2823,5519,6,0.304813,0.321666,215.786846,0.002224,0.001889,112,0.000189,0,28,0.575758,0.014206
39159,Union County,,OH,2731,38041,40772,9,7,16,2428,1759,4187,6,0.301713,0.317613,5.692537,0.001062,0.001007,112,0.000178,0,28,0.625,0.008331
39161,Van Wert County,,OH,1593,35510,37103,6,8,14,668,815,1483,6,0.303128,0.320009,99.141646,0.000342,0.001011,112,0.000138,0,28,0.428571,0.002388
39163,Vinton County,,OH,741,10693,11434,6,6,12,581,533,1114,6,0.30165,0.317383,2.166667,0.000812,0.000797,112,0.000163,0,28,0.766667,0.006139
39165,Warren County,,OH,13760,169385,183145,31,29,60,14473,9318,23791,6,0.359911,0.385277,2083.362189,0.01079,0.011433,112,0.000427,0,28,0.534535,0.072859
39167,Washington County,,OH,3707,67638,71345,7,8,15,1454,1735,3189,6,0.302214,0.318392,4291.474212,0.000814,0.000827,112,0.000215,0,28,0.333333,0.006143
39169,Wayne County,,OH,6787,133962,140749,12,16,28,4112,4094,8206,6,0.332191,0.352219,136.55092,0.002567,0.003648,112,0.000169,0,28,0.639706,0.01547
39171,Williams County,,OH,2367,47256,49623,8,9,17,1172,1128,2300,6,0.303286,0.320411,128.477403,0.000646,0.001182,113,0.000166,0,28,0.486111,0.003868
39173,Wood County,,OH,10509,130464,140973,24,26,50,7036,7049,14085,6,0.350621,0.374447,1851.43729,0.00571,0.008294,113,0.000312,0,28,0.429924,0.035648
39175,Wyandot County,,OH,1453,24483,25936,5,6,11,791,925,1716,6,0.301713,0.317498,2.826923,0.000063,0.000795,113,0.000122,0,28,0.7,0.00088
40001,Adair County,,OK,1580,22116,23696,6,6,12,895,904,1799,7,0.295878,0.309211,3.382607,0.00072,0.000661,50,0.000158,0,28,0.8,0.005615
40003,Alfalfa County,,OK,471,5558,6029,1,2,3,71,144,215,7,0.256056,0.264856,0,0.000041,0.000025,50,0.000067,0,28,1,0.000284
40005,Atoka County,,OK,851,12169,13020,4,5,9,328,325,653,6,0.296693,0.310119,1957.058957,0.000982,0.000437,50,0.000129,0,28,0.366667,0.006431
40007,Beaver County,,OK,606,5467,6073,1,2,3,110,129,239,7,0.236784,0.243855,0,0.000009,0.000022,50,0.000076,0,28,1,0.000197
40009,Beckham County,,OK,1481,18771,20252,6,4,10,542,397,939,6,0.296572,0.309775,7357.8774,0.000541,0.000414,50,0.000226,0,28,0.3,0.003811
40011,Blaine County,,OK,1025,11898,12923,8,4,12,481,379,860,6,0.296572,0.309775,537.162404,0.0006,0.00044,50,0.000229,0,28,0.428571,0.004303
40013,Bryan County,,OK,2734,32262,34996,11,13,24,1225,1562,2787,6,0.319065,0.338138,2676.530128,0.002281,0.003461,153,0.000281,0,28,0.448718,0.018129
40015,Caddo County,,OK,2559,31567,34126,9,8,17,1236,1491,2727,6,0.305646,0.320084,36.37389,0.001407,0.001124,50,0.000187,0,28,0.566667,0.009208
40017,Canadian County,,OK,8053,93706,101759,18,19,37,6136,5367,11503,6,0.328437,0.349283,1061.983755,0.003237,0.005109,50,0.000352,0,28,0.417749,0.023697
40019,Carter County,,OK,3196,46386,49582,17,18,35,1637,1731,3368,6,0.328326,0.348997,8300.15819,0.003581,0.004411,50,0.00035,0,28,0.386842,0.026927
40021,Cherokee County,,OK,3142,36729,39871,12,14,26,1512,1793,3305,6,0.303921,0.319252,50.50643,0.001346,0.001297,50,0.000256,0,28,0.538462,0.010042
40023,Choctaw County,,OK,1084,13743,14827,5,4,9,369,408,777,7,0.247699,0.256856,24.054881,0.000572,0.000068,153,0.000175,0,28,0.55,0.004022
40025,Cimarron County,,OK,301,3477,3778,0,0,0,0,0,0,0,0,0,0,0,0,114,0.00005,102,188,0,0
40027,Cleveland County,,OK,21546,213051,234597,51,58,109,17937,15546,33483,6,0.373843,0.402987,13599.650991,0.016389,0.021822,50,0.000813,0,28,0.354859,0.125849
40029,Coal County,,OK,390,5017,5407,2,2,4,165,149,314,7,0.241988,0.250192,0.583333,0.000032,0.000018,50,0.000087,0,28,0,0.000315
40031,Comanche County,,OK,16262,108020,124282,46,64,110,5389,7999,13388,6,0.376019,0.406364,12269.549916,0.018019,0.026046,50,0.000616,0,28,0.463768,0.127101
40033,Cotton County,,OK,594,6262,6856,2,2,4,196,267,463,7,0.279627,0.29198,0,0.0004,0.000277,50,0.000068,0,28,1,0.002202
40035,Craig County,,OK,1358,16455,17813,5,5,10,653,666,1319,7,0.295157,0.307978,0.708333,0.000518,0.000444,50,0.000141,0,28,0.9,0.003836
40037,Creek County,,OK,6593,73651,80244,13,13,26,4999,4695,9694,6,0.33098,0.350029,287.396265,0.001325,0.002094,50,0.000259,0,28,0.528571,0.009208
40039,Custer County,,OK,2629,25035,27664,7,10,17,789,1311,2100,6,0.305743,0.320485,1718.906806,0.000723,0.001133,50,0.000226,0,28,0.577778,0.005043
40041,Delaware County,,OK,2598,31877,34475,14,12,26,1925,1338,3263,6,0.303921,0.318903,191.251131,0.001329,0.001072,50,0.000308,0,28,0.456044,0.010383
40043,Dewey County,,OK,428,5402,5830,1,2,3,52,126,178,6,0.296572,0.309546,0,0.000008,0.000412,50,0.00008,0,28,1,0.000125
40045,Ellis County,,OK,357,4088,4445,1,1,2,57,99,156,7,0.232616,0.238806,0,0.000008,0.000004,50,0.00008,0,28,0,0.000125
40047,Garfield County,,OK,5353,62545,67898,17,20,37,1504,2084,3588,6,0.344105,0.366397,18899.720476,0.003117,0.005086,50,0.0004,0,28,0.354762,0.022409
40049,Garvin County,,OK,2493,30327,32820,9,9,18,1192,1411,2603,6,0.303033,0.317332,122.697581,0.001632,0.00101,50,0.000186,0,28,0.644444,0.012072
40051,Grady County,,OK,4045,46970,51015,10,11,21,2697,2467,5164,6,0.30571,0.320542,250.760492,0.002001,0.00119,50,0.000202,0,28,0.570513,0.015037
40053,Grant County,,OK,476,5317,5793,2,2,4,144,159,303,7,0.256327,0.265303,0,0.00006,0.000046,50,0.000082,0,28,1,0.000522
40055,Greer County,,OK,521,5134,5655,2,3,5,100,185,285,7,0.248313,0.256731,7.6503,0.000044,0.000047,50,0.000091,0,28,0.333333,0.000488
40057,Harmon County,,OK,322,3034,3356,0,1,1,0,68,68,7,0.248165,0.256127,0,0,0.000037,50,0.00005,0,189,0,0
40059,Harper County,,OK,425,4502,4927,1,1,2,52,91,143,7,0.232616,0.238806,0,0.000008,0.000004,50,0.00008,0,28,0,0.000125
40061,Haskell County,,OK,771,11678,12449,3,5,8,224,301,525,7,0.2596,0.2697,0.366667,0.000032,0.000126,50,0.0001,0,28,0.7,0.0005
40063,Hughes County,,OK,1153,12037,13190,6,8,14,387,611,998,6,0.303002,0.31716,5.358251,0.001021,0.000991,50,0.000142,0,28,0.75,0.006848
40065,Jackson County,,OK,3950,28755,32705,15,14,29,962,1171,2133,6,0.329966,0.34965,9252.234758,0.004558,0.00485,50,0.000291,0,28,0.376623,0.03297
40067,Jefferson County,,OK,626,6326,6952,2,3,5,126,268,394,7,0.269491,0.281563,2.96803,0.000067,0.00018,50,0.000081,0,28,0.5,0.000547
40069,Johnston County,,OK,951,9655,10606,5,5,10,349,410,759,7,0.249421,0.258968,4.258387,0.0001,0.000139,50,0.000146,0,28,0.5,0.001004
40071,Kay County,,OK,3691,52228,55919,11,13,24,1251,1847,3098,6,0.327956,0.34734,2710.568708,0.002575,0.002401,50,0.00023,0,28,0.5,0.017501
40073,Kingfisher County,,OK,1037,15523,16560,4,6,10,392,563,955,6,0.302907,0.316758,0.25,0.000602,0.000874,50,0.000109,0,28,0.833333,0.003958
40075,Kiowa County,,OK,813,10068,10881,5,5,10,312,306,618,6,0.299382,0.313187,500.752679,0.000739,0.000601,50,0.000133,0,28,0.466667,0.004761
40077,Latimer County,,OK,1052,11563,12615,2,5,7,268,507,775,6,0.302876,0.316586,1.410714,0.000024,0.000817,50,0.000081,0,28,0.65,0.000329
40079,Le Flore County,,OK,3169,44350,47519,9,12,21,1423,1627,3050,6,0.303825,0.318851,2690.727914,0.001071,0.001032,50,0.000196,0,28,0.462121,0.007562
40081,Lincoln County,,OK,3495,38687,42182,10,10,20,2106,2225,4331,6,0.302939,0.317274,9.640321,0.001322,0.001044,50,0.000199,0,28,0.688889,0.008781
40083,Logan County,,OK,4099,42825,46924,12,13,25,2762,2594,5356,6,0.31896,0.337994,341.6408,0.003019,0.004052,50,0.000223,0,28,0.6,0.021737
40085,Love County,,OK,660,8567,9227,2,2,4,266,280,546,7,0.24732,0.255904,0.371919,0.000061,0.000051,50,0.000087,0,28,0.5,0.000594
40087,McClain County,,OK,2544,22485,25029,4,5,9,1585,1639,3224,6,0.296572,0.30989,0.166667,0.00068,0.000595,50,0.000107,0,28,0.9,0.004637
40089,McCurtain County,,OK,2027,32333,34360,12,12,24,669,821,1490,6,0.31646,0.334698,8693.053921,0.001942,0.001815,153,0.000323,0,28,0.280303,0.014475
40091,McIntosh County,,OK,1419,18221,19640,7,5,12,763,644,1407,6,0.302812,0.316472,1.428968,0.001183,0.000852,50,0.000167,0,28,0.785714,0.008214
40093,Major County,,OK,551,8296,8847,3,2,5,242,182,424,7,0.256101,0.264942,2.497258,0.000045,0.00003,50,0.000145,0,28,0.5,0.000507
40095,Marshall County,,OK,1006,12067,13073,5,5,10,381,417,798,6,0.296754,0.310234,208.891388,0.000602,0.000533,50,0.000147,0,28,0.8,0.004463
40097,Mayes County,,OK,2857,40124,42981,9,10,19,1619,1774,3393,6,0.302939,0.317274,34.506786,0.001157,0.000919,50,0.000203,0,28,0.645455,0.008431
40099,Murray County,,OK,912,10863,11775,4,5,9,448,503,951,6,0.296693,0.310119,0,0.000559,0.000591,50,0.00011,0,28,1,0.00379
40101,Muskogee County,,OK,4406,69501,73907,17,11,28,2440,2422,4862,6,0.316253,0.334297,707.401139,0.003977,0.001924,50,0.000318,0,28,0.46732,0.029876
40103,Noble County,,OK,966,11849,12815,5,5,10,453,538,991,6,0.296723,0.310177,0.452381,0.000652,0.000498,50,0.000121,0,28,0.9,0.004161
40105,Nowata County,,OK,806,10800,11606,4,4,8,486,438,924,7,0.295277,0.308036,2.268913,0.000527,0.000448,50,0.000111,0,28,0.833333,0.003752
40107,Okfuskee County,,OK,772,10943,11715,5,7,12,334,467,801,6,0.302812,0.316701,4.819759,0.000986,0.000861,50,0.000129,0,28,0.738095,0.006661
40109,Oklahoma County,,OK,51556,657170,708726,156,172,328,36602,40509,77111,5,0.421243,0.462046,178015.512723,0.050713,0.060587,50,0.002369,0,28,0.252105,0.371394
40111,Okmulgee County,,OK,2818,34971,37789,9,8,17,1354,1569,2923,6,0.302844,0.316873,74.322102,0.002038,0.000895,50,0.0002,0,28,0.6,0.01485
40113,Osage County,,OK,5251,51261,56512,11,11,22,3951,3776,7727,6,0.327033,0.346388,220.063478,0.002004,0.002824,50,0.000223,0,28,0.643939,0.014504
40115,Ottawa County,,OK,2364,31956,34320,8,7,15,952,1147,2099,7,0.295878,0.309234,133.9429,0.000739,0.0005,50,0.000194,0,28,0.464286,0.00571
40117,Pawnee County,,OK,1595,16554,18149,5,4,9,1001,992,1993,7,0.295097,0.307749,0,0.000609,0.000433,50,0.000125,0,28,1,0.003995
40119,Payne County,,OK,6831,57675,64506,20,25,45,3111,3653,6764,6,0.349567,0.373352,1355.120339,0.0025,0.008949,50,0.000373,0,28,0.428571,0.018509
40121,Pittsburg County,,OK,2815,41735,44550,11,12,23,1004,1130,2134,6,0.316598,0.334985,2891.584039,0.001207,0.001973,50,0.000235,0,28,0.416667,0.008528
40123,Pontotoc County,,OK,2869,33097,35966,12,16,28,1177,1566,2743,6,0.3191,0.338568,5068.652473,0.001226,0.003551,50,0.000269,0,28,0.433333,0.008771
40125,Pottawatomie County,,OK,4898,61343,66241,13,11,24,3089,2823,5912,6,0.316219,0.334239,244.493439,0.002951,0.001929,50,0.000237,0,28,0.527473,0.021307
40127,Pushmataha County,,OK,689,9912,10601,4,2,6,255,95,350,7,0.240427,0.248163,2.453571,0.000509,0.00002,50,0.000136,0,28,0.5,0.003538
40129,Roger Mills County,,OK,303,3515,3818,1,1,2,40,84,124,7,0.228754,0.234673,0,0.000003,0.000004,50,0.000098,0,28,0,0.000125
40131,Rogers County,,OK,6566,86422,92988,18,19,37,5720,4422,10142,6,0.328289,0.349054,1358.741256,0.003937,0.003869,50,0.00035,0,28,0.428947,0.029729
40133,Seminole County,,OK,2009,22957,24966,7,7,14,971,1186,2157,6,0.302907,0.316873,2.408658,0.00073,0.000978,50,0.000154,0,28,0.785714,0.00513
40135,Sequoyah County,,OK,2607,37794,40401,10,10,20,1373,1490,2863,6,0.303762,0.318507,1267.430329,0.001176,0.001026,50,0.000228,0,28,0.581818,0.008918
40137,Stephens County,,OK,2983,43823,46806,10,11,21,1143,1310,2453,6,0.328512,0.348337,1449.245286,0.002387,0.003912,50,0.000189,0,28,0.651515,0.016608
40139,Texas County,,OK,2508,19092,21600,7,7,14,504,588,1092,6,0.307002,0.322388,4340.774223,0.001058,0.000993,50,0.000205,0,28,0.361111,0.006813
40141,Tillman County,,OK,629,8394,9023,2,3,5,128,188,316,7,0.279761,0.292324,0,0.000248,0.000314,50,0.000076,0,28,0.833333,0.001473
40143,Tulsa County,,OK,44718,568794,613512,142,150,292,31085,34733,65818,6,0.418334,0.456863,113299.294564,0.048063,0.058021,50,0.00212,0,28,0.265049,0.359488
40145,Wagoner County,,OK,5681,55217,60898,10,13,23,4388,3954,8342,6,0.31882,0.337765,74.338383,0.001137,0.003262,50,0.000215,0,28,0.598901,0.008005
40147,Washington County,,OK,4040,52058,56098,13,12,25,1876,1997,3873,6,0.325386,0.344485,400.392564,0.002827,0.002426,50,0.00024,0,28,0.441667,0.02118
40149,Washita County,,OK,1026,10949,11975,2,5,7,293,551,844,6,0.296633,0.310005,2.866667,0.000012,0.000435,50,0.000118,0,28,0.65,0.000262
40151,Woods County,,OK,804,8611,9415,2,3,5,102,155,257,6,0.296693,0.30989,0,0.000049,0.000437,50,0.000097,0,28,1,0.000409
40153,Woodward County,,OK,1496,19534,21030,6,8,14,468,504,972,6,0.303097,0.317332,15028.856713,0.000535,0.000952,50,0.000275,0,28,0.285714,0.003746
41001,Baker County,,OR,1450,16476,17926,7,7,14,450,515,965,7,0.286178,0.301007,18.928703,0.001027,0.001117,5,0.000172,0,28,0.75,0.009348
41003,Benton County,,OR,8591,83692,92283,24,27,51,4603,5592,10195,6,0.340318,0.362418,45.902972,0.007921,0.011429,5,0.000372,0,28,0.762097,0.064904
41005,Clackamas County,,OR,35159,393074,428233,86,77,163,32904,29969,62873,6,0.366721,0.399071,7341.596432,0.033204,0.029915,5,0.001114,0,28,0.463286,0.257151
41007,Clatsop County,,OR,3104,34114,37218,13,16,29,1233,1534,2767,6,0.334561,0.354466,95.153817,0.003651,0.005931,5,0.000221,0,28,0.775735,0.030467
41009,Columbia County,,OR,3318,48012,51330,9,9,18,2334,2057,4391,6,0.327956,0.346233,0,0.002558,0.003032,5,0.000165,0,28,0.981818,0.021942
41011,Coos County,,OR,4166,60211,64377,21,18,39,1879,2257,4136,6,0.330266,0.349616,114.198287,0.007981,0.005989,5,0.000332,0,28,0.798333,0.065957
41013,Crook County,,OR,1439,19247,20686,8,2,10,1060,520,1580,7,0.254553,0.263968,0.47619,0.001446,0.000155,5,0.000199,0,28,0.732143,0.013293
41015,Curry County,,OR,1911,21749,23660,10,8,18,734,766,1500,7,0.284025,0.298203,6.304087,0.002377,0.001347,5,0.000185,0,28,0.833333,0.019752
41017,Deschutes County,,OR,9605,125368,134973,59,47,106,9943,6259,16202,6,0.341398,0.3663,17639.962498,0.017614,0.014398,5,0.000951,0,28,0.455004,0.139049
41019,Douglas County,,OR,6400,105545,111945,30,28,58,3413,3947,7360,6,0.33992,0.362,200.906732,0.010062,0.01071,5,0.000442,0,28,0.754902,0.081383
41021,Gilliam County,,OR,175,2095,2270,0,0,0,0,0,0,0,0,0,0,0,0,115,0.00005,103,190,0,0
41023,Grant County,,OR,870,7959,8829,1,3,4,44,185,229,7,0.265165,0.276752,0,0.000116,0.000379,5,0.000067,0,28,0.833333,0.001215
41025,Harney County,,OR,779,7770,8549,1,2,3,47,148,195,7,0.254665,0.264255,1.690528,0.000116,0.000145,5,0.000067,0,28,0,0.001215
41027,Hood River County,,OR,1846,22544,24390,6,8,14,628,871,1499,7,0.286263,0.300422,17.103047,0.001832,0.001703,5,0.000143,0,28,0.777778,0.016184
41029,Jackson County,,OR,11019,190660,201679,59,50,109,9005,7295,16300,6,0.344472,0.370244,578.323154,0.020257,0.018705,5,0.000739,0,28,0.585821,0.157268
41031,Jefferson County,,OR,1249,17209,18458,8,4,12,691,494,1185,7,0.286094,0.299619,86.522484,0.001657,0.001125,5,0.000226,0,28,0.803571,0.014814
41033,Josephine County,,OR,4702,75167,79869,30,19,49,3569,2712,6281,6,0.339325,0.360136,168.326509,0.012957,0.00786,5,0.000409,0,28,0.756629,0.101789
41035,Klamath County,,OR,4743,64155,68898,26,23,49,2221,2521,4742,6,0.339563,0.360939,5045.908979,0.008473,0.008552,5,0.000411,0,28,0.691954,0.068766
41037,Lake County,,OR,652,7378,8030,2,2,4,135,119,254,7,0.254665,0.264197,0,0.000185,0.00021,5,0.000083,0,28,1,0.001857
41039,Lane County,,OR,21136,331304,352440,81,75,156,13869,15606,29475,6,0.360446,0.391767,5559.56829,0.028092,0.028913,5,0.001048,0,28,0.459506,0.218195
41041,Lincoln County,,OR,4290,43196,47486,20,19,39,2122,2483,4605,6,0.331282,0.351605,77.208049,0.006091,0.005832,5,0.000316,0,28,0.829004,0.051129
41043,Linn County,,OR,7534,105790,113324,21,24,45,5099,5320,10419,6,0.34004,0.361713,89.853933,0.00741,0.009135,5,0.000323,0,28,0.801538,0.060088
41045,Malheur County,,OR,2569,28024,30593,7,7,14,897,1230,2127,7,0.286038,0.30072,128.790959,0.00037,0.0011,5,0.000223,0,28,0.5,0.004025
41047,Marion County,,OR,20487,287328,307815,64,60,124,15411,16364,31775,6,0.351894,0.379853,2970.573652,0.02089,0.020631,5,0.000855,0,28,0.491855,0.163345
41049,Morrow County,,OR,1139,10458,11597,2,2,4,419,465,884,7,0.258354,0.268279,0,0.000169,0.00016,5,0.000074,0,28,1,0.001453
41051,Multnomah County,,OR,60218,685353,745571,170,138,308,52738,52494,105232,6,0.395887,0.435535,50838.368415,0.06523,0.054793,5,0.002219,0,28,0.31697,0.475922
41053,Polk County,,OR,6616,63741,70357,16,15,31,5155,4893,10048,6,0.329854,0.349169,25.889746,0.00515,0.00433,5,0.00026,0,28,0.930147,0.042887
41055,Sherman County,,OR,197,1774,1971,0,0,0,0,0,0,0,0,0,0,0,0,116,0.00005,104,191,0,0
41057,Tillamook County,,OR,1778,25059,26837,9,10,19,876,899,1775,7,0.286404,0.300938,0.600372,0.002149,0.002182,5,0.000173,0,28,0.910256,0.019013
41059,Umatilla County,,OR,5674,71810,77484,21,28,49,2483,3394,5877,6,0.332609,0.35446,1604.806597,0.005037,0.007303,5,0.000341,0,28,0.597701,0.041083
41061,Union County,,OR,2286,26022,28308,10,13,23,841,1096,1937,7,0.288536,0.304372,5905.852364,0.001791,0.002339,5,0.000239,0,28,0.634615,0.016299
41063,Wallowa County,,OR,646,7703,8349,1,1,2,64,62,126,8,0.223943,0.230861,0,0.000019,0.000014,5,0.000066,0,28,0,0.000224
41065,Wasco County,,OR,2109,24489,26598,9,8,17,939,974,1913,7,0.286348,0.300594,3.627017,0.001734,0.001838,5,0.000175,0,28,0.8,0.015591
41067,Washington County,,OR,42412,452197,494609,143,102,245,41357,35896,77253,6,0.383762,0.418834,17471.839175,0.055662,0.041209,5,0.001853,0,28,0.370485,0.413128
41069,Wheeler County,,OR,160,1388,1548,0,0,0,0,0,0,0,0,0,0,0,0,117,0.00005,105,192,0,0
41071,Yamhill County,,OR,6382,81436,87818,24,20,44,4652,4314,8966,6,0.339246,0.360136,102.306936,0.009227,0.008233,5,0.000347,0,28,0.813846,0.072661
42001,Adams County,,PA,6104,128787,134891,14,12,26,4506,3767,8273,6,0.309453,0.326941,8.081742,0.005208,0.003605,118,0.000188,0,28,0.8,0.035775
42003,Allegheny County,,PA,56444,1506305,1562749,211,241,452,37733,47609,85342,5,0.429141,0.477182,179527.979335,0.086585,0.096016,118,0.00244,0,28,0.280395,0.603987
42005,Armstrong County,,PA,3836,93563,97399,6,6,12,2474,2423,4897,6,0.300527,0.315681,2.83956,0.001016,0.000853,118,0.000145,0,28,0.733333,0.006372
42007,Beaver County,,PA,8242,212458,220700,10,15,25,3746,4552,8298,6,0.316116,0.335845,115.581131,0.00193,0.005042,118,0.000153,0,28,0.490476,0.011895
42009,Bedford County,,PA,2243,62996,65239,9,10,19,1087,1116,2203,6,0.301493,0.317676,792.729821,0.001188,0.001065,118,0.000171,0,28,0.518182,0.007799
42011,Berks County,,PA,16158,463614,479772,51,59,110,12851,10639,23490,6,0.369659,0.399524,3093.92123,0.024616,0.030466,118,0.000477,0,28,0.623097,0.15441
42013,Blair County,,PA,4934,150422,155356,12,12,24,2021,2159,4180,6,0.301744,0.318335,71.196207,0.002048,0.001637,118,0.000175,0,28,0.615385,0.012056
42015,Bradford County,,PA,3206,73559,76765,11,11,22,1390,1465,2855,7,0.273987,0.288456,1252.488434,0.001513,0.000581,100,0.000223,0,28,0.384615,0.009412
42017,Bucks County,,PA,39702,776787,816489,107,133,240,34534,32687,67221,6,0.386929,0.426683,8622.203793,0.056146,0.065244,118,0.001016,0,28,0.488708,0.37551
42019,Butler County,,PA,9415,211695,221110,19,23,42,6540,5117,11657,6,0.348938,0.37244,1800.752397,0.005225,0.008592,118,0.000272,0,28,0.432266,0.03371
42021,Cambria County,,PA,6217,176212,182429,15,21,36,2429,3347,5776,6,0.335604,0.35684,380.585055,0.004402,0.006858,118,0.000204,0,28,0.557312,0.027742
42023,Cameron County,,PA,290,7137,7427,1,0,1,41,0,41,0,0,0,0,0.000006,0,118,0.000069,0,21,0,0.000095
42025,Carbon County,,PA,3303,72932,76235,13,9,22,2859,2121,4980,6,0.292249,0.307648,1.308211,0.005066,0.002526,118,0.000147,0,28,0.916667,0.030333
42027,Centre County,,PA,9423,129866,139289,34,46,80,4196,4710,8906,6,0.363284,0.390638,14675.967269,0.011418,0.020279,118,0.000424,0,28,0.466531,0.077247
42029,Chester County,,PA,30641,528084,558725,104,104,208,27304,23852,51156,6,0.377631,0.413789,4748.760683,0.053559,0.054651,118,0.001046,0,28,0.540153,0.366808
42031,Clarion County,,PA,2092,45470,47562,8,6,14,993,893,1886,6,0.300527,0.315681,1341.143492,0.001027,0.000769,118,0.000198,0,28,0.517857,0.006664
42033,Clearfield County,,PA,3905,92163,96068,8,9,17,1723,1936,3659,6,0.301462,0.317561,2192.229534,0.001315,0.001156,118,0.000153,0,28,0.555556,0.007995
42035,Clinton County,,PA,1957,40856,42813,3,2,5,788,880,1668,7,0.266746,0.277053,0,0.000492,0.000117,118,0.000077,0,28,1,0.002475
42037,Columbia County,,PA,3390,77286,80676,9,12,21,1767,1786,3553,6,0.29269,0.308824,2842.369175,0.001683,0.002182,118,0.000167,0,28,0.598485,0.010883
42039,Crawford County,,PA,4443,105043,109486,11,9,20,2272,2298,4570,6,0.303762,0.319786,32.927392,0.002037,0.001527,118,0.000174,0,28,0.537879,0.012115
42041,Cumberland County,,PA,16050,263564,279614,54,48,102,11323,10331,21654,6,0.354512,0.381103,8222.694817,0.01943,0.021266,118,0.000613,0,28,0.408173,0.131101
42043,Dauphin County,,PA,17649,320499,338148,51,57,108,10721,12423,23144,6,0.362288,0.390752,11924.971085,0.021139,0.026523,118,0.00056,0,28,0.540625,0.141315
42045,Delaware County,,PA,33113,635530,668643,81,92,173,26136,28007,54143,6,0.378565,0.413244,2333.424104,0.043353,0.04968,118,0.000785,0,28,0.636867,0.291017
42047,Elk County,,PA,1297,44196,45493,3,5,8,341,481,822,6,0.30062,0.315738,2971.923413,0.000022,0.000723,118,0.000108,0,28,0.4,0.000447
42049,Erie County,,PA,10849,322461,333310,27,47,74,3885,5230,9115,6,0.36566,0.39429,4748.559133,0.009849,0.022678,118,0.000353,0,28,0.470211,0.066444
42051,Fayette County,,PA,5867,171865,177732,8,8,16,2688,3310,5998,6,0.305005,0.321368,49.41602,0.001933,0.001645,118,0.000144,0,28,0.513889,0.011445
42053,Forest County,,PA,373,5701,6074,2,2,4,95,108,203,7,0.23121,0.238166,0,0.000778,0.000017,118,0.000087,0,28,1,0.005007
42055,Franklin County,,PA,6097,159522,165619,16,18,34,3337,3000,6337,6,0.306129,0.324842,2617.872863,0.004137,0.003486,118,0.000273,0,28,0.507143,0.028047
42057,Fulton County,,PA,716,17354,18070,4,4,8,393,426,819,7,0.23663,0.245418,3.179278,0.000073,0.000087,118,0.000115,0,28,0.666667,0.000993
42059,Greene County,,PA,1930,42247,44177,4,5,9,903,1002,1905,6,0.301244,0.31646,3.053294,0.000877,0.000848,118,0.000104,0,28,0.9,0.005595
42061,Huntingdon County,,PA,1973,48600,50573,8,9,17,943,1059,2002,7,0.27518,0.288841,239.441476,0.000589,0.000673,118,0.000153,0,28,0.597222,0.003793
42063,Indiana County,,PA,4505,97776,102281,11,9,20,2114,2157,4271,6,0.301181,0.317085,17.794869,0.00161,0.001122,118,0.00018,0,28,0.576923,0.009287
42065,Jefferson County,,PA,2398,53797,56195,7,6,13,1338,1267,2605,6,0.300558,0.315738,1867.685165,0.000972,0.000736,118,0.000165,0,28,0.52381,0.006297
42067,Juniata County,,PA,1133,28338,29471,7,5,12,631,610,1241,7,0.268918,0.280401,28.917843,0.000887,0.000339,118,0.000138,0,28,0.738095,0.005265
42069,Lackawanna County,,PA,8047,243912,251959,29,28,57,4006,4425,8431,6,0.336031,0.358405,3372.77704,0.010189,0.010284,118,0.000349,0,28,0.554054,0.063741
42071,Lancaster County,,PA,18891,579777,598668,64,83,147,12072,12124,24196,6,0.372454,0.405601,19124.761252,0.02689,0.036217,118,0.000663,0,28,0.439642,0.17794
42073,Lawrence County,,PA,3841,109402,113243,6,10,16,1738,1997,3735,6,0.300683,0.316455,2.805745,0.001192,0.000994,118,0.000103,0,28,0.644444,0.006777
42075,Lebanon County,,PA,5731,144470,150201,14,11,25,3653,3244,6897,6,0.302812,0.319717,3.502995,0.004934,0.003477,118,0.000162,0,28,0.938095,0.029841
42077,Lehigh County,,PA,19655,370412,390067,63,73,136,15349,14588,29937,6,0.367649,0.398779,1593.425447,0.032243,0.038614,118,0.000572,0,28,0.6603,0.204932
42079,Luzerne County,,PA,11153,361291,372444,38,47,85,5791,6964,12755,6,0.350663,0.376964,8816.157412,0.014579,0.019991,118,0.000431,0,28,0.579826,0.09242
42081,Lycoming County,,PA,5668,138897,144565,18,22,40,2107,2809,4916,6,0.332723,0.353216,9705.621734,0.003139,0.004726,118,0.000316,0,28,0.471014,0.019732
42083,McKean County,,PA,2105,51051,53156,7,7,14,650,699,1349,6,0.300838,0.316369,4503.630792,0.000994,0.000806,100,0.000167,0,28,0.261905,0.006119
42085,Mercer County,,PA,5332,134993,140325,10,12,22,2711,2835,5546,6,0.307456,0.325404,60.121743,0.001458,0.002448,118,0.000154,0,28,0.636364,0.008108
42087,Mifflin County,,PA,1713,54514,56227,4,9,13,628,812,1440,7,0.275441,0.289104,22.105285,0.000173,0.000805,118,0.00012,0,28,0.680556,0.001112
42089,Monroe County,,PA,9335,151656,160991,41,40,81,10930,5930,16860,6,0.336614,0.360194,1006.432807,0.017455,0.016173,118,0.00038,0,28,0.694686,0.103886
42091,Montgomery County,,PA,51646,855921,907567,137,146,283,47974,44722,92696,6,0.39893,0.439359,17314.577282,0.069876,0.072018,118,0.00138,0,28,0.474078,0.480919
42093,Montour County,,PA,1222,17683,18905,3,3,6,618,505,1123,7,0.226897,0.234527,0,0.000068,0.000026,118,0.000087,0,28,1,0.000591
42095,Northampton County,,PA,15714,312487,328201,44,50,94,13290,11534,24824,6,0.360402,0.387989,664.187882,0.019433,0.023657,118,0.000398,0,28,0.708409,0.119682
42097,Northumberland County,,PA,4459,105183,109642,10,13,23,2446,2849,5295,6,0.288909,0.305183,1434.906331,0.001008,0.001504,118,0.000188,0,28,0.587912,0.005903
42099,Perry County,,PA,2639,54344,56983,7,6,13,1833,1851,3684,7,0.274349,0.287287,6.067235,0.000895,0.000701,118,0.000131,0,28,0.696429,0.005286
42101,Philadelphia County,,PA,78943,1458202,1537145,158,165,323,45802,71410,117212,5,0.402966,0.445769,24016.960197,0.075863,0.07952,118,0.001599,0,28,0.440016,0.516327
42103,Pike County,,PA,3454,50273,53727,27,13,40,4173,1776,5949,6,0.301713,0.318845,159.817034,0.011093,0.004625,99,0.000243,0,28,0.7849,0.059105
42105,Potter County,,PA,1367,20324,21691,3,3,6,273,470,743,7,0.232746,0.240671,8.427268,0.000015,0.00003,100,0.000115,0,28,0.333333,0.000462
42107,Schuylkill County,,PA,5362,170484,175846,18,18,36,3393,3312,6705,6,0.32933,0.349151,156.86788,0.003932,0.004858,118,0.000214,0,28,0.742105,0.023546
42109,Snyder County,,PA,1966,40183,42149,8,6,14,1263,1041,2304,7,0.266355,0.277586,31.083219,0.00055,0.000216,118,0.000168,0,28,0.555556,0.00353
42111,Somerset County,,PA,2990,88748,91738,6,7,13,1133,1252,2385,6,0.300869,0.316328,24.898499,0.001019,0.000881,118,0.000123,0,28,0.571429,0.006433
42113,Sullivan County,,PA,434,6314,6748,2,2,4,159,158,317,7,0.250022,0.25846,0,0.000043,0.000037,118,0.00008,0,28,1,0.000436
42115,Susquehanna County,,PA,2375,51056,53431,8,7,15,1279,1231,2510,7,0.261915,0.273911,81.361289,0.001072,0.000353,118,0.000171,0,28,0.517857,0.00693
42117,Tioga County,,PA,2078,47215,49293,8,5,13,945,696,1641,7,0.253444,0.263092,1068.174682,0.001481,0.000078,100,0.000159,0,28,0.357143,0.00926
42119,Union County,,PA,2535,41462,43997,7,5,12,1387,1263,2650,7,0.266893,0.277741,142.384438,0.000524,0.000143,118,0.00015,0,28,0.571429,0.003027
42121,Venango County,,PA,2773,64609,67382,9,7,16,1335,1241,2576,6,0.300527,0.315824,1575.235354,0.001076,0.000862,118,0.000196,0,28,0.597222,0.006779
42123,Warren County,,PA,2063,50340,52403,6,6,12,776,725,1501,6,0.300652,0.31591,7.719719,0.001026,0.000833,118,0.000137,0,28,0.666667,0.0062
42125,Washington County,,PA,9136,229064,238200,16,18,34,6676,5511,12187,6,0.33992,0.361604,1315.388305,0.00366,0.006382,118,0.00025,0,28,0.393281,0.024845
42127,Wayne County,,PA,2865,51361,54226,15,5,20,1736,1233,2969,7,0.260367,0.271388,17.270207,0.004862,0.000437,118,0.00018,0,28,0.6,0.026634
42129,Westmoreland County,,PA,15272,419409,434681,30,43,73,10198,10052,20250,6,0.362921,0.390202,3694.366257,0.010726,0.019156,118,0.000382,0,28,0.46301,0.072585
42131,Wyoming County,,PA,1889,30138,32027,4,4,8,1010,1101,2111,7,0.260088,0.270557,0.261272,0.000251,0.00022,118,0.000107,0,28,0.916667,0.001752
42133,York County,,PA,17078,455507,472585,51,58,109,13229,11096,24325,6,0.35198,0.379154,5279.756471,0.018316,0.024632,118,0.000543,0,28,0.454565,0.120369
44001,Bristol County,,RI,3177,55894,59071,7,7,14,2024,1948,3972,6,0.296029,0.311793,0.111429,0.003346,0.002772,100,0.000111,0,28,0.946429,0.022329
44003,Kent County,,RI,11305,196630,207935,20,23,43,9494,8278,17772,6,0.340239,0.361834,153.823869,0.010082,0.013383,100,0.000228,0,28,0.833333,0.068421
44005,Newport County,,RI,9694,93553,103247,37,35,72,4500,5238,9738,6,0.341157,0.365027,251.492303,0.018298,0.018419,100,0.000394,0,28,0.617172,0.127003
44007,Providence County,,RI,28366,649194,677560,85,90,175,23228,22685,45913,6,0.379059,0.413313,2223.971427,0.047901,0.050989,100,0.000875,0,28,0.61021,0.331597
44009,Washington County,,RI,8181,138688,146869,21,24,45,6179,5385,11564,6,0.335836,0.357258,54.032807,0.010652,0.012433,100,0.000235,0,28,0.827692,0.07196
45001,Abbeville County,,SC,1644,28818,30462,5,5,10,991,1095,2086,6,0.284192,0.296508,369.660658,0.000421,0.000482,101,0.000171,0,28,0.7,0.003903
45003,Aiken County,,SC,8667,168428,177095,23,26,49,4550,4990,9540,6,0.320048,0.341824,6434.319659,0.006696,0.007927,0,0.000364,0,28,0.482796,0.049379
45005,Allendale County,,SC,664,11023,11687,2,3,5,155,304,459,7,0.242614,0.251805,3.863689,0.00001,0.000057,0,0.000087,0,28,0.333333,0.000211
45007,Anderson County,,SC,9940,202445,212385,30,19,49,7957,6181,14138,6,0.313322,0.332456,2363.365346,0.008509,0.005306,101,0.000534,0,28,0.487356,0.066504
45009,Bamberg County,,SC,1056,16589,17645,3,5,8,303,584,887,7,0.283195,0.296076,10.144891,0.000219,0.000557,101,0.000087,0,28,0.9,0.001379
45011,Barnwell County,,SC,1221,22810,24031,4,6,10,504,644,1148,7,0.283251,0.296305,522.570458,0.000103,0.000558,0,0.000112,0,28,0.633333,0.000965
45013,Beaufort County,,SC,13876,130922,144798,75,59,134,7434,6120,13554,6,0.372501,0.402339,12907.366411,0.038843,0.030469,5,0.000839,0,28,0.526685,0.268006
45015,Berkeley County,,SC,19920,153831,173751,53,54,107,11853,13313,25166,6,0.358756,0.387427,3373.434716,0.02575,0.023353,101,0.000633,0,28,0.523293,0.185189
45017,Calhoun County,,SC,957,15860,16817,3,3,6,723,613,1336,7,0.28292,0.295428,0,0.000608,0.000502,101,0.000082,0,28,1,0.003876
45019,Charleston County,,SC,29828,319237,349065,130,115,245,20221,20912,41133,5,0.402911,0.439239,26432.428327,0.057841,0.053998,101,0.001558,0,28,0.400575,0.406474
45021,Cherokee County,,SC,2751,61101,63852,8,8,16,1826,1734,3560,6,0.299938,0.315497,181.162934,0.001348,0.001506,101,0.000175,0,28,0.732143,0.011492
45023,Chester County,,SC,2184,40702,42886,5,7,12,1247,1396,2643,6,0.301995,0.317618,177.621209,0.000841,0.001678,101,0.000129,0,28,0.571429,0.007077
45025,Chesterfield County,,SC,2458,48063,50521,10,12,22,1352,1466,2818,6,0.300932,0.317378,60.048881,0.001107,0.001718,101,0.000189,0,28,0.532051,0.008904
45027,Clarendon County,,SC,2136,35918,38054,9,9,18,1203,1137,2340,6,0.292514,0.306874,20.680375,0.001429,0.001356,101,0.000151,0,28,0.777778,0.009938
45029,Colleton County,,SC,2140,40921,43061,6,7,13,1061,981,2042,6,0.291253,0.305389,43.266696,0.000963,0.001499,101,0.000125,0,28,0.785714,0.00776
45031,Darlington County,,SC,4043,78365,82408,12,13,25,2383,2453,4836,6,0.306226,0.323484,260.783832,0.002114,0.003009,101,0.000204,0,28,0.571429,0.015903
45033,Dillon County,,SC,1501,35072,36573,5,6,11,720,734,1454,7,0.285252,0.298581,7.587391,0.000355,0.000701,101,0.000112,0,28,0.533333,0.002861
45035,Dorchester County,,SC,9376,89069,98445,14,18,32,6637,5930,12567,6,0.317601,0.338098,162.956394,0.004942,0.007017,101,0.000218,0,28,0.695906,0.037269
45037,Edgefield County,,SC,1333,17730,19063,6,6,12,726,900,1626,7,0.278155,0.291011,7.790465,0.000627,0.00049,0,0.00013,0,28,0.766667,0.004147
45039,Fairfield County,,SC,1516,26555,28071,5,5,10,894,932,1826,7,0.282975,0.295801,4.996558,0.000686,0.000502,101,0.000119,0,28,0.633333,0.004784
45041,Florence County,,SC,8033,133780,141813,22,29,51,4283,4894,9177,6,0.317635,0.339284,1363.721851,0.004777,0.008283,101,0.000329,0,28,0.477823,0.035353
45043,Georgetown County,,SC,4076,66126,70202,9,9,18,2005,2041,4046,6,0.304909,0.321236,34.679111,0.002577,0.00267,101,0.000157,0,28,0.902778,0.019469
45045,Greenville County,,SC,27401,422914,450315,115,99,214,20235,19380,39615,5,0.396481,0.431051,46230.899898,0.048463,0.042802,101,0.001494,0,28,0.372263,0.342676
45047,Greenwood County,,SC,3830,72930,76760,15,16,31,2106,2283,4389,6,0.305646,0.323117,2792.27267,0.001869,0.002635,101,0.000325,0,28,0.507353,0.01484
45049,Hampton County,,SC,1100,22124,23224,4,5,9,406,443,849,7,0.283665,0.296672,2746.355824,0.000263,0.000679,5,0.000122,0,28,0.35,0.002531
45051,Horry County,,SC,14958,208142,223100,98,64,162,9754,7846,17600,6,0.368628,0.399174,17233.487583,0.033616,0.028855,101,0.001179,0,28,0.358968,0.228046
45053,Jasper County,,SC,762,9130,9892,3,4,7,434,455,889,6,0.283637,0.295912,38.631535,0.000579,0.000646,5,0.000095,0,28,0.583333,0.004686
45055,Kershaw County,,SC,3511,63395,66906,11,12,23,2170,1911,4081,6,0.303476,0.320221,119.944264,0.001909,0.002242,101,0.000203,0,28,0.615385,0.014483
45057,Lancaster County,,SC,3258,65768,69026,7,10,17,1701,2006,3707,6,0.304685,0.321035,10.016795,0.001232,0.002493,101,0.000155,0,28,0.688889,0.010562
45059,Laurens County,,SC,3872,72021,75893,8,10,18,2777,2575,5352,6,0.295878,0.310366,20.354944,0.000733,0.001544,101,0.000193,0,28,0.788889,0.006022
45061,Lee County,,SC,1673,23933,25606,6,6,12,1072,1111,2183,7,0.283361,0.296277,1.01746,0.000629,0.000506,101,0.000123,0,28,0.8,0.004193
45063,Lexington County,,SC,18465,261742,280207,50,58,108,13986,13090,27076,6,0.366629,0.395809,14841.248909,0.01471,0.022384,101,0.000727,0,28,0.368086,0.111727
45065,McCormick County,,SC,614,9776,10390,4,2,6,202,228,430,7,0.234133,0.241617,8.101569,0.000383,0.000018,101,0.00012,0,28,0.416667,0.002664
45067,Marion County,,SC,2135,37761,39896,4,7,11,797,1134,1931,6,0.303286,0.319304,12.947981,0.000328,0.002071,101,0.000105,0,28,0.821429,0.00264
45069,Marlboro County,,SC,1588,32486,34074,7,8,15,638,826,1464,7,0.285364,0.29904,45.21245,0.000885,0.000719,101,0.000131,0,28,0.416667,0.005927
45071,Newberry County,,SC,1823,39616,41439,8,7,15,965,987,1952,6,0.290091,0.303732,93.920102,0.000967,0.00099,101,0.000171,0,28,0.611111,0.007114
45073,Oconee County,,SC,3569,75570,79139,7,5,12,1555,1671,3226,6,0.29337,0.306645,16.296084,0.00172,0.001046,101,0.000163,0,28,0.75,0.013245
45075,Orangeburg County,,SC,5093,94538,99631,16,20,36,2346,3074,5420,6,0.311843,0.330673,1349.431501,0.003656,0.004304,101,0.000235,0,28,0.482213,0.023803
45077,Pickens County,,SC,7905,104124,112029,12,17,29,5050,5197,10247,6,0.318401,0.338734,105.761649,0.00202,0.006269,101,0.00024,0,28,0.689542,0.016022
45079,Richland County,,SC,29621,311524,341145,111,106,217,21202,21663,42865,6,0.393529,0.429148,48890.364397,0.044054,0.048883,101,0.001403,0,28,0.373092,0.315776
45081,Saluda County,,SC,819,15373,16192,5,6,11,431,596,1027,7,0.283251,0.296305,7.108931,0.000662,0.000554,101,0.00012,0,28,0.8,0.004425
45083,Spartanburg County,,SC,11958,270663,282621,38,32,70,8008,7348,15356,6,0.322642,0.345488,4630.496628,0.013231,0.010338,101,0.000602,0,28,0.46723,0.099416
45085,Sumter County,,SC,9448,108102,117550,25,32,57,3010,4145,7155,6,0.349988,0.374447,2599.274683,0.008664,0.014501,101,0.000355,0,28,0.486486,0.063213
45087,Union County,,SC,1427,34042,35469,4,7,11,526,856,1382,6,0.290062,0.303675,6.56855,0.000117,0.000994,101,0.000121,0,28,0.595238,0.001368
45089,Williamsburg County,,SC,2010,38229,40239,5,9,14,729,1308,2037,6,0.292661,0.307075,2.062977,0.000724,0.001502,101,0.000116,0,28,0.847222,0.005313
45091,York County,,SC,10422,186652,197074,40,30,70,7851,6089,13940,6,0.320826,0.343183,1269.509673,0.011998,0.010155,101,0.00059,0,28,0.465116,0.092125
46003,Aurora County,,SD,281,4002,4283,1,1,2,59,77,136,7,0.247594,0.254967,0,0.00001,0.000001,127,0.000109,0,28,0,0.000114
46005,Beadle County,,SD,1222,19918,21140,3,5,8,168,318,486,7,0.267778,0.278926,2921,0.0001,0.000126,127,0.000168,0,28,0.466667,0.000964
46007,Bennett County,,SD,246,3160,3406,0,1,1,0,53,53,7,0.257027,0.26594,0,0,0.000044,127,0.00005,0,193,0,0
46009,Bon Homme County,,SD,489,7476,7965,1,2,3,111,162,273,7,0.265504,0.275584,0,0.000001,0.000079,127,0.000086,0,28,1,0.000111
46011,Brookings County,,SD,2594,28253,30847,10,6,16,818,773,1591,6,0.304239,0.319482,6382.143936,0.000181,0.000745,127,0.000441,0,28,0.257576,0.002031
46013,Brown County,,SD,2622,41597,44219,12,11,23,859,914,1773,6,0.306161,0.322388,20056.725094,0.00018,0.000815,127,0.000545,0,28,0.154167,0.002184
46015,Brule County,,SD,532,5885,6417,0,3,3,0,181,181,7,0.265638,0.275967,0,0,0.000079,127,0.00005,0,195,0.333333,0
46017,Buffalo County,,SD,162,1890,2052,0,0,0,0,0,0,0,0,0,0,0,0,119,0.00005,106,196,0,0
46019,Butte County,,SD,1017,10242,11259,4,4,8,395,440,835,7,0.257599,0.267351,25.053138,0.000084,0.000061,127,0.000176,0,28,0.65,0.00087
46021,Campbell County,,SD,130,2534,2664,0,0,0,0,0,0,0,0,0,0,0,0,120,0.00005,107,197,0,0
46023,Charles Mix County,,SD,601,10173,10774,1,2,3,41,103,144,7,0.265528,0.275641,0,0.000093,0.000079,127,0.000084,0,28,1,0.000753
46025,Clark County,,SD,216,4680,4896,1,1,2,61,53,114,7,0.233382,0.240181,0,0.000006,0.000001,127,0.000102,0,28,0,0.000117
46027,Clay County,,SD,1814,12041,13855,6,5,11,541,630,1171,7,0.272932,0.28463,95.252222,0.000264,0.000152,127,0.000282,0,28,0.566667,0.001897
46029,Codington County,,SD,2244,30828,33072,10,11,21,857,926,1783,6,0.304398,0.320342,33716.504256,0.000107,0.000746,127,0.000669,0,28,0.159091,0.001625
46031,Corson County,,SD,327,3950,4277,2,1,3,88,68,156,8,0.204805,0.209475,2968.174242,0,0,127,0.000118,0,28,0,0.000178
46033,Custer County,,SD,801,7376,8177,1,2,3,162,296,458,7,0.257006,0.266032,0,0.000072,0.000045,127,0.00008,0,28,1,0.000485
46035,Davison County,,SD,1742,20736,22478,9,7,16,580,600,1180,6,0.329032,0.347036,16190.704296,0.000098,0.001265,127,0.000481,0,28,0.172727,0.001505
46037,Day County,,SD,498,7179,7677,1,4,5,49,227,276,7,0.265698,0.276272,0,0.000006,0.00008,127,0.000102,0,28,0.666667,0.000117
46039,Deuel County,,SD,368,5910,6278,1,2,3,67,104,171,7,0.233419,0.240411,0,0.000006,0.000002,127,0.000102,0,28,1,0.000117
46041,Dewey County,,SD,438,6517,6955,1,2,3,40,89,129,7,0.257029,0.266089,2967,0.000072,0.000044,127,0.00008,0,28,0,0.000485
46043,Douglas County,,SD,199,4169,4368,0,1,1,0,40,40,7,0.265474,0.275374,0,0,0.000078,127,0.00005,0,198,0,0
46045,Edmunds County,,SD,255,4828,5083,1,1,2,90,78,168,7,0.234417,0.241305,0,0.000007,0.000001,127,0.000092,0,28,0,0.000126
46047,Fall River County,,SD,780,7472,8252,2,1,3,154,133,287,7,0.256984,0.26586,0,0.000072,0.000044,127,0.000114,0,28,1,0.000576
46049,Faulk County,,SD,178,2745,2923,0,0,0,0,0,0,0,0,0,0,0,0,121,0.00005,108,199,0,0
46051,Grant County,,SD,614,9890,10504,1,1,2,42,124,166,7,0.233382,0.240181,0,0.000006,0.000001,127,0.000102,0,28,0,0.000117
46053,Gregory County,,SD,331,5822,6153,0,1,1,0,49,49,7,0.265474,0.275374,0,0,0.000078,127,0.00005,0,200,0,0
46055,Haakon County,,SD,206,2874,3080,0,0,0,0,0,0,0,0,0,0,0,0,122,0.00005,109,201,0,0
46057,Hamlin County,,SD,482,6103,6585,1,2,3,116,169,285,7,0.233419,0.240411,0,0.000006,0.000002,127,0.000102,0,28,1,0.000117
46059,Hand County,,SD,219,4609,4828,0,0,0,0,0,0,0,0,0,0,0,0,123,0.00005,110,202,0,0
46061,Hanson County,,SD,234,4205,4439,1,2,3,94,118,212,7,0.265528,0.275641,0,0.00001,0.000079,127,0.000109,0,28,1,0.000114
46063,Harding County,,SD,135,1678,1813,0,0,0,0,0,0,0,0,0,0,0,0,124,0.00005,111,203,0,0
46065,Hughes County,,SD,1704,19381,21085,4,3,7,377,556,933,7,0.267606,0.278295,2978.098384,0.000173,0.000122,127,0.000201,0,28,0.583333,0.001451
46067,Hutchinson County,,SD,536,9097,9633,3,3,6,134,182,316,7,0.265601,0.275928,8,0.000104,0.00008,127,0.000187,0,28,0.583333,0.000963
46069,Hyde County,,SD,139,1899,2038,0,0,0,0,0,0,0,0,0,0,0,0,125,0.00005,112,204,0,0
46071,Jackson County,,SD,286,2788,3074,0,1,1,0,57,57,7,0.257027,0.26594,0,0,0.000044,127,0.00005,0,205,0,0
46073,Jerauld County,,SD,150,2555,2705,0,1,1,0,48,48,8,0.211276,0.216601,0,0,0.000001,127,0.00005,0,206,0,0
46075,Jones County,,SD,127,1402,1529,0,0,0,0,0,0,0,0,0,0,0,0,126,0.00005,113,207,0,0
46077,Kingsbury County,,SD,443,6180,6623,1,2,3,42,135,177,7,0.265479,0.275526,0,0.000006,0.000079,127,0.000113,0,28,1,0.000121
46079,Lake County,,SD,864,12437,13301,1,2,3,201,277,478,7,0.265479,0.275526,0,0.000093,0.000079,127,0.000084,0,28,1,0.000753
46081,Lawrence County,,SD,2600,23194,25794,7,7,14,964,1052,2016,6,0.329854,0.348183,2859.951407,0.000191,0.001362,127,0.000264,0,28,0.402778,0.001844
46083,Lincoln County,,SD,2655,31022,33677,10,5,15,3232,1592,4824,7,0.265552,0.276042,274.100468,0.00064,0.000083,127,0.00044,0,28,0.336364,0.004429
46085,Lyman County,,SD,302,4449,4751,1,0,1,57,0,57,0,0,0,0,0.000001,0,127,0.000065,0,194,0,0.000085
46087,McCook County,,SD,452,6535,6987,1,1,2,168,143,311,7,0.265431,0.275297,0,0.000093,0.000078,127,0.000084,0,28,0,0.000753
46089,McPherson County,,SD,158,2953,3111,0,1,1,0,48,48,7,0.234459,0.241394,0,0,0.000001,127,0.00005,0,208,0,0
46091,Marshall County,,SD,346,5711,6057,0,2,2,0,106,106,7,0.234497,0.241623,0,0,0.000001,127,0.00005,0,209,0,0
46093,Meade County,,SD,4569,29701,34270,6,4,10,1705,1830,3535,7,0.267902,0.278783,1032.407985,0.001393,0.000125,127,0.000206,0,28,0.566667,0.011081
46095,Mellette County,,SD,181,2118,2299,1,0,1,46,0,46,0,0,0,0,0,0,127,0.000084,0,23,0,0.000091
46097,Miner County,,SD,202,2652,2854,0,1,1,0,48,48,7,0.265474,0.275374,0,0,0.000078,127,0.00005,0,210,0,0
46099,Minnehaha County,,SD,13236,177295,190531,57,50,107,8118,8139,16257,6,0.361298,0.388493,172665.917769,0.009696,0.011619,127,0.001956,0,28,0.137494,0.074215
46101,Moody County,,SD,456,7536,7992,1,2,3,152,205,357,7,0.265479,0.275526,0,0.000093,0.000079,127,0.000084,0,28,1,0.000753
46103,Pennington County,,SD,8254,97257,105511,33,32,65,4287,3926,8213,6,0.345824,0.369252,74248.76049,0.005518,0.008966,127,0.001111,0,28,0.187632,0.044836
46105,Perkins County,,SD,273,4133,4406,0,0,0,0,0,0,0,0,0,0,0,0,128,0.00005,114,211,0,0
46107,Potter County,,SD,274,3185,3459,0,0,0,0,0,0,0,0,0,0,0,0,129,0.00005,115,212,0,0
46109,Roberts County,,SD,628,10237,10865,4,1,5,245,82,327,7,0.233382,0.240181,2910,0.000007,0.000001,127,0.000188,0,28,0.166667,0.000377
46111,Sanborn County,,SD,259,2919,3178,1,1,2,47,54,101,7,0.247594,0.254967,0,0.00001,0.000001,127,0.000109,0,28,0,0.000114
46113,Shannon County,,SD,583,10537,11120,2,2,4,176,220,396,7,0.25712,0.266261,3531.502367,0.000072,0.000044,127,0.000107,0,28,0,0.000573
46115,Spink County,,SD,607,7722,8329,1,2,3,78,203,281,7,0.234549,0.241821,0,0.000007,0.000002,127,0.000092,0,28,1,0.000126
46117,Stanley County,,SD,389,3349,3738,1,2,3,175,221,396,7,0.265479,0.275526,0,0.000001,0.000079,127,0.000107,0,28,1,0.000105
46119,Sully County,,SD,124,1690,1814,0,0,0,0,0,0,0,0,0,0,0,0,130,0.00005,116,213,0,0
46121,Todd County,,SD,514,7408,7922,1,2,3,67,97,164,7,0.257029,0.266089,2967,0.000072,0.000044,127,0.00008,0,28,0,0.000485
46123,Tripp County,,SD,448,7068,7516,0,2,2,0,103,103,7,0.267599,0.278142,0,0,0.000122,127,0.00005,0,214,1,0
46125,Turner County,,SD,763,9504,10267,2,3,5,303,396,699,7,0.265479,0.275641,0.5,0.000094,0.000084,127,0.000158,0,28,0.666667,0.000891
46127,Union County,,SD,1635,14003,15638,6,5,11,899,684,1583,7,0.270696,0.281918,49.833117,0.000214,0.000121,127,0.00026,0,28,0.433333,0.001557
46129,Walworth County,,SD,609,6625,7234,1,3,4,68,178,246,7,0.25753,0.267024,2908.174242,0,0.000046,127,0.00015,0,28,0.333333,0.000091
46135,Yankton County,,SD,1844,24014,25858,7,7,14,620,707,1327,7,0.273214,0.285347,3276.824912,0.00011,0.000152,127,0.000291,0,28,0.255556,0.001471
46137,Ziebach County,,SD,98,1182,1280,1,0,1,41,0,41,0,0,0,0,0,0,127,0.000084,0,3,0,0.000091
47001,Anderson County,,TN,5848,87648,93496,11,11,22,3247,3359,6606,6,0.301587,0.316036,182.507606,0.000651,0.001131,49,0.00031,0,28,0.410256,0.005617
47003,Bedford County,,TN,2409,42908,45317,8,6,14,1673,1352,3025,6,0.299814,0.313152,4.847263,0.000943,0.000767,49,0.00021,0,28,0.696429,0.008082
47005,Benton County,,TN,1061,18187,19248,5,4,9,461,388,849,7,0.239377,0.247406,42.899981,0.000696,0.00004,49,0.000176,0,28,0.4,0.005016
47007,Bledsoe County,,TN,680,10424,11104,4,4,8,342,397,739,6,0.2796,0.291274,10.699632,0.000257,0.000223,0,0.000134,0,28,0.583333,0.002067
47009,Blount County,,TN,6589,123962,130551,19,12,31,4175,3472,7647,6,0.31181,0.328185,1424.743717,0.005235,0.001909,49,0.000413,0,28,0.365789,0.038732
47011,Bradley County,,TN,6126,96107,102233,13,13,26,2860,2978,5838,6,0.313999,0.331229,6227.986523,0.001359,0.002517,0,0.00037,0,28,0.319048,0.010961
47013,Campbell County,,TN,1938,38739,40677,5,5,10,795,958,1753,6,0.287395,0.299673,57.58147,0.000374,0.000325,49,0.000197,0,28,0.3,0.002849
47015,Cannon County,,TN,1237,16932,18169,6,5,11,901,747,1648,6,0.299845,0.313095,2.127749,0.000741,0.000752,49,0.000178,0,28,0.8,0.006221
47017,Carroll County,,TN,2842,41282,44124,8,8,16,1639,1542,3181,6,0.309915,0.325118,1248.004923,0.000725,0.001283,49,0.000233,0,28,0.583333,0.005618
47019,Carter County,,TN,3545,58955,62500,8,9,17,2143,2254,4397,6,0.302152,0.316558,2068.020705,0.000455,0.000962,49,0.000262,0,28,0.433333,0.003379
47021,Cheatham County,,TN,3578,45037,48615,8,10,18,2753,2422,5175,6,0.302686,0.317022,9.094946,0.001169,0.00125,49,0.000205,0,28,0.744444,0.009614
47023,Chester County,,TN,1371,18084,19455,6,6,12,924,769,1693,7,0.239358,0.247618,3.767857,0.000722,0.000048,49,0.000175,0,28,0.690476,0.005286
47025,Claiborne County,,TN,1614,32418,34032,8,8,16,1025,915,1940,6,0.287622,0.30039,797.889178,0.000377,0.000329,49,0.000256,0,28,0.267857,0.003155
47027,Clay County,,TN,495,8699,9194,2,4,6,108,231,339,7,0.232821,0.239981,6.372745,0.000006,0.00003,49,0.000133,0,28,0.5,0.000275
47029,Cocke County,,TN,1779,37543,39322,5,6,11,876,908,1784,6,0.287111,0.299329,0.894444,0.000382,0.000384,49,0.000157,0,28,0.8,0.002988
47031,Coffee County,,TN,3622,53596,57218,10,12,22,1984,2052,4036,6,0.303571,0.318633,3433.702956,0.000983,0.001599,49,0.000279,0,28,0.461538,0.008046
47033,Crockett County,,TN,1327,18027,19354,7,7,14,748,814,1562,6,0.311309,0.326528,125.293358,0.000993,0.000917,49,0.000181,0,28,0.595238,0.007325
47035,Cumberland County,,TN,2676,56101,58777,12,13,25,1056,1059,2115,6,0.303002,0.318186,7242.442311,0.00268,0.001282,49,0.000278,0,28,0.291667,0.019035
47037,Davidson County,,TN,56162,620190,676352,202,175,377,37496,44985,82481,5,0.427689,0.468272,232271.567651,0.075334,0.073283,49,0.003024,0,28,0.26878,0.539421
47039,Decatur County,,TN,723,12807,13530,3,3,6,324,283,607,7,0.237035,0.244144,2.642857,0.000034,0.000017,49,0.000123,0,28,0.5,0.000536
47041,DeKalb County,,TN,1195,21361,22556,8,8,16,796,675,1471,6,0.299969,0.313668,827.926571,0.000746,0.000797,49,0.000247,0,28,0.660714,0.006559
47043,Dickson County,,TN,3288,47198,50486,9,9,18,2162,1927,4089,6,0.302623,0.316793,103.556331,0.00117,0.001181,49,0.000237,0,28,0.590909,0.009595
47045,Dyer County,,TN,2597,41754,44351,10,10,20,1123,1179,2302,6,0.310146,0.32572,4483.290256,0.001325,0.001286,49,0.000263,0,28,0.444444,0.01009
47047,Fayette County,,TN,3724,48631,52355,6,8,14,4029,2438,6467,6,0.309783,0.324946,36.256804,0.000751,0.001317,49,0.000181,0,28,0.513889,0.005526
47049,Fentress County,,TN,784,17816,18600,1,3,4,122,255,377,7,0.232802,0.239947,0,0.00001,0.000047,49,0.000068,0,28,0.833333,0.000247
47051,Franklin County,,TN,2330,41314,43644,9,10,19,1209,1227,2436,6,0.303381,0.318117,3899.776485,0.001303,0.001266,49,0.000235,0,28,0.522222,0.010029
47053,Gibson County,,TN,3161,56909,60070,8,11,19,1753,1979,3732,6,0.31008,0.325748,490.678323,0.00074,0.001307,49,0.000215,0,28,0.554545,0.005646
47055,Giles County,,TN,2012,36482,38494,10,8,18,1241,1157,2398,6,0.302089,0.316111,38.97623,0.001138,0.001102,49,0.000234,0,28,0.533333,0.009148
47057,Grainger County,,TN,1341,20596,21937,6,6,12,925,884,1809,6,0.287253,0.299587,7.31728,0.000374,0.000328,49,0.000203,0,28,0.7,0.003001
47059,Greene County,,TN,3024,73267,76291,8,9,17,1581,1525,3106,6,0.302057,0.316414,99.593289,0.000467,0.000968,49,0.000229,0,28,0.611111,0.003473
47061,Grundy County,,TN,731,15097,15828,4,5,9,228,375,603,6,0.279681,0.291618,16.934688,0.000031,0.000224,49,0.000142,0,28,0.5,0.000605
47063,Hamblen County,,TN,4272,64959,69231,10,12,22,2242,2552,4794,6,0.28845,0.302247,4693.546712,0.000436,0.000512,49,0.000298,0,28,0.401515,0.003697
47065,Hamilton County,,TN,20141,354949,375090,68,74,142,10985,13101,24086,5,0.387445,0.419401,69932.563181,0.024609,0.029935,0,0.001214,0,28,0.324664,0.188757
47067,Hancock County,,TN,243,5774,6017,1,2,3,46,82,128,7,0.223925,0.230239,0,0.000004,0.000007,49,0.000071,0,28,1,0.000132
47069,Hardeman County,,TN,1580,27106,28686,7,7,14,1043,862,1905,6,0.30975,0.324774,494.148726,0.000718,0.001268,49,0.000202,0,28,0.482143,0.005419
47071,Hardin County,,TN,1447,28180,29627,8,8,16,803,650,1453,6,0.310345,0.32572,4529.928383,0.000735,0.001264,49,0.000249,0,28,0.347222,0.005493
47073,Hawkins County,,TN,3345,56386,59731,11,7,18,2506,2081,4587,6,0.287622,0.300224,2301.584952,0.000472,0.000355,49,0.00031,0,28,0.427273,0.003756
47075,Haywood County,,TN,1224,22672,23896,7,7,14,744,781,1525,6,0.307067,0.32123,6.777259,0.00073,0.00067,49,0.000198,0,28,0.642857,0.005432
47077,Henderson County,,TN,1710,26323,28033,6,6,12,868,887,1755,6,0.307132,0.321202,1708.873475,0.000712,0.000657,49,0.000182,0,28,0.595238,0.005248
47079,Henry County,,TN,2029,33666,35695,8,7,15,833,827,1660,6,0.303128,0.317383,501.121519,0.001322,0.000846,49,0.000222,0,28,0.527778,0.009883
47081,Hickman County,,TN,1559,21196,22755,7,6,13,1229,857,2086,6,0.299907,0.313295,1580.225264,0.000829,0.000857,49,0.000207,0,28,0.571429,0.00691
47083,Houston County,,TN,629,9068,9697,4,3,7,273,289,562,7,0.276515,0.287648,9.650177,0.000226,0.000197,49,0.000163,0,28,0.5,0.001865
47085,Humphreys County,,TN,1063,19060,20123,5,6,11,516,498,1014,6,0.299938,0.313353,473.09308,0.000607,0.000755,49,0.0002,0,28,0.366667,0.00496
47087,Jackson County,,TN,962,14839,15801,4,3,7,520,482,1002,7,0.232728,0.239718,2.305556,0.000018,0.000031,49,0.000176,0,28,0.583333,0.000635
47089,Jefferson County,,TN,4988,52039,57027,11,10,21,3467,3347,6814,6,0.287253,0.300075,98.883035,0.000421,0.000399,49,0.000291,0,28,0.393939,0.004006
47091,Johnson County,,TN,746,15836,16582,5,3,8,364,208,572,7,0.246586,0.255853,22.480974,0.00012,0.000053,49,0.000159,0,28,0.55,0.001039
47093,Knox County,,TN,26286,407101,433387,96,97,193,17987,18072,36059,5,0.402353,0.43663,121158.945791,0.038729,0.044519,49,0.001614,0,28,0.379481,0.28442
47095,Lake County,,TN,444,6152,6596,2,2,4,175,245,420,7,0.23719,0.244167,0,0.000021,0.000016,49,0.000092,0,28,1,0.000317
47097,Lauderdale County,,TN,1555,26197,27752,6,6,12,814,908,1722,6,0.307067,0.321116,4.65,0.000711,0.000669,49,0.000175,0,28,0.690476,0.005217
47099,Lawrence County,,TN,2037,43774,45811,7,8,15,948,1036,1984,6,0.302277,0.316397,3240.170116,0.00066,0.001078,49,0.000225,0,28,0.472222,0.005355
47101,Lewis County,,TN,727,11120,11847,4,4,8,360,323,683,7,0.244491,0.25305,4416.644984,0.000042,0.000036,49,0.000163,0,28,0.333333,0.000651
47103,Lincoln County,,TN,1560,33672,35232,8,8,16,1044,878,1922,6,0.302057,0.316082,783.439806,0.001066,0.00108,49,0.000222,0,28,0.638889,0.008508
47105,Loudon County,,TN,3133,45133,48266,7,6,13,1937,1929,3866,6,0.287168,0.299444,95.797383,0.00111,0.00037,49,0.000206,0,28,0.571429,0.007981
47107,McMinn County,,TN,2825,54698,57523,9,8,17,1750,1557,3307,6,0.288937,0.302156,1080.47574,0.000641,0.000579,0,0.000276,0,28,0.4,0.004948
47109,McNairy County,,TN,1658,25142,26800,6,6,12,851,982,1833,6,0.307196,0.321316,276.013657,0.000717,0.000663,49,0.000184,0,28,0.633333,0.005293
47111,Macon County,,TN,1103,22274,23377,7,5,12,915,574,1489,6,0.299938,0.313209,2760.390212,0.000648,0.000677,49,0.000224,0,28,0.47619,0.005565
47113,Madison County,,TN,6594,90691,97285,19,20,39,3710,3803,7513,6,0.314236,0.332135,5413.760833,0.002373,0.002349,49,0.000471,0,28,0.27,0.018314
47115,Marion County,,TN,1619,29588,31207,6,6,12,880,875,1755,6,0.279546,0.291446,174.485758,0.000256,0.000216,0,0.00019,0,28,0.4,0.00223
47117,Marshall County,,TN,1891,31342,33233,8,8,16,1252,1097,2349,6,0.299969,0.313611,11.095444,0.000954,0.001,49,0.000223,0,28,0.638889,0.008056
47119,Maury County,,TN,5205,81440,86645,14,12,26,2934,2756,5690,6,0.32207,0.341033,7596.001489,0.003037,0.003271,49,0.00033,0,28,0.433333,0.022337
47121,Meigs County,,TN,787,9274,10061,5,4,9,539,513,1052,6,0.279519,0.291159,7.182814,0.000273,0.000216,0,0.000164,0,28,0.7,0.002168
47123,Monroe County,,TN,2237,40284,42521,6,6,12,1298,1275,2573,6,0.28731,0.299731,20.417759,0.000404,0.000381,49,0.000198,0,28,0.595238,0.003368
47125,Montgomery County,,TN,19937,136590,156527,62,65,127,10512,11205,21717,6,0.381797,0.412493,25018.833362,0.023517,0.026019,49,0.000933,0,28,0.426324,0.169166
47127,Moore County,,TN,367,5337,5704,2,3,5,193,212,405,7,0.233644,0.240629,0.142857,0.000023,0.000027,49,0.00009,0,28,0.833333,0.00034
47129,Morgan County,,TN,1395,25033,26428,4,5,9,916,857,1773,6,0.287281,0.299501,5.119094,0.000381,0.000344,49,0.000128,0,28,0.65,0.002872
47131,Obion County,,TN,2285,35708,37993,7,10,17,1068,1277,2345,6,0.310676,0.326465,6346.27272,0.000709,0.001283,49,0.000228,0,28,0.4,0.005255
47133,Overton County,,TN,1289,23898,25187,6,4,10,696,639,1335,7,0.232728,0.239832,4881.395147,0.000611,0.00002,49,0.000211,0,28,0.309524,0.005188
47135,Perry County,,TN,562,7814,8376,1,2,3,66,85,151,8,0.20011,0.20534,1.36652,0,0.000001,49,0.000085,0,28,0,0.000098
47137,Pickett County,,TN,192,4326,4518,1,0,1,55,0,55,0,0,0,0,0,0,49,0.000095,0,19,0,0.000135
47139,Polk County,,TN,1318,17515,18833,6,5,11,919,829,1748,7,0.241626,0.250152,5080.778079,0.000278,0.000051,0,0.000275,0,28,0.3,0.002502
47141,Putnam County,,TN,4557,59767,64324,18,13,31,2468,2307,4775,6,0.303097,0.318358,12664.815633,0.002514,0.001351,49,0.000461,0,28,0.333333,0.019436
47143,Rhea County,,TN,1917,30732,32649,5,8,13,749,974,1723,6,0.288966,0.302213,45.095254,0.000258,0.000554,0,0.000167,0,28,0.517857,0.002196
47145,Roane County,,TN,2799,45828,48627,7,8,15,1444,1636,3080,6,0.287367,0.300017,28.172133,0.000403,0.000398,49,0.000205,0,28,0.535714,0.003533
47147,Robertson County,,TN,4903,69008,73911,11,9,20,4206,3261,7467,6,0.302718,0.316936,371.458455,0.001375,0.001016,49,0.000285,0,28,0.590909,0.011073
47149,Rutherford County,,TN,15100,198756,213856,52,40,92,13353,9183,22536,6,0.369894,0.397254,17228.273425,0.01571,0.014139,49,0.000984,0,28,0.315185,0.118409
47151,Scott County,,TN,692,20491,21183,4,3,7,368,229,597,6,0.287225,0.299043,1284.201075,0.000363,0.000314,49,0.000175,0,28,0.333333,0.002674
47153,Sequatchie County,,TN,642,10358,11000,3,3,6,422,346,768,6,0.279412,0.290815,1.535714,0.000244,0.000202,0,0.00012,0,28,0.666667,0.001826
47155,Sevier County,,TN,5578,67566,73144,10,8,18,2759,2997,5756,6,0.302718,0.317097,544.577233,0.002529,0.001172,49,0.000233,0,28,0.481818,0.018565
47157,Shelby County,,TN,54605,1017737,1072342,221,237,458,32843,42617,75460,5,0.4426,0.487564,359156.850714,0.077099,0.083617,49,0.003164,0,28,0.215282,0.544347
47159,Smith County,,TN,1376,18647,20023,7,9,16,891,905,1796,6,0.299969,0.313783,1952.926537,0.000734,0.000829,49,0.000238,0,28,0.569444,0.006364
47161,Stewart County,,TN,970,12312,13282,3,2,5,512,351,863,7,0.276383,0.287316,4.252061,0.000404,0.000191,49,0.000117,0,28,0.666667,0.002689
47163,Sullivan County,,TN,10184,173497,183681,18,24,42,5659,6418,12077,6,0.322928,0.34449,49222.422661,0.001594,0.005152,49,0.000512,0,28,0.252645,0.013139
47165,Sumner County,,TN,10059,133153,143212,21,20,41,7585,6118,13703,6,0.341398,0.362802,10004.702158,0.004782,0.004755,49,0.000494,0,28,0.392308,0.035156
47167,Tipton County,,TN,3601,50345,53946,5,5,10,3204,2125,5329,6,0.306969,0.320829,2.233333,0.000745,0.000687,49,0.000154,0,28,0.75,0.005386
47169,Trousdale County,,TN,513,7013,7526,3,4,7,312,302,614,7,0.254732,0.263715,0.587338,0.000057,0.000076,49,0.000115,0,28,0.833333,0.000829
47171,Unicoi County,,TN,1166,19235,20401,3,3,6,577,607,1184,7,0.246314,0.25548,0,0.000096,0.000037,49,0.000109,0,28,1,0.000601
47173,Union County,,TN,1147,17916,19063,6,6,12,1172,885,2057,6,0.287196,0.299473,6.775253,0.000391,0.000368,49,0.000198,0,28,0.666667,0.003283
47175,Van Buren County,,TN,319,5001,5320,1,0,1,59,0,59,0,0,0,0,0.000006,0,49,0.000076,0,22,0,0.000151
47177,Warren County,,TN,1874,38544,40418,9,9,18,872,914,1786,6,0.300031,0.313897,4565.296799,0.000751,0.000773,49,0.000268,0,28,0.422222,0.006551
47179,Washington County,,TN,8244,109029,117273,15,20,35,4775,4936,9711,6,0.326043,0.347265,13767.820237,0.00257,0.005792,49,0.000382,0,28,0.421429,0.019574
47181,Wayne County,,TN,657,14813,15470,4,3,7,325,269,594,7,0.241646,0.25002,1460.349486,0.000046,0.000018,49,0.000148,0,28,0.333333,0.000521
47183,Weakley County,,TN,2343,33173,35516,9,10,19,1045,1168,2213,6,0.31061,0.32635,4969.403372,0.001247,0.001295,49,0.000232,0,28,0.427273,0.008557
47185,White County,,TN,983,20068,21051,4,4,8,496,406,902,7,0.232877,0.240262,4.882007,0.000034,0.000054,49,0.00015,0,28,0.666667,0.00081
47187,Williamson County,,TN,12103,131237,143340,54,45,99,10024,7797,17821,6,0.377974,0.406284,9809.519966,0.02644,0.023391,49,0.00085,0,28,0.518244,0.200359
47189,Wilson County,,TN,7765,100470,108235,16,15,31,6003,4788,10791,6,0.304334,0.319831,1597.056264,0.00333,0.001555,49,0.00037,0,28,0.437909,0.024832
48001,Anderson County,,TX,3388,43175,46563,11,15,26,1476,1771,3247,6,0.325787,0.345683,36.822622,0.003037,0.005959,153,0.000216,0,28,0.643791,0.024357
48003,Andrews County,,TX,1198,14091,15289,2,2,4,185,375,560,7,0.26128,0.271638,0,0.0002,0.000145,153,0.000074,0,28,1,0.001358
48005,Angelina County,,TX,5588,84032,89620,21,28,49,2749,3414,6163,6,0.333257,0.354587,406.980027,0.004533,0.007741,153,0.000375,0,28,0.466667,0.037695
48007,Aransas County,,TX,2417,20667,23084,6,6,12,1103,1057,2160,6,0.327365,0.345614,0,0.003445,0.003733,153,0.000124,0,28,1,0.027319
48009,Archer County,,TX,1268,10763,12031,3,2,5,763,714,1477,7,0.269092,0.280617,1.366667,0.000219,0.000134,153,0.000102,0,28,0.666667,0.001343
48011,Armstrong County,,TX,257,2131,2388,1,2,3,57,103,160,7,0.262412,0.272487,0,0.000097,0.000155,153,0.000067,0,28,1,0.000626
48013,Atascosa County,,TX,3536,44341,47877,8,7,15,3118,2307,5425,6,0.325532,0.343275,24.122628,0.003445,0.002908,153,0.000165,0,28,0.638889,0.027366
48015,Austin County,,TX,1947,27375,29322,7,7,14,1541,1093,2634,6,0.32079,0.33823,3.846522,0.001421,0.002209,153,0.000149,0,28,0.652778,0.011057
48017,Bailey County,,TX,647,7301,7948,1,2,3,50,147,197,7,0.267409,0.278518,0,0.000003,0.000166,98,0.000063,0,28,0.833333,0.000101
48019,Bandera County,,TX,1654,17826,19480,5,4,9,1231,814,2045,6,0.311642,0.325995,0.916667,0.001797,0.000868,153,0.000126,0,28,0.8,0.013892
48021,Bastrop County,,TX,5014,59691,64705,15,12,27,5548,3097,8645,6,0.329032,0.348446,101.551354,0.0068,0.005542,153,0.000284,0,28,0.766667,0.054536
48023,Baylor County,,TX,397,3845,4242,0,1,1,0,94,94,7,0.26911,0.28052,0,0,0.000132,153,0.00005,0,215,0,0
48025,Bee County,,TX,2148,24502,26650,11,10,21,1069,1016,2085,6,0.325714,0.343906,414.390271,0.003143,0.002972,153,0.000201,0,28,0.615385,0.025033
48027,Bell County,,TX,47629,253254,300883,154,157,311,26481,30265,56746,5,0.418936,0.458835,28711.014352,0.061935,0.063883,153,0.001887,0,28,0.322265,0.437931
48029,Bexar County,,TX,88149,1533665,1621814,305,286,591,71452,72616,144068,5,0.452451,0.500969,189682.63532,0.098662,0.094433,153,0.003912,0,28,0.188424,0.704128
48031,Blanco County,,TX,1249,11686,12935,8,8,16,862,674,1536,6,0.314508,0.330209,2.695635,0.00256,0.002246,153,0.000205,0,28,0.791667,0.021299
48033,Borden County,,TX,104,693,797,0,0,0,0,0,0,0,0,0,0,0,0,131,0.00005,117,216,0,0
48035,Bosque County,,TX,1623,17539,19162,9,6,15,1093,821,1914,6,0.315122,0.332324,13.412319,0.002923,0.002001,153,0.000194,0,28,0.763889,0.022978
48037,Bowie County,,TX,6830,92127,98957,19,21,40,3670,3988,7658,6,0.331774,0.35332,13075.782485,0.005284,0.006399,153,0.000403,0,28,0.382246,0.042901
48039,Brazoria County,,TX,18093,255589,273682,44,43,87,16058,12564,28622,6,0.35198,0.377795,1581.67023,0.014682,0.013676,153,0.000606,0,28,0.413697,0.11238
48041,Brazos County,,TX,15523,121854,137377,49,47,96,7577,10079,17656,6,0.363966,0.391205,2809.038828,0.012937,0.019095,153,0.000764,0,28,0.405191,0.102287
48043,Brewster County,,TX,1135,8367,9502,3,6,9,195,313,508,6,0.31677,0.332829,23.688195,0.000601,0.002132,153,0.000087,0,28,0.866667,0.003691
48045,Briscoe County,,TX,198,1853,2051,0,0,0,0,0,0,0,0,0,0,0,0,132,0.00005,118,217,0,0
48047,Brooks County,,TX,622,7675,8297,2,4,6,89,295,384,7,0.2868,0.299966,0,0.000276,0.00052,153,0.000076,0,28,1,0.00196
48049,Brown County,,TX,2699,36351,39050,13,16,29,1140,1258,2398,6,0.331471,0.351978,7449.348473,0.00235,0.006255,153,0.00035,0,28,0.486842,0.018215
48051,Burleson County,,TX,1327,18158,19485,4,3,7,685,566,1251,6,0.320472,0.337255,0,0.001744,0.001116,153,0.000112,0,28,1,0.014119
48053,Burnet County,,TX,3322,35533,38855,17,9,26,2903,1832,4735,6,0.325459,0.343476,85.799085,0.005621,0.003646,153,0.000317,0,28,0.694853,0.045731
48055,Caldwell County,,TX,3288,33168,36456,12,12,24,3388,2323,5711,6,0.329256,0.348704,15.615615,0.004717,0.005267,153,0.000238,0,28,0.863636,0.039142
48057,Calhoun County,,TX,1808,22074,23882,6,7,13,624,884,1508,6,0.322928,0.340729,15.987523,0.001558,0.002236,153,0.000123,0,28,0.821429,0.011807
48059,Callahan County,,TX,1342,13104,14446,3,2,5,639,586,1225,7,0.267828,0.278742,0.25,0.000197,0.000144,153,0.000088,0,28,0.666667,0.001405
48061,Cameron County,,TX,17621,338019,355640,40,49,89,9054,10936,19990,6,0.363193,0.391314,4576.173643,0.018741,0.020163,153,0.000581,0,28,0.464286,0.146495
48063,Camp County,,TX,1477,15064,16541,7,9,16,543,828,1371,6,0.31519,0.332783,21.728968,0.001755,0.00206,153,0.000196,0,28,0.7,0.014246
48065,Carson County,,TX,822,7414,8236,3,4,7,355,441,796,7,0.262483,0.272888,0,0.00023,0.000159,153,0.000098,0,28,1,0.001527
48067,Cass County,,TX,2566,35558,38124,13,14,27,1274,1619,2893,6,0.325168,0.344863,159.545955,0.00312,0.003933,153,0.000281,0,28,0.590476,0.024704
48069,Castro County,,TX,881,8249,9130,4,6,10,255,382,637,7,0.267976,0.279768,7.910336,0.000271,0.000282,153,0.000113,0,28,0.7,0.001667
48071,Chambers County,,TX,4539,47757,52296,7,8,15,3766,3076,6842,6,0.320861,0.338459,0.496078,0.001617,0.002498,153,0.000144,0,28,0.902778,0.01322
48073,Cherokee County,,TX,3128,46928,50056,10,10,20,1785,1699,3484,6,0.324804,0.343888,1.948016,0.003041,0.003867,153,0.00019,0,28,0.845455,0.023763
48075,Childress County,,TX,537,6281,6818,0,1,1,0,40,40,7,0.261205,0.270863,0,0,0.000089,153,0.00005,0,218,0,0
48077,Clay County,,TX,1299,11100,12399,3,4,7,996,848,1844,6,0.312648,0.328345,84.93542,0.000212,0.001025,153,0.000124,0,28,0.666667,0.001427
48079,Cochran County,,TX,349,3789,4138,2,2,4,96,129,225,7,0.266624,0.277337,0,0.000162,0.00012,153,0.000098,0,28,1,0.001171
48081,Coke County,,TX,372,3687,4059,1,1,2,155,121,276,7,0.260998,0.271122,0,0.00014,0.000104,153,0.000065,0,28,0,0.000897
48083,Coleman County,,TX,795,9202,9997,4,2,6,254,242,496,7,0.267828,0.278742,0.809524,0.000358,0.000148,153,0.000117,0,28,0.833333,0.002345
48085,Collin County,,TX,56576,540955,597531,229,153,382,78202,47270,125472,5,0.418695,0.457448,39498.110886,0.089493,0.066781,153,0.002856,0,28,0.285152,0.631492
48087,Collingsworth County,,TX,319,3225,3544,0,0,0,0,0,0,0,0,0,0,0,0,133,0.00005,119,219,0,0
48089,Colorado County,,TX,1527,21096,22623,6,8,14,659,873,1532,6,0.325168,0.34296,18.457906,0.0013,0.002921,153,0.000149,0,28,0.607143,0.010139
48091,Comal County,,TX,7367,86331,93698,25,21,46,6774,4733,11507,6,0.342847,0.364878,252.716132,0.008921,0.008257,153,0.000421,0,28,0.655271,0.072602
48093,Comanche County,,TX,1271,14993,16264,4,3,7,287,448,735,6,0.310444,0.325886,0.487179,0.000912,0.00092,153,0.000114,0,28,0.833333,0.007155
48095,Concho County,,TX,332,2743,3075,1,0,1,61,0,61,0,0,0,0,0.00014,0,153,0.000065,0,12,0,0.000897
48097,Cooke County,,TX,2970,39338,42308,8,9,17,2079,1806,3885,6,0.315532,0.333328,2384.214116,0.002744,0.0032,153,0.000214,0,28,0.638889,0.023496
48099,Coryell County,,TX,14944,54993,69937,36,38,74,8280,8562,16842,6,0.358446,0.384727,4317.55231,0.013072,0.015809,153,0.000499,0,28,0.594131,0.096372
48101,Cottle County,,TX,213,1904,2117,0,0,0,0,0,0,0,0,0,0,0,0,134,0.00005,120,220,0,0
48103,Crane County,,TX,386,4390,4776,1,2,3,50,128,178,7,0.26128,0.271638,0,0.000089,0.000145,153,0.000061,0,28,1,0.000613
48105,Crockett County,,TX,414,3951,4365,0,1,1,0,90,90,7,0.261041,0.271201,0,0,0.000104,153,0.00005,0,221,0,0
48107,Crosby County,,TX,855,7916,8771,1,1,2,209,421,630,7,0.266599,0.277165,0,0.000154,0.000119,153,0.000067,0,28,0,0.001067
48109,Culberson County,,TX,367,3015,3382,0,1,1,0,43,43,7,0.296342,0.309019,0,0,0.00039,153,0.00005,0,222,0,0
48111,Dallam County,,TX,876,7778,8654,3,4,7,134,281,415,7,0.262507,0.272945,5873,0.000128,0.000161,153,0.000129,0,28,0.3,0.001013
48113,Dallas County,,TX,182501,2271027,2453528,406,340,746,140522,166686,307208,5,0.451608,0.507201,320062.92324,0.113497,0.106278,153,0.005461,0,28,0.130876,0.799171
48115,Dawson County,,TX,1204,13820,15024,2,5,7,233,502,735,7,0.267016,0.278512,5.927578,0.000264,0.000213,153,0.00008,0,28,0.5,0.001812
48117,Deaf Smith County,,TX,1760,19780,21540,4,7,11,410,783,1193,6,0.316219,0.334216,155.67391,0.000217,0.002062,153,0.000113,0,28,0.690476,0.001628
48119,Delta County,,TX,475,5009,5484,3,3,6,186,231,417,7,0.24808,0.256893,0,0.000948,0.000088,153,0.000092,0,28,1,0.007427
48121,Denton County,,TX,48615,428331,476946,177,133,310,56874,39460,96334,5,0.414634,0.4516,37843.183392,0.065937,0.056088,153,0.002395,0,28,0.291421,0.479309
48123,DeWitt County,,TX,1241,21040,22281,7,5,12,740,606,1346,6,0.325131,0.342558,921.749478,0.002643,0.002648,153,0.000161,0,28,0.666667,0.021194
48125,Dickens County,,TX,213,2124,2337,1,1,2,40,50,90,7,0.266599,0.277165,0,0.000154,0.000119,153,0.000067,0,28,0,0.001067
48127,Dimmit County,,TX,880,9921,10801,3,5,8,178,382,560,6,0.31444,0.32975,0.708333,0.000797,0.001709,153,0.000099,0,28,0.75,0.006167
48129,Donley County,,TX,328,3400,3728,2,2,4,101,118,219,7,0.262412,0.272487,0,0.000213,0.000155,153,0.000084,0,28,1,0.001421
48131,Duval County,,TX,943,15209,16152,2,3,5,273,474,747,6,0.312144,0.326597,0,0.000276,0.001031,153,0.000076,0,28,1,0.00196
48133,Eastland County,,TX,1612,17368,18980,7,10,17,538,772,1310,6,0.317012,0.334698,725.875347,0.001936,0.002044,153,0.000177,0,28,0.5,0.015181
48135,Ector County,,TX,8772,130827,139599,30,38,68,4365,5430,9795,6,0.347727,0.373306,18493.283161,0.008164,0.011111,153,0.000494,0,28,0.397463,0.06249
48137,Edwards County,,TX,315,4156,4471,1,0,1,41,0,41,0,0,0,0,0.000058,0,153,0.000061,0,10,0,0.000435
48139,Ellis County,,TX,9777,120766,130543,21,20,41,8839,6632,15471,6,0.345126,0.367263,207.192932,0.008862,0.009077,153,0.000335,0,28,0.672101,0.069
48141,El Paso County,,TX,44570,771586,816156,131,166,297,21519,32356,53875,6,0.420999,0.461358,77561.431807,0.048538,0.063128,153,0.001761,0,28,0.30059,0.358497
48143,Erath County,,TX,3308,30578,33886,15,17,32,1401,1709,3110,6,0.32803,0.348418,1091.985446,0.003628,0.005185,153,0.000327,0,28,0.526144,0.029004
48145,Falls County,,TX,1421,15872,17293,3,3,6,617,774,1391,6,0.307424,0.321867,0,0.001503,0.001406,153,0.000088,0,28,1,0.011191
48147,Fannin County,,TX,2355,28246,30601,8,8,16,1542,1423,2965,6,0.315395,0.332984,2.543152,0.002818,0.003199,153,0.000179,0,28,0.857143,0.023752
48149,Fayette County,,TX,1363,24229,25592,9,6,15,954,603,1557,6,0.320755,0.338058,17.15219,0.002864,0.00189,153,0.000196,0,28,0.611111,0.022856
48151,Fisher County,,TX,414,4160,4574,1,2,3,65,105,170,7,0.267828,0.278742,0,0.000023,0.000132,153,0.000065,0,28,1,0.000112
48153,Floyd County,,TX,784,8150,8934,2,2,4,169,286,455,7,0.266673,0.277452,0,0.000196,0.000124,153,0.000082,0,28,1,0.001208
48155,Foard County,,TX,127,1642,1769,0,0,0,0,0,0,0,0,0,0,0,0,135,0.00005,121,223,0,0
48157,Fort Bend County,,TX,32902,394242,427144,77,70,147,39654,26363,66017,6,0.387084,0.418186,5901.289817,0.033868,0.03405,153,0.000989,0,28,0.461658,0.246731
48159,Franklin County,,TX,1044,11604,12648,8,5,13,679,387,1066,6,0.311275,0.327663,7.016504,0.002259,0.000978,153,0.000182,0,28,0.696429,0.018299
48161,Freestone County,,TX,1387,17522,18909,6,8,14,640,684,1324,6,0.324623,0.343372,6.026227,0.002695,0.002983,153,0.000138,0,28,0.767857,0.021069
48163,Frio County,,TX,1016,14305,15321,3,5,8,366,499,865,6,0.320119,0.337077,18.516005,0.000788,0.001844,153,0.000097,0,28,0.5,0.006153
48165,Gaines County,,TX,1281,14805,16086,3,5,8,228,428,656,7,0.269816,0.282165,9.169838,0.000204,0.000341,153,0.000111,0,28,0.75,0.001545
48167,Galveston County,,TX,21288,272742,294030,53,46,99,16992,14828,31820,6,0.366675,0.393871,2464.194598,0.020906,0.019142,153,0.000742,0,28,0.481227,0.158909
48169,Garza County,,TX,290,3696,3986,1,1,2,97,103,200,7,0.266599,0.277165,0,0.000154,0.000119,153,0.000067,0,28,0,0.001067
48171,Gillespie County,,TX,1496,23283,24779,8,6,14,761,537,1298,6,0.325095,0.342616,12.928932,0.00348,0.002737,153,0.000181,0,28,0.75,0.029233
48173,Glasscock County,,TX,282,2497,2779,0,0,0,0,0,0,0,0,0,0,0,0,136,0.00005,122,224,0,0
48175,Goliad County,,TX,831,9602,10433,1,2,3,421,369,790,7,0.249293,0.257868,0,0.000051,0.000067,153,0.000065,0,28,1,0.000482
48177,Gonzales County,,TX,1217,19145,20362,6,7,13,479,579,1058,6,0.325204,0.342902,5.879196,0.002451,0.002811,153,0.000142,0,28,0.785714,0.019835
48179,Gray County,,TX,1862,22586,24448,4,7,11,354,652,1006,6,0.324659,0.343516,181.526713,0.000242,0.002188,153,0.000116,0,28,0.761905,0.001632
48181,Grayson County,,TX,7529,113470,120999,26,15,41,5272,4306,9578,6,0.330454,0.350797,1806.523775,0.009612,0.006301,153,0.000437,0,28,0.552707,0.074749
48183,Gregg County,,TX,10635,134546,145181,34,36,70,6560,7129,13689,6,0.348311,0.373054,1410.027755,0.007651,0.010826,153,0.000572,0,28,0.38599,0.059893
48185,Grimes County,,TX,1810,21068,22878,7,6,13,1618,1035,2653,6,0.320578,0.337771,8.800151,0.002246,0.001591,153,0.000159,0,28,0.732143,0.017719
48187,Guadalupe County,,TX,7671,89255,96926,20,17,37,5844,4943,10787,6,0.334754,0.35477,85.872446,0.006144,0.007373,153,0.000333,0,28,0.61413,0.049408
48189,Hale County,,TX,3694,37554,41248,9,14,23,1146,1906,3052,6,0.341197,0.361942,2055.87815,0.000651,0.00517,153,0.000248,0,28,0.495238,0.004993
48191,Hall County,,TX,302,3507,3809,0,0,0,0,0,0,0,0,0,0,0,0,137,0.00005,123,225,0,0
48193,Hamilton County,,TX,689,6658,7347,2,3,5,141,221,362,7,0.270544,0.281849,0.453252,0.000169,0.000244,153,0.000078,0,28,0.666667,0.001198
48195,Hansford County,,TX,549,5913,6462,1,2,3,40,100,140,7,0.259127,0.268867,0,0.000001,0.000066,153,0.000084,0,226,0.5,0.000091
48197,Hardeman County,,TX,455,4701,5156,1,2,3,56,114,170,7,0.269117,0.280674,0,0.000015,0.000134,153,0.000069,0,28,1,0.000098
48199,Hardin County,,TX,4101,52085,56186,10,10,20,3144,2548,5692,6,0.32207,0.339434,7.938597,0.001631,0.001752,153,0.000193,0,28,0.628788,0.013368
48201,Harris County,,TX,195417,3532942,3728359,458,430,888,154942,176613,331555,5,0.47138,0.532049,509721.680333,0.124125,0.117934,153,0.006001,0,28,0.115578,0.86892
48203,Harrison County,,TX,4414,55979,60393,12,15,27,2390,2824,5214,6,0.325168,0.345035,78.553036,0.003124,0.005302,153,0.000254,0,28,0.671429,0.024808
48205,Hartley County,,TX,318,3002,3320,1,0,1,55,0,55,0,0,0,0,0.000001,0,153,0.000078,0,17,0,0.000099
48207,Haskell County,,TX,508,6204,6712,2,1,3,115,80,195,7,0.267778,0.278512,0,0.000017,0.000129,153,0.000075,0,28,0.5,0.000181
48209,Hays County,,TX,10493,88634,99127,35,26,61,11478,7730,19208,6,0.346195,0.369356,346.111488,0.011025,0.010438,153,0.000559,0,28,0.614865,0.08839
48211,Hemphill County,,TX,424,3465,3889,0,2,2,0,88,88,7,0.262455,0.272565,0,0,0.000155,153,0.00005,0,227,1,0
48213,Henderson County,,TX,6300,74238,80538,19,17,36,5009,4136,9145,6,0.329032,0.349077,35.201697,0.005494,0.006081,153,0.00033,0,28,0.664286,0.044847
48215,Hidalgo County,,TX,26609,567169,593778,99,103,202,16448,17018,33466,6,0.388377,0.423833,62445.806167,0.031118,0.033592,153,0.001402,0,28,0.224163,0.234374
48217,Hill County,,TX,2934,32008,34942,7,11,18,1717,1848,3565,6,0.31854,0.336951,6.733895,0.001998,0.003925,153,0.000162,0,28,0.754545,0.0158
48219,Hockley County,,TX,2096,23504,25600,4,5,9,812,929,1741,6,0.31201,0.328896,308.292829,0.000157,0.001039,153,0.00018,0,28,0.433333,0.001368
48221,Hood County,,TX,3699,42221,45920,13,10,23,3221,2187,5408,6,0.315327,0.333127,28.930843,0.004698,0.003326,153,0.00026,0,28,0.685714,0.038753
48223,Hopkins County,,TX,2516,32718,35234,9,10,19,1175,1386,2561,6,0.315293,0.33307,497.821215,0.002332,0.002675,153,0.000224,0,28,0.572727,0.019821
48225,Houston County,,TX,1496,20596,22092,6,6,12,591,617,1208,6,0.320649,0.337886,1.586783,0.001431,0.001238,153,0.000128,0,28,0.678571,0.011448
48227,Howard County,,TX,2410,30362,32772,8,11,19,604,1052,1656,6,0.324696,0.34382,500.934566,0.001489,0.004593,153,0.000155,0,28,0.660256,0.010996
48229,Hudspeth County,,TX,395,3490,3885,1,1,2,85,127,212,7,0.2963,0.308953,0,0.000508,0.00039,153,0.000059,0,28,0,0.002953
48231,Hunt County,,TX,7830,78799,86629,19,24,43,5400,5479,10879,6,0.329368,0.350396,1574.963258,0.004863,0.00641,153,0.000383,0,28,0.513333,0.041282
48233,Hutchinson County,,TX,2402,25901,28303,5,10,15,524,974,1498,6,0.327291,0.347357,320.813317,0.000243,0.003473,153,0.000138,0,28,0.554545,0.001761
48235,Irion County,,TX,225,1786,2011,1,0,1,102,0,102,0,0,0,0,0.00014,0,153,0.000065,0,13,0,0.000897
48237,Jack County,,TX,706,7314,8020,5,4,9,309,257,566,6,0.310378,0.325886,0.75,0.000928,0.000985,153,0.000147,0,28,0.75,0.007714
48239,Jackson County,,TX,1133,15339,16472,4,7,11,421,610,1031,6,0.320861,0.338344,0.45,0.001047,0.002002,153,0.000101,0,28,0.880952,0.00811
48241,Jasper County,,TX,2759,37660,40419,8,9,17,1604,1489,3093,6,0.323539,0.342054,203.088508,0.001222,0.002112,153,0.000171,0,28,0.638889,0.009517
48243,Jeff Davis County,,TX,288,2018,2306,0,0,0,0,0,0,0,0,0,0,0,0,138,0.00005,124,228,0,0
48245,Jefferson County,,TX,16349,257450,273799,38,45,83,7997,11575,19572,6,0.354339,0.380501,3853.244814,0.012893,0.015773,153,0.00055,0,28,0.466939,0.098199
48247,Jim Hogg County,,TX,412,5323,5735,0,0,0,0,0,0,0,0,0,0,0,0,139,0.00005,125,229,0,0
48249,Jim Wells County,,TX,2629,38443,41072,11,11,22,1753,1609,3362,6,0.330604,0.349885,703.337208,0.003016,0.004106,153,0.000207,0,28,0.602564,0.023888
48251,Johnson County,,TX,11099,137634,148733,23,23,46,10363,7741,18104,6,0.342847,0.365457,443.48282,0.007653,0.009267,153,0.000414,0,28,0.563218,0.062138
48253,Jones County,,TX,1690,15846,17536,1,5,6,582,770,1352,6,0.316805,0.333781,2965,0.000165,0.001915,153,0.000062,0,28,0.45,0.001096
48255,Karnes County,,TX,861,13296,14157,2,4,6,215,358,573,6,0.31191,0.326453,0.416667,0.000783,0.000879,153,0.000079,0,28,0.666667,0.00607
48257,Kaufman County,,TX,5996,74510,80506,12,13,25,6723,4416,11139,6,0.324913,0.344404,3.284706,0.003709,0.005204,153,0.000238,0,28,0.857143,0.031691
48259,Kendall County,,TX,2081,24381,26462,6,7,13,1363,1198,2561,6,0.325131,0.342788,25.003541,0.002069,0.002742,153,0.000144,0,28,0.75,0.015978
48261,Kenedy County,,TX,0,0,0,0,0,0,0,0,0,0,0,0,0,0,0,140,0.00005,126,230,0,0
48263,Kent County,,TX,84,1032,1116,0,0,0,0,0,0,0,0,0,0,0,0,141,0.00005,127,231,0,0
48265,Kerr County,,TX,3317,44866,48183,13,13,26,1495,1647,3142,6,0.329854,0.34965,143.9745,0.004787,0.005694,153,0.000255,0,28,0.6375,0.037993
48267,Kimble County,,TX,334,4402,4736,0,0,0,0,0,0,0,0,0,0,0,0,142,0.00005,128,232,0,0
48269,King County,,TX,0,0,0,0,0,0,0,0,0,0,0,0,0,0,0,143,0.00005,129,233,0,0
48271,Kinney County,,TX,252,3179,3431,1,0,1,55,0,55,0,0,0,0,0.000058,0,153,0.000061,0,11,0,0.000435
48273,Kleberg County,,TX,3618,29288,32906,10,14,24,1227,1924,3151,6,0.340159,0.361008,222.777968,0.003926,0.00745,153,0.000175,0,28,0.643382,0.029654
48275,Knox County,,TX,468,4085,4553,0,3,3,0,135,135,7,0.272183,0.284572,0,0,0.000261,153,0.00005,0,234,0.5,0
48277,Lamar County,,TX,3317,51252,54569,12,17,29,1430,1718,3148,6,0.325386,0.345551,2825.658917,0.003716,0.00525,153,0.000283,0,28,0.507353,0.0309
48279,Lamb County,,TX,1282,14614,15896,4,3,7,439,557,996,7,0.266697,0.277624,1,0.000206,0.000125,153,0.000129,0,28,0.666667,0.001417
48281,Lampasas County,,TX,1645,15209,16854,5,5,10,948,676,1624,6,0.307326,0.321981,0,0.001502,0.001842,153,0.000139,0,28,1,0.013566
48283,La Salle County,,TX,372,5616,5988,1,3,4,42,155,197,6,0.311642,0.32588,0,0.000759,0.000891,153,0.000062,0,28,0.833333,0.005778
48285,Lavaca County,,TX,1294,19944,21238,5,6,11,520,731,1251,6,0.320826,0.338172,4.773737,0.00167,0.001893,153,0.000135,0,28,0.666667,0.013881
48287,Lee County,,TX,1029,15823,16852,5,5,10,657,433,1090,6,0.320719,0.337886,0.392857,0.00184,0.00227,153,0.000148,0,28,0.9,0.016722
48289,Leon County,,TX,1426,15335,16761,8,7,15,752,649,1401,6,0.323431,0.341652,16.329097,0.002274,0.002336,153,0.000166,0,28,0.589286,0.017837
48291,Liberty County,,TX,5388,62431,67819,15,13,28,4812,3780,8592,6,0.326189,0.345207,56.507799,0.004164,0.003648,153,0.000255,0,28,0.691176,0.032759
48293,Limestone County,,TX,1633,20823,22456,7,8,15,804,897,1701,6,0.325459,0.344364,7.80594,0.002549,0.003458,153,0.000141,0,28,0.722222,0.019234
48295,Lipscomb County,,TX,362,3008,3370,1,1,2,48,46,94,8,0.207991,0.213058,0,0.000001,0,153,0.000084,0,226,0,0.000091
48297,Live Oak County,,TX,958,10592,11550,3,4,7,245,383,628,6,0.312178,0.326769,0,0.000331,0.001057,153,0.000089,0,28,0.95,0.002503
48299,Llano County,,TX,1310,13554,14864,7,6,13,830,592,1422,6,0.325095,0.342616,8.588344,0.003101,0.003051,153,0.000174,0,28,0.904762,0.025995
48301,Loving County,,TX,0,0,0,0,0,0,0,0,0,0,0,0,0,0,0,144,0.00005,130,235,0,0
48303,Lubbock County,,TX,18463,238308,256771,66,63,129,12045,12460,24505,6,0.363466,0.393051,69882.84808,0.014745,0.019147,153,0.001269,0,28,0.269649,0.115002
48305,Lynn County,,TX,642,6658,7300,2,1,3,290,270,560,7,0.266599,0.277165,0,0.000156,0.000119,153,0.000081,0,28,1,0.00117
48307,McCulloch County,,TX,740,8503,9243,1,2,3,40,108,148,7,0.261139,0.271552,2.89885,0.000627,0.000123,153,0.000066,0,28,0.833333,0.00571
48309,McLennan County,,TX,13730,213611,227341,48,44,92,7930,8901,16831,6,0.359244,0.386085,3208.620077,0.013655,0.01676,153,0.00074,0,28,0.431619,0.105072
48311,McMullen County,,TX,61,809,870,0,0,0,0,0,0,0,0,0,0,0,0,145,0.00005,131,236,0,0
48313,Madison County,,TX,1062,10453,11515,5,6,11,485,592,1077,6,0.320578,0.337771,0.85,0.00119,0.001449,153,0.000133,0,28,0.866667,0.009129
48315,Marion County,,TX,672,7179,7851,5,4,9,449,267,716,6,0.320719,0.337771,24.009071,0.001037,0.001116,153,0.000138,0,28,0.966667,0.008202
48317,Martin County,,TX,463,4437,4900,2,0,2,171,0,171,0,0,0,0,0.000147,0,153,0.000075,0,0,1,0.000929
48319,Mason County,,TX,230,3707,3937,1,0,1,41,0,41,0,0,0,0,0.000627,0,153,0.000066,0,25,0,0.00571
48321,Matagorda County,,TX,3312,44610,47922,9,11,20,1634,1810,3444,6,0.325714,0.34402,15.735443,0.002227,0.003827,153,0.000167,0,28,0.757576,0.018389
48323,Maverick County,,TX,3646,54826,58472,11,15,26,1282,1982,3264,6,0.332457,0.352827,261.340853,0.005099,0.005344,153,0.000187,0,28,0.504167,0.039421
48325,Medina County,,TX,3085,36995,40080,7,8,15,2148,1927,4075,6,0.325204,0.343017,81.890666,0.002404,0.002729,153,0.000168,0,28,0.535714,0.019635
48327,Menard County,,TX,193,2301,2494,0,0,0,0,0,0,0,0,0,0,0,0,146,0.00005,132,237,0,0
48329,Midland County,,TX,9695,122220,131915,39,42,81,5685,6177,11862,6,0.352535,0.378879,17032.677972,0.009902,0.013723,153,0.000629,0,28,0.346667,0.078479
48331,Milam County,,TX,1612,24196,25808,6,6,12,963,809,1772,6,0.322248,0.339995,4.450461,0.002464,0.002898,153,0.00014,0,28,0.809524,0.020592
48333,Mills County,,TX,360,4703,5063,1,1,2,55,77,132,7,0.248972,0.257168,0,0.00005,0.000019,153,0.000069,0,28,0,0.000247
48335,Mitchell County,,TX,681,6987,7668,3,2,5,162,143,305,7,0.242472,0.250479,2.285599,0.000188,0.000005,153,0.00009,0,28,0.833333,0.001121
48337,Montague County,,TX,1449,18486,19935,7,7,14,822,742,1564,6,0.317462,0.334927,307.97767,0.00236,0.002511,153,0.000172,0,28,0.738095,0.018828
48339,Montgomery County,,TX,23959,291448,315407,83,60,143,27888,16792,44680,6,0.371929,0.401714,6460.767604,0.033019,0.025628,153,0.001119,0,28,0.425031,0.242493
48341,Moore County,,TX,1977,21602,23579,6,7,13,494,755,1249,6,0.315875,0.333391,422.328298,0.000757,0.001469,153,0.000157,0,28,0.571429,0.00473
48343,Morris County,,TX,1124,14983,16107,6,6,12,745,581,1326,6,0.311309,0.327835,1.681081,0.001075,0.001053,153,0.000146,0,28,0.785714,0.008368
48345,Motley County,,TX,189,1229,1418,0,0,0,0,0,0,0,0,0,0,0,0,147,0.00005,133,238,0,0
48347,Nacogdoches County,,TX,4879,53452,58331,19,20,39,2327,2857,5184,6,0.329219,0.349708,124.702116,0.004401,0.007056,153,0.000325,0,28,0.57971,0.035882
48349,Navarro County,,TX,3205,43333,46538,11,13,24,1857,1886,3743,6,0.324913,0.344404,17.845201,0.003439,0.005236,153,0.000207,0,28,0.730769,0.027316
48351,Newton County,,TX,905,9630,10535,3,4,7,518,478,996,6,0.320543,0.337484,0,0.000186,0.001139,153,0.00009,0,28,1,0.001382
48353,Nolan County,,TX,1647,16450,18097,5,9,14,390,700,1090,6,0.318122,0.336137,4585.710432,0.000332,0.00286,153,0.000153,0,28,0.555556,0.002293
48355,Nueces County,,TX,25907,332744,358651,72,86,158,13492,18347,31839,6,0.379454,0.412258,19577.567233,0.026587,0.030171,153,0.000983,0,28,0.33739,0.197311
48357,Ochiltree County,,TX,739,9487,10226,2,4,6,89,196,285,7,0.262588,0.273065,2916.046383,0.000001,0.000155,153,0.000157,0,226,0.25,0.000176
48359,Oldham County,,TX,309,2161,2470,1,2,3,70,140,210,7,0.262412,0.272487,0,0.000116,0.000155,153,0.000067,0,28,1,0.000795
48361,Orange County,,TX,6045,93770,99815,15,18,33,3261,3962,7223,6,0.329854,0.350172,659.87977,0.003387,0.00529,153,0.000271,0,28,0.515789,0.027768
48363,Palo Pinto County,,TX,2222,26562,28784,9,7,16,1215,1088,2303,6,0.31519,0.332554,30.040394,0.002332,0.001921,153,0.000205,0,28,0.666667,0.018916
48365,Panola County,,TX,1688,23866,25554,7,8,15,731,870,1601,6,0.323647,0.342111,14.089441,0.002115,0.00217,153,0.000148,0,28,0.75,0.01615
48367,Parker County,,TX,8709,98717,107426,19,17,36,8084,6076,14160,6,0.340997,0.362693,534.570897,0.00668,0.007722,153,0.000359,0,28,0.560606,0.054639
48369,Parmer County,,TX,1295,10307,11602,3,6,9,215,460,675,7,0.268719,0.280863,2968.459577,0.000199,0.000323,98,0.000092,0,28,0.6,0.001338
48371,Pecos County,,TX,1505,14142,15647,3,7,10,172,530,702,6,0.323251,0.341268,251.332291,0.000201,0.002211,153,0.000088,0,28,0.553571,0.001444
48373,Polk County,,TX,5051,52340,57391,27,18,45,3025,2123,5148,6,0.345824,0.36775,1328.777282,0.012509,0.00822,153,0.000406,0,28,0.555172,0.097295
48375,Potter County,,TX,13662,120810,134472,38,36,74,8505,9720,18225,6,0.353435,0.379165,45249.097037,0.011092,0.014419,153,0.000699,0,28,0.35303,0.085123
48377,Presidio County,,TX,1095,9881,10976,4,5,9,243,376,619,7,0.297087,0.310719,0.912769,0.000724,0.000546,153,0.000095,0,28,0.85,0.004429
48379,Rains County,,TX,884,8938,9822,6,5,11,1120,465,1585,6,0.311275,0.327663,0.125,0.002295,0.001028,153,0.000147,0,28,0.952381,0.019108
48381,Randall County,,TX,11251,94988,106239,36,34,70,8640,8122,16762,6,0.349441,0.37459,29687.439021,0.00819,0.012014,153,0.00068,0,28,0.313425,0.063356
48383,Reagan County,,TX,337,3713,4050,0,1,1,0,87,87,7,0.261041,0.271201,0,0,0.000104,153,0.00005,0,239,0,0
48385,Real County,,TX,313,3082,3395,1,1,2,46,42,88,7,0.2448,0.252425,0,0.000025,0.00002,153,0.000065,0,28,0,0.000248
48387,Red River County,,TX,1026,14017,15043,4,4,8,432,484,916,6,0.311509,0.327892,0.305357,0.000963,0.001,153,0.000117,0,28,0.916667,0.007657
48389,Reeves County,,TX,1272,12993,14265,5,4,9,309,498,807,7,0.297057,0.310547,77.481462,0.000729,0.000536,153,0.00011,0,28,0.633333,0.004539
48391,Refugio County,,TX,674,8653,9327,3,4,7,203,289,492,7,0.275336,0.287227,0,0.000358,0.000343,153,0.000086,0,28,1,0.002692
48393,Roberts County,,TX,87,856,943,0,0,0,0,0,0,0,0,0,0,0,0,148,0.00005,134,240,0,0
48395,Robertson County,,TX,1459,16679,18138,2,4,6,606,757,1363,6,0.323323,0.341136,0,0.001102,0.002034,153,0.000076,0,28,0.833333,0.008199
48397,Rockwall County,,TX,4300,39036,43336,9,10,19,4760,2951,7711,6,0.324804,0.343888,3.103795,0.00452,0.004976,153,0.000181,0,28,0.9,0.037812
48399,Runnels County,,TX,1194,12677,13871,2,3,5,238,451,689,7,0.268843,0.280336,0,0.000306,0.000236,153,0.000077,0,28,0.833333,0.001994
48401,Rusk County,,TX,3369,42859,46228,10,10,20,1752,2115,3867,6,0.324804,0.343888,37.868973,0.002964,0.003866,153,0.000208,0,28,0.772727,0.023485
48403,Sabine County,,TX,841,10156,10997,5,5,10,353,333,686,6,0.320578,0.337656,2.072222,0.001143,0.00108,153,0.000122,0,28,0.766667,0.008798
48405,San Augustine County,,TX,729,8313,9042,5,5,10,289,373,662,6,0.320578,0.337656,1.866667,0.001092,0.001088,153,0.000123,0,28,0.75,0.008379
48407,San Jacinto County,,TX,1798,18552,20350,5,6,11,1445,1253,2698,6,0.321891,0.338688,0.1,0.001306,0.001611,153,0.000128,0,28,0.966667,0.010961
48409,San Patricio County,,TX,8129,64773,72902,17,20,37,3789,4400,8189,6,0.341398,0.363565,1563.480038,0.007262,0.008067,153,0.000277,0,28,0.569264,0.056093
48411,San Saba County,,TX,473,5565,6038,0,2,2,0,84,84,6,0.300817,0.31446,0,0,0.000817,153,0.00005,0,241,0.5,0
48413,Schleicher County,,TX,260,3114,3374,1,1,2,77,76,153,7,0.260998,0.271122,0,0.00014,0.000104,153,0.000065,0,28,0,0.000897
48415,Scurry County,,TX,1560,15450,17010,4,11,15,247,734,981,6,0.319908,0.3387,1567.770998,0.000342,0.003095,153,0.000132,0,28,0.727273,0.002375
48417,Shackelford County,,TX,302,3621,3923,1,1,2,48,83,131,7,0.267754,0.278455,0,0.000165,0.000129,153,0.000062,0,28,0,0.001096
48419,Shelby County,,TX,1375,23990,25365,6,8,14,543,639,1182,6,0.323539,0.341939,130.544592,0.00111,0.002072,153,0.000142,0,28,0.607143,0.008546
48421,Sherman County,,TX,285,2478,2763,0,0,0,0,0,0,0,0,0,0,0,0,149,0.00005,135,242,0,0
48423,Smith County,,TX,12792,185226,198018,51,43,94,8767,8633,17400,6,0.349441,0.37545,1874.446537,0.015213,0.01265,153,0.000782,0,28,0.412281,0.118091
48425,Somervell County,,TX,692,6899,7591,4,4,8,350,320,670,6,0.310378,0.325886,0,0.001759,0.000995,153,0.000115,0,28,0.95,0.014012
48427,Starr County,,TX,3428,55188,58616,8,10,18,1169,2134,3303,6,0.344431,0.365652,228.368929,0.004478,0.005657,153,0.000146,0,28,0.719697,0.034688
48429,Stephens County,,TX,956,9761,10717,2,4,6,119,268,387,6,0.312077,0.327571,2.544828,0.000182,0.001025,153,0.000077,0,28,0.666667,0.001309
48431,Sterling County,,TX,160,1265,1425,0,0,0,0,0,0,0,0,0,0,0,0,150,0.00005,136,243,0,0
48433,Stonewall County,,TX,230,1702,1932,0,0,0,0,0,0,0,0,0,0,0,0,151,0.00005,137,244,0,0
48435,Sutton County,,TX,410,4559,4969,1,1,2,49,69,118,7,0.260998,0.271122,0,0.00014,0.000104,153,0.000065,0,28,0,0.000897
48437,Swisher County,,TX,798,8059,8857,2,4,6,159,397,556,7,0.267926,0.279424,0,0.000138,0.000279,153,0.000082,0,28,1,0.000766
48439,Tarrant County,,TX,111315,1532516,1643831,364,310,674,105286,96128,201414,5,0.449791,0.50227,240522.64874,0.108449,0.099907,153,0.004904,0,28,0.15547,0.769407
48441,Taylor County,,TX,14343,129095,143438,48,61,109,5987,8484,14471,6,0.365614,0.395528,43448.807306,0.016028,0.020548,153,0.00086,0,28,0.341219,0.12383
48443,Terrell County,,TX,119,963,1082,0,0,0,0,0,0,0,0,0,0,0,0,152,0.00005,138,245,0,0
48445,Terry County,,TX,1206,12183,13389,2,2,4,202,429,631,7,0.266624,0.277337,0.5,0.000156,0.00012,153,0.000081,0,28,0.666667,0.00117
48447,Throckmorton County,,TX,230,1999,2229,0,1,1,0,59,59,7,0.241028,0.24845,0,0,0.000008,153,0.00005,0,246,0,0
48449,Titus County,,TX,2116,24550,26666,8,10,18,717,1109,1826,6,0.324696,0.343716,67.998393,0.001079,0.00416,153,0.0002,0,28,0.613636,0.008848
48451,Tom Green County,,TX,11471,107595,119066,42,47,89,4857,6171,11028,6,0.353134,0.380581,42087.429638,0.012974,0.017453,153,0.000813,0,28,0.320932,0.09882
48453,Travis County,,TX,83842,819040,902882,295,207,502,80994,72885,153879,5,0.429648,0.473529,107519.679919,0.099248,0.07795,153,0.003825,0,28,0.207032,0.697946
48455,Trinity County,,TX,1209,12575,13784,6,5,11,746,650,1396,6,0.321856,0.338516,2.065472,0.001349,0.001446,153,0.000141,0,28,0.833333,0.011193
48457,Tyler County,,TX,1557,17652,19209,7,7,14,756,882,1638,6,0.321963,0.338918,2.698901,0.001277,0.001289,153,0.000148,0,28,0.785714,0.01011
48459,Upshur County,,TX,2933,31701,34634,14,11,25,1982,1869,3851,6,0.315293,0.333184,8765.437564,0.003918,0.002619,153,0.000379,0,28,0.542857,0.032481
48461,Upton County,,TX,485,3590,4075,0,3,3,0,177,177,7,0.262171,0.272725,0,0,0.000147,153,0.00005,0,247,1,0
48463,Uvalde County,,TX,2038,27751,29789,8,12,20,716,924,1640,6,0.324116,0.34273,5984.936229,0.002426,0.003125,153,0.000213,0,28,0.49359,0.019759
48465,Val Verde County,,TX,4916,45611,50527,12,17,29,1209,1887,3096,6,0.34378,0.365767,6039.016082,0.005657,0.007253,153,0.000206,0,28,0.513158,0.043796
48467,Van Zandt County,,TX,3268,42489,45757,15,10,25,2821,2120,4941,6,0.324696,0.343716,44.103414,0.004094,0.004292,153,0.00029,0,28,0.733333,0.034007
48469,Victoria County,,TX,5880,89247,95127,25,25,50,3755,4056,7811,6,0.332001,0.353469,5890.149084,0.005696,0.006292,153,0.000428,0,28,0.424877,0.046968
48471,Walker County,,TX,4687,42801,47488,19,20,39,2579,3108,5687,6,0.330717,0.35074,195.854678,0.005684,0.006996,153,0.000342,0,28,0.595238,0.04576
48473,Waller County,,TX,2274,23198,25472,5,6,11,1696,1533,3229,6,0.323395,0.34148,8.862249,0.001462,0.002474,153,0.000128,0,28,0.666667,0.011718
48475,Ward County,,TX,1196,11158,12354,3,3,6,238,382,620,6,0.310743,0.326402,81.026731,0.000095,0.001017,153,0.000098,0,28,0.65,0.000833
48477,Washington County,,TX,2070,31167,33237,7,8,15,938,1103,2041,6,0.320826,0.338402,11.884052,0.00179,0.001978,153,0.000187,0,28,0.5,0.014746
48479,Webb County,,TX,8042,215733,223775,24,24,48,3977,4749,8726,6,0.353478,0.377388,4154.74686,0.011388,0.012195,153,0.000404,0,28,0.565341,0.085408
48481,Wharton County,,TX,2727,45620,48347,7,13,20,1290,1791,3081,6,0.325423,0.343934,11.107846,0.001453,0.003742,153,0.000142,0,28,0.679487,0.011357
48483,Wheeler County,,TX,504,5417,5921,0,0,0,0,0,0,0,0,0,0,0,0,154,0.00005,139,248,0,0
48485,Wichita County,,TX,15484,126160,141644,44,71,115,5396,9367,14763,6,0.368068,0.400155,31925.79505,0.016438,0.02373,153,0.000761,0,28,0.306556,0.123547
48487,Wilbarger County,,TX,1176,14491,15667,2,4,6,214,381,595,6,0.317323,0.334354,3133.222183,0.000192,0.001917,153,0.000089,0,28,0.583333,0.001175
48489,Willacy County,,TX,1545,19401,20946,3,5,8,428,807,1235,6,0.325678,0.344037,0,0.00138,0.003109,153,0.000084,0,28,1,0.010497
48491,Williamson County,,TX,26130,232201,258331,117,61,178,36396,20248,56644,6,0.372597,0.40219,8692.598607,0.049256,0.02558,153,0.001594,0,28,0.395109,0.361568
48493,Wilson County,,TX,2541,31395,33936,5,6,11,2097,1601,3698,6,0.327808,0.346096,39.447057,0.001797,0.003579,153,0.000127,0,28,0.666667,0.013965
48495,Winkler County,,TX,721,7328,8049,1,4,5,72,303,375,7,0.261421,0.272212,0,0.000089,0.000183,153,0.000061,0,28,0.75,0.000613
48497,Wise County,,TX,4042,47122,51164,13,10,23,4037,2617,6654,6,0.317601,0.335501,157.019123,0.005051,0.00333,153,0.000274,0,28,0.673077,0.041419
48499,Wood County,,TX,2241,26657,28898,13,12,25,1781,1353,3134,6,0.315361,0.333414,25.249682,0.003028,0.003352,153,0.000296,0,28,0.637363,0.026039
48501,Yoakum County,,TX,769,8028,8797,3,3,6,204,214,418,7,0.266722,0.277652,0,0.000206,0.000157,153,0.000101,0,28,1,0.001545
48503,Young County,,TX,1430,17226,18656,5,8,13,326,613,939,6,0.317462,0.335042,3050.688243,0.001018,0.002528,153,0.000157,0,28,0.388889,0.007878
48505,Zapata County,,TX,567,11110,11677,3,1,4,271,115,386,7,0.261186,0.270286,0,0.000414,0.000092,153,0.000089,0,28,0.833333,0.003122
48507,Zavala County,,TX,873,11107,11980,4,4,8,246,344,590,6,0.314372,0.329521,0.333333,0.000841,0.001617,153,0.000104,0,28,0.85,0.006563
49001,Beaver County,,UT,548,6439,6987,1,4,5,59,267,326,6,0.313897,0.329383,0,0.000036,0.001647,5,0.000068,0,28,1,0.000457
49003,Box Elder County,,UT,3228,49516,52744,7,8,15,2032,1916,3948,6,0.327512,0.345746,635.394307,0.001493,0.002376,5,0.000162,0,28,0.785714,0.009835
49005,Cache County,,UT,9552,92963,102515,32,26,58,4767,5797,10564,6,0.340518,0.362774,7566.298301,0.005912,0.008596,5,0.000521,0,28,0.328078,0.045548
49007,Carbon County,,UT,2050,21799,23849,4,10,14,514,1154,1668,6,0.314747,0.331304,16.323205,0.001224,0.002253,5,0.000091,0,28,0.5,0.00772
49009,Daggett County,,UT,119,855,974,0,0,0,0,0,0,0,0,0,0,0,0,155,0.00005,140,249,0,0
49011,Davis County,,UT,24372,272835,297207,50,66,116,17937,18100,36037,6,0.364697,0.395431,5533.736379,0.019909,0.029466,5,0.00068,0,28,0.472233,0.149485
49013,Duchesne County,,UT,1193,16016,17209,4,7,11,562,728,1290,6,0.298062,0.312516,0.45,0.001224,0.001126,5,0.000096,0,28,0.809524,0.007738
49015,Emery County,,UT,899,11923,12822,3,6,9,254,481,735,6,0.29797,0.312384,1.784471,0.000997,0.000966,5,0.000079,0,28,0.566667,0.00645
49017,Garfield County,,UT,514,4906,5420,0,2,2,0,149,149,7,0.253443,0.26198,0,0,0.000122,5,0.00005,0,250,1,0
49019,Grand County,,UT,779,8405,9184,2,2,4,115,118,233,6,0.298001,0.311925,0,0.000638,0.000639,5,0.000068,0,28,0.833333,0.0042
49021,Iron County,,UT,3559,31978,35537,17,14,31,2247,2147,4394,6,0.336303,0.356209,4474.854714,0.006006,0.004483,5,0.000289,0,28,0.479532,0.045325
49023,Juab County,,UT,687,8672,9359,3,2,5,543,368,911,6,0.297574,0.311266,0,0.000987,0.000824,5,0.000091,0,28,1,0.006523
49025,Kane County,,UT,618,6061,6679,5,5,10,218,301,519,6,0.297818,0.312069,0.451149,0.001677,0.001065,5,0.00012,0,28,0.866667,0.013174
49027,Millard County,,UT,929,13074,14003,2,5,7,250,453,703,6,0.297696,0.311839,0,0.000979,0.000961,5,0.000071,0,28,1,0.006301
49029,Morgan County,,UT,646,8286,8932,3,3,6,457,393,850,6,0.297848,0.311656,0,0.000997,0.000827,5,0.00008,0,28,1,0.006316
49031,Piute County,,UT,166,1362,1528,0,0,0,0,0,0,0,0,0,0,0,0,156,0.00005,141,251,0,0
49033,Rich County,,UT,182,1938,2120,0,0,0,0,0,0,0,0,0,0,0,0,157,0.00005,142,252,0,0
49035,Salt Lake County,,UT,60637,977236,1037873,183,203,386,40689,50350,91039,5,0.423391,0.467469,113191.677243,0.06768,0.076984,5,0.002432,0,28,0.27939,0.49725
49037,San Juan County,,UT,1695,9022,10717,4,11,15,440,1223,1663,6,0.327882,0.346663,10.631582,0.001094,0.002358,5,0.000093,0,28,0.536364,0.007237
49039,Sanpete County,,UT,1645,21311,22956,8,7,15,1066,1037,2103,6,0.297787,0.312241,22.275737,0.002233,0.001017,5,0.000164,0,28,0.791667,0.016418
49041,Sevier County,,UT,1395,19766,21161,7,7,14,736,789,1525,6,0.314033,0.329956,21.574158,0.001926,0.001993,5,0.000152,0,28,0.839286,0.0148
49043,Summit County,,UT,3433,30527,33960,10,13,23,1810,1850,3660,6,0.339167,0.359362,273.701348,0.005785,0.007166,5,0.000172,0,28,0.774725,0.042805
49045,Tooele County,,UT,4114,45748,49862,9,11,20,4171,2416,6587,6,0.336264,0.355808,21.463268,0.00241,0.00447,5,0.000176,0,28,0.810606,0.017642
49047,Uintah County,,UT,1626,24870,26496,6,6,12,830,692,1522,6,0.298307,0.312716,4.737535,0.001279,0.001058,5,0.000113,0,28,0.660714,0.008113
49049,Utah County,,UT,28854,368963,397817,100,106,206,21382,21994,43376,6,0.387393,0.423392,21794.043075,0.034781,0.044764,5,0.001365,0,28,0.393391,0.269438
49051,Wasatch County,,UT,1265,15488,16753,6,4,10,1058,653,1711,6,0.297635,0.31161,0.529762,0.001349,0.000944,5,0.00012,0,28,0.833333,0.008809
49053,Washington County,,UT,7298,86466,93764,30,23,53,6493,4790,11283,6,0.339286,0.36071,2913.130136,0.009166,0.008263,5,0.000455,0,28,0.390121,0.069406
49055,Wayne County,,UT,304,2518,2822,1,0,1,41,0,41,0,0,0,0,0.000619,0,5,0.00006,0,24,0,0.004054
49057,Weber County,,UT,16108,213344,229452,34,38,72,11098,11281,22379,6,0.351002,0.37678,1790.236314,0.015317,0.017538,5,0.000469,0,28,0.556522,0.112902
50001,Addison County,,VT,2393,40544,42937,5,8,13,1121,1247,2368,6,0.29435,0.310538,15.291814,0.000261,0.001086,100,0.000134,0,28,0.553571,0.002273
50003,Bennington County,,VT,2439,42417,44856,8,7,15,845,853,1698,7,0.273987,0.286963,29.657021,0.001472,0.000579,100,0.000141,0,28,0.433333,0.008604
50005,Caledonia County,,VT,2029,33189,35218,8,8,16,924,1029,1953,7,0.270771,0.282709,1620.576666,0.001033,0.000336,100,0.000253,0,28,0.541667,0.008326
50007,Chittenden County,,VT,11991,178346,190337,59,56,115,6780,7443,14223,6,0.37046,0.40004,38302.628164,0.024435,0.026361,100,0.000799,0,28,0.481489,0.167787
50009,Essex County,,VT,557,7287,7844,3,3,6,307,332,639,7,0.227572,0.235287,3.739062,0.000019,0.000024,100,0.000133,0,28,0.333333,0.000466
50011,Franklin County,,VT,2263,45769,48032,5,4,9,1384,1122,2506,7,0.270444,0.281505,3.541667,0.000233,0.000208,100,0.000161,0,28,0.6,0.00199
50013,Grand Isle County,,VT,656,7876,8532,2,3,5,582,443,1025,7,0.270746,0.281849,1.506253,0.000214,0.000209,100,0.000097,0,28,0.666667,0.001525
50015,Lamoille County,,VT,1745,25746,27491,6,5,11,1013,802,1815,7,0.270469,0.281677,116.086043,0.000976,0.000224,100,0.000194,0,28,0.7,0.00758
50017,Orange County,,VT,2250,33581,35831,9,5,14,1683,1337,3020,7,0.270696,0.282193,3.96117,0.00072,0.000328,100,0.000196,0,28,0.597222,0.00617
50019,Orleans County,,VT,1384,29978,31362,6,5,11,640,526,1166,7,0.270494,0.281735,438.62723,0.000227,0.000228,100,0.000218,0,28,0.633333,0.002144
50021,Rutland County,,VT,3514,73227,76741,10,12,22,1325,1405,2730,6,0.296633,0.313622,150.954968,0.002012,0.001944,100,0.000188,0,28,0.438095,0.013386
50023,Washington County,,VT,3920,64463,68383,12,10,22,2120,1957,4077,6,0.29441,0.310882,422.5704,0.001906,0.001084,100,0.000278,0,28,0.429487,0.014241
50025,Windham County,,VT,3490,50208,53698,13,13,26,1498,1622,3120,6,0.296149,0.312877,74.777632,0.003377,0.002404,100,0.000189,0,28,0.55,0.021876
50027,Windsor County,,VT,4825,67008,71833,17,15,32,2580,2648,5228,6,0.296209,0.313307,321.455578,0.003859,0.002434,100,0.000293,0,28,0.486842,0.027203
51001,Accomack County,,VA,1997,38278,40275,5,9,14,580,759,1339,6,0.321535,0.338723,3084.767624,0.00163,0.002904,45,0.000127,0,28,0.4,0.011611
51003,Albemarle County,,VA,10982,105967,116949,40,39,79,5966,6335,12301,6,0.353091,0.379354,30370.438864,0.018656,0.015937,45,0.000647,0,28,0.501961,0.137522
51005,Alleghany County,,VA,744,16151,16895,4,3,7,282,226,508,7,0.230458,0.237731,11755.707168,0.000008,0.000002,45,0.000327,0,28,0.166667,0.000395
51007,Amelia County,,VA,964,14802,15766,7,5,12,689,522,1211,7,0.282123,0.295239,14.520613,0.000888,0.000916,45,0.000164,0,28,0.666667,0.007098
51009,Amherst County,,VA,2027,33473,35500,5,5,10,1349,1159,2508,7,0.238279,0.247115,44.363338,0.000063,0.000026,45,0.000192,0,28,0.5,0.000699
51011,Appomattox County,,VA,823,16547,17370,5,3,8,517,383,900,7,0.23783,0.245997,12.767614,0.000048,0.000009,45,0.00017,0,28,0.4,0.000618
51013,Arlington County,,VA,38848,203087,241935,119,92,211,26997,32439,59436,6,0.386518,0.421551,6088.451536,0.064953,0.052457,45,0.001316,0,28,0.561742,0.451857
51015,Augusta County,,VA,4400,94394,98794,11,11,22,2859,2398,5257,6,0.308927,0.326127,3917.418292,0.001746,0.001856,45,0.000334,0,28,0.358974,0.015012
51017,Bath County,,VA,354,6052,6406,0,0,0,0,0,0,0,0,0,0,0,0,158,0.00005,143,253,0,0
51019,Bedford County,,VA,6161,84217,90378,13,15,28,4147,3775,7922,6,0.312211,0.331292,11641.877296,0.00195,0.002688,45,0.000367,0,28,0.425,0.015296
51021,Bland County,,VA,380,7220,7600,3,2,5,208,108,316,7,0.232672,0.240181,65.215729,0.000012,0.000001,49,0.000117,0,28,0.333333,0.000307
51023,Botetourt County,,VA,3203,43519,46722,8,8,16,2011,1928,3939,6,0.29932,0.315153,18189.896842,0.000201,0.000952,45,0.000322,0,28,0.486111,0.001835
51025,Brunswick County,,VA,1248,18397,19645,5,5,10,496,527,1023,7,0.277783,0.290377,666.23109,0.000312,0.000555,45,0.000162,0,28,0.5,0.003227
51027,Buchanan County,,VA,1264,24701,25965,4,5,9,254,596,850,7,0.225892,0.23387,250.304779,0.000002,0.000004,49,0.000132,0,28,0.333333,0.000411
51029,Buckingham County,,VA,669,14162,14831,5,4,9,367,266,633,7,0.261374,0.271983,774.012378,0.000507,0.000156,45,0.00014,0,28,0.366667,0.004202
51031,Campbell County,,VA,5652,67343,72995,8,11,19,3478,3569,7047,6,0.311175,0.329458,5553.393663,0.000098,0.002215,45,0.000262,0,28,0.386364,0.001471
51033,Caroline County,,VA,1963,27269,29232,8,8,16,1209,1100,2309,7,0.2827,0.296546,62.420414,0.002108,0.001111,45,0.000207,0,28,0.645455,0.016601
51035,Carroll County,,VA,1554,36421,37975,7,6,13,852,660,1512,7,0.258791,0.269277,4825.127094,0.000295,0.000048,101,0.000228,0,28,0.303571,0.002998
51036,Charles City County,,VA,730,9509,10239,4,4,8,392,407,799,7,0.282041,0.294952,0,0.000893,0.000921,45,0.000107,0,28,1,0.007031
51037,Charlotte County,,VA,801,14378,15179,3,5,8,211,327,538,7,0.237869,0.246737,11.368503,0.000014,0.000022,45,0.000114,0,28,0.35,0.000432
51041,Chesterfield County,,VA,23258,320204,343462,108,88,196,19759,16574,36333,6,0.380846,0.413972,70042.608056,0.047029,0.036075,45,0.001486,0,28,0.397934,0.329766
51043,Clarke County,,VA,1220,13567,14787,6,6,12,988,772,1760,6,0.307099,0.322692,0.958396,0.001607,0.001416,45,0.000174,0,28,0.809524,0.013825
51045,Craig County,,VA,309,5574,5883,1,1,2,58,67,125,7,0.253377,0.261943,0,0.000049,0.000052,45,0.000077,0,28,0,0.000507
51047,Culpeper County,,VA,2719,38362,41081,9,8,17,2042,1408,3450,6,0.307229,0.323151,1022.368166,0.001825,0.001789,45,0.000235,0,28,0.638889,0.016132
51049,Cumberland County,,VA,816,10040,10856,4,7,11,266,393,659,7,0.282178,0.295583,61.568812,0.000305,0.000932,45,0.000129,0,28,0.642857,0.003074
51051,Dickenson County,,VA,617,15013,15630,2,3,5,178,212,390,8,0.199137,0.204861,1.489899,0,0.000001,49,0.000104,0,28,0.833333,0.000202
51053,Dinwiddie County,,VA,2053,25713,27766,9,10,19,1285,1398,2683,7,0.283085,0.297234,45.915412,0.000946,0.001001,45,0.00021,0,28,0.588889,0.007804
51057,Essex County,,VA,676,11561,12237,5,3,8,284,173,457,7,0.278395,0.290681,1423.912678,0.000398,0.00039,45,0.000189,0,28,0.4,0.003383
51059,Fairfax County,,VA,115839,1119172,1235011,310,292,602,94318,102223,196541,5,0.442668,0.493865,219150.770974,0.112227,0.106346,45,0.003784,0,28,0.205768,0.777626
51061,Fauquier County,,VA,5106,62563,67669,16,13,29,4357,2951,7308,6,0.307424,0.324068,1303.64714,0.003902,0.003209,45,0.000351,0,28,0.533333,0.033244
51063,Floyd County,,VA,865,17055,17920,4,3,7,446,385,831,7,0.261022,0.270537,0.333333,0.000177,0.000107,45,0.000137,0,28,0.833333,0.001225
51065,Fluvanna County,,VA,1578,19461,21039,5,4,9,1118,728,1846,7,0.261209,0.27161,4.26327,0.000547,0.000196,45,0.000136,0,28,0.6,0.004457
51067,Franklin County,,VA,2993,56339,59332,10,10,20,2049,1685,3734,7,0.261939,0.273054,1733.04343,0.000653,0.000137,45,0.00028,0,28,0.481818,0.005163
51069,Frederick County,,VA,5406,80056,85462,15,12,27,4166,2987,7153,6,0.307456,0.323982,2066.690049,0.003616,0.00206,45,0.000393,0,28,0.4625,0.029563
51071,Giles County,,VA,849,19175,20024,4,3,7,473,380,853,7,0.258653,0.268268,3025.460818,0.000099,0.000036,45,0.000141,0,28,0.416667,0.000666
51073,Gloucester County,,VA,2625,40265,42890,8,7,15,1425,1167,2592,6,0.298276,0.313181,3019.361437,0.001727,0.001325,45,0.000271,0,28,0.589286,0.012314
51075,Goochland County,,VA,2091,25421,27512,5,6,11,1699,1176,2875,7,0.282123,0.295354,0.65,0.000893,0.000962,45,0.000133,0,28,0.9,0.007132
51077,Grayson County,,VA,1068,20049,21117,3,5,8,297,509,806,8,0.210104,0.21669,125.114232,0.000001,0.000004,101,0.000144,0,28,0.3,0.000312
51079,Greene County,,VA,1154,14272,15426,4,5,9,781,649,1430,7,0.261163,0.271668,1.65049,0.000189,0.000197,45,0.000128,0,28,0.7,0.001791
51081,Greensville County,,VA,819,13247,14066,6,7,13,401,366,767,7,0.276594,0.289374,5964.475788,0.00003,0.000399,45,0.000238,0,28,0.190476,0.000735
51083,Halifax County,,VA,1748,41180,42928,7,6,13,642,535,1177,7,0.238925,0.248319,1825.878591,0.000719,0.000032,101,0.000188,0,28,0.238095,0.006686
51085,Hanover County,,VA,6413,99839,106252,14,12,26,5295,3984,9279,6,0.309717,0.327382,322.42591,0.003145,0.002658,45,0.000295,0,28,0.47619,0.02334
51087,Henrico County,,VA,29298,315615,344913,110,102,212,22653,23269,45922,6,0.385493,0.420743,79543.293786,0.046351,0.045263,45,0.001668,0,28,0.384698,0.328902
51089,Henry County,,VA,3365,70400,73765,8,9,17,1579,1801,3380,6,0.299475,0.315692,3030.480668,0.000732,0.001362,101,0.000224,0,28,0.4,0.006266
51091,Highland County,,VA,109,2755,2864,0,0,0,0,0,0,0,0,0,0,0,0,159,0.00005,144,254,0,0
51093,Isle of Wight County,,VA,2393,34722,37115,11,10,21,1935,1303,3238,6,0.298399,0.3138,4426.257066,0.002145,0.001859,45,0.000244,0,28,0.572727,0.014246
51095,James City County,,VA,5327,63616,68943,17,15,32,2940,2371,5311,6,0.310146,0.328317,471.916693,0.006377,0.003896,45,0.000289,0,28,0.544737,0.043962
51097,King and Queen County,,VA,491,6708,7199,2,3,5,172,231,403,7,0.278342,0.290566,0.583333,0.000367,0.000383,45,0.000097,0,28,0.666667,0.002828
51099,King George County,,VA,2406,18913,21319,13,8,21,1276,1038,2314,6,0.329144,0.346675,505.738122,0.00496,0.003025,45,0.000238,0,28,0.608974,0.036446
51101,King William County,,VA,1016,15775,16791,6,4,10,789,524,1313,7,0.278342,0.290681,9.01888,0.000918,0.000411,45,0.000156,0,28,0.714286,0.007422
51103,Lancaster County,,VA,711,14046,14757,2,2,4,129,137,266,8,0.217851,0.223839,18.379428,0.000858,0.000015,45,0.00012,0,28,0.166667,0.006457
51105,Lee County,,VA,980,22271,23251,4,3,7,322,287,609,7,0.244615,0.253901,41.416889,0.000044,0.000016,49,0.000156,0,28,0.5,0.000541
51107,Loudoun County,,VA,17265,197497,214762,99,61,160,26284,11264,37548,6,0.366259,0.396554,9252.095963,0.052168,0.033544,45,0.001253,0,28,0.530099,0.372977
51109,Louisa County,,VA,1680,26191,27871,12,10,22,1286,1066,2352,7,0.282617,0.296747,125.578417,0.002451,0.001262,45,0.00025,0,28,0.613636,0.019928
51111,Lunenburg County,,VA,701,11991,12692,5,4,9,324,251,575,7,0.276095,0.288026,165.345621,0.000308,0.000393,45,0.000144,0,28,0.5,0.003181
51113,Madison County,,VA,894,13276,14170,5,4,9,519,401,920,7,0.261163,0.271553,31.928093,0.000602,0.000182,45,0.000142,0,28,0.7,0.005558
51115,Mathews County,,VA,571,9672,10243,2,1,3,217,140,357,7,0.229766,0.236318,0,0.000352,0.000014,45,0.000093,0,28,1,0.002425
51117,Mecklenburg County,,VA,1904,33132,35036,7,8,15,693,830,1523,7,0.282645,0.296529,2043.652146,0.001194,0.000931,45,0.00019,0,28,0.291667,0.008909
51119,Middlesex County,,VA,658,10252,10910,4,2,6,248,121,369,7,0.278315,0.290394,1465.665968,0.000665,0.000387,45,0.000163,0,28,0.25,0.005687
51121,Montgomery County,,VA,7815,69492,77307,23,28,51,3133,3756,6889,6,0.347478,0.37162,42277.601454,0.004294,0.010868,45,0.00053,0,28,0.391597,0.03206
51125,Nelson County,,VA,1031,15699,16730,4,4,8,434,538,972,7,0.261327,0.27184,122.749382,0.000145,0.000166,45,0.000155,0,28,0.5,0.001585
51127,New Kent County,,VA,1094,15456,16550,8,5,13,1028,582,1610,7,0.282096,0.295182,6.090812,0.001266,0.000987,45,0.000194,0,28,0.732143,0.009843
51131,Northampton County,,VA,736,13802,14538,1,2,3,160,310,470,6,0.296542,0.310589,0,0.000023,0.000667,45,0.000062,0,28,1,0.000179
51133,Northumberland County,,VA,758,12386,13144,5,3,8,321,219,540,7,0.278395,0.290681,3796.64068,0.001222,0.00038,45,0.000208,0,28,0.3,0.009402
51135,Nottoway County,,VA,1000,15341,16341,5,6,11,432,435,867,7,0.277597,0.290205,10.917089,0.000315,0.000558,45,0.000158,0,28,0.533333,0.003232
51137,Orange County,,VA,2359,30426,32785,12,12,24,1674,1406,3080,6,0.307586,0.324212,496.913778,0.001998,0.001989,45,0.000277,0,28,0.5,0.017615
51139,Page County,,VA,1144,28441,29585,5,3,8,484,453,937,7,0.236034,0.243733,2.030631,0.000896,0.000038,45,0.000168,0,28,0.8,0.00708
51141,Patrick County,,VA,853,17575,18428,5,4,9,420,362,782,7,0.232709,0.240904,18.157871,0.00004,0.000021,101,0.000168,0,28,0.4,0.000712
51143,Pittsylvania County,,VA,4161,88778,92939,10,12,22,2665,2450,5115,6,0.286884,0.301829,1296.030841,0.000536,0.000555,101,0.000253,0,28,0.320513,0.004565
51145,Powhatan County,,VA,1402,21890,23292,5,6,11,1331,780,2111,7,0.282096,0.295296,6.727386,0.000877,0.000945,45,0.000126,0,28,0.738095,0.006861
51147,Prince Edward County,,VA,1218,13918,15136,6,9,15,347,580,927,7,0.282206,0.29587,1307.579535,0.000385,0.00077,45,0.000179,0,28,0.319444,0.003281
51149,Prince George County,,VA,5255,32826,38081,22,20,42,3104,2821,5925,6,0.329854,0.350132,1862.518861,0.007124,0.005811,45,0.000324,0,28,0.541311,0.049287
51153,Prince William County,,VA,38640,327159,365799,146,126,272,39816,29094,68910,6,0.393316,0.431911,30072.102403,0.06844,0.054923,45,0.001698,0,28,0.371345,0.480326
51155,Pulaski County,,VA,2227,38842,41069,5,7,12,1041,1148,2189,7,0.261774,0.272108,154.378992,0.000138,0.000093,45,0.000197,0,28,0.380952,0.001163
51157,Rappahannock County,,VA,597,7843,8440,4,3,7,339,208,547,7,0.235327,0.24289,0.6,0.000908,0.000059,45,0.000135,0,28,0.833333,0.007076
51159,Richmond County,,VA,523,8566,9089,3,3,6,286,227,513,8,0.218342,0.224865,6.133983,0.000009,0.000027,45,0.00019,0,28,0.166667,0.000482
51161,Roanoke County,,VA,10700,121151,131851,29,21,50,7347,6713,14060,6,0.339325,0.361318,34111.910909,0.006466,0.006111,45,0.000654,0,28,0.306452,0.04986
51163,Rockbridge County,,VA,1542,27766,29308,4,4,8,397,449,846,7,0.253909,0.263336,9460.192589,0.00087,0.000068,45,0.000211,0,28,0.2,0.006683
51165,Rockingham County,,VA,5018,90740,95758,11,11,22,2995,2715,5710,6,0.308075,0.324762,11188.291032,0.001752,0.001152,45,0.000328,0,28,0.25641,0.01382
51167,Russell County,,VA,1547,30615,32162,6,6,12,689,854,1543,7,0.246002,0.25581,1327.291055,0.000043,0.000014,49,0.000189,0,28,0.5,0.00072
51169,Scott County,,VA,1119,22988,24107,3,4,7,613,706,1319,7,0.244368,0.253632,5.277778,0.000044,0.000017,49,0.000137,0,28,0.75,0.000457
51171,Shenandoah County,,VA,2206,40175,42381,9,8,17,1295,1031,2326,6,0.307391,0.323409,866.542215,0.002101,0.000997,45,0.000266,0,28,0.477778,0.01656
51173,Smyth County,,VA,1613,39104,40717,4,4,8,564,600,1164,7,0.245192,0.254761,690.86517,0.000001,0.000014,49,0.000152,0,28,0.3,0.000408
51175,Southampton County,,VA,1160,19201,20361,8,5,13,609,508,1117,7,0.256259,0.265837,1091.958954,0.000742,0.000113,45,0.000218,0,28,0.388889,0.005156
51177,Spotsylvania County,,VA,8416,105027,113443,40,25,65,9461,5148,14609,6,0.332837,0.353595,1633.361609,0.015749,0.009307,45,0.000596,0,28,0.546341,0.114885
51179,Stafford County,,VA,11641,102423,114064,41,37,78,10174,7441,17615,6,0.346484,0.370818,4057.55255,0.018685,0.01749,45,0.000598,0,28,0.544218,0.138223
51181,Surry County,,VA,515,7031,7546,2,3,5,144,176,320,7,0.279304,0.291438,7.216853,0.000019,0.000337,45,0.000095,0,28,0.333333,0.000332
51183,Sussex County,,VA,807,10308,11115,6,6,12,322,373,695,7,0.277571,0.290274,1366.321562,0.000359,0.000454,45,0.000173,0,28,0.357143,0.003709
51185,Tazewell County,,VA,2444,39997,42441,5,10,15,997,1024,2021,7,0.269691,0.28154,1412.040248,0.000012,0.000101,49,0.000156,0,28,0.233333,0.000513
51187,Warren County,,VA,2512,36317,38829,10,9,19,1669,1298,2967,6,0.307261,0.323323,807.040472,0.001661,0.001567,45,0.000277,0,28,0.509091,0.014724
51191,Washington County,,VA,3488,59862,63350,9,10,19,2172,1818,3990,7,0.248398,0.259167,5250.814809,0.000089,0.000039,49,0.000291,0,28,0.3,0.00116
51193,Westmoreland County,,VA,1196,17605,18801,7,6,13,522,535,1057,7,0.257758,0.267935,2120.560232,0.001792,0.000342,45,0.000194,0,28,0.513889,0.013926
51195,Wise County,,VA,1918,39454,41372,7,8,15,717,949,1666,7,0.244821,0.254824,9415.675463,0.000042,0.000018,49,0.000292,0,28,0.303571,0.000803
51197,Wythe County,,VA,1397,28392,29789,6,5,11,559,585,1144,7,0.259345,0.26946,5353.306044,0.000089,0.000038,49,0.000229,0,28,0.266667,0.00087
51199,York County,,VA,8958,57710,66668,27,25,52,5617,4552,10169,6,0.341478,0.363662,2543.543596,0.011537,0.01142,45,0.00039,0,28,0.56328,0.081899
51510,Alexandria city,,VA,30284,128577,158861,100,64,164,21829,24839,46668,6,0.381646,0.41282,3619.317004,0.055529,0.039304,45,0.001124,0,28,0.627224,0.385709
51515,Bedford city,,VA,334,3685,4019,1,1,2,75,108,183,7,0.237947,0.245854,0,0.000022,0.000016,45,0.000071,0,28,0,0.000222
51520,Bristol city,,VA,1495,12303,13798,3,2,5,1080,969,2049,7,0.244532,0.253419,0,0.000042,0.000014,49,0.00012,0,28,1,0.000431
51530,Buena Vista city,,VA,422,4958,5380,1,1,2,144,169,313,8,0.202508,0.207158,0,0.000001,0.000007,45,0.000095,0,28,0,0.000142
51540,Charlottesville city,,VA,5109,23296,28405,10,13,23,2198,2832,5030,6,0.331056,0.351347,1731.509706,0.002707,0.005358,45,0.000217,0,28,0.628571,0.021626
51550,Chesapeake city,,VA,23765,216068,239833,60,75,135,17872,16941,34813,6,0.375436,0.407006,8654.584846,0.028468,0.034635,45,0.000714,0,28,0.469828,0.197944
51570,Colonial Heights city,,VA,1658,15493,17151,6,7,13,984,1135,2119,7,0.282837,0.29646,0,0.000729,0.000995,45,0.000148,0,28,1,0.006346
51580,Covington city,,VA,360,6282,6642,2,2,4,103,92,195,8,0.187319,0.191328,0,0,0,45,0.000249,0,28,1,0.000187
51590,Danville city,,VA,2625,32124,34749,5,5,10,1426,1651,3077,6,0.284805,0.298165,195.566996,0.000463,0.000472,101,0.000141,0,28,0.666667,0.003796
51595,Emporia city,,VA,337,3904,4241,1,1,2,43,57,100,8,0.216682,0.222545,0,0.000003,0,45,0.000079,0,28,0,0.000103
51600,Fairfax city,,VA,3118,17061,20179,7,7,14,1998,2259,4257,6,0.308043,0.324086,0,0.003593,0.004287,45,0.000139,0,28,1,0.029564
51610,Falls Church city,,VA,1851,9344,11195,5,6,11,1071,1128,2199,6,0.307164,0.322807,0,0.002882,0.003522,45,0.00011,0,28,1,0.022749
51620,Franklin city,,VA,706,7708,8414,3,3,6,273,317,590,7,0.230458,0.237849,0,0.000034,0.000068,45,0.000132,0,28,1,0.000735
51630,Fredericksburg city,,VA,3359,13160,16519,9,7,16,2183,2316,4499,6,0.307196,0.322979,148.032925,0.001928,0.002232,45,0.000215,0,28,0.677778,0.015992
51640,Galax city,,VA,204,2032,2236,0,0,0,0,0,0,0,0,0,0,0,0,160,0.00005,145,255,0,0
51650,Hampton city,,VA,20124,142178,162302,52,51,103,11014,12839,23853,6,0.372931,0.401749,5668.129371,0.025046,0.025914,45,0.000666,0,28,0.571687,0.179041
51660,Harrisonburg city,,VA,3206,14819,18025,5,6,11,1434,1779,3213,6,0.30801,0.324212,1123.006122,0.000888,0.001327,45,0.000188,0,28,0.633333,0.007085
51670,Hopewell city,,VA,2706,22568,25274,7,8,15,1577,1684,3261,6,0.29929,0.315153,29.834081,0.000933,0.001567,45,0.000161,0,28,0.839286,0.007573
51678,Lexington city,,VA,288,2515,2803,0,1,1,0,71,71,8,0.202549,0.207259,0,0,0.000007,45,0.00005,0,256,0,0
51680,Lynchburg city,,VA,5467,47424,52891,9,11,20,2536,3338,5874,6,0.311776,0.330232,5053.269501,0.000955,0.002792,45,0.000257,0,28,0.530303,0.007779
51683,Manassas city,,VA,3804,23066,26870,5,8,13,2191,2449,4640,6,0.307196,0.323094,1.258824,0.001604,0.002603,45,0.000139,0,28,0.785714,0.013659
51685,Manassas Park city,,VA,1302,7043,8345,5,4,9,997,787,1784,6,0.307034,0.322348,0.2,0.001765,0.001497,45,0.000123,0,28,0.95,0.014255
51690,Martinsville city,,VA,1041,12173,13214,3,3,6,560,566,1126,6,0.284721,0.297649,24.035922,0.000017,0.000462,101,0.000113,0,28,0.916667,0.000429
51700,Newport News city,,VA,26356,183304,209660,83,89,172,16385,17295,33680,6,0.386878,0.421001,22336.534701,0.039428,0.042425,45,0.000979,0,28,0.452944,0.27455
51710,Norfolk city,,VA,34576,211514,246090,89,104,193,19991,24102,44093,6,0.389157,0.424957,11576.808336,0.044288,0.051855,45,0.001006,0,28,0.482213,0.311401
51720,Norton city,,VA,361,3974,4335,1,1,2,183,197,380,8,0.196685,0.201576,0,0,0,49,0.000081,0,28,0,0.000105
51730,Petersburg city,,VA,3623,33528,37151,9,8,17,1827,2372,4199,7,0.28303,0.29689,55.45676,0.001564,0.000991,45,0.000191,0,28,0.722222,0.011717
51735,Poquoson city,,VA,1295,13648,14943,3,3,6,564,573,1137,7,0.281114,0.293209,0,0.000641,0.000611,45,0.000084,0,28,1,0.004455
51740,Portsmouth city,,VA,12129,99849,111978,15,25,40,7029,8125,15154,6,0.34382,0.366357,2939.827164,0.006284,0.012337,45,0.00025,0,28,0.660969,0.043276
51750,Radford city,,VA,1622,9552,11174,2,3,5,512,646,1158,7,0.261069,0.270623,0,0.000088,0.000088,45,0.00009,0,28,1,0.000465
51760,Richmond city,,VA,21990,160155,182145,57,60,117,14917,17764,32681,6,0.362514,0.39175,14182.012248,0.019849,0.025869,45,0.000882,0,28,0.403951,0.1443
51770,Roanoke city,,VA,9027,77338,86365,16,16,32,5541,6222,11763,6,0.315122,0.335564,3012.60167,0.002606,0.00499,45,0.000377,0,28,0.463158,0.01887
51775,Salem city,,VA,2166,17711,19877,6,6,12,1241,1502,2743,7,0.261374,0.271587,0,0.000207,0.00013,45,0.000192,0,28,1,0.001602
51790,Staunton city,,VA,1509,15093,16602,4,3,7,774,824,1598,7,0.236265,0.244065,0,0.000154,0.000029,45,0.000148,0,28,1,0.001691
51800,Suffolk city,,VA,5597,70237,75834,16,11,27,5250,3328,8578,6,0.299166,0.315262,6150.25592,0.005569,0.002213,45,0.000314,0,28,0.606618,0.03792
51810,Virginia Beach city,,VA,55008,461345,516353,188,202,390,37056,40659,77715,5,0.421121,0.465835,69476.214465,0.081348,0.085532,45,0.002177,0,28,0.317992,0.562752
51820,Waynesboro city,,VA,1671,16743,18414,5,5,10,929,961,1890,7,0.261374,0.272069,72.11046,0.000154,0.000181,45,0.00019,0,28,0.75,0.001793
51830,Williamsburg city,,VA,928,4235,5163,3,3,6,329,409,738,7,0.279465,0.291552,0,0.000464,0.000461,45,0.000089,0,28,1,0.003401
51840,Winchester city,,VA,2584,16557,19141,8,8,16,1581,1686,3267,6,0.307261,0.32318,1496.906742,0.001192,0.001451,45,0.00028,0,28,0.625,0.010846
53001,Adams County,,WA,1701,18608,20309,4,7,11,473,974,1447,6,0.310676,0.327405,1.841719,0.000463,0.001665,5,0.000096,0,28,0.809524,0.003524
53003,Asotin County,,WA,2279,21834,24113,7,8,15,1234,1199,2433,6,0.307229,0.323719,136.313831,0.00116,0.001988,5,0.000166,0,28,0.655556,0.009286
53005,Benton County,,WA,11118,158171,169289,43,38,81,8495,7650,16145,6,0.347935,0.373266,6029.852913,0.014913,0.013747,5,0.000592,0,28,0.525935,0.116404
53007,Chelan County,,WA,6399,71190,77589,15,21,36,3788,4416,8204,6,0.339127,0.360165,69.595411,0.004363,0.00897,5,0.000216,0,28,0.792208,0.032735
53009,Clallam County,,WA,4265,70393,74658,17,17,34,2368,2244,4612,6,0.33893,0.359334,93.338576,0.008587,0.007971,5,0.000252,0,28,0.831579,0.066054
53011,Clark County,,WA,22514,383894,406408,96,84,180,24550,16643,41193,6,0.362243,0.395276,7521.839804,0.031783,0.029743,5,0.001311,0,28,0.400539,0.249795
53013,Columbia County,,WA,494,5472,5966,1,1,2,190,157,347,7,0.252783,0.260946,0,0.000056,0.000026,5,0.00006,0,28,0,0.000299
53015,Cowlitz County,,WA,5700,99982,105682,22,26,48,3677,3654,7331,6,0.336069,0.357792,6012.399837,0.007152,0.008421,5,0.000372,0,28,0.664021,0.057405
53017,Douglas County,,WA,3671,33682,37353,7,9,16,2638,2644,5282,6,0.329592,0.348125,9.109655,0.001699,0.003407,5,0.000132,0,28,0.944444,0.013586
53019,Ferry County,,WA,815,7262,8077,5,3,8,372,318,690,6,0.306,0.321139,0.166667,0.001484,0.001153,5,0.000128,0,28,0.9,0.011989
53021,Franklin County,,WA,4797,47295,52092,11,12,23,3247,3429,6676,6,0.338417,0.358416,188.488183,0.003301,0.004436,5,0.000173,0,28,0.75641,0.025016
53023,Garfield County,,WA,109,1261,1370,0,0,0,0,0,0,0,0,0,0,0,0,161,0.00005,146,257,0,0
53025,Grant County,,WA,5098,72307,77405,21,23,44,2895,3071,5966,6,0.339325,0.360996,1020.252584,0.005339,0.00563,5,0.000316,0,28,0.54,0.041507
53027,Grays Harbor County,,WA,4432,68753,73185,14,17,31,2590,2879,5469,6,0.331282,0.351279,41.414762,0.003466,0.005488,5,0.000229,0,28,0.771242,0.027823
53029,Island County,,WA,9480,70289,79769,30,32,62,9201,4809,14010,6,0.35322,0.377921,194.669451,0.014154,0.015878,5,0.000381,0,28,0.67042,0.104852
53031,Jefferson County,,WA,2087,28517,30604,6,7,13,1190,995,2185,6,0.311242,0.327124,0,0.00252,0.002498,5,0.00012,0,28,1,0.019862
53033,King County,,WA,136297,1976063,2112360,328,282,610,111549,123095,234644,5,0.440188,0.490718,187546.710779,0.110734,0.098644,5,0.004163,0,28,0.194768,0.779809
53035,Kitsap County,,WA,23693,255398,279091,77,76,153,15555,15943,31498,6,0.371929,0.403457,3343.190781,0.033013,0.033402,5,0.000906,0,28,0.478022,0.245543
53037,Kittitas County,,WA,3238,30701,33939,11,12,23,2094,1825,3919,6,0.329891,0.348899,0.0801,0.002836,0.004093,5,0.000172,0,28,0.956044,0.021784
53039,Klickitat County,,WA,1686,20206,21892,9,8,17,773,726,1499,7,0.286573,0.301528,31.766777,0.00243,0.001418,5,0.000189,0,28,0.688889,0.019667
53041,Lewis County,,WA,4848,72496,77344,16,14,30,3203,3012,6215,6,0.330266,0.349587,82.020257,0.005238,0.004905,5,0.000253,0,28,0.815789,0.04268
53043,Lincoln County,,WA,790,10385,11175,3,2,5,369,385,754,7,0.270393,0.282537,0,0.001091,0.000289,5,0.000088,0,28,1,0.008788
53045,Mason County,,WA,4357,52968,57325,10,9,19,3567,2783,6350,6,0.31191,0.328122,0.422742,0.002839,0.00271,5,0.000174,0,28,0.963636,0.02236
53047,Okanogan County,,WA,3003,39733,42736,10,13,23,1149,1523,2672,6,0.311843,0.328523,4.590131,0.002484,0.002936,5,0.000161,0,28,0.782051,0.018932
53049,Pacific County,,WA,1654,20135,21789,8,8,16,724,817,1541,6,0.311042,0.326952,1.036412,0.002336,0.00202,5,0.000152,0,28,0.888889,0.018809
53051,Pend Oreille County,,WA,1512,15560,17072,5,4,9,990,923,1913,6,0.306064,0.321368,0.869048,0.001473,0.001172,5,0.000141,0,28,0.85,0.011988
53053,Pierce County,,WA,58718,756458,815176,171,182,353,53169,45160,98329,6,0.421121,0.463651,37448.63126,0.064705,0.068659,5,0.002037,0,28,0.294287,0.469793
53055,San Juan County,,WA,1076,15147,16223,5,4,9,478,438,916,6,0.30629,0.321477,0,0.002456,0.001524,5,0.000107,0,28,1,0.018947
53057,Skagit County,,WA,8127,119876,128003,22,26,48,5836,5272,11108,6,0.34196,0.36415,277.300334,0.009768,0.010631,5,0.000315,0,28,0.720443,0.075872
53059,Skamania County,,WA,784,8611,9395,5,3,8,460,350,810,7,0.283887,0.297343,0,0.000945,0.0008,5,0.000125,0,28,0.95,0.008559
53061,Snohomish County,,WA,51302,680451,731753,132,125,257,47935,42592,90527,6,0.388688,0.42705,18322.102796,0.052465,0.049976,5,0.001685,0,28,0.35421,0.38914
53063,Spokane County,,WA,25878,456809,482687,101,97,198,19473,18580,38053,6,0.369284,0.404117,28426.277221,0.030585,0.031475,5,0.001512,0,28,0.321968,0.234595
53065,Stevens County,,WA,2770,36813,39583,7,5,12,1463,1372,2835,6,0.306193,0.321683,4.089467,0.002064,0.001582,5,0.000175,0,28,0.714286,0.016161
53067,Thurston County,,WA,18105,229684,247789,68,50,118,15740,12694,28434,6,0.355075,0.382439,1916.201945,0.02455,0.022346,5,0.000841,0,28,0.465439,0.18511
53069,Wahkiakum County,,WA,351,3743,4094,1,1,2,73,102,175,7,0.251558,0.259989,0,0.000068,0.000058,5,0.000062,0,28,0,0.000552
53071,Walla Walla County,,WA,4127,51828,55955,12,20,32,2028,2455,4483,6,0.338259,0.359145,5879.413095,0.003255,0.006939,5,0.000232,0,28,0.742105,0.026088
53073,Whatcom County,,WA,11187,171265,182452,42,36,78,8128,7341,15469,6,0.341839,0.365468,528.162217,0.016596,0.015536,5,0.000544,0,28,0.626272,0.126548
53075,Whitman County,,WA,4639,31830,36469,15,19,34,1918,2527,4445,6,0.335217,0.355418,107.279801,0.003167,0.006693,5,0.000246,0,28,0.712121,0.024771
53077,Yakima County,,WA,11957,233955,245912,38,52,90,5279,8426,13705,6,0.348728,0.37572,1674.327178,0.01109,0.016089,5,0.000509,0,28,0.484277,0.086499
54001,Barbour County,,WV,806,15540,16346,2,4,6,224,318,542,7,0.232151,0.239794,3.333333,0.000006,0.000002,112,0.00014,0,28,0.583333,0.000212
54003,Berkeley County,,WV,4608,87561,92169,24,12,36,4109,2130,6239,6,0.308337,0.325204,7965.482997,0.005841,0.002251,45,0.00056,0,28,0.398551,0.044892
54005,Boone County,,WV,1553,28870,30423,4,6,10,679,773,1452,6,0.265819,0.276362,8.995952,0.000116,0.000032,112,0.000137,0,28,0.733333,0.000569
54007,Braxton County,,WV,617,14312,14929,3,3,6,162,137,299,6,0.264754,0.274521,6094.73757,0.0001,0.00002,112,0.000196,0,28,0.166667,0.000433
54009,Brooke County,,WV,1743,34448,36191,6,6,12,807,926,1733,6,0.300714,0.315956,5.783239,0.000883,0.000777,112,0.000125,0,28,0.7,0.005878
54011,Cabell County,,WV,6933,105937,112870,16,16,32,3335,3552,6887,5,0.34603,0.367211,9630.416858,0.000959,0.00468,112,0.00044,0,28,0.254941,0.007392
54013,Calhoun County,,WV,507,7094,7601,0,2,2,0,152,152,7,0.236654,0.244761,0,0,0.000008,112,0.00005,0,258,0,0
54015,Clay County,,WV,514,9367,9881,2,1,3,132,114,246,6,0.264682,0.27412,0,0.0001,0.000019,112,0.000124,0,28,1,0.000349
54017,Doddridge County,,WV,595,8966,9561,2,2,4,710,254,964,7,0.232096,0.239393,12.232308,0.000006,0.000001,112,0.000138,0,28,0,0.000201
54019,Fayette County,,WV,2904,48244,51148,4,5,9,946,1228,2174,6,0.265892,0.276362,815.379574,0.00011,0.000029,112,0.000152,0,28,0.55,0.000561
54021,Gilmer County,,WV,407,6109,6516,1,1,2,41,68,109,7,0.209348,0.214105,0,0,0.000001,112,0.000106,0,28,0,0.000095
54023,Grant County,,WV,613,13549,14162,3,2,5,241,171,412,8,0.195652,0.201113,61.048535,0.000001,0,45,0.000219,0,28,0,0.000287
54025,Greenbrier County,,WV,1600,35315,36915,5,5,10,424,368,792,6,0.265383,0.275737,2836.797727,0.00001,0.00002,112,0.000182,0,28,0.238095,0.000489
54027,Hampshire County,,WV,1111,22554,23665,8,5,13,704,529,1233,7,0.236746,0.244948,4418.186396,0.001206,0.000086,45,0.000321,0,28,0.339286,0.009275
54029,Hancock County,,WV,1766,35356,37122,6,6,12,846,907,1753,6,0.300527,0.315709,2.773109,0.000913,0.000787,112,0.000121,0,28,0.666667,0.005928
54031,Hardy County,,WV,648,14067,14715,3,2,5,235,186,421,8,0.191464,0.195839,566.410755,0.00001,0.00001,45,0.000223,0,28,0,0.000467
54033,Harrison County,,WV,4358,77126,81484,8,11,19,1343,2066,3409,6,0.302152,0.318725,21015.530147,0.000146,0.000745,112,0.000331,0,28,0.254545,0.001072
54035,Jackson County,,WV,1465,31427,32892,5,6,11,671,644,1315,6,0.265601,0.27615,16.145216,0.000126,0.000044,112,0.000204,0,28,0.6,0.00077
54037,Jefferson County,,WV,3252,48132,51384,14,7,21,2495,1706,4201,6,0.308075,0.324114,12.212645,0.005241,0.002358,45,0.000277,0,28,0.752747,0.040359
54039,Kanawha County,,WV,11424,233777,245201,23,34,57,4619,5893,10512,5,0.359911,0.385369,75480.226849,0.002393,0.012374,112,0.000708,0,28,0.242532,0.016925
54041,Lewis County,,WV,912,17021,17933,2,3,5,310,363,673,7,0.23217,0.239708,8.333333,0.000006,0.000002,112,0.000135,0,28,0.333333,0.000205
54043,Lincoln County,,WV,1089,19983,21072,6,5,11,687,668,1355,6,0.265431,0.275662,38.579436,0.00015,0.00003,112,0.000193,0,28,0.566667,0.000874
54045,Logan County,,WV,1892,32953,34845,4,6,10,445,808,1253,6,0.302939,0.318914,168.21018,0.000106,0.000774,112,0.000135,0,28,0.6,0.00059
54047,McDowell County,,WV,1208,19626,20834,3,5,8,208,561,769,7,0.235442,0.245003,7867.059743,0.000041,0.000065,49,0.000098,0,28,0.35,0.000793
54049,Marion County,,WV,2838,62760,65598,5,6,11,1083,1170,2253,6,0.301775,0.317492,1757.590026,0.000047,0.000738,112,0.000192,0,28,0.428571,0.000646
54051,Marshall County,,WV,1638,37630,39268,3,5,8,752,791,1543,6,0.30297,0.318845,6867.532178,0.000033,0.000785,112,0.000094,0,28,0.4,0.00045
54053,Mason County,,WV,1157,28025,29182,7,7,14,736,631,1367,6,0.302844,0.318914,1072.620208,0.000906,0.000782,112,0.0002,0,28,0.547619,0.006153
54055,Mercer County,,WV,3483,63438,66921,7,14,21,962,1292,2254,6,0.30297,0.319923,9297.197241,0.000011,0.001376,49,0.000243,0,28,0.192308,0.00069
54057,Mineral County,,WV,1554,29976,31530,5,6,11,849,760,1609,7,0.243182,0.253809,5146.633156,0.000035,0.000105,45,0.000295,0,28,0.266667,0.001094
54059,Mingo County,,WV,1571,25437,27008,4,7,11,401,684,1085,6,0.30373,0.320193,2090.105067,0.000758,0.000778,112,0.00012,0,28,0.160714,0.005537
54061,Monongalia County,,WV,5666,73045,78711,17,22,39,2175,2241,4416,6,0.319661,0.342317,44980.585528,0.002551,0.004989,112,0.000477,0,28,0.21,0.018205
54063,Monroe County,,WV,627,12883,13510,4,4,8,339,306,645,7,0.232765,0.240588,115.011594,0.000012,0.000001,112,0.000167,0,28,0.416667,0.000398
54065,Morgan County,,WV,885,16460,17345,4,2,6,445,267,712,7,0.237171,0.244891,0.382857,0.000639,0.000086,45,0.00015,0,28,0.583333,0.004858
54067,Nicholas County,,WV,1409,27277,28686,3,4,7,295,364,659,6,0.26514,0.275221,5872,0.0001,0.000022,112,0.000167,0,28,0.5,0.00044
54069,Ohio County,,WV,3052,53298,56350,6,8,14,1300,1604,2904,6,0.306226,0.324011,4520.822288,0.001576,0.001524,112,0.000127,0,28,0.571429,0.010729
54071,Pendleton County,,WV,658,9163,9821,1,2,3,53,119,172,7,0.235652,0.24297,389.845518,0.000009,0.000014,45,0.000076,0,28,0,0.000207
54073,Pleasants County,,WV,424,8410,8834,3,1,4,227,146,373,7,0.236572,0.244444,0,0.00002,0.000008,112,0.000129,0,28,0.5,0.000398
54075,Pocahontas County,,WV,536,9489,10025,0,2,2,0,126,126,7,0.210146,0.215728,0,0,0,112,0.00005,0,259,0,0
54077,Preston County,,WV,1280,31967,33247,4,3,7,630,491,1121,7,0.242391,0.251951,45.152827,0.000047,0.000027,112,0.000168,0,28,0.583333,0.000586
54079,Putnam County,,WV,4177,49048,53225,8,8,16,2525,2258,4783,6,0.303223,0.319688,294.017921,0.000194,0.000804,112,0.000232,0,28,0.522222,0.001239
54081,Raleigh County,,WV,4223,77506,81729,9,13,22,1491,1409,2900,6,0.302876,0.319723,10166.542538,0.000189,0.001238,112,0.000265,0,28,0.236264,0.001262
54083,Randolph County,,WV,1346,30387,31733,6,4,10,490,315,805,7,0.242391,0.252123,8531.821781,0.000046,0.000021,112,0.000302,0,28,0.233333,0.000721
54085,Ritchie County,,WV,582,12597,13179,2,2,4,161,231,392,7,0.236688,0.244816,462.918235,0.000014,0.000008,112,0.000146,0,28,0,0.000256
54087,Roane County,,WV,842,14780,15622,3,2,5,417,293,710,6,0.264706,0.274292,114.945866,0.0001,0.00002,112,0.000118,0,28,0.333333,0.000441
54089,Summers County,,WV,694,10404,11098,4,4,8,270,338,608,7,0.23325,0.241466,46.255706,0.000021,0.000002,112,0.000149,0,28,0.583333,0.000412
54091,Taylor County,,WV,674,14172,14846,4,4,8,324,341,665,7,0.242391,0.252123,43.30793,0.000052,0.000022,112,0.000151,0,28,0.6,0.000551
54093,Tucker County,,WV,436,8184,8620,1,1,2,65,143,208,8,0.195114,0.200033,0,0,0,112,0.000114,0,28,0,0.000103
54095,Tyler County,,WV,537,10769,11306,1,3,4,160,242,402,7,0.236823,0.245206,9.83813,0,0.000008,112,0.000068,0,28,0.333333,0.000091
54097,Upshur County,,WV,1059,21900,22959,4,3,7,343,262,605,7,0.232151,0.239651,9,0.000006,0.000002,112,0.000208,0,28,0.583333,0.000394
54099,Wayne County,,WV,2193,37027,39220,6,5,11,1212,1237,2449,6,0.258262,0.267532,692.363062,0.000812,0.000031,112,0.000225,0,28,0.452381,0.005988
54101,Webster County,,WV,389,8588,8977,1,1,2,60,60,120,7,0.209589,0.214454,0,0,0.000001,112,0.000086,0,28,0,0.000095
54103,Wetzel County,,WV,1047,19165,20212,2,4,6,200,383,583,7,0.235061,0.243664,2979.406667,0.000006,0.000001,112,0.000086,0,28,0,0.000183
54105,Wirt County,,WV,531,7486,8017,1,1,2,333,297,630,7,0.236572,0.244444,0,0.000014,0.000008,112,0.000087,0,28,0,0.000165
54107,Wood County,,WV,4710,97873,102583,14,12,26,2064,1964,4028,6,0.309849,0.328626,23389.674603,0.000946,0.001689,112,0.000518,0,28,0.169118,0.007065
54109,Wyoming County,,WV,1143,22975,24118,3,3,6,181,388,569,7,0.238376,0.247448,31.915826,0.000022,0.000008,112,0.000099,0,28,0.333333,0.000314
55001,Adams County,,WI,2014,24388,26402,17,12,29,1776,1280,3056,6,0.328809,0.347775,244.91296,0.003315,0.002202,23,0.000267,0,28,0.562092,0.021799
55003,Ashland County,,WI,1304,20798,22102,2,4,6,351,411,762,7,0.255067,0.264616,81.640305,0.000001,0.000042,127,0.000124,0,28,0.25,0.000188
55005,Barron County,,WI,2970,57359,60329,15,15,30,1703,1720,3423,6,0.307261,0.324223,1330.825122,0.002909,0.001856,127,0.000355,0,28,0.509804,0.021794
55007,Bayfield County,,WI,1034,15246,16280,3,2,5,392,380,772,7,0.233082,0.240279,2963.633398,0.00006,0.000011,127,0.000122,0,28,0.5,0.000723
55009,Brown County,,WI,13236,283455,296691,45,43,88,8903,9007,17910,6,0.354383,0.38073,31883.2056,0.009809,0.009575,23,0.000778,0,28,0.301224,0.073075
55011,Buffalo County,,WI,1132,19849,20981,7,5,12,588,581,1169,7,0.255067,0.264902,13.229147,0.000126,0.000095,127,0.000212,0,28,0.5,0.001747
55013,Burnett County,,WI,1162,20697,21859,11,7,18,907,555,1462,6,0.302057,0.316713,4.827037,0.001562,0.001269,127,0.000253,0,28,0.754545,0.012154
55015,Calumet County,,WI,4578,60062,64640,13,10,23,3913,3314,7227,6,0.296572,0.311048,16.847272,0.002534,0.00118,23,0.000228,0,28,0.884615,0.017433
55017,Chippewa County,,WI,3688,69633,73321,13,11,24,2489,2285,4774,6,0.303603,0.319952,1696.335435,0.002522,0.001422,127,0.000282,0,28,0.521978,0.019103
55019,Clark County,,WI,2298,41015,43313,7,8,15,1091,1317,2408,6,0.287367,0.301141,361.695407,0.000534,0.000481,23,0.000184,0,28,0.607143,0.004136
55021,Columbia County,,WI,4297,65042,69339,11,12,23,3365,2748,6113,6,0.296209,0.310888,35.658767,0.002378,0.001127,23,0.000201,0,28,0.637363,0.015536
55023,Crawford County,,WI,1585,21154,22739,5,6,11,592,868,1460,6,0.287423,0.300843,149.976138,0.000467,0.000401,23,0.000142,0,28,0.566667,0.003412
55025,Dane County,,WI,29489,501257,530746,134,131,265,23788,22174,45962,5,0.401963,0.440099,86308.07743,0.042807,0.051701,23,0.001908,0,28,0.292349,0.307097
55027,Dodge County,,WI,6367,104456,110823,12,18,30,4571,4433,9004,6,0.338023,0.358806,139.984303,0.001517,0.003511,23,0.000212,0,28,0.678363,0.010016
55029,Door County,,WI,1598,35941,37539,9,6,15,905,648,1553,6,0.2963,0.310159,537.620511,0.003087,0.000945,23,0.000175,0,28,0.8,0.01999
55031,Douglas County,,WI,2487,49387,51874,9,9,18,1225,1147,2372,6,0.303603,0.319625,4097.660308,0.001364,0.001385,127,0.000274,0,28,0.44697,0.010449
55033,Dunn County,,WI,3287,42678,45965,13,14,27,1974,2023,3997,6,0.307229,0.324051,707.776849,0.001953,0.002137,127,0.00028,0,28,0.554167,0.014693
55035,Eau Claire County,,WI,7368,98637,106005,33,29,62,4801,4789,9590,6,0.341638,0.364643,17041.766884,0.005026,0.004896,127,0.000695,0,28,0.313063,0.037677
55037,Florence County,,WI,376,5840,6216,1,1,2,135,103,238,8,0.208761,0.214207,0,0.000001,0.000001,113,0.000079,0,28,0,0.000112
55039,Fond du Lac County,,WI,5847,118193,124040,18,18,36,3650,3704,7354,6,0.32907,0.349438,412.266214,0.003673,0.003017,23,0.000307,0,28,0.661905,0.026896
55041,Forest County,,WI,597,10297,10894,4,3,7,182,141,323,7,0.261798,0.271931,0.49,0.000627,0.000119,23,0.000124,0,28,0.75,0.004241
55043,Grant County,,WI,3408,59503,62911,11,13,24,1525,2057,3582,6,0.297178,0.312372,118.311171,0.000873,0.001047,23,0.000242,0,28,0.384615,0.005647
55045,Green County,,WI,2304,43402,45706,5,7,12,1449,1301,2750,6,0.296451,0.310601,77.723955,0.001515,0.000933,23,0.000117,0,28,0.678571,0.010377
55047,Green Lake County,,WI,1489,23930,25419,9,7,16,938,879,1817,6,0.295908,0.309741,34.93448,0.002055,0.000886,23,0.000182,0,28,0.777778,0.014425
55049,Iowa County,,WI,1605,26667,28272,5,5,10,1125,1026,2151,6,0.286884,0.29992,1.333333,0.000447,0.000377,23,0.000141,0,28,0.8,0.003212
55051,Iron County,,WI,444,7407,7851,1,1,2,77,103,180,8,0.193542,0.19764,0,0,0,113,0.000159,0,28,0,0.000098
55053,Jackson County,,WI,1198,21829,23027,7,6,13,703,607,1310,6,0.287196,0.300596,175.263597,0.001035,0.000447,127,0.000171,0,28,0.642857,0.006929
55055,Jefferson County,,WI,6728,93897,100625,12,11,23,4639,4507,9146,6,0.328697,0.347517,53.780377,0.002566,0.002221,23,0.000183,0,28,0.736264,0.016715
55057,Juneau County,,WI,1952,29735,31687,13,8,21,1349,1085,2434,6,0.287139,0.300711,62.064078,0.002481,0.000491,23,0.000225,0,28,0.653846,0.016408
55059,Kenosha County,,WI,10483,178084,188567,18,25,43,7939,6419,14358,6,0.350537,0.3742,197.458103,0.007739,0.009593,23,0.000238,0,28,0.599754,0.053195
55061,Kewaunee County,,WI,1035,22285,23320,3,3,6,632,617,1249,7,0.261727,0.271759,0.166667,0.000102,0.000121,23,0.000106,0,28,0.833333,0.00119
55063,La Crosse County,,WI,6935,120741,127676,31,28,59,3949,4078,8027,6,0.341678,0.364557,10910.453972,0.005087,0.004726,127,0.000576,0,28,0.330252,0.037519
55065,Lafayette County,,WI,1030,18584,19614,4,4,8,612,582,1194,6,0.286884,0.299805,1.777778,0.000435,0.000367,23,0.000117,0,28,0.666667,0.003037
55067,Langlade County,,WI,1172,24291,25463,6,8,14,526,570,1096,6,0.287566,0.301359,56.852226,0.001632,0.00061,23,0.000145,0,28,0.833333,0.011501
55069,Lincoln County,,WI,1829,38068,39897,6,6,12,879,925,1804,6,0.296209,0.309947,4.220882,0.00091,0.000894,23,0.000138,0,28,0.902778,0.005556
55071,Manitowoc County,,WI,3764,100861,104625,9,11,20,1582,2078,3660,6,0.324804,0.34351,779.830267,0.002146,0.00216,23,0.000197,0,28,0.781818,0.015257
55073,Marathon County,,WI,7157,155151,162308,28,29,57,4148,4529,8677,6,0.341719,0.364729,9912.007676,0.003746,0.004821,23,0.00051,0,28,0.393048,0.027307
55075,Marinette County,,WI,2987,51514,54501,11,9,20,1714,1690,3404,6,0.296451,0.31079,1379.228974,0.002457,0.00109,23,0.000228,0,28,0.627273,0.016482
55077,Marquette County,,WI,1247,15784,17031,10,7,17,855,744,1599,6,0.286998,0.300378,17.127991,0.002295,0.000505,23,0.000193,0,28,0.736364,0.015278
55078,Menominee County,,WI,292,5363,5655,2,1,3,114,133,247,7,0.22879,0.235111,0,0.000085,0.000006,23,0.000088,0,28,1,0.000868
55079,Milwaukee County,,WI,52888,1053503,1106391,129,155,284,32491,44206,76697,5,0.416774,0.456072,63859.962681,0.051325,0.065916,23,0.00171,0,28,0.329148,0.36851
55081,Monroe County,,WI,2929,47307,50236,7,8,15,1096,1301,2397,6,0.29627,0.310475,96.049291,0.001987,0.000892,127,0.00017,0,28,0.694444,0.013677
55083,Oconto County,,WI,2324,40755,43079,7,6,13,2037,1528,3565,7,0.261963,0.272648,4.193328,0.000712,0.000219,23,0.00019,0,28,0.738095,0.005324
55085,Oneida County,,WI,2689,44677,47366,17,13,30,1550,1234,2784,6,0.32933,0.348481,951.528811,0.004319,0.002324,23,0.000339,0,28,0.606618,0.030813
55087,Outagamie County,,WI,12537,197173,209710,36,31,67,10162,9369,19531,6,0.341839,0.365101,5062.572225,0.006424,0.005508,23,0.000627,0,28,0.38529,0.047739
55089,Ozaukee County,,WI,6790,104489,111279,15,17,32,5089,4467,9556,6,0.340997,0.362378,63.708531,0.004924,0.005319,23,0.00023,0,28,0.845588,0.03433
55091,Pepin County,,WI,438,6981,7419,4,3,7,268,172,440,7,0.254799,0.264054,1.000111,0.000078,0.000053,127,0.000143,0,28,0.75,0.000964
55093,Pierce County,,WI,2886,43548,46434,11,12,23,1749,1847,3596,6,0.330003,0.349335,1343.649014,0.001492,0.002565,127,0.00027,0,28,0.641026,0.011684
55095,Polk County,,WI,2375,46228,48603,11,12,23,2279,1528,3807,6,0.302403,0.317917,5.824338,0.001571,0.001549,127,0.000254,0,28,0.780303,0.012233
55097,Portage County,,WI,4734,77453,82187,16,20,36,2320,2758,5078,6,0.329368,0.350126,221.293089,0.002617,0.003314,23,0.000291,0,28,0.607143,0.018116
55099,Price County,,WI,1143,18452,19595,2,4,6,137,312,449,7,0.255201,0.265046,25.050123,0.000001,0.000071,23,0.000102,0,28,0.5,0.00019
55101,Racine County,,WI,11717,224257,235974,22,32,54,7487,7290,14777,6,0.34877,0.372601,528.380742,0.00732,0.009271,23,0.0003,0,28,0.5,0.050929
55103,Richland County,,WI,1314,21289,22603,6,6,12,835,745,1580,6,0.287026,0.300321,4.078211,0.00045,0.000419,23,0.000161,0,28,0.690476,0.003339
55105,Rock County,,WI,8474,175681,184155,21,33,54,4832,5139,9971,6,0.353693,0.378695,780.493035,0.004279,0.009582,23,0.00029,0,28,0.43994,0.027612
55107,Rusk County,,WI,1003,17077,18080,3,4,7,269,388,657,7,0.254866,0.264272,0.25,0.000066,0.00009,127,0.000113,0,28,0.833333,0.000969
55109,St. Croix County,,WI,4570,73968,78538,16,13,29,4348,2897,7245,6,0.302434,0.318089,207.699333,0.003139,0.00155,127,0.000326,0,28,0.594771,0.024639
55111,Sauk County,,WI,4130,66128,70258,13,14,27,2580,2589,5169,6,0.324768,0.343854,496.755667,0.00238,0.002003,23,0.000242,0,28,0.5375,0.015772
55113,Sawyer County,,WI,1050,18937,19987,6,4,10,326,281,607,6,0.302152,0.316541,159.593305,0.000731,0.000729,127,0.000185,0,28,0.7,0.005992
55115,Shawano County,,WI,2380,43460,45840,9,10,19,1580,1448,3028,6,0.296633,0.311094,3050.672341,0.000749,0.001006,23,0.000259,0,28,0.644444,0.00577
55117,Sheboygan County,,WI,5642,139029,144671,18,16,34,3082,3231,6313,6,0.340877,0.362063,145.580021,0.004773,0.004108,23,0.000278,0,28,0.760234,0.034918
55119,Taylor County,,WI,1161,21715,22876,4,4,8,435,437,872,7,0.255157,0.264931,2964.720343,0.000068,0.000075,23,0.000121,0,28,0.7,0.000821
55121,Trempealeau County,,WI,1855,30768,32623,5,6,11,992,1109,2101,7,0.25509,0.265074,3.941955,0.000101,0.000123,127,0.000169,0,28,0.6,0.001327
55123,Vernon County,,WI,1546,28401,29947,6,6,12,919,894,1813,6,0.287111,0.300396,5.579224,0.000471,0.000428,127,0.000165,0,28,0.666667,0.003704
55125,Vilas County,,WI,1397,23115,24512,7,2,9,742,367,1109,6,0.294231,0.306794,0.107519,0.002864,0.000447,23,0.000134,0,28,0.880952,0.018326
55127,Walworth County,,WI,6970,101883,108853,18,15,33,5501,4357,9858,6,0.33767,0.358032,87.54764,0.004729,0.004684,23,0.000221,0,28,0.672515,0.029575
55129,Washburn County,,WI,1075,15751,16826,6,6,12,549,517,1066,6,0.302277,0.316971,4.328029,0.000713,0.000753,127,0.000203,0,28,0.666667,0.005961
55131,Washington County,,WI,8504,146692,155196,18,19,37,7327,6102,13429,6,0.341077,0.362722,180.320295,0.004371,0.004188,23,0.00027,0,28,0.677489,0.031171
55133,Waukesha County,,WI,27863,441854,469717,52,83,135,22728,22273,45001,5,0.388221,0.421098,9011.809281,0.017217,0.034193,23,0.000712,0,28,0.383172,0.122205
55135,Waupaca County,,WI,3213,57984,61197,12,12,24,1997,2006,4003,6,0.297696,0.31263,114.72192,0.00151,0.001177,23,0.000231,0,28,0.673077,0.010033
55137,Waushara County,,WI,1620,24046,25666,12,10,22,1198,973,2171,6,0.29636,0.310675,13.7708,0.001472,0.00099,23,0.000231,0,28,0.689394,0.009769
55139,Winnebago County,,WI,11417,178361,189778,39,29,68,8554,8196,16750,6,0.34192,0.365044,2990.636207,0.007114,0.005374,23,0.000637,0,28,0.365273,0.052419
55141,Wood County,,WI,4653,90627,95280,16,17,33,2240,2699,4939,6,0.332571,0.353199,2543.36054,0.002663,0.003103,23,0.000284,0,28,0.583333,0.018259
56001,Albany County,,WY,4278,29503,33781,17,19,36,1612,1754,3366,6,0.332799,0.353188,6295.913579,0.0017,0.006432,98,0.000351,0,28,0.366667,0.015095
56003,Big Horn County,,WY,948,11521,12469,1,3,4,103,276,379,7,0.251885,0.260752,0,0.000006,0.000016,98,0.000066,0,28,0.666667,0.000113
56005,Campbell County,,WY,3251,39806,43057,16,17,33,1412,1338,2750,6,0.331395,0.351313,15045.412356,0.000474,0.003005,98,0.000406,0,28,0.294737,0.003888
56007,Carbon County,,WY,1808,16521,18329,5,7,12,409,609,1018,7,0.276488,0.288844,33.898893,0.000259,0.000485,98,0.000135,0,28,0.714286,0.001719
56009,Converse County,,WY,1591,14046,15637,4,4,8,517,655,1172,7,0.251819,0.26125,7.953831,0.000089,0.000041,98,0.000125,0,28,0.5,0.000766
56011,Crook County,,WY,599,5760,6359,1,3,4,98,240,338,7,0.249957,0.258349,2.675441,0.000024,0.000006,98,0.000071,0,28,0.833333,0.000146
56013,Fremont County,,WY,2859,39672,42531,11,10,21,815,882,1697,7,0.260881,0.272453,3426.75036,0.000333,0.000175,98,0.000263,0,28,0.454545,0.002507
56015,Goshen County,,WY,1098,13322,14420,3,4,7,208,345,553,7,0.258653,0.268532,25.000816,0.000131,0.000111,98,0.000115,0,28,0.35,0.001036
56017,Hot Springs County,,WY,548,5115,5663,2,2,4,110,118,228,7,0.23297,0.239767,0.25,0.000002,0.000004,98,0.000091,0,28,0.666667,0.000217
56019,Johnson County,,WY,667,7568,8235,2,3,5,148,219,367,7,0.251579,0.260752,0,0.000036,0.000041,98,0.000088,0,28,1,0.000265
56021,Laramie County,,WY,8619,93138,101757,37,30,67,3917,3271,7188,6,0.345783,0.369166,20903.583239,0.010256,0.012647,98,0.000676,0,28,0.397992,0.080753
56023,Lincoln County,,WY,1428,16739,18167,4,8,12,369,469,838,6,0.327993,0.346319,21.379332,0.000736,0.002073,5,0.000104,0,28,0.553571,0.004934
56025,Natrona County,,WY,5255,74321,79576,22,25,47,2308,2605,4913,6,0.33572,0.357975,15395.078985,0.004208,0.00735,98,0.000464,0,28,0.396825,0.034759
56027,Niobrara County,,WY,230,2706,2936,0,0,0,0,0,0,0,0,0,0,0,0,162,0.00005,147,260,0,0
56029,Park County,,WY,2635,29507,32142,7,11,18,567,772,1339,6,0.303223,0.318083,9311.910096,0.000226,0.000705,98,0.000199,0,28,0.348485,0.001791
56031,Platte County,,WY,771,9683,10454,3,3,6,186,217,403,7,0.258814,0.268549,2.117782,0.000358,0.00013,98,0.000114,0,28,0.75,0.003406
56033,Sheridan County,,WY,2324,29711,32035,7,9,16,660,798,1458,6,0.328141,0.34652,1750.057626,0.000356,0.001436,98,0.000182,0,28,0.566667,0.002499
56035,Sublette County,,WY,610,6733,7343,0,1,1,0,67,67,7,0.253134,0.261424,0,0,0.000017,98,0.00005,0,261,0,0
56037,Sweetwater County,,WY,3884,44878,48762,12,18,30,934,1451,2385,6,0.338811,0.359838,5511.598381,0.002064,0.005578,98,0.000255,0,28,0.390476,0.015399
56039,Teton County,,WY,2784,19328,22112,7,9,16,412,696,1108,6,0.335217,0.35461,4390.980499,0.00254,0.003747,5,0.000166,0,28,0.4,0.018774
56041,Uinta County,,WY,2093,22222,24315,6,9,15,572,709,1281,6,0.314474,0.330759,13.665637,0.001239,0.002172,5,0.000116,0,28,0.622222,0.008059
56043,Washakie County,,WY,917,9745,10662,2,4,6,94,227,321,7,0.253333,0.262953,12.759424,0.000006,0.000039,98,0.000084,0,28,0.4,0.000201
56045,Weston County,,WY,637,7219,7856,1,2,3,58,162,220,7,0.249936,0.258177,0,0.000024,0.000005,98,0.000071,0,28,1,0.000146
12086,Dade County,,FL,111283,2321618,2432901,212,238,450,63380,98788,162168,5,0.43531,0.481957,39107.048679,0.097899,0.099615,99,0.002417,0,28,0.30906,0.68872
2230,Skagway Hoonah Ango,,AK,482,3585,4067,1,1,2,69,71,140,7,0.248717,0.256509,0,0.000032,0.000019,5,0.000073,0,28,0,0.000252
51560,Clifton Forge,,VA,384,4487,4871,2,2,4,172,183,355,8,0.187319,0.191328,0,0,0,45,0.000249,0,28,1,0.000187
2275,Wrangell Petersburg,,AK,678,7135,7813,1,2,3,45,100,145,7,0.281359,0.294115,0,0.000032,0.000314,5,0.000073,0,28,1,0.000252
2198,Prince Of Wales Oute,,AK,726,5143,5869,1,3,4,71,220,291,7,0.281413,0.294345,0,0.000011,0.000323,5,0.000067,0,28,1,0.00016
