Id,Label,timeset,state,totalmig,totalnonmig,population,indegree,outdegree,Degree,weighted indegree,weighted outdegree,Weighted Degree,Eccentricity,closnesscentrality,harmonicclosnesscentrality,betweenesscentrality,Authority,Hub,modularity_class,pageranks,componentnumber,strongcompnum,clustering,eigencentrality
1001,Autauga County,,AL,5500,50963,56463,26,24,50,15273,13454,28727,6,0.358729,0.379788,1367.395311,0.005639,0.005927,0,0.000291,0,14,0.528736,0.050987
1003,Baldwin County,,AL,9469,164112,173581,87,65,152,34962,22600,57562,5,0.39186,0.419485,11848.623873,0.0219,0.016642,0,0.000844,0,14,0.438828,0.190674
1005,Barbour County,,AL,1793,26722,28515,11,13,24,2803,3978,6781,6,0.313537,0.326787,6249.952732,0.001187,0.000928,0,0.000219,0,14,0.494505,0.010894
1007,Bibb County,,AL,1292,21074,22366,5,4,9,4233,3898,8131,6,0.309085,0.32019,0.431995,0.000505,0.000486,0,0.000102,0,14,0.8,0.004655
1009,Blount County,,AL,3244,52978,56222,11,13,24,12310,9822,22132,6,0.310812,0.323729,3.34771,0.000828,0.001008,0,0.00018,0,14,0.813187,0.008656
1011,Bullock County,,AL,535,8482,9017,4,4,8,962,1273,2235,6,0.298371,0.309504,0.988095,0.00023,0.000198,0,0.000097,0,14,0.75,0.001999
1013,Butler County,,AL,1032,21695,22727,6,10,16,1715,2227,3942,6,0.311521,0.323757,31.488824,0.000554,0.000668,0,0.000118,0,14,0.618182,0.004912
1015,Calhoun County,,AL,6303,122844,129147,36,33,69,14642,15494,30136,6,0.339243,0.35972,4256.312666,0.006007,0.005614,0,0.000446,0,14,0.45061,0.054987
1017,Chambers County,,AL,2189,38853,41042,9,10,19,5374,6483,11857,6,0.323707,0.338538,77.02125,0.000564,0.001314,15,0.000158,0,14,0.627273,0.005046
1019,Cherokee County,,AL,1263,24613,25876,9,7,16,3400,3275,6675,6,0.309627,0.321438,33.799099,0.000654,0.000415,0,0.000163,0,14,0.577778,0.007272
1021,Chilton County,,AL,2099,41436,43535,9,13,22,6342,6051,12393,6,0.312656,0.325866,10.365774,0.000777,0.00114,0,0.000154,0,14,0.807692,0.007117
1023,Choctaw County,,AL,862,15327,16189,6,8,14,635,1065,1700,6,0.310491,0.322881,19.266286,0.00025,0.000585,0,0.000126,0,14,0.597222,0.002444
1025,Clarke County,,AL,1424,29524,30948,10,10,20,2490,3267,5757,6,0.312299,0.32495,48.185568,0.000894,0.000863,0,0.000165,0,14,0.622222,0.008202
1027,Clay County,,AL,810,15637,16447,6,6,12,1729,2086,3815,6,0.309213,0.320661,20.338523,0.000349,0.000336,0,0.000132,0,14,0.733333,0.003423
1029,Cleburne County,,AL,962,14117,15079,5,5,10,2563,2249,4812,7,0.255442,0.264856,5.690188,0.000084,0.000109,15,0.000121,0,14,0.55,0.001372
1031,Coffee County,,AL,4846,44757,49603,27,26,53,11450,10474,21924,6,0.349587,0.369324,1141.976436,0.005878,0.004997,0,0.000292,0,14,0.529356,0.052587
1033,Colbert County,,AL,3165,58520,61685,12,11,23,8607,8661,17268,6,0.321731,0.335597,469.233015,0.001115,0.001184,0,0.000216,0,14,0.576923,0.010869
1035,Conecuh County,,AL,838,14027,14865,7,9,16,1730,2177,3907,6,0.314588,0.328024,4.964252,0.000531,0.001143,0,0.000117,0,14,0.819444,0.005013
1037,Coosa County,,AL,1065,11486,12551,7,6,13,2980,3098,6078,6,0.311328,0.32298,4.36712,0.00066,0.000499,0,0.000134,0,14,0.857143,0.006055
1039,Covington County,,AL,1598,33537,35135,16,18,34,4401,4356,8757,6,0.319235,0.334043,123.626399,0.001459,0.001911,0,0.000217,0,14,0.575163,0.014308
1041,Crenshaw County,,AL,863,14396,15259,6,6,12,2286,2273,4559,6,0.299233,0.310575,1.753887,0.000275,0.000255,0,0.000112,0,14,0.733333,0.002662
1043,Cullman County,,AL,3783,81550,85333,19,15,34,9656,8999,18655,6,0.311037,0.324312,41.288419,0.001426,0.001085,0,0.000275,0,14,0.669591,0.014226
1045,Dale County,,AL,7998,47748,55746,36,34,70,14327,17259,31586,5,0.370316,0.393009,3057.529563,0.008449,0.007912,0,0.000347,0,14,0.594077,0.072541
1047,Dallas County,,AL,2348,46412,48760,13,16,29,3611,5636,9247,6,0.324371,0.340269,145.179926,0.001448,0.001946,0,0.00019,0,14,0.602941,0.012106
1049,DeKalb County,,AL,3362,68337,71699,15,12,27,8007,8394,16401,6,0.312396,0.325899,165.656763,0.001412,0.001023,0,0.000239,0,14,0.463235,0.014025
1051,Elmore County,,AL,5790,74223,80013,31,23,54,22432,17142,39574,6,0.323463,0.340396,535.933539,0.003811,0.002698,0,0.000376,0,14,0.464718,0.035561
1053,Escambia County,,AL,2123,37035,39158,10,13,23,4554,5035,9589,6,0.318693,0.332806,17.400903,0.001596,0.001769,0,0.00014,0,14,0.775641,0.0144
1055,Etowah County,,AL,5156,108127,113283,20,22,42,12836,13112,25948,6,0.329603,0.347354,199.665079,0.002403,0.002968,0,0.000276,0,14,0.600791,0.021632
1057,Fayette County,,AL,816,18325,19141,5,6,11,2031,2432,4463,6,0.309213,0.320578,37.099462,0.000384,0.000359,0,0.000119,0,14,0.733333,0.003514
1059,Franklin County,,AL,1639,31047,32686,11,11,22,3884,4621,8505,6,0.31078,0.323397,993.719354,0.001644,0.000706,0,0.000202,0,14,0.5,0.014903
1061,Geneva County,,AL,1666,25209,26875,8,7,15,4701,4582,9283,6,0.29236,0.304156,4.351829,0.000387,0.000457,0,0.000144,0,14,0.642857,0.004784
1063,Greene County,,AL,543,9364,9907,3,4,7,839,1586,2425,6,0.309022,0.320107,31.245514,0.000379,0.000353,0,0.000081,0,14,0.916667,0.003327
1065,Hale County,,AL,940,17640,18580,4,4,8,2947,2668,5615,6,0.309022,0.320107,0.25,0.000087,0.000355,0,0.000102,0,14,0.9,0.000951
1067,Henry County,,AL,1256,17472,18728,3,4,7,3199,3127,6326,6,0.299741,0.311024,0,0.000092,0.000315,0,0.000086,0,14,1,0.001375
1069,Houston County,,AL,6343,99907,106250,53,35,88,19455,16208,35663,6,0.343825,0.364825,13262.633401,0.013237,0.006758,0,0.000582,0,14,0.520266,0.117323
1071,Jackson County,,AL,2668,56944,59612,11,12,23,5996,6209,12205,6,0.312136,0.325455,124.159921,0.00078,0.000906,0,0.000208,0,14,0.480769,0.00838
1073,Jefferson County,,AL,37782,704651,742433,197,180,377,110934,129107,240041,5,0.446691,0.48214,109937.034963,0.047881,0.050503,0,0.001959,0,14,0.346355,0.423124
1075,Lamar County,,AL,876,15853,16729,6,6,12,1819,2139,3958,6,0.287409,0.298097,14.568228,0.000128,0.000099,0,0.000142,0,14,0.533333,0.001311
1077,Lauderdale County,,AL,4673,93163,97836,22,21,43,11038,11365,22403,6,0.329422,0.346283,2727.83492,0.002086,0.002539,0,0.000364,0,14,0.403333,0.020505
1079,Lawrence County,,AL,1889,36719,38608,7,8,15,5105,5593,10698,6,0.310331,0.322342,2.282431,0.000295,0.000662,0,0.000154,0,14,0.857143,0.003786
1081,Lee County,,AL,9606,114096,123702,64,62,126,31261,26695,57956,5,0.391962,0.41918,9044.758996,0.012989,0.015959,15,0.000686,0,14,0.426306,0.117165
1083,Limestone County,,AL,3810,73410,77220,19,14,33,14849,10319,25168,6,0.321903,0.336263,217.937111,0.002611,0.001459,0,0.000291,0,14,0.489474,0.024827
1085,Lowndes County,,AL,947,13925,14872,5,5,10,2452,3440,5892,6,0.298371,0.309615,1.290388,0.000274,0.000248,0,0.000101,0,14,0.8,0.002514
1087,Macon County,,AL,1523,21524,23047,10,10,20,3182,4058,7240,6,0.324757,0.33973,100.664336,0.000856,0.00176,15,0.000168,0,14,0.570513,0.007637
1089,Madison County,,AL,16834,333999,350833,175,128,303,61200,47622,108822,5,0.425616,0.458877,31970.740709,0.049255,0.040407,0,0.001554,0,14,0.417479,0.422701
1091,Marengo County,,AL,1229,23128,24357,11,14,25,2177,2879,5056,6,0.313374,0.326853,124.52108,0.000805,0.001166,0,0.00019,0,14,0.494505,0.007224
1093,Marion County,,AL,1509,28540,30049,12,11,23,3545,3783,7328,6,0.310812,0.323535,420.589089,0.000424,0.000688,0,0.000229,0,14,0.403846,0.004462
1095,Marshall County,,AL,5037,89885,94922,20,15,35,13967,14102,28069,6,0.311199,0.324589,90.066479,0.003187,0.001114,0,0.000268,0,14,0.602632,0.029734
1097,Mobile County,,AL,16364,418585,434949,119,117,236,44071,43884,87955,5,0.417628,0.45061,29879.020277,0.03213,0.032599,0,0.001058,0,14,0.419602,0.277172
1099,Monroe County,,AL,1175,25312,26487,8,9,17,2131,2530,4661,6,0.314555,0.327968,9.256105,0.000849,0.001137,0,0.00013,0,14,0.763889,0.007831
1101,Montgomery County,,AL,17852,239686,257538,121,131,252,51481,57102,108583,5,0.424894,0.458655,49036.974672,0.030589,0.035292,0,0.001146,0,14,0.402207,0.26426
1103,Morgan County,,AL,6746,124912,131658,32,24,56,17283,17459,34742,6,0.33011,0.34838,1234.139473,0.006308,0.00274,0,0.000392,0,14,0.456349,0.055303
1105,Perry County,,AL,685,11306,11991,5,7,12,815,1703,2518,6,0.311424,0.323258,34.888446,0.000393,0.000545,0,0.000113,0,14,0.690476,0.003542
1107,Pickens County,,AL,1053,20984,22037,5,4,9,2180,2546,4726,6,0.30985,0.32105,37.100892,0.000417,0.000372,0,0.000114,0,14,0.75,0.003647
1109,Pike County,,AL,1937,28350,30287,13,14,27,3902,4563,8465,6,0.313406,0.326814,84.386144,0.001029,0.001094,0,0.000197,0,14,0.595238,0.009975
1111,Randolph County,,AL,1168,22655,23823,11,10,21,2719,2730,5449,6,0.282889,0.294174,65.123996,0.000351,0.00021,15,0.000208,0,14,0.409091,0.005018
1113,Russell County,,AL,5482,50048,55530,15,16,31,15938,15859,31797,6,0.344298,0.361784,226.567164,0.002949,0.004177,15,0.000184,0,14,0.614625,0.023657
1115,St. Clair County,,AL,4611,72121,76732,16,16,32,22112,13624,35736,6,0.313799,0.327769,12.800816,0.001417,0.001463,0,0.000224,0,14,0.779412,0.01375
1117,Shelby County,,AL,14694,179119,193813,82,73,155,60970,44165,105135,5,0.400053,0.428723,8965.796253,0.022583,0.020767,0,0.000809,0,14,0.498723,0.201221
1119,Sumter County,,AL,906,13684,14590,6,6,12,917,1717,2634,6,0.310684,0.322759,26.742512,0.000879,0.000677,0,0.000107,0,14,0.642857,0.006305
1121,Talladega County,,AL,4666,83717,88383,18,19,37,12236,13225,25461,6,0.31393,0.328323,484.240175,0.001233,0.001457,0,0.000276,0,14,0.545238,0.012317
1123,Tallapoosa County,,AL,2543,43194,45737,12,13,25,6183,6179,12362,6,0.311974,0.324839,57.828848,0.000869,0.000883,0,0.000205,0,14,0.621795,0.008311
1125,Tuscaloosa County,,AL,9281,173292,182573,64,61,125,28105,24377,52482,5,0.396672,0.423951,20006.912939,0.011201,0.012698,0,0.000772,0,14,0.343947,0.098052
1127,Walker County,,AL,2903,68673,71576,11,13,24,7293,7774,15067,6,0.312982,0.326021,25.881133,0.000861,0.001147,0,0.000188,0,14,0.666667,0.008879
1129,Washington County,,AL,965,18329,19294,5,5,10,2110,2643,4753,6,0.295059,0.306475,10.78063,0.0003,0.000328,0,0.000112,0,14,0.6,0.003179
1131,Wilcox County,,AL,657,12716,13373,6,7,13,1081,1537,2618,6,0.312136,0.32434,2.994402,0.000536,0.000675,0,0.000114,0,14,0.833333,0.004656
1133,Winston County,,AL,1331,25192,26523,6,8,14,3055,3606,6661,6,0.309627,0.32141,3.244345,0.000335,0.000423,0,0.000133,0,14,0.767857,0.003488
2013,Aleutians East Borough,,AK,281,1615,1896,3,2,5,178,317,495,6,0.33091,0.343908,0,0.001492,0.000872,4,0.000072,0,14,1,0.013225
2016,Aleutians West Census Area,,AK,732,4391,5123,3,4,7,496,986,1482,6,0.350935,0.367305,0.17752,0.001348,0.001682,4,0.000072,0,14,0.95,0.011934
2020,Anchorage Municipality,,AK,27711,294184,321895,210,205,415,69988,79142,149130,5,0.453708,0.489997,82080.135185,0.05141,0.051784,4,0.001977,0,14,0.331827,0.44658
2050,Bethel Census Area,,AK,992,16877,17869,4,5,9,1292,2498,3790,6,0.312982,0.324229,0.583333,0.000469,0.00048,4,0.000096,0,14,0.85,0.004292
2060,Bristol Bay Borough,,AK,140,1298,1438,0,0,0,0,0,0,0,0,0,0,0,0,1,0.000049,1,15,0,0
2068,Denali Borough,,AK,468,2167,2635,2,2,4,260,494,754,6,0.312884,0.323729,0,0.000436,0.000416,4,0.000064,0,14,1,0.003759
2070,Dillingham Census Area,,AK,406,4645,5051,1,1,2,337,547,884,6,0.312136,0.322686,0,0.000305,0.000303,4,0.000057,0,14,0,0.00269
2090,Fairbanks North Star Borough,,AK,11599,97189,108788,80,98,178,20164,24448,44612,5,0.405727,0.435941,15330.087244,0.019242,0.022109,4,0.000777,0,14,0.400629,0.169435
2100,Haines Borough,,AK,206,2582,2788,1,1,2,114,111,225,6,0.263255,0.270761,0,0.000031,0.000021,4,0.000062,0,14,0,0.000261
2105,Hoonah-Angoon Census Area,,AK,0,0,0,0,1,1,0,60,60,6,0.263296,0.270837,0,0,0.000021,4,0.000049,0,16,0,0
2110,Juneau City and Borough,,AK,2933,34902,37835,17,21,38,3251,4473,7724,5,0.357279,0.377275,18240.707051,0.003577,0.005229,4,0.000323,0,14,0.469697,0.032846
2122,Kenai Peninsula Borough,,AK,4036,54688,58724,15,15,30,6743,6095,12838,5,0.354412,0.373197,311.234872,0.003256,0.003838,4,0.000209,0,14,0.655263,0.030842
2130,Ketchikan Gateway Borough,,AK,1310,14620,15930,6,7,13,1069,1397,2466,6,0.331714,0.345656,584.309732,0.000865,0.001677,4,0.00013,0,14,0.583333,0.008035
2150,Kodiak Island Borough,,AK,1954,14952,16906,9,10,19,1215,2737,3952,5,0.357151,0.37515,54.658347,0.002658,0.00348,4,0.000133,0,14,0.590909,0.023292
2164,Lake and Peninsula Borough,,AK,152,1501,1653,1,1,2,140,220,360,6,0.312136,0.322686,0,0.000305,0.000303,4,0.000057,0,14,0,0.00269
2170,Matanuska-Susitna Borough,,AK,5266,72221,77487,29,21,50,20707,10553,31260,5,0.357321,0.37733,1387.366109,0.007032,0.005288,4,0.000368,0,14,0.481855,0.064148
2180,Nome Census Area,,AK,692,8980,9672,3,5,8,563,1251,1814,6,0.312982,0.324229,0.25,0.000438,0.00048,4,0.000081,0,14,0.85,0.003846
2185,North Slope Borough,,AK,604,6824,7428,2,3,5,468,1191,1659,6,0.312917,0.323896,0,0.000436,0.000458,4,0.000064,0,14,1,0.003759
2188,Northwest Arctic Borough,,AK,525,6313,6838,3,4,7,579,898,1477,6,0.312949,0.324062,0,0.000438,0.00046,4,0.000078,0,14,0.916667,0.003846
2195,Petersburg Census Area,,AK,0,0,0,0,0,0,0,0,0,0,0,0,0,0,0,2,0.000049,2,17,0,0
2220,Sitka City and Borough,,AK,956,9845,10801,4,5,9,572,806,1378,6,0.331202,0.344685,12.971731,0.000858,0.000914,4,0.000092,0,14,0.666667,0.007858
2240,Southeast Fairbanks Census Area,,AK,599,6814,7413,4,4,8,1144,1241,2385,6,0.312949,0.324062,13.055283,0.000956,0.000461,4,0.000087,0,14,0.85,0.00865
2261,Valdez-Cordova Census Area,,AK,1185,10925,12110,5,5,10,1246,1986,3232,6,0.331567,0.345062,9.143099,0.000492,0.001046,4,0.000109,0,14,0.866667,0.004569
2270,Wade Hampton Census Area,,AK,408,7060,7468,3,4,7,709,1055,1764,6,0.312949,0.324062,0,0.000438,0.000461,4,0.00008,0,14,1,0.003849
2282,Yakutat City and Borough,,AK,45,563,608,0,0,0,0,0,0,0,0,0,0,0,0,3,0.000049,3,18,0,0
2290,Yukon-Koyukuk Census Area,,AK,669,5971,6640,2,3,5,858,1494,2352,6,0.312917,0.323896,0,0.000436,0.000458,4,0.000064,0,14,1,0.003759
4001,Apache County,,AZ,7322,56445,63767,18,16,34,23555,22790,46345,5,0.355377,0.374306,82.777739,0.004279,0.00415,4,0.000218,0,14,0.74269,0.040708
4003,Cochise County,,AZ,12715,117649,130364,66,68,134,28849,29956,58805,5,0.396515,0.424162,1385.454599,0.021201,0.021372,4,0.000549,0,14,0.579254,0.184658
4005,Coconino County,,AZ,13091,121341,134432,49,54,103,33509,36625,70134,5,0.379676,0.405437,642.272683,0.015691,0.016638,4,0.000461,0,14,0.668644,0.14187
4007,Gila County,,AZ,4133,50210,54343,16,11,27,12176,10171,22347,5,0.354454,0.372531,5.447941,0.005291,0.003258,4,0.000184,0,14,0.895833,0.047678
4009,Graham County,,AZ,1773,25567,27340,11,10,21,6162,4422,10584,5,0.350239,0.367288,29.333364,0.002329,0.001973,4,0.000169,0,14,0.795455,0.023298
4011,Greenlee County,,AZ,662,7244,7906,6,5,11,1219,1719,2938,5,0.349994,0.3664,0.44881,0.000847,0.001447,4,0.000117,0,14,0.904762,0.009721
4012,La Paz County,,AZ,1401,14209,15610,10,8,18,2904,2962,5866,5,0.352045,0.369396,0,0.004534,0.003219,4,0.000118,0,14,1,0.03931
4013,Maricopa County,,AZ,157013,3492040,3649053,833,727,1560,842811,636055,1478866,4,0.537388,0.604278,818692.78133,0.117642,0.113152,4,0.007504,0,14,0.083072,1
4015,Mohave County,,AZ,12889,166946,179835,76,68,144,50926,33929,84855,5,0.375688,0.403634,618.336117,0.020447,0.017528,4,0.000638,0,14,0.564262,0.178736
4017,Navajo County,,AZ,7923,91946,99869,25,23,48,27422,22765,50187,5,0.359976,0.379888,127.090487,0.006897,0.005807,4,0.000266,0,14,0.695157,0.061987
4019,Pima County,,AZ,46259,911995,958254,376,305,681,178812,144154,322966,5,0.47675,0.518597,58687.724539,0.091739,0.079698,4,0.002878,0,14,0.266258,0.752867
4021,Pinal County,,AZ,17395,179692,197087,136,53,189,145313,57210,202523,5,0.382383,0.408039,1437.035803,0.041579,0.018114,4,0.001021,0,14,0.529534,0.345407
4023,Santa Cruz County,,AZ,2318,47330,49648,10,6,16,6960,7143,14103,5,0.357491,0.374867,0,0.005142,0.002923,4,0.000114,0,14,1,0.044016
4025,Yavapai County,,AZ,13171,185736,198907,94,70,164,58359,34250,92609,5,0.383017,0.411052,1236.653058,0.029642,0.02006,4,0.000763,0,14,0.595755,0.254698
4027,Yuma County,,AZ,10868,182377,193245,70,58,128,35722,26784,62506,5,0.386466,0.41306,286.671747,0.02081,0.019422,4,0.000567,0,14,0.680109,0.186082
5001,Arkansas County,,AR,1183,21596,22779,6,8,14,1800,2455,4255,6,0.308514,0.320284,5.861356,0.000321,0.000456,0,0.00014,0,14,0.75,0.00331
5003,Ashley County,,AR,1359,23834,25193,7,9,16,1525,2045,3570,6,0.308387,0.320534,52.317654,0.000361,0.000377,0,0.00013,0,14,0.486111,0.003173
5005,Baxter County,,AR,2659,40036,42695,22,13,35,5075,4199,9274,6,0.313537,0.326925,6374.259317,0.005772,0.000817,0,0.000351,0,14,0.448617,0.051389
5007,Benton County,,AR,13997,187219,201216,123,70,193,55878,36562,92440,5,0.404035,0.431419,25353.571047,0.030894,0.01825,0,0.001312,0,14,0.375369,0.264195
5009,Boone County,,AR,2318,36126,38444,13,14,27,5099,5139,10238,6,0.313243,0.326565,4557.210856,0.000697,0.000911,0,0.000338,0,14,0.428571,0.008939
5011,Bradley County,,AR,713,11588,12301,4,6,10,761,1273,2034,6,0.307409,0.318536,197.285577,0.00026,0.000241,0,0.000099,0,14,0.533333,0.00231
5013,Calhoun County,,AR,367,5220,5587,4,3,7,597,685,1282,7,0.257104,0.264967,2.144048,0.000024,0.000016,0,0.000105,0,14,0.416667,0.000443
5015,Carroll County,,AR,1937,26030,27967,11,8,19,3082,3392,6474,6,0.301788,0.313277,115.072938,0.001624,0.000543,0,0.000224,0,14,0.681818,0.016067
5017,Chicot County,,AR,927,11988,12915,6,7,13,1205,1757,2962,6,0.308039,0.31948,18.778951,0.000313,0.000326,0,0.000116,0,14,0.595238,0.002844
5019,Clark County,,AR,1769,20947,22716,11,13,24,2978,3549,6527,6,0.334633,0.351276,636.163555,0.000389,0.001235,0,0.000219,0,14,0.519048,0.004419
5021,Clay County,,AR,1112,17121,18233,6,6,12,2086,2810,4896,7,0.26453,0.274254,125.464435,0.00004,0.000035,0,0.000176,0,14,0.566667,0.000781
5023,Cleburne County,,AR,1470,24610,26080,9,9,18,3523,3320,6843,6,0.30899,0.321116,59.053315,0.000793,0.000457,0,0.000207,0,14,0.733333,0.007409
5025,Cleveland County,,AR,597,8934,9531,5,6,11,1675,1620,3295,6,0.307315,0.31837,5.234314,0.000281,0.000257,0,0.000122,0,14,0.5,0.002585
5027,Columbia County,,AR,1450,24677,26127,9,15,24,2014,2879,4893,6,0.343904,0.362067,1067.610873,0.000338,0.001727,0,0.000165,0,14,0.490476,0.003427
5029,Conway County,,AR,1302,21018,22320,6,6,12,3295,3314,6609,6,0.307377,0.318481,1.620635,0.000318,0.000297,0,0.000157,0,14,0.809524,0.00337
5031,Craighead County,,AR,6086,85084,91170,38,35,73,18362,15024,33386,6,0.356727,0.379594,23808.599719,0.003419,0.004265,0,0.000622,0,14,0.273171,0.032854
5033,Crawford County,,AR,4390,57728,62118,15,14,29,13583,12506,26089,6,0.342141,0.360469,786.493677,0.002012,0.001615,0,0.000249,0,14,0.575,0.017882
5035,Crittenden County,,AR,3441,52644,56085,16,15,31,8311,8202,16513,6,0.3566,0.376487,399.032724,0.002372,0.002644,0,0.000228,0,14,0.511696,0.019387
5037,Cross County,,AR,1411,19604,21015,8,10,18,2717,3254,5971,6,0.325319,0.339486,54.882621,0.000782,0.000827,0,0.000157,0,14,0.677778,0.007121
5039,Dallas County,,AR,677,8594,9271,5,6,11,829,1144,1973,6,0.307377,0.318481,364.312605,0.000269,0.000237,0,0.000132,0,14,0.433333,0.002421
5041,Desha County,,AR,1046,14737,15783,6,6,12,1611,2217,3828,6,0.307346,0.318398,21.945234,0.000741,0.000304,0,0.000118,0,14,0.666667,0.005155
5043,Drew County,,AR,1314,17894,19208,8,12,20,2620,2783,5403,6,0.308895,0.321366,28.055654,0.000301,0.000534,0,0.000157,0,14,0.537879,0.002937
5045,Faulkner County,,AR,6873,95622,102495,61,38,99,24941,19083,44024,5,0.36986,0.393853,10020.524067,0.008262,0.005081,0,0.000888,0,14,0.239583,0.076334
5047,Franklin County,,AR,1179,17478,18657,7,7,14,2967,3049,6016,6,0.292104,0.302802,0.966522,0.000292,0.000383,0,0.000154,0,14,0.97619,0.003904
5049,Fulton County,,AR,781,10501,11282,6,6,12,1539,1651,3190,7,0.264041,0.273833,518.782808,0.000034,0.000059,0,0.000174,0,14,0.5,0.00099
5051,Garland County,,AR,5610,92372,97982,48,33,81,15025,11793,26818,5,0.37891,0.402369,13399.958104,0.010568,0.007225,0,0.00061,0,14,0.392287,0.092729
5053,Grant County,,AR,1260,17970,19230,9,7,16,3804,3398,7202,6,0.307409,0.318647,5.259896,0.000385,0.000414,0,0.0002,0,14,0.652778,0.004399
5055,Greene County,,AR,2067,40360,42427,10,11,21,5886,4935,10821,6,0.326273,0.340929,1665.119691,0.000745,0.00083,0,0.000207,0,14,0.439394,0.006797
5057,Hempstead County,,AR,1578,22706,24284,9,13,22,2698,3540,6238,6,0.334447,0.350999,1079.500393,0.000426,0.001113,0,0.000162,0,14,0.532967,0.004322
5059,Hot Spring County,,AR,2023,30532,32555,7,6,13,5472,5245,10717,6,0.307409,0.318536,0.566667,0.000379,0.000373,0,0.00016,0,14,0.904762,0.004082
5061,Howard County,,AR,974,15086,16060,7,9,16,1547,1957,3504,6,0.309022,0.321283,119.828943,0.000063,0.000472,0,0.00015,0,14,0.522222,0.001083
5063,Independence County,,AR,2302,36354,38656,12,14,26,4440,5122,9562,6,0.30934,0.322254,1067.916959,0.000882,0.000673,0,0.000264,0,14,0.528571,0.008552
5065,Izard County,,AR,860,11964,12824,5,6,11,1287,1544,2831,7,0.263624,0.273111,7.568255,0.000035,0.000064,0,0.000148,0,14,0.566667,0.00095
5067,Jackson County,,AR,1085,15980,17065,7,7,14,1865,2327,4192,6,0.307724,0.319091,176.321008,0.000309,0.000315,0,0.00016,0,14,0.571429,0.002918
5069,Jefferson County,,AR,4947,83049,87996,24,27,51,8974,13156,22130,6,0.361666,0.383727,3305.28969,0.004084,0.003964,0,0.000354,0,14,0.391129,0.036084
5071,Johnson County,,AR,1368,23049,24417,9,9,18,2610,2822,5432,6,0.308831,0.320922,18.237575,0.00055,0.000657,0,0.000181,0,14,0.866667,0.006057
5073,Lafayette County,,AR,567,7427,7994,4,5,9,593,1033,1626,7,0.261058,0.270237,3.251278,0.00004,0.000076,0,0.000097,0,14,0.65,0.000599
5075,Lawrence County,,AR,1292,16791,18083,6,6,12,2223,2712,4935,7,0.263116,0.272335,4.442857,0.000038,0.000035,0,0.000157,0,14,0.566667,0.000774
5077,Lee County,,AR,620,8711,9331,5,7,12,839,1503,2342,6,0.32599,0.340041,1.714611,0.000737,0.000823,0,0.000101,0,14,0.857143,0.006314
5079,Lincoln County,,AR,845,11305,12150,5,5,10,1513,1801,3314,6,0.307252,0.318148,1.166667,0.000283,0.000258,0,0.000114,0,14,0.8,0.002608
5081,Little River County,,AR,884,13465,14349,4,5,9,1590,1802,3392,7,0.261764,0.271031,0.994042,0.000055,0.000069,89,0.000103,0,14,0.8,0.000847
5083,Logan County,,AR,1472,22399,23871,9,10,19,3152,3691,6843,6,0.292445,0.3038,56.410239,0.000445,0.000436,0,0.000183,0,14,0.763636,0.004512
5085,Lonoke County,,AR,5215,61522,66737,26,16,42,19418,13990,33408,6,0.339397,0.356009,688.695669,0.003308,0.001752,0,0.000385,0,14,0.407692,0.0303
5087,Madison County,,AR,1104,14776,15880,3,3,6,3202,2657,5859,6,0.291707,0.301664,0,0.00021,0.000312,0,0.000103,0,14,1,0.002958
5089,Marion County,,AR,1264,14936,16200,3,3,6,1866,2121,3987,6,0.288153,0.298202,25.31826,0.000634,0.000159,0,0.000099,0,14,0.75,0.005919
5091,Miller County,,AR,3725,40442,44167,18,16,34,11341,10841,22182,6,0.33806,0.355992,6165.750011,0.003317,0.002399,89,0.000252,0,14,0.447619,0.028973
5093,Mississippi County,,AR,3059,48305,51364,10,14,24,4070,5780,9850,6,0.326451,0.341539,262.150057,0.001412,0.000964,0,0.000179,0,14,0.466667,0.01267
5095,Monroe County,,AR,713,9183,9896,4,8,12,728,1401,2129,6,0.307755,0.319258,3.214837,0.000268,0.000336,0,0.000092,0,14,0.680556,0.002357
5097,Montgomery County,,AR,638,8109,8747,3,3,6,799,966,1765,6,0.274991,0.283866,1.725595,0.000047,0.000067,0,0.000103,0,14,0.666667,0.000814
5099,Nevada County,,AR,775,9625,10400,4,8,12,1117,1620,2737,6,0.307882,0.319591,4.8014,0.00003,0.000298,0,0.000096,0,14,0.660714,0.000405
5101,Newton County,,AR,627,8057,8684,3,2,5,943,1211,2154,6,0.28796,0.297759,0.258824,0.000116,0.000125,0,0.000101,0,14,0.833333,0.001514
5103,Ouachita County,,AR,1803,27750,29553,9,12,21,2560,3434,5994,6,0.334447,0.350888,3458.479539,0.000876,0.001065,0,0.000175,0,14,0.530303,0.008131
5105,Perry County,,AR,798,10057,10855,6,6,12,2159,2223,4382,6,0.307346,0.318425,0.75,0.000322,0.000326,0,0.00015,0,14,0.866667,0.003396
5107,Phillips County,,AR,1490,23743,25233,6,14,20,1152,2939,4091,6,0.32599,0.340957,82.268603,0.000747,0.001083,0,0.000126,0,14,0.505495,0.006715
5109,Pike County,,AR,778,10876,11654,5,5,10,1350,1407,2757,6,0.307472,0.318536,67.156002,0.00006,0.000291,0,0.000133,0,14,0.566667,0.000968
5111,Poinsett County,,AR,1599,24476,26075,6,8,14,3919,4260,8179,6,0.325143,0.338987,20.216269,0.000502,0.000713,0,0.000125,0,14,0.714286,0.004598
5113,Polk County,,AR,1173,19411,20584,9,10,19,1037,1581,2618,6,0.309053,0.321449,595.310118,0.000766,0.000487,0,0.000184,0,14,0.418182,0.007683
5115,Pope County,,AR,3811,55616,59427,23,20,43,9210,9097,18307,5,0.357236,0.376848,1852.586365,0.002342,0.00191,0,0.000408,0,14,0.438333,0.023632
5117,Prairie County,,AR,591,8654,9245,5,5,10,1161,1443,2604,6,0.307252,0.318148,0.25,0.000289,0.000309,0,0.000121,0,14,0.866667,0.002684
5119,Pulaski County,,AR,27680,397731,425411,162,165,327,81475,85832,167307,5,0.443199,0.477497,156702.843627,0.038329,0.043023,0,0.001768,0,14,0.327318,0.335364
5121,Randolph County,,AR,1163,17914,19077,5,6,11,1959,1982,3941,6,0.307724,0.31898,275.165407,0.000031,0.0003,0,0.000148,0,14,0.52381,0.00064
5123,St. Francis County,,AR,2066,25742,27808,9,11,20,3327,4927,8254,6,0.326132,0.340707,49.298513,0.000782,0.000911,0,0.000149,0,14,0.659091,0.006972
5125,Saline County,,AR,6346,96286,102632,30,23,53,25245,17059,42304,6,0.350689,0.371077,1794.957632,0.005288,0.003344,0,0.000441,0,14,0.44254,0.049435
5127,Scott County,,AR,708,10461,11169,5,6,11,1089,1554,2643,6,0.288347,0.298868,2.70192,0.00008,0.000195,0,0.000119,0,14,0.8,0.001029
5129,Searcy County,,AR,484,7166,7650,2,2,4,372,514,886,7,0.23864,0.244475,1.280679,0.000007,0.000006,0,0.000093,0,14,0,0.000215
5131,Sebastian County,,AR,9119,121950,131069,37,42,79,24787,26304,51091,5,0.381412,0.406375,7998.442982,0.00833,0.00991,0,0.000482,0,14,0.468085,0.073265
5133,Sevier County,,AR,881,15267,16148,6,8,14,1266,1687,2953,6,0.289514,0.301143,45.91079,0.000069,0.000243,0,0.000136,0,14,0.482143,0.001111
5135,Sharp County,,AR,1477,16916,18393,7,7,14,2624,2705,5329,7,0.263648,0.273278,663.641014,0.000482,0.00006,0,0.000167,0,14,0.444444,0.004536
5137,Stone County,,AR,580,11126,11706,5,4,9,615,520,1135,6,0.307315,0.318148,95.398916,0.000291,0.000284,0,0.000135,0,14,0.7,0.002913
5139,Union County,,AR,2616,47374,49990,15,19,34,3474,4700,8174,6,0.345764,0.365036,4759.32115,0.001598,0.002578,0,0.000248,0,14,0.434211,0.015391
5141,Van Buren County,,AR,1082,15523,16605,7,7,14,2003,2225,4228,6,0.307409,0.318647,1692.696721,0.00032,0.000308,0,0.000194,0,14,0.571429,0.003299
5143,Washington County,,AR,14006,174754,188760,101,78,179,45474,41964,87438,5,0.404144,0.432817,40086.937838,0.020485,0.016838,0,0.001277,0,14,0.279934,0.182752
5145,White County,,AR,4498,70862,75360,28,22,50,11556,10321,21877,5,0.364917,0.386141,1807.11437,0.002277,0.00353,0,0.000443,0,14,0.389247,0.020922
5147,Woodruff County,,AR,533,7941,8474,4,5,9,674,1199,1873,6,0.307661,0.318758,0.616667,0.000281,0.000266,0,0.000108,0,14,0.85,0.002457
5149,Yell County,,AR,1615,19935,21550,9,10,19,3427,4092,7519,6,0.316844,0.330032,60.561911,0.000757,0.00097,0,0.000188,0,14,0.7,0.00762
6001,Alameda County,,CA,124906,1520776,1645682,247,262,509,352482,416023,768505,5,0.456535,0.499107,15648.5964,0.075025,0.072344,4,0.001703,0,14,0.365568,0.611116
6003,Alpine County,,CA,188,1012,1200,1,2,3,94,238,332,6,0.270924,0.280642,0,0.0001,0.000138,4,0.000054,0,14,1,0.00076
6005,Amador County,,CA,2333,36453,38786,20,14,34,8393,4941,13334,5,0.347323,0.364741,0.290594,0.005711,0.003815,4,0.000154,0,14,0.966667,0.04657
6007,Butte County,,CA,12157,198689,210846,59,79,138,39266,37457,76723,5,0.36986,0.39803,933.337677,0.013842,0.017457,4,0.00044,0,14,0.59521,0.117913
6009,Calaveras County,,CA,3324,43992,47316,22,22,44,12525,7790,20315,5,0.359201,0.378834,12.76093,0.006775,0.006097,4,0.000168,0,14,0.953704,0.055424
6011,Colusa County,,CA,1414,22130,23544,8,8,16,3449,3380,6829,6,0.316644,0.329383,1.123891,0.001692,0.001054,4,0.000099,0,14,0.877778,0.01372
6013,Contra Costa County,,CA,71886,1075933,1147819,173,204,377,240439,239357,479796,5,0.443526,0.481991,6452.906483,0.056515,0.059382,4,0.001191,0,14,0.45027,0.470248
6015,Del Norte County,,CA,1638,21975,23613,17,11,28,2864,2601,5465,5,0.353121,0.370495,2.346577,0.004341,0.002431,4,0.000154,0,14,0.866013,0.035493
6017,El Dorado County,,CA,13738,181589,195327,56,70,126,48923,41050,89973,5,0.371414,0.39889,5126.700269,0.013884,0.017047,4,0.000411,0,14,0.664384,0.118032
6019,Fresno County,,CA,33225,847163,880388,108,133,241,104022,108635,212657,5,0.408763,0.443442,2606.119819,0.032753,0.035485,4,0.000791,0,14,0.495629,0.282113
6021,Glenn County,,CA,1925,27658,29583,10,7,17,4153,3904,8057,6,0.349384,0.365723,23.94668,0.002849,0.001345,4,0.000112,0,14,0.881818,0.023868
6023,Humboldt County,,CA,7294,125247,132541,51,65,116,17727,20234,37961,5,0.370087,0.395767,1738.04726,0.012652,0.015197,4,0.0004,0,14,0.675569,0.107895
6025,Imperial County,,CA,8284,177571,185855,26,29,55,29162,25053,54215,5,0.362933,0.384132,31.741923,0.009352,0.009521,4,0.0002,0,14,0.885081,0.077879
6027,Inyo County,,CA,1449,19366,20815,10,10,20,2859,2414,5273,5,0.354705,0.372409,9.482722,0.004218,0.003929,4,0.000115,0,14,0.818182,0.03566
6029,Kern County,,CA,31486,706830,738316,110,162,272,133567,100614,234181,5,0.415491,0.453085,3343.249113,0.032022,0.040527,4,0.000811,0,14,0.413669,0.276212
6031,Kings County,,CA,10661,122770,133431,43,53,96,27756,27216,54972,5,0.384192,0.409776,196.113585,0.013489,0.018061,4,0.000311,0,14,0.709273,0.112052
6033,Lake County,,CA,4045,55117,59162,30,29,59,13117,9318,22435,5,0.35989,0.38047,0.273195,0.009111,0.008379,4,0.000211,0,14,0.966132,0.075191
6035,Lassen County,,CA,2135,25332,27467,17,13,30,3763,3429,7192,5,0.35362,0.371355,122.527977,0.004566,0.002721,4,0.000164,0,14,0.843137,0.037806
6037,Los Angeles County,,CA,421162,10005039,10426201,607,708,1315,1005526,1633565,2639091,5,0.53595,0.601376,412290.087781,0.112235,0.114187,4,0.004883,0,14,0.110398,0.93857
6039,Madera County,,CA,7850,121843,129693,31,34,65,29258,22804,52062,5,0.360754,0.382107,23.429398,0.009525,0.00992,4,0.000219,0,14,0.911765,0.077731
6041,Marin County,,CA,18740,244791,263531,64,74,138,50559,53192,103751,5,0.392475,0.420844,290.741648,0.022925,0.023406,4,0.000432,0,14,0.703181,0.191605
6043,Mariposa County,,CA,1536,17275,18811,13,8,21,3672,2344,6016,6,0.349424,0.36589,0.147399,0.003988,0.001605,4,0.000116,0,14,0.967033,0.0325
6045,Mendocino County,,CA,5257,88839,94096,33,43,76,10604,12216,22820,5,0.361841,0.384521,6.97781,0.009531,0.010904,4,0.000234,0,14,0.882664,0.079577
6047,Merced County,,CA,14434,230707,245141,39,61,100,49432,48348,97780,5,0.380109,0.406697,146.498169,0.011923,0.017664,4,0.000271,0,14,0.777322,0.098787
6049,Modoc County,,CA,724,8478,9202,5,5,10,473,733,1206,6,0.298876,0.311041,0.398219,0.00078,0.000517,4,0.00009,0,14,0.9,0.007328
6051,Mono County,,CA,1655,12013,13668,9,14,23,2623,3039,5662,5,0.355209,0.373519,1.843517,0.003584,0.004838,4,0.000108,0,14,0.835165,0.029173
6053,Monterey County,,CA,35026,416693,451719,123,164,287,65448,102752,168200,5,0.423636,0.460586,3052.385928,0.039283,0.044719,4,0.000874,0,14,0.455097,0.338261
6055,Napa County,,CA,9780,138959,148739,40,45,85,27437,26883,54320,5,0.363197,0.386379,11.600055,0.012309,0.012649,4,0.00027,0,14,0.914894,0.102174
6057,Nevada County,,CA,7617,102913,110530,41,46,87,23064,20037,43101,5,0.362495,0.38563,823.320718,0.011087,0.01241,4,0.000297,0,14,0.819592,0.092202
6059,Orange County,,CA,193645,3161099,3354744,348,419,767,531952,691557,1223509,5,0.48941,0.540374,51484.582806,0.091603,0.09595,4,0.00252,0,14,0.235535,0.752514
6061,Placer County,,CA,27439,327061,354500,87,101,188,118957,87381,206338,5,0.390586,0.422298,902.66457,0.023233,0.02717,4,0.000637,0,14,0.572957,0.202067
6063,Plumas County,,CA,1739,21978,23717,15,9,24,3155,2927,6082,5,0.346882,0.363632,59.211281,0.004719,0.001755,4,0.000151,0,14,0.8375,0.039155
6065,Riverside County,,CA,115449,1836330,1951779,284,364,648,635906,443392,1079298,5,0.478496,0.526642,36453.741334,0.079342,0.082603,4,0.002079,0,14,0.253791,0.658575
6067,Sacramento County,,CA,89193,1402578,1491771,231,250,481,293517,304812,598329,5,0.459257,0.499789,22667.80483,0.066389,0.065134,4,0.001723,0,14,0.344509,0.55737
6069,San Benito County,,CA,5721,59147,64868,19,27,46,12767,14293,27060,5,0.359459,0.379749,0,0.007,0.007628,4,0.00015,0,14,0.992063,0.05786
6071,San Bernardino County,,CA,130755,1901962,2032717,285,399,684,534387,507936,1042323,5,0.490609,0.538793,47974.050125,0.0757,0.087482,4,0.00214,0,14,0.231358,0.634395
6073,San Diego County,,CA,214824,3168550,3383374,607,675,1282,590815,698795,1289610,4,0.52906,0.593708,318071.085082,0.111573,0.113184,4,0.004832,0,14,0.122151,0.932011
6075,San Francisco County,,CA,79455,789966,869421,225,188,413,248997,271312,520309,5,0.443003,0.479882,7134.934558,0.069315,0.059172,4,0.001511,0,14,0.449682,0.557435
6077,San Joaquin County,,CA,38796,648466,687262,90,132,222,139468,136155,275623,5,0.406936,0.441628,2414.299546,0.025148,0.033733,4,0.00066,0,14,0.464895,0.215106
6079,San Luis Obispo County,,CA,16370,252882,269252,65,84,149,50968,47926,98894,5,0.384783,0.414225,261.849518,0.017219,0.022656,4,0.000461,0,14,0.678553,0.150406
6081,San Mateo County,,CA,63945,761738,825683,146,146,292,186204,211498,397702,5,0.420375,0.455992,2260.539215,0.050978,0.04658,4,0.000969,0,14,0.560843,0.420148
6083,Santa Barbara County,,CA,29539,410436,439975,112,130,242,64305,85931,150236,5,0.415089,0.448741,1939.575101,0.035927,0.039887,4,0.000791,0,14,0.549521,0.305138
6085,Santa Clara County,,CA,116211,1862894,1979105,279,274,553,331497,384295,715792,5,0.457718,0.501398,19231.328517,0.07844,0.075141,4,0.001962,0,14,0.324738,0.636114
6087,Santa Cruz County,,CA,18783,265425,284208,56,82,138,43332,55070,98402,5,0.383555,0.412811,191.45289,0.016415,0.02235,4,0.000385,0,14,0.667646,0.14053
6089,Shasta County,,CA,10192,174293,184485,68,71,139,32150,27313,59463,5,0.368228,0.395229,2379.644272,0.015768,0.015541,4,0.000546,0,14,0.62038,0.137355
6091,Sierra County,,CA,355,3093,3448,2,3,5,286,548,834,6,0.298579,0.310264,0,0.000322,0.000344,4,0.000062,0,14,1,0.002835
6093,Siskiyou County,,CA,2818,43811,46629,31,26,57,6674,5699,12373,5,0.360062,0.380415,4.035044,0.007943,0.006783,4,0.000223,0,14,0.874111,0.06494
6095,Solano County,,CA,36997,433283,470280,109,147,256,97618,111374,208992,5,0.413717,0.4497,4028.328909,0.032036,0.040501,4,0.00079,0,14,0.460663,0.273197
6097,Sonoma County,,CA,27870,505160,533030,89,120,209,68325,80489,148814,5,0.401175,0.434743,1184.371075,0.027326,0.033601,4,0.00064,0,14,0.553912,0.237766
6099,Stanislaus County,,CA,28713,505507,534220,68,110,178,97769,97608,195377,5,0.392321,0.425078,827.124216,0.01917,0.027175,4,0.000489,0,14,0.54783,0.166492
6101,Sutter County,,CA,7197,87250,94447,33,37,70,25224,21194,46418,5,0.361971,0.383883,154.436785,0.009524,0.010542,4,0.000249,0,14,0.844872,0.079348
6103,Tehama County,,CA,3593,55922,59515,31,24,55,12469,8595,21064,5,0.359373,0.37925,55.7415,0.008785,0.006091,4,0.000241,0,14,0.849432,0.072559
6105,Trinity County,,CA,818,11142,11960,7,2,9,1357,1200,2557,6,0.272843,0.282379,0,0.001942,0.000168,4,0.000087,0,14,1,0.016011
6107,Tulare County,,CA,16157,388341,404498,58,71,129,56251,49791,106042,5,0.382042,0.409859,338.767075,0.017159,0.020073,4,0.000429,0,14,0.686073,0.148867
6109,Tuolumne County,,CA,3522,55464,58986,27,30,57,9927,8131,18058,5,0.359674,0.38036,15.797117,0.007657,0.008503,4,0.000195,0,14,0.901961,0.06159
6111,Ventura County,,CA,54054,867555,921609,161,215,376,139203,165723,304926,5,0.43931,0.48006,4590.974738,0.05298,0.061056,4,0.001126,0,14,0.426549,0.4433
6113,Yolo County,,CA,18209,175655,193864,59,69,128,55211,54580,109791,5,0.384045,0.411812,526.913238,0.017107,0.020363,4,0.000411,0,14,0.72144,0.14558
6115,Yuba County,,CA,8273,57864,66137,40,31,71,30037,21875,51912,5,0.364077,0.385797,126.742493,0.011848,0.009947,4,0.000297,0,14,0.787456,0.099986
8001,Adams County,,CO,43457,399067,442524,136,118,254,171789,149505,321294,5,0.424894,0.456292,19373.892387,0.037916,0.032594,6,0.001293,0,14,0.450956,0.33041
8003,Alamosa County,,CO,1499,14259,15758,8,11,19,2332,2811,5143,5,0.352251,0.369951,2341.219991,0.001422,0.002974,6,0.000164,0,14,0.643939,0.013504
8005,Arapahoe County,,CO,65340,551261,616601,223,196,419,228778,221318,450096,5,0.454051,0.489386,30165.553456,0.064489,0.059622,6,0.001906,0,14,0.418112,0.544895
8007,Archuleta County,,CO,1111,10854,11965,9,5,14,1216,730,1946,5,0.351551,0.36837,0,0.003817,0.001435,6,0.00012,0,14,0.977778,0.033956
8009,Baca County,,CO,274,4315,4589,0,1,1,0,44,44,7,0.248758,0.254146,0,0,0.000003,6,0.000049,0,19,0,0
8011,Bent County,,CO,433,4526,4959,3,3,6,425,584,1009,6,0.270071,0.278812,0.333333,0.000074,0.000074,6,0.000096,0,14,0.833333,0.00088
8013,Boulder County,,CO,29518,289167,318685,193,142,335,82326,88018,170344,5,0.428959,0.462628,13107.654491,0.060034,0.044559,6,0.001513,0,14,0.476784,0.497635
8014,Broomfield County,,CO,7675,46481,54156,33,21,54,31819,27576,59395,5,0.372335,0.393353,35.797823,0.012969,0.00857,6,0.000317,0,14,0.868984,0.117516
8015,Chaffee County,,CO,1531,16893,18424,16,12,28,2695,2240,4935,6,0.331238,0.345162,2417.651065,0.003313,0.002665,6,0.000212,0,14,0.713235,0.032775
8017,Cheyenne County,,CO,180,2187,2367,0,0,0,0,0,0,0,0,0,0,0,0,5,0.000049,4,20,0,0
8019,Clear Creek County,,CO,1124,9288,10412,7,5,12,1990,2149,4139,6,0.318693,0.33006,0.395294,0.001748,0.001336,6,0.000109,0,14,0.928571,0.017218
8021,Conejos County,,CO,456,8182,8638,2,2,4,424,646,1070,6,0.270071,0.278701,0,0.000029,0.000072,6,0.000076,0,14,1,0.000272
8023,Costilla County,,CO,311,3103,3414,0,2,2,0,245,245,6,0.329171,0.341109,0,0,0.000526,6,0.000049,0,21,1,0
8025,Crowley County,,CO,364,2983,3347,2,2,4,508,537,1045,6,0.270047,0.278645,0,0.000065,0.00007,6,0.000082,0,14,1,0.000784
8027,Custer County,,CO,406,3858,4264,3,3,6,404,636,1040,6,0.329242,0.341334,0,0.000567,0.000605,6,0.000083,0,14,1,0.005388
8029,Delta County,,CO,2089,29037,31126,15,12,27,4880,4040,8920,5,0.352128,0.369896,10.010549,0.003787,0.003369,6,0.000201,0,14,0.942857,0.03694
8031,Denver County,,CO,77333,523920,601253,263,210,473,266994,274675,541669,5,0.461586,0.496904,52680.914512,0.070769,0.062778,6,0.002254,0,14,0.356324,0.587598
8033,Dolores County,,CO,186,1874,2060,1,1,2,243,152,395,6,0.261331,0.268425,0,0.000025,0.000022,4,0.000061,0,14,0,0.000266
8035,Douglas County,,CO,26930,254908,281838,149,113,262,119476,82566,202042,5,0.429204,0.459537,6503.608392,0.048479,0.03815,6,0.001198,0,14,0.542328,0.414081
8037,Eagle County,,CO,4956,43687,48643,32,33,65,10359,10566,20925,5,0.375594,0.398308,350.68217,0.011792,0.010617,6,0.000322,0,14,0.706259,0.106321
8039,Elbert County,,CO,2313,22349,24662,7,8,15,6451,5296,11747,6,0.331165,0.344385,0,0.002025,0.0025,6,0.00011,0,14,1,0.019244
8041,El Paso County,,CO,55710,600759,656469,393,369,762,170752,160390,331142,5,0.490369,0.535325,165301.583289,0.087855,0.083087,6,0.003346,0,14,0.226748,0.740452
8043,Fremont County,,CO,2993,39511,42504,17,15,32,5986,5466,11452,5,0.352665,0.370783,113.469012,0.003919,0.003757,6,0.000233,0,14,0.761438,0.038219
8045,Garfield County,,CO,4244,47066,51310,35,26,61,11427,9873,21300,5,0.367192,0.388931,2284.102291,0.009744,0.007169,6,0.000387,0,14,0.655556,0.088261
8047,Gilpin County,,CO,614,4848,5462,6,5,11,1498,1279,2777,6,0.318794,0.330226,0.21969,0.001484,0.001681,6,0.000111,0,14,0.966667,0.01447
8049,Grand County,,CO,1603,13376,14979,10,10,20,2260,2018,4278,6,0.320188,0.332257,0,0.00255,0.002406,6,0.000138,0,14,1,0.025001
8051,Gunnison County,,CO,1635,13446,15081,12,13,25,1643,2253,3896,5,0.352128,0.370034,1.131911,0.002432,0.003459,6,0.000177,0,14,0.912088,0.024508
8053,Hinsdale County,,CO,104,794,898,0,0,0,0,0,0,0,0,0,0,0,0,7,0.000049,5,22,0,0
8055,Huerfano County,,CO,557,6373,6930,3,3,6,555,788,1343,6,0.329278,0.341389,0,0.000556,0.000596,6,0.000084,0,14,1,0.005297
8057,Jackson County,,CO,227,1548,1775,0,0,0,0,0,0,0,0,0,0,0,0,8,0.000049,6,23,0,0
8059,Jefferson County,,CO,56450,577050,633500,178,175,353,173901,178471,352372,5,0.442807,0.477929,24335.073426,0.051955,0.05087,6,0.001581,0,14,0.428651,0.447595
8061,Kiowa County,,CO,144,1554,1698,0,0,0,0,0,0,0,0,0,0,0,0,9,0.000049,7,24,0,0
8063,Kit Carson County,,CO,673,8245,8918,2,5,7,163,502,665,6,0.33011,0.342516,3017.318264,0.000682,0.000845,6,0.000066,0,14,0.45,0.006438
8065,Lake County,,CO,896,6551,7447,5,6,11,794,1156,1950,6,0.330509,0.343414,0.139423,0.001269,0.001374,6,0.00009,0,14,0.9,0.01174
8067,La Plata County,,CO,4195,45893,50088,36,27,63,8800,7874,16674,5,0.374051,0.396127,295.83004,0.010773,0.009143,6,0.000382,0,14,0.706456,0.099798
8069,Larimer County,,CO,24036,288097,312133,174,126,300,70065,65196,135261,5,0.426341,0.458206,24758.297803,0.045565,0.036437,6,0.001672,0,14,0.392063,0.392154
8071,Las Animas County,,CO,1132,14765,15897,9,9,18,1378,1692,3070,6,0.330873,0.344274,165.076618,0.002435,0.001921,6,0.000149,0,14,0.622222,0.022963
8073,Lincoln County,,CO,499,5059,5558,1,3,4,176,394,570,6,0.330619,0.343054,0,0.00049,0.001036,6,0.000057,0,14,1,0.004445
8075,Logan County,,CO,1545,20494,22039,13,15,28,2414,2702,5116,6,0.331787,0.346105,5999.515828,0.002303,0.002393,6,0.000226,0,14,0.5625,0.022596
8077,Mesa County,,CO,7853,136016,143869,75,48,123,28595,17986,46581,5,0.37169,0.396727,9193.587279,0.01647,0.011586,6,0.000823,0,14,0.427544,0.151921
8079,Mineral County,,CO,78,884,962,0,0,0,0,0,0,0,0,0,0,0,0,10,0.000049,8,25,0,0
8081,Moffat County,,CO,1346,13842,15188,8,7,15,1507,1441,2948,6,0.341209,0.356924,228.973415,0.001334,0.001331,6,0.000147,0,14,0.791667,0.013437
8083,Montezuma County,,CO,2037,24075,26112,15,16,31,3673,3482,7155,5,0.353745,0.372392,6117.933593,0.003651,0.004208,4,0.000228,0,14,0.720779,0.033849
8085,Montrose County,,CO,2672,37801,40473,25,17,42,7453,4996,12449,5,0.35584,0.374695,6668.068179,0.006771,0.004403,6,0.000319,0,14,0.693333,0.061925
8087,Morgan County,,CO,2153,29269,31422,12,10,22,3382,4108,7490,6,0.331348,0.344885,2661.391432,0.002539,0.002582,6,0.000179,0,14,0.704545,0.024116
8089,Otero County,,CO,1370,20142,21512,8,8,16,1725,2698,4423,6,0.331019,0.344191,946.137375,0.001129,0.001593,6,0.000179,0,14,0.577778,0.01102
8091,Ouray County,,CO,372,3921,4293,3,2,5,463,440,903,6,0.262496,0.269774,15.486369,0.0001,0.00004,6,0.000098,0,14,0.833333,0.001463
8093,Park County,,CO,1872,14485,16357,10,13,23,4183,3920,8103,5,0.352334,0.370118,7.647169,0.002272,0.003305,6,0.000144,0,14,0.906593,0.022217
8095,Phillips County,,CO,348,4871,5219,1,2,3,177,292,469,6,0.281063,0.290479,0,0.000014,0.000115,6,0.000062,0,14,1,0.000198
8097,Pitkin County,,CO,1951,13857,15808,11,10,21,2670,3452,6122,5,0.363636,0.382035,7.984461,0.003892,0.003939,6,0.000144,0,14,0.856061,0.036205
8099,Prowers County,,CO,1054,13690,14744,4,8,12,507,1175,1682,6,0.331019,0.344191,3349.631549,0.000545,0.001599,6,0.000139,0,14,0.611111,0.005233
8101,Pueblo County,,CO,7435,154702,162137,43,36,79,21059,16870,37929,5,0.36986,0.393231,15116.98678,0.010805,0.009357,6,0.000564,0,14,0.45202,0.09981
8103,Rio Blanco County,,CO,758,6075,6833,4,4,8,609,959,1568,6,0.271266,0.280787,0.917419,0.00013,0.000177,6,0.00011,0,14,0.75,0.001911
8105,Rio Grande County,,CO,1385,15471,16856,6,10,16,1202,2020,3222,6,0.33091,0.344441,5001.878905,0.001125,0.001981,6,0.000168,0,14,0.6,0.010796
8107,Routt County,,CO,2347,20829,23176,18,16,34,3585,3431,7016,5,0.353828,0.372281,65.25273,0.005161,0.004392,6,0.00022,0,14,0.852632,0.048495
8109,Saguache County,,CO,387,3077,3464,2,1,3,193,112,305,7,0.248655,0.254114,0.3,0.000027,0.000007,6,0.000078,0,14,0,0.000386
8111,San Juan County,,CO,93,631,724,0,0,0,0,0,0,0,0,0,0,0,0,11,0.000049,9,26,0,0
8113,San Miguel County,,CO,864,6380,7244,2,5,7,321,863,1184,6,0.316544,0.327547,272.060772,0.000026,0.000909,6,0.000107,0,14,0.75,0.000502
8115,Sedgwick County,,CO,173,2693,2866,0,0,0,0,0,0,0,0,0,0,0,0,12,0.000049,10,27,0,0
8117,Summit County,,CO,4156,25656,29812,23,28,51,6106,7932,14038,5,0.371782,0.39327,404.156494,0.007377,0.008008,6,0.000256,0,14,0.696774,0.06811
8119,Teller County,,CO,2970,23390,26360,12,11,23,5519,5887,11406,5,0.352045,0.369674,18.011221,0.004307,0.003193,6,0.000157,0,14,0.912088,0.039688
8121,Washington County,,CO,344,4825,5169,3,3,6,309,510,819,7,0.249233,0.255246,0.25,0.000037,0.00003,6,0.000092,0,14,0.833333,0.00049
8123,Weld County,,CO,17286,223032,240318,67,63,130,70719,50026,120745,5,0.390688,0.417538,7620.442713,0.017182,0.016478,6,0.000733,0,14,0.444012,0.154673
8125,Yuma County,,CO,804,9887,10691,5,7,12,664,871,1535,6,0.330291,0.343137,832.950467,0.000331,0.001297,6,0.00012,0,14,0.660714,0.003704
9001,Fairfield County,,CT,54033,979240,1033273,172,249,421,138701,176788,315489,5,0.441765,0.485996,4604.831389,0.061516,0.07481,13,0.001017,0,14,0.43996,0.48475
9003,Hartford County,,CT,43461,1017688,1061149,191,225,416,135709,149133,284842,5,0.438284,0.480432,7804.839303,0.063961,0.07101,13,0.001172,0,14,0.480782,0.508621
9005,Litchfield County,,CT,11912,223444,235356,28,57,85,33704,30606,64310,5,0.378576,0.404322,54.998866,0.011347,0.021537,13,0.000179,0,14,0.80113,0.084835
9007,Middlesex County,,CT,11910,189162,201072,38,55,93,37696,33955,71651,5,0.379868,0.405487,25.863498,0.014957,0.022284,13,0.000219,0,14,0.842788,0.109326
9009,New Haven County,,CT,44487,945672,990159,178,223,401,138452,150441,288893,5,0.437965,0.480099,5173.432278,0.061695,0.070353,13,0.001084,0,14,0.493766,0.490757
9011,New London County,,CT,19466,312095,331561,102,119,221,51247,53422,104669,5,0.401443,0.435186,757.015402,0.036826,0.041676,13,0.000581,0,14,0.628583,0.282088
9013,Tolland County,,CT,11252,158176,169428,26,38,64,34607,31346,65953,5,0.375172,0.398247,39.968344,0.009944,0.015409,13,0.000166,0,14,0.902439,0.073978
9015,Windham County,,CT,7380,129391,136771,11,29,40,19737,19396,39133,5,0.359674,0.38057,1.032879,0.002994,0.010424,13,0.000092,0,14,0.903448,0.019683
10001,Kent County,,DE,9559,156817,166376,78,58,136,38242,15468,53710,5,0.381606,0.408012,1560.596489,0.024957,0.020648,76,0.000491,0,14,0.614275,0.189508
10003,New Castle County,,DE,28501,593222,621723,148,162,310,85472,86941,172413,5,0.428225,0.464703,4298.175572,0.05346,0.058196,76,0.000933,0,14,0.61996,0.424241
10005,Sussex County,,DE,8420,189954,198374,78,53,131,30639,19407,50046,5,0.371414,0.396222,886.116927,0.023778,0.017415,76,0.000474,0,14,0.6493,0.178355
11001,District of Columbia,,DC,63668,542111,605779,282,217,499,201224,223669,424893,5,0.454532,0.492405,18286.013577,0.08255,0.069073,104,0.001903,0,14,0.387198,0.658876
12001,Alachua County,,FL,21447,211620,233067,133,131,264,60702,64903,125605,5,0.432728,0.465202,9952.229107,0.047128,0.047673,13,0.001103,0,14,0.61861,0.402588
12003,Baker County,,FL,1419,24013,25432,9,8,17,5364,4051,9415,6,0.32315,0.336912,6.189644,0.001252,0.001229,13,0.000158,0,14,0.722222,0.013011
12005,Bay County,,FL,13531,170614,184145,133,109,242,32214,32276,64490,5,0.409209,0.441622,18282.563505,0.037612,0.033532,13,0.001182,0,14,0.472422,0.329381
12007,Bradford County,,FL,1661,22487,24148,9,8,17,5327,4281,9608,6,0.323254,0.337023,1.883026,0.001488,0.001562,13,0.00015,0,14,0.847222,0.015549
12009,Brevard County,,FL,30904,572446,603350,293,251,544,121440,88534,209974,5,0.457648,0.498635,19629.340205,0.083991,0.074084,13,0.001951,0,14,0.323706,0.676757
12011,Broward County,,FL,128004,1823174,1951178,363,427,790,437259,504133,941392,5,0.485299,0.538443,63835.795907,0.094546,0.097884,13,0.00258,0,14,0.223188,0.776517
12013,Calhoun County,,FL,654,11037,11691,6,5,11,2097,1783,3880,6,0.305068,0.316828,6.429959,0.000529,0.000512,13,0.00014,0,14,0.766667,0.005012
12015,Charlotte County,,FL,16822,152099,168921,114,69,183,43081,33920,77001,5,0.397249,0.425477,623.03719,0.039866,0.025269,13,0.000656,0,14,0.586839,0.301466
12017,Citrus County,,FL,8401,130999,139400,81,35,116,33887,16719,50606,5,0.3734,0.396155,75.94665,0.02966,0.014369,13,0.000527,0,14,0.766676,0.233328
12019,Clay County,,FL,18826,182562,201388,124,80,204,74099,54921,129020,5,0.402465,0.431691,3138.810741,0.043996,0.029083,13,0.000919,0,14,0.623641,0.367223
12021,Collier County,,FL,22098,304357,326455,196,145,341,81985,72811,154796,5,0.432355,0.466328,3661.520132,0.06314,0.050863,13,0.001203,0,14,0.467034,0.489955
12023,Columbia County,,FL,3931,52004,55935,38,29,67,14812,10452,25264,6,0.340204,0.359349,1915.304978,0.009599,0.008553,13,0.00043,0,14,0.603239,0.088236
12027,DeSoto County,,FL,2665,26172,28837,13,10,23,4420,4593,9013,6,0.333778,0.348885,6.076764,0.004802,0.003834,13,0.000142,0,14,0.916667,0.042645
12029,Dixie County,,FL,965,11676,12641,11,8,19,1985,1854,3839,6,0.326806,0.34084,22.737647,0.003284,0.001382,13,0.00018,0,14,0.769231,0.02924
12031,Duval County,,FL,68994,902615,971609,390,350,740,235696,229964,465660,5,0.476598,0.523852,123950.200362,0.093875,0.087829,13,0.003158,0,14,0.251574,0.78635
12033,Escambia County,,FL,31902,303902,335804,180,182,362,70066,84909,154975,5,0.437518,0.475383,17752.675403,0.05692,0.05508,0,0.001415,0,14,0.439875,0.488544
12035,Flagler County,,FL,5271,75226,80497,88,30,118,38485,14534,53019,5,0.371277,0.393048,39.221691,0.033681,0.013582,13,0.000513,0,14,0.801873,0.258432
12037,Franklin County,,FL,745,9582,10327,4,5,9,695,1037,1732,6,0.305068,0.316828,4.557639,0.000499,0.000499,13,0.000103,0,14,0.6,0.00452
12039,Gadsden County,,FL,3134,47584,50718,15,13,28,9611,9176,18787,6,0.334186,0.350205,763.621888,0.004702,0.002794,13,0.000215,0,14,0.507353,0.040246
12041,Gilchrist County,,FL,1263,13477,14740,13,5,18,3805,2827,6632,6,0.302274,0.313055,1.811056,0.004326,0.000449,13,0.000167,0,14,0.897436,0.038006
12043,Glades County,,FL,980,8272,9252,6,6,12,2205,1871,4076,6,0.328665,0.344174,0.111111,0.002188,0.001731,13,0.000088,0,14,0.97619,0.017959
12045,Gulf County,,FL,1001,12110,13111,4,5,9,1698,1785,3483,6,0.305068,0.316828,0.833333,0.000495,0.000513,13,0.000107,0,14,0.8,0.004371
12047,Hamilton County,,FL,993,11336,12329,5,6,11,1702,1846,3548,6,0.331056,0.345739,4.064656,0.000727,0.001372,13,0.00011,0,14,0.9,0.006886
12049,Hardee County,,FL,1812,22346,24158,6,7,13,2780,3478,6258,6,0.32935,0.343953,0.408719,0.001884,0.00228,13,0.000096,0,14,0.97619,0.016782
12051,Hendry County,,FL,3107,35220,38327,10,13,23,7526,7520,15046,6,0.33825,0.355093,11.923384,0.004004,0.004597,13,0.000121,0,14,0.833333,0.034581
12053,Hernando County,,FL,10763,152129,162892,97,44,141,54954,26935,81889,5,0.377245,0.401481,69.087368,0.036103,0.017913,13,0.00058,0,14,0.736667,0.277777
12055,Highlands County,,FL,5899,86703,92602,36,29,65,17539,11445,28984,6,0.339589,0.3586,87.620903,0.011502,0.010348,13,0.000303,0,14,0.75,0.100233
12057,Hillsborough County,,FL,83340,1173369,1256709,445,402,847,348252,310798,659050,5,0.485927,0.535963,94177.708584,0.10165,0.096624,13,0.003321,0,14,0.205146,0.833944
12059,Holmes County,,FL,1195,16737,17932,8,8,16,3344,3363,6707,6,0.311651,0.324412,21.304786,0.000969,0.001017,13,0.000147,0,14,0.777778,0.009941
12061,Indian River County,,FL,9496,132610,142106,82,50,132,32807,19294,52101,5,0.385029,0.410414,144.446617,0.032282,0.020166,13,0.000523,0,14,0.78141,0.256701
12063,Jackson County,,FL,2610,44260,46870,20,15,35,6592,5785,12377,6,0.334409,0.351387,540.362493,0.005877,0.003057,13,0.000265,0,14,0.562771,0.051209
12065,Jefferson County,,FL,1083,13673,14756,4,4,8,2350,2484,4834,6,0.301849,0.313055,1.882179,0.000321,0.000307,13,0.000107,0,14,0.5,0.002916
12067,Lafayette County,,FL,388,4689,5077,1,3,4,405,631,1036,7,0.253974,0.261627,0,0.000038,0.000118,13,0.000061,0,14,0.5,0.000486
12069,Lake County,,FL,21943,267493,289436,167,102,269,110421,65345,175766,5,0.414516,0.445867,1488.437334,0.058292,0.036483,13,0.001057,0,14,0.544203,0.457723
12071,Lee County,,FL,31968,545423,577391,369,298,667,202254,116350,318604,5,0.457927,0.504333,37531.24993,0.087845,0.078705,13,0.002463,0,14,0.222986,0.698927
12073,Leon County,,FL,22090,241735,263825,137,148,285,64760,73599,138359,5,0.431919,0.466506,43757.498528,0.042492,0.049498,13,0.001296,0,14,0.523193,0.372656
12075,Levy County,,FL,3101,35708,38809,24,15,39,10298,7453,17751,6,0.337528,0.354366,111.881743,0.007988,0.005632,13,0.000259,0,14,0.869565,0.073163
12077,Liberty County,,FL,431,5855,6286,5,4,9,1183,1023,2206,6,0.301819,0.312999,1,0.000332,0.000316,13,0.000127,0,14,0.65,0.003047
12079,Madison County,,FL,1031,17623,18654,9,8,17,1680,1783,3463,6,0.324161,0.338271,90.769703,0.002088,0.001029,13,0.000167,0,14,0.655556,0.017954
12081,Manatee County,,FL,22708,306353,329061,197,158,355,87992,66982,154974,5,0.428775,0.464869,3973.011233,0.064066,0.05302,13,0.001211,0,14,0.443825,0.501738
12083,Marion County,,FL,18310,301723,320033,188,114,302,91839,47890,139729,5,0.420081,0.452219,4113.146961,0.059988,0.040018,13,0.00121,0,14,0.485004,0.469913
12085,Martin County,,FL,12647,142545,155192,70,56,126,37322,32426,69748,5,0.392014,0.418459,128.716928,0.028026,0.023343,13,0.000443,0,14,0.785434,0.22217
12086,Miami-Dade County,,FL,122367,2471315,2593682,308,354,662,308694,465754,774448,5,0.472401,0.521161,39163.611472,0.087647,0.091237,13,0.002196,0,14,0.29125,0.72468
12087,Monroe County,,FL,11430,79132,90562,65,65,130,16299,23592,39891,5,0.392218,0.41979,213.931416,0.025418,0.025151,13,0.000471,0,14,0.713194,0.214232
12089,Nassau County,,FL,5606,71336,76942,30,23,53,17702,12718,30420,6,0.341558,0.360542,327.047154,0.010834,0.007256,13,0.000302,0,14,0.712121,0.096019
12091,Okaloosa County,,FL,22978,201406,224384,161,168,329,52595,62083,114678,5,0.439889,0.4751,15652.323947,0.046372,0.048599,0,0.001307,0,14,0.421322,0.398477
12093,Okeechobee County,,FL,2772,34343,37115,15,16,31,6331,4676,11007,6,0.335156,0.352175,10.013135,0.004915,0.005907,13,0.000156,0,14,0.860294,0.043286
12095,Orange County,,FL,98980,1066801,1165781,412,378,790,407967,395888,803855,5,0.48141,0.530287,61397.73658,0.099137,0.094461,13,0.003025,0,14,0.229714,0.817686
12097,Osceola County,,FL,27590,221538,249128,141,118,259,127619,95227,222846,5,0.410888,0.444202,901.527192,0.051474,0.042914,13,0.00088,0,14,0.614731,0.403694
12099,Palm Beach County,,FL,79600,1310585,1390185,340,389,729,307002,298744,605746,5,0.47842,0.5294,48280.503035,0.090861,0.0929,13,0.002305,0,14,0.239363,0.738206
12101,Pasco County,,FL,32363,405147,437510,251,196,447,183122,105588,288710,5,0.433791,0.473496,7957.483163,0.074319,0.060374,13,0.001584,0,14,0.366183,0.584696
12103,Pinellas County,,FL,66068,976486,1042554,393,385,778,210666,217408,428074,5,0.48397,0.532756,72689.392356,0.095136,0.093286,13,0.002798,0,14,0.224799,0.771176
12105,Polk County,,FL,31792,548004,579796,278,225,503,163590,101335,264925,5,0.449163,0.489187,21869.572105,0.07732,0.064584,13,0.001888,0,14,0.316409,0.617028
12107,Putnam County,,FL,4513,69662,74175,25,22,47,12779,11359,24138,6,0.338975,0.356935,30.524631,0.00819,0.008248,13,0.000251,0,14,0.9,0.075416
12109,St. Johns County,,FL,14590,161672,176262,130,70,200,64775,39416,104191,5,0.401927,0.430027,1433.250893,0.046724,0.028627,13,0.000927,0,14,0.668044,0.385998
12111,St. Lucie County,,FL,18963,236519,255482,130,119,249,105471,56952,162423,5,0.412184,0.445478,1230.335072,0.046653,0.040261,13,0.000764,0,14,0.551682,0.361605
12113,Santa Rosa County,,FL,15073,138243,153316,101,82,183,46527,38403,84930,5,0.398039,0.427918,2604.522843,0.033572,0.027814,0,0.000812,0,14,0.559177,0.290867
12115,Sarasota County,,FL,28032,380583,408615,239,184,423,112511,85073,197584,5,0.439889,0.476981,5629.363508,0.072039,0.061088,13,0.00144,0,14,0.39224,0.562374
12117,Seminole County,,FL,46014,419176,465190,214,199,413,171828,165318,337146,5,0.44749,0.484915,3675.705097,0.071985,0.068477,13,0.001478,0,14,0.492997,0.589739
12119,Sumter County,,FL,4202,58180,62382,93,17,110,28185,10122,38307,6,0.33787,0.35506,11.300807,0.035281,0.007047,13,0.000577,0,14,0.775109,0.27674
12121,Suwannee County,,FL,2719,36619,39338,27,21,48,9327,6400,15727,6,0.339397,0.357324,4423.111403,0.008244,0.006415,13,0.000301,0,14,0.680645,0.074162
12123,Taylor County,,FL,915,19591,20506,10,5,15,1265,1009,2274,6,0.330655,0.345129,323.150256,0.0021,0.001435,13,0.000171,0,14,0.522222,0.019076
12125,Union County,,FL,1003,10236,11239,6,6,12,2675,2472,5147,6,0.32308,0.336579,0,0.001037,0.001163,13,0.000119,0,14,1,0.010058
12127,Volusia County,,FL,31844,492817,524661,257,227,484,128403,100596,228999,5,0.448827,0.489009,14612.03233,0.074614,0.067952,13,0.001686,0,14,0.349205,0.593583
12129,Wakulla County,,FL,1923,24745,26668,11,7,18,7459,4338,11797,6,0.323707,0.337633,176.214913,0.003797,0.00107,13,0.000156,0,14,0.606061,0.031985
12131,Walton County,,FL,4506,42803,47309,31,22,53,13630,9605,23235,6,0.343197,0.361673,702.068199,0.009932,0.006422,0,0.000314,0,14,0.75504,0.085299
12133,Washington County,,FL,1680,20371,22051,9,7,16,5299,4269,9568,6,0.309531,0.322553,6.459697,0.002228,0.000985,13,0.000135,0,14,0.855556,0.019501
13001,Appling County,,GA,1082,17908,18990,5,7,12,1190,1524,2714,6,0.303926,0.316012,602.045871,0.000019,0.000399,15,0.000156,0,14,0.404762,0.000498
13003,Atkinson County,,GA,511,7894,8405,1,2,3,756,928,1684,7,0.246169,0.252864,0,0.000007,0.000008,15,0.000063,0,14,0.5,0.00011
13005,Bacon County,,GA,542,9774,10316,4,5,9,1031,1049,2080,7,0.247487,0.25505,8.592857,0.000024,0.000014,15,0.000121,0,14,0.55,0.000419
13007,Baker County,,GA,268,3340,3608,2,2,4,365,326,691,6,0.265935,0.274534,0,0.000058,0.000057,15,0.000082,0,14,1,0.000636
13009,Baldwin County,,GA,2608,41868,44476,15,20,35,5782,6513,12295,6,0.326699,0.343348,6657.782192,0.002445,0.00363,15,0.000273,0,14,0.568421,0.023864
13011,Banks County,,GA,1651,16210,17861,10,10,20,5582,5041,10623,6,0.317749,0.331297,2.856695,0.000749,0.000834,15,0.00019,0,14,0.811111,0.007876
13013,Barrow County,,GA,4912,56015,60927,25,19,44,25508,14471,39979,6,0.323881,0.339336,296.112609,0.006172,0.003172,15,0.000315,0,14,0.575499,0.054998
13015,Bartow County,,GA,6951,94147,101098,31,24,55,22616,17771,40387,6,0.325496,0.342183,831.444321,0.007546,0.003834,15,0.000395,0,14,0.559715,0.072551
13017,Ben Hill County,,GA,1230,17464,18694,5,6,11,1872,1804,3676,6,0.285905,0.297781,1546.844437,0.000142,0.000283,15,0.000139,0,14,0.466667,0.001427
13019,Berrien County,,GA,1368,16516,17884,10,6,16,3193,3051,6244,6,0.28265,0.293581,955.673337,0.000677,0.000147,15,0.000242,0,14,0.277778,0.006587
13021,Bibb County,,GA,11329,159034,170363,61,65,126,26625,31295,57920,5,0.391299,0.418653,21700.689672,0.014162,0.016583,15,0.000715,0,14,0.418038,0.122274
13023,Bleckley County,,GA,739,12921,13660,6,6,12,1502,1471,2973,6,0.289961,0.301165,6.391323,0.000248,0.00027,15,0.000151,0,14,0.766667,0.002765
13025,Brantley County,,GA,1250,15431,16681,6,6,12,3171,2826,5997,6,0.323185,0.336745,0.965509,0.000635,0.0007,13,0.000137,0,14,0.866667,0.006285
13027,Brooks County,,GA,1356,14432,15788,4,4,8,3110,3459,6569,6,0.278303,0.288521,0.920408,0.000138,0.000139,15,0.000113,0,14,0.833333,0.001499
13029,Bryan County,,GA,3590,28013,31603,13,13,26,9016,6942,15958,6,0.345168,0.3627,290.328934,0.003428,0.003149,15,0.000173,0,14,0.599415,0.030145
13031,Bulloch County,,GA,4192,49277,53469,30,29,59,10916,9887,20803,6,0.331787,0.351343,3617.037746,0.004705,0.005248,15,0.000436,0,14,0.4082,0.044139
13033,Burke County,,GA,1523,24344,25867,8,8,16,3883,4343,8226,6,0.296985,0.309154,492.186271,0.000967,0.000479,15,0.000154,0,14,0.472222,0.008921
13035,Butts County,,GA,1826,20857,22683,16,13,29,7556,5461,13017,6,0.323672,0.338338,35.221836,0.002605,0.002754,15,0.000227,0,14,0.729167,0.026708
13037,Calhoun County,,GA,438,5681,6119,2,3,5,418,706,1124,6,0.266005,0.274811,1.291851,0.000058,0.000058,15,0.000083,0,14,0.666667,0.000633
13039,Camden County,,GA,7110,46632,53742,38,33,71,13981,13702,27683,5,0.362714,0.384659,893.320008,0.011703,0.009525,13,0.00036,0,14,0.618393,0.101493
13043,Candler County,,GA,681,9339,10020,4,4,8,1474,1346,2820,6,0.303342,0.314764,0.637302,0.000333,0.000356,15,0.000112,0,14,0.916667,0.00329
13045,Carroll County,,GA,7230,99627,106857,39,30,69,26942,21100,48042,6,0.33175,0.351592,3138.213126,0.009091,0.005586,15,0.00045,0,14,0.579878,0.082582
13047,Catoosa County,,GA,5251,58916,64167,13,11,24,17807,14804,32611,6,0.320495,0.334937,300.843156,0.002048,0.001142,0,0.000222,0,14,0.544872,0.019412
13049,Charlton County,,GA,718,9043,9761,4,5,9,1683,1604,3287,6,0.323045,0.336413,1.133283,0.000624,0.0007,13,0.000094,0,14,0.8,0.006069
13051,Chatham County,,GA,21847,237825,259672,186,161,347,57600,58563,116163,5,0.434795,0.470334,58218.539056,0.054521,0.050164,15,0.001638,0,14,0.446724,0.465943
13053,Chattahoochee County,,GA,4424,7578,12002,23,27,50,6546,9129,15675,6,0.361579,0.382063,410.431515,0.005829,0.006429,15,0.000214,0,14,0.722988,0.049672
13055,Chattooga County,,GA,1272,25414,26686,8,10,18,3156,3355,6511,6,0.295059,0.307135,15.986668,0.000303,0.000362,15,0.000164,0,14,0.6,0.003691
13057,Cherokee County,,GA,15411,181468,196879,103,76,179,74394,47013,121407,5,0.398779,0.427752,4162.937864,0.033275,0.025378,15,0.000957,0,14,0.560394,0.290251
13059,Clarke County,,GA,11590,85516,97106,78,81,159,27095,31718,58813,5,0.402034,0.431663,15546.623837,0.018683,0.022993,15,0.000881,0,14,0.449328,0.172329
13061,Clay County,,GA,216,2769,2985,0,0,0,0,0,0,0,0,0,0,0,0,14,0.000049,11,28,0,0
13063,Clayton County,,GA,35502,246602,282104,145,114,259,125086,126618,251704,5,0.424054,0.456131,14031.107811,0.04688,0.035311,15,0.001187,0,14,0.50794,0.391283
13065,Clinch County,,GA,328,6522,6850,2,2,4,271,378,649,6,0.278225,0.288188,0,0.000125,0.000108,15,0.000076,0,14,1,0.001123
13067,Cobb County,,GA,73665,692032,765697,333,297,630,264752,262850,527602,5,0.465809,0.509981,77808.138252,0.085554,0.080667,15,0.002796,0,14,0.293631,0.71997
13069,Coffee County,,GA,1937,37254,39191,11,16,27,3090,3485,6575,6,0.326061,0.341933,13544.347753,0.000666,0.001259,15,0.000267,0,14,0.283088,0.00648
13071,Colquitt County,,GA,2101,40246,42347,13,13,26,3902,4084,7986,6,0.323498,0.338366,1584.130633,0.002427,0.001151,15,0.000218,0,14,0.455882,0.019879
13073,Columbia County,,GA,10281,113304,123585,64,50,114,33945,24280,58225,5,0.383555,0.409415,9154.02595,0.02218,0.017279,15,0.000578,0,14,0.650304,0.191656
13075,Cook County,,GA,1051,16005,17056,5,6,11,2698,2670,5368,6,0.278406,0.288992,6.757747,0.000143,0.000137,15,0.000145,0,14,0.6,0.001548
13077,Coweta County,,GA,7901,111500,119401,64,41,105,32762,20407,53169,6,0.373957,0.398385,2576.365597,0.020728,0.010956,15,0.000594,0,14,0.615942,0.182331
13079,Crawford County,,GA,1121,12637,13758,6,4,10,2968,2683,5651,6,0.28971,0.300527,0.45,0.000247,0.000254,15,0.000129,0,14,0.766667,0.002729
13081,Crisp County,,GA,1379,21917,23296,9,10,19,2396,2556,4952,6,0.322041,0.33598,5080.137718,0.000232,0.000784,15,0.000219,0,14,0.422222,0.002857
13083,Dade County,,GA,1125,15475,16600,6,6,12,2863,3042,5905,6,0.293847,0.305021,2.687908,0.000205,0.000232,0,0.000143,0,14,0.766667,0.002518
13085,Dawson County,,GA,1746,18263,20009,12,7,19,6883,4673,11556,6,0.321421,0.334926,2.530198,0.002799,0.001569,15,0.000197,0,14,0.818182,0.026772
13087,Decatur County,,GA,1675,27815,29490,9,10,19,2939,2967,5906,6,0.30513,0.318265,5164.1125,0.000385,0.00054,13,0.000227,0,14,0.4,0.003696
13089,DeKalb County,,GA,87793,641076,728869,292,276,568,297411,325997,623408,5,0.465664,0.507579,59951.333533,0.078995,0.076477,15,0.002422,0,14,0.333581,0.663418
13091,Dodge County,,GA,976,17750,18726,6,6,12,1725,1930,3655,6,0.290157,0.301443,438.310939,0.000247,0.000269,15,0.000155,0,14,0.633333,0.002751
13093,Dooly County,,GA,903,13006,13909,5,4,9,1640,1911,3551,6,0.283986,0.294546,5.821624,0.00015,0.000177,15,0.000134,0,14,0.6,0.001894
13095,Dougherty County,,GA,7838,94778,102616,42,44,86,17814,21072,38886,5,0.36219,0.385686,37080.359807,0.009641,0.009672,15,0.000582,0,14,0.441752,0.083667
13097,Douglas County,,GA,12352,108566,120918,81,50,131,57300,41546,98846,5,0.388566,0.414325,2840.778747,0.028341,0.015136,15,0.000686,0,14,0.623824,0.238116
13099,Early County,,GA,714,12106,12820,5,6,11,958,1374,2332,6,0.267522,0.277558,786.158473,0.000098,0.000138,13,0.000162,0,14,0.466667,0.001516
13101,Echols County,,GA,245,2686,2931,1,1,2,404,499,903,6,0.278071,0.287744,0,0.000115,0.000102,15,0.00006,0,14,0,0.000988
13103,Effingham County,,GA,3320,46451,49771,11,9,20,12778,7912,20690,6,0.326984,0.342382,79.291113,0.002514,0.001908,15,0.000158,0,14,0.681818,0.022252
13105,Elbert County,,GA,1064,22075,23139,6,6,12,1614,2024,3638,6,0.287464,0.298557,3.076175,0.000656,0.000238,15,0.000137,0,14,0.714286,0.006766
13107,Emanuel County,,GA,1297,22480,23777,11,12,23,2373,2623,4996,6,0.305688,0.318819,1516.869627,0.000571,0.000587,15,0.000248,0,14,0.348485,0.005718
13109,Evans County,,GA,681,10447,11128,4,4,8,1340,1330,2670,6,0.30322,0.314569,0.25,0.000348,0.000372,15,0.000106,0,14,0.916667,0.003423
13111,Fannin County,,GA,1368,21437,22805,11,8,19,2716,2154,4870,6,0.321524,0.335148,221.824282,0.002792,0.001338,15,0.000255,0,14,0.575758,0.026866
13113,Fayette County,,GA,9814,111214,121028,55,45,100,29251,26812,56063,5,0.388114,0.413077,1458.492201,0.0211,0.015952,15,0.000474,0,14,0.705769,0.178243
13115,Floyd County,,GA,6625,95547,102172,27,28,55,11292,12245,23537,6,0.352499,0.373336,1994.112414,0.004811,0.005,15,0.000378,0,14,0.445076,0.044867
13117,Forsyth County,,GA,10998,134031,145029,98,56,154,58752,28819,87571,5,0.383947,0.410192,3035.838853,0.033324,0.019254,15,0.000881,0,14,0.599495,0.289295
13119,Franklin County,,GA,1539,22087,23626,12,11,23,4401,4443,8844,6,0.317884,0.33163,29.525929,0.000857,0.000896,15,0.000224,0,14,0.641026,0.009638
13121,Fulton County,,GA,103901,748429,852330,380,300,680,412763,384690,797453,5,0.469228,0.512838,122300.988353,0.089402,0.081105,15,0.003329,0,14,0.259525,0.75297
13123,Gilmer County,,GA,1599,23041,24640,17,12,29,4291,3471,7762,6,0.321696,0.335841,76.24136,0.004409,0.00161,15,0.000281,0,14,0.611111,0.041089
13125,Glascock County,,GA,188,2706,2894,2,0,2,290,0,290,0,0,0,0,0.000005,0,15,0.000084,0,4,1,0.00018
13127,Glynn County,,GA,5288,72746,78034,37,27,64,11181,9956,21137,6,0.359416,0.379672,1456.155785,0.010487,0.006902,13,0.000417,0,14,0.552632,0.092531
13129,Gordon County,,GA,3222,52403,55625,19,15,34,10006,8308,18314,6,0.344614,0.363083,479.854931,0.003078,0.003178,15,0.000292,0,14,0.581579,0.030262
13131,Grady County,,GA,1428,22912,24340,7,7,14,3465,3296,6761,6,0.304542,0.316961,68.508452,0.000391,0.000461,15,0.000155,0,14,0.696429,0.003664
13133,Greene County,,GA,976,15625,16601,9,11,20,1867,1991,3858,6,0.322629,0.33684,3046.86942,0.002081,0.001785,15,0.000146,0,14,0.67033,0.019387
13135,Gwinnett County,,GA,67181,723584,790765,335,294,629,295645,250917,546562,5,0.464872,0.508994,88252.607084,0.085703,0.077575,15,0.002798,0,14,0.283572,0.720667
13137,Habersham County,,GA,2243,38748,40991,14,14,28,7515,6052,13567,6,0.323637,0.338393,29.338822,0.002256,0.002509,15,0.000235,0,14,0.703297,0.022099
13139,Hall County,,GA,11095,163338,174433,65,50,115,39218,30213,69431,6,0.38088,0.406502,3385.453694,0.018646,0.013132,15,0.000697,0,14,0.525466,0.167557
13141,Hancock County,,GA,584,9188,9772,1,1,2,602,947,1549,7,0.24627,0.25288,0,0.000021,0.000014,15,0.000061,0,14,0,0.000207
13143,Haralson County,,GA,2099,26771,28870,10,8,18,6870,5996,12866,6,0.321455,0.335037,463.131233,0.001839,0.001441,15,0.000168,0,14,0.781818,0.019054
13145,Harris County,,GA,2487,29051,31538,10,9,19,8654,6122,14776,6,0.32308,0.3374,107.176376,0.001401,0.001352,15,0.00016,0,14,0.527273,0.012138
13147,Hart County,,GA,1384,24232,25616,11,9,20,3567,3066,6633,6,0.317783,0.331242,43.805915,0.002081,0.000799,15,0.000195,0,14,0.621212,0.019789
13149,Heard County,,GA,979,10351,11330,6,5,11,2610,2553,5163,6,0.319847,0.332623,46.413594,0.00107,0.000724,15,0.000123,0,14,0.833333,0.010754
13151,Henry County,,GA,16070,175076,191146,127,81,208,84941,55162,140103,5,0.403221,0.432662,8555.471733,0.040688,0.024409,15,0.001055,0,14,0.525428,0.342136
13153,Houston County,,GA,12224,136527,148751,110,82,192,33675,27368,61043,5,0.396045,0.425738,52911.829537,0.027899,0.021397,15,0.001111,0,14,0.408413,0.242569
13155,Irwin County,,GA,808,9155,9963,4,4,8,1684,1840,3524,7,0.248655,0.256664,2.998088,0.000029,0.000022,15,0.00013,0,14,0.75,0.000488
13157,Jackson County,,GA,4300,49475,53775,24,18,42,22180,12912,35092,6,0.323777,0.339059,278.570259,0.004088,0.002577,15,0.000357,0,14,0.585145,0.040145
13159,Jasper County,,GA,1097,13034,14131,9,9,18,4014,2608,6622,6,0.321077,0.334798,1.122716,0.001385,0.001474,15,0.000155,0,14,0.855556,0.014972
13161,Jeff Davis County,,GA,801,13750,14551,5,4,9,1466,1275,2741,7,0.24765,0.255205,27.864305,0.000015,0.000009,15,0.00015,0,14,0.45,0.000439
13163,Jefferson County,,GA,988,19673,20661,6,7,13,1458,2219,3677,6,0.29634,0.307878,1333.927984,0.000326,0.000345,15,0.000136,0,14,0.404762,0.003331
13165,Jenkins County,,GA,393,8275,8668,4,5,9,692,968,1660,6,0.296282,0.307573,1.65337,0.000041,0.00024,15,0.000113,0,14,0.8,0.000642
13167,Johnson County,,GA,515,8438,8953,3,3,6,924,1217,2141,7,0.246593,0.253785,0.925669,0.000028,0.000024,15,0.0001,0,14,0.666667,0.000438
13169,Jones County,,GA,2128,28640,30768,9,10,19,6932,5601,12533,6,0.301334,0.314808,86.206688,0.000278,0.000594,15,0.000199,0,14,0.455556,0.003245
13171,Lamar County,,GA,1483,15787,17270,10,9,19,4433,3769,8202,6,0.320085,0.333455,12.351892,0.001445,0.001187,15,0.000166,0,14,0.855556,0.014468
13173,Lanier County,,GA,776,6698,7474,4,2,6,2050,1588,3638,6,0.278174,0.288049,0,0.000559,0.000106,15,0.000122,0,14,0.75,0.005107
13175,Laurens County,,GA,2386,50057,52443,22,21,43,4529,3987,8516,6,0.326913,0.343764,19744.885881,0.003199,0.003341,15,0.000399,0,14,0.365942,0.029971
13177,Lee County,,GA,2716,27630,30346,13,12,25,9461,6357,15818,6,0.328234,0.344391,1850.338186,0.001909,0.001934,15,0.000233,0,14,0.522059,0.016436
13179,Liberty County,,GA,17513,57366,74879,72,93,165,21759,29367,51126,5,0.40782,0.438088,7799.349574,0.021888,0.030158,15,0.000657,0,14,0.564444,0.189652
13181,Lincoln County,,GA,539,8700,9239,4,4,8,934,1133,2067,6,0.295815,0.306724,0.53915,0.000317,0.000336,15,0.000108,0,14,0.833333,0.003104
13183,Long County,,GA,1689,7662,9351,4,4,8,3446,3047,6493,6,0.30411,0.31564,0.817832,0.000483,0.00046,15,0.000106,0,14,0.833333,0.004148
13185,Lowndes County,,GA,9502,93693,103195,74,74,148,21640,20699,42339,5,0.385128,0.413532,41422.349938,0.017294,0.019543,15,0.000917,0,14,0.38254,0.15718
13187,Lumpkin County,,GA,2224,22603,24827,15,11,26,6655,5056,11711,6,0.323567,0.337949,43.050149,0.003663,0.002591,15,0.000251,0,14,0.680952,0.035094
13189,McDuffie County,,GA,1497,23497,24994,7,8,15,3600,3286,6886,6,0.296486,0.308361,1731.117772,0.000387,0.00045,15,0.000172,0,14,0.375,0.004311
13191,McIntosh County,,GA,958,10674,11632,4,4,8,1873,1632,3505,6,0.304203,0.315779,0,0.001032,0.000519,13,0.000085,0,14,1,0.009191
13193,Macon County,,GA,853,10672,11525,4,6,10,1139,1844,2983,6,0.283959,0.29474,219.330432,0.000148,0.000181,15,0.000123,0,14,0.433333,0.00184
13195,Madison County,,GA,2099,27924,30023,12,11,23,6700,5962,12662,6,0.317783,0.331464,49.952716,0.000755,0.000828,15,0.000241,0,14,0.666667,0.008319
13197,Marion County,,GA,523,6582,7105,3,1,4,756,620,1376,6,0.292902,0.303451,196.82549,0.000233,0.000196,15,0.000099,0,14,0.333333,0.002148
13199,Meriwether County,,GA,1798,23196,24994,11,13,24,5192,5208,10400,6,0.321696,0.335874,92.205223,0.001241,0.0016,15,0.000187,0,14,0.628205,0.013638
13201,Miller County,,GA,394,5603,5997,3,3,6,814,783,1597,7,0.233884,0.239898,0.305556,0.000004,0.000003,13,0.000121,0,14,0.833333,0.000242
13205,Mitchell County,,GA,1596,22237,23833,8,8,16,3034,3472,6506,6,0.266218,0.275866,19.998583,0.000097,0.000109,15,0.000203,0,14,0.5,0.001484
13207,Monroe County,,GA,1837,24524,26361,12,13,25,5737,4217,9954,6,0.324687,0.339458,158.708622,0.002016,0.002108,15,0.000191,0,14,0.580952,0.020143
13209,Montgomery County,,GA,635,7860,8495,3,4,7,1242,1330,2572,7,0.246614,0.253951,680.602799,0.000006,0.000024,15,0.000127,0,14,0.5,0.000255
13211,Morgan County,,GA,1038,17471,18509,12,10,22,4015,2679,6694,6,0.322595,0.336673,3.084148,0.002139,0.001869,15,0.00019,0,14,0.833333,0.020745
13213,Murray County,,GA,3172,39954,43126,10,9,19,9252,9233,18485,6,0.294973,0.306913,107.341198,0.001274,0.000371,0,0.000179,0,14,0.5,0.011306
13215,Muscogee County,,GA,21503,193647,215150,114,116,230,48334,56104,104438,5,0.414173,0.446965,36418.670171,0.03318,0.033098,15,0.001123,0,14,0.479833,0.286133
13217,Newton County,,GA,7480,84009,91489,51,29,80,39076,24716,63792,6,0.33538,0.355543,379.249604,0.015577,0.006321,15,0.000464,0,14,0.589797,0.127852
13219,Oconee County,,GA,2677,30758,33435,15,12,27,8335,6241,14576,6,0.323567,0.33806,104.918657,0.002233,0.002343,15,0.000246,0,14,0.747619,0.022304
13221,Oglethorpe County,,GA,1156,13188,14344,8,5,13,3367,2560,5927,6,0.286942,0.297476,1.369007,0.000657,0.000188,15,0.000164,0,14,0.714286,0.006626
13223,Paulding County,,GA,10105,111385,121490,65,33,98,54890,29977,84867,5,0.373353,0.395462,1311.24237,0.023146,0.009732,15,0.000566,0,14,0.645756,0.1963
13225,Peach County,,GA,2543,24768,27311,7,7,14,6812,6213,13025,6,0.321283,0.334565,155.434757,0.000711,0.000791,15,0.000152,0,14,0.571429,0.007083
13227,Pickens County,,GA,2100,28100,30200,12,10,22,7493,5035,12528,6,0.322595,0.336729,5.668091,0.00225,0.00217,15,0.000222,0,14,0.787879,0.023038
13229,Pierce County,,GA,1262,17044,18306,7,6,13,3690,2843,6533,6,0.323219,0.336773,1302.714663,0.000587,0.000632,13,0.000159,0,14,0.690476,0.005818
13231,Pike County,,GA,1324,16462,17786,9,8,17,5317,3383,8700,6,0.319745,0.33279,1.730952,0.000574,0.001221,15,0.000159,0,14,0.833333,0.007481
13233,Polk County,,GA,2113,39760,41873,11,12,23,6352,6074,12426,6,0.321938,0.336257,33.378437,0.001378,0.001726,15,0.000185,0,14,0.673077,0.015129
13235,Pulaski County,,GA,598,9477,10075,4,5,9,876,1234,2110,6,0.289822,0.300804,466.694468,0.000129,0.000252,15,0.000129,0,14,0.466667,0.001722
13237,Putnam County,,GA,1656,20066,21722,17,12,29,3833,3157,6990,6,0.324056,0.338726,124.735692,0.002726,0.001926,15,0.000241,0,14,0.709559,0.027424
13239,Quitman County,,GA,197,2147,2344,1,1,2,328,352,680,7,0.238716,0.244245,0,0.000005,0.000007,0,0.000063,0,14,0,0.000134
13241,Rabun County,,GA,947,16023,16970,8,7,15,1245,1292,2537,6,0.321559,0.33512,16.69879,0.001704,0.00124,15,0.000157,0,14,0.611111,0.016758
13243,Randolph County,,GA,500,7746,8246,2,2,4,219,378,597,6,0.265935,0.274534,0.5,0.000057,0.000057,15,0.000084,0,14,0.666667,0.000625
13245,Richmond County,,GA,21390,199722,221112,113,117,230,49132,58468,107600,5,0.419729,0.45233,45848.515709,0.03406,0.035703,15,0.001067,0,14,0.469935,0.293887
13247,Rockdale County,,GA,10046,75349,85395,43,33,76,34180,31054,65234,6,0.336847,0.358095,579.572351,0.014988,0.006793,15,0.000389,0,14,0.607765,0.123148
13249,Schley County,,GA,312,4121,4433,2,2,4,923,697,1620,7,0.246129,0.252681,3.078268,0.000018,0.000012,15,0.000082,0,14,0.333333,0.000243
13251,Screven County,,GA,986,15267,16253,5,6,11,1725,2089,3814,6,0.305068,0.317099,121.151816,0.000342,0.000571,15,0.000121,0,14,0.633333,0.003469
13253,Seminole County,,GA,766,9386,10152,4,4,8,1396,1460,2856,7,0.256445,0.265111,417.873403,0.000044,0.000081,13,0.00014,0,14,0.666667,0.000987
13255,Spalding County,,GA,5148,62435,67583,21,22,43,16385,14547,30932,6,0.326948,0.343864,108.626598,0.003987,0.003857,15,0.000274,0,14,0.653846,0.037767
13257,Stephens County,,GA,1879,26554,28433,12,13,25,3289,3366,6655,6,0.321249,0.335519,19.074975,0.001092,0.001419,15,0.000226,0,14,0.582418,0.011349
13259,Stewart County,,GA,383,4766,5149,2,2,4,288,535,823,6,0.292959,0.303673,6040,0.000195,0.000196,15,0.000155,0,14,0,0.001792
13261,Sumter County,,GA,2075,32638,34713,12,14,26,2867,3977,6844,6,0.32638,0.342172,6648.798364,0.00178,0.002793,15,0.000251,0,14,0.471429,0.016754
13263,Talbot County,,GA,476,7340,7816,3,3,6,1021,1106,2127,6,0.293045,0.30395,0,0.000212,0.000211,15,0.000085,0,14,1,0.002013
13265,Taliaferro County,,GA,165,1688,1853,1,0,1,79,0,79,0,0,0,0,0.000011,0,15,0.00006,0,10,0,0.000176
13267,Tattnall County,,GA,1180,18665,19845,9,7,16,2668,2303,4971,6,0.304295,0.316278,23.280706,0.000539,0.00049,15,0.000196,0,14,0.527778,0.004972
13269,Taylor County,,GA,548,9062,9610,2,6,8,306,791,1097,6,0.297337,0.309621,14.788313,0.000127,0.000455,15,0.000078,0,14,0.52381,0.001564
13271,Telfair County,,GA,650,11232,11882,4,5,9,972,1168,2140,7,0.249067,0.257491,2437.759252,0.000021,0.000024,15,0.000148,0,14,0.2,0.000468
13273,Terrell County,,GA,770,11175,11945,3,3,6,1253,1672,2925,6,0.266029,0.274867,2.083333,0.000069,0.000079,15,0.000113,0,14,0.666667,0.00079
13275,Thomas County,,GA,2533,44619,47152,16,12,28,6214,5530,11744,6,0.333852,0.350344,1890.882071,0.003636,0.002575,15,0.000254,0,14,0.511029,0.031794
13277,Tift County,,GA,2654,40127,42781,17,22,39,5630,5772,11402,6,0.330182,0.348385,11350.287432,0.002176,0.003198,15,0.000328,0,14,0.411232,0.020714
13279,Toombs County,,GA,1602,26158,27760,10,10,20,2746,2969,5715,6,0.321938,0.335969,12302.653398,0.000853,0.000902,15,0.000254,0,14,0.310606,0.008308
13281,Towns County,,GA,650,9893,10543,6,2,8,1127,799,1926,7,0.24144,0.247143,24.969659,0.001962,0.000041,13,0.000195,0,14,0.666667,0.017856
13283,Treutlen County,,GA,395,6248,6643,4,4,8,541,527,1068,7,0.246715,0.254201,30.593907,0.000029,0.000027,15,0.000132,0,14,0.666667,0.000538
13285,Troup County,,GA,3678,65103,68781,19,16,35,9737,8450,18187,6,0.325425,0.34109,267.429493,0.003294,0.003011,15,0.000259,0,14,0.605263,0.031397
13287,Turner County,,GA,645,9601,10246,3,3,6,873,1136,2009,7,0.248388,0.255982,0,0.000024,0.000015,15,0.000101,0,14,1,0.000359
13289,Twiggs County,,GA,1060,10874,11934,6,6,12,1983,2454,4437,6,0.289961,0.301165,22.118651,0.000249,0.000271,15,0.000145,0,14,0.733333,0.002771
13291,Union County,,GA,1121,18869,19990,21,7,28,3158,1355,4513,6,0.31822,0.331436,5350.682665,0.00635,0.000616,13,0.000417,0,14,0.619048,0.057771
13293,Upson County,,GA,1435,28069,29504,10,9,19,2896,2614,5510,6,0.320188,0.333622,24.771634,0.000989,0.001291,15,0.000167,0,14,0.672727,0.010572
13295,Walker County,,GA,4455,64289,68744,13,14,27,14284,12973,27257,6,0.322941,0.337827,184.033811,0.000801,0.001395,0,0.00024,0,14,0.519048,0.008705
13297,Walton County,,GA,4971,72831,77802,27,19,46,25689,15067,40756,6,0.323916,0.339392,74.071774,0.006725,0.003426,15,0.000329,0,14,0.650794,0.062174
13299,Ware County,,GA,2310,34187,36497,13,13,26,4956,5383,10339,6,0.32734,0.343309,2970.353768,0.001095,0.001717,13,0.000253,0,14,0.428571,0.010956
13301,Warren County,,GA,486,6610,7096,2,2,4,887,1104,1991,6,0.295728,0.306336,0,0.000213,0.000203,15,0.000075,0,14,1,0.001859
13303,Washington County,,GA,895,21619,22514,6,7,13,1014,1511,2525,6,0.321627,0.335164,743.905055,0.000351,0.000847,15,0.000139,0,14,0.52381,0.003161
13305,Wayne County,,GA,1542,26492,28034,11,10,21,3169,2496,5665,6,0.324546,0.339148,1262.380941,0.001089,0.00111,13,0.000215,0,14,0.481818,0.010139
13307,Webster County,,GA,186,2513,2699,1,1,2,149,40,189,7,0.226597,0.231506,0,0.000001,0.000001,15,0.000115,0,14,0,0.000075
13309,Wheeler County,,GA,301,4605,4906,2,3,5,458,424,882,7,0.243811,0.250078,3.58656,0,0.000005,15,0.000101,0,14,0.333333,0.000138
13311,White County,,GA,1819,23431,25250,13,11,24,5353,4561,9914,6,0.322525,0.336729,23.644336,0.003235,0.001929,15,0.000199,0,14,0.714286,0.029647
13313,Whitfield County,,GA,6548,103818,110366,21,26,47,14525,16422,30947,6,0.371782,0.393731,1580.098546,0.005559,0.006693,0,0.000278,0,14,0.529915,0.049254
13315,Wilcox County,,GA,461,7058,7519,2,3,5,434,596,1030,7,0.244486,0.250972,3.03799,0.000006,0.000003,15,0.000087,0,14,0,0.000164
13317,Wilkes County,,GA,660,11092,11752,4,4,8,456,748,1204,6,0.298519,0.310109,12.576254,0.000351,0.000315,15,0.000107,0,14,0.666667,0.003017
13319,Wilkinson County,,GA,754,11254,12008,5,5,10,1334,1666,3000,6,0.281643,0.291733,3.03858,0.000144,0.00012,15,0.000124,0,14,0.8,0.001415
13321,Worth County,,GA,1682,22474,24156,7,7,14,3823,4190,8013,6,0.266359,0.275976,48.377482,0.000099,0.000097,15,0.000173,0,14,0.642857,0.001334
15001,Hawaii County,,HI,6860,164377,171237,66,46,112,27993,17744,45737,5,0.378385,0.403201,79.111328,0.019415,0.016617,4,0.000522,0,14,0.813433,0.172303
15003,Honolulu County,,HI,59069,1015723,1074792,345,360,705,172950,200622,373572,5,0.479872,0.527058,45099.20276,0.089581,0.088649,4,0.002505,0,14,0.278675,0.743842
15005,Kalawao County,,HI,-2,-2,-4,0,0,0,0,0,0,0,0,0,0,0,0,16,0.000049,12,29,0,0
15007,Kauai County,,HI,3093,67942,71035,18,13,31,3497,5750,9247,5,0.359717,0.378529,0.152007,0.007695,0.005892,4,0.000163,0,14,0.962451,0.065689
15009,Maui County,,HI,7730,151705,159435,58,53,111,20088,19533,39621,5,0.381122,0.406974,40.334115,0.020465,0.019378,4,0.000451,0,14,0.870712,0.180298
16001,Ada County,,ID,23604,364837,388441,179,145,324,109903,81234,191137,5,0.409934,0.446089,76266.144058,0.037004,0.030838,4,0.001857,0,14,0.319508,0.33067
16003,Adams County,,ID,356,3763,4119,3,4,7,641,568,1209,6,0.291029,0.302924,0.25,0.000251,0.000321,4,0.000088,0,14,0.833333,0.003099
16005,Bannock County,,ID,6875,79162,86037,39,41,80,15101,16258,31359,5,0.359933,0.382507,14822.514527,0.006268,0.006074,4,0.000568,0,14,0.364015,0.058024
16007,Bear Lake County,,ID,459,6811,7270,2,2,4,267,442,709,6,0.273688,0.283095,0,0.0001,0.000084,4,0.000072,0,14,1,0.000931
16009,Benewah County,,ID,619,9324,9943,4,3,7,1129,1323,2452,6,0.290832,0.302674,0,0.000312,0.0003,4,0.000094,0,14,1,0.003159
16011,Bingham County,,ID,3461,46232,49693,14,14,28,8333,9587,17920,5,0.353246,0.371532,1921.648445,0.002411,0.002646,4,0.000223,0,14,0.757143,0.023021
16013,Blaine County,,ID,1966,22448,24414,12,14,26,2424,3187,5611,5,0.360149,0.379194,5435.887832,0.003141,0.004419,4,0.000184,0,14,0.6,0.028331
16015,Boise County,,ID,863,6495,7358,2,3,5,1834,1873,3707,6,0.291001,0.302757,0,0.00025,0.000316,4,0.000072,0,14,1,0.002985
16017,Bonner County,,ID,2936,38274,41210,22,11,33,6437,5661,12098,5,0.352831,0.370672,1212.163531,0.006824,0.002549,4,0.000269,0,14,0.699134,0.061058
16019,Bonneville County,,ID,7439,98445,105884,40,32,72,23653,18993,42646,5,0.363636,0.385286,3946.296457,0.008697,0.007437,4,0.000484,0,14,0.507198,0.078936
16021,Boundary County,,ID,790,10607,11397,3,3,6,1096,1117,2213,6,0.290775,0.302591,0,0.000279,0.000314,4,0.000093,0,14,1,0.003073
16023,Butte County,,ID,277,2909,3186,0,2,2,0,219,219,6,0.267873,0.276511,0,0,0.000088,4,0.000049,0,30,1,0
16025,Camas County,,ID,123,911,1034,1,0,1,192,0,192,0,0,0,0,0.000026,0,4,0.00006,0,7,0,0.000232
16027,Canyon County,,ID,12094,159848,171942,89,62,151,58671,39038,97709,5,0.367462,0.393398,10702.222531,0.01642,0.011498,4,0.000898,0,14,0.446608,0.145503
16029,Caribou County,,ID,600,7898,8498,1,2,3,438,666,1104,6,0.273688,0.283095,0,0.000036,0.000084,4,0.000061,0,14,1,0.000425
16031,Cassia County,,ID,1932,21836,23768,7,10,17,3787,4814,8601,6,0.319711,0.333333,4.514602,0.000717,0.001101,4,0.000133,0,14,0.833333,0.007598
16033,Clark County,,ID,96,952,1048,0,0,0,0,0,0,0,0,0,0,0,0,17,0.000049,13,31,0,0
16035,Clearwater County,,ID,705,8543,9248,5,5,10,850,1076,1926,6,0.290944,0.302979,0,0.000296,0.000266,4,0.000112,0,14,0.966667,0.003536
16037,Custer County,,ID,405,4262,4667,1,1,2,73,136,209,6,0.290775,0.302203,0,0.000182,0.000218,4,0.00006,0,14,0,0.00204
16039,Elmore County,,ID,4959,26994,31953,22,25,47,5604,6341,11945,5,0.365272,0.387162,1151.806576,0.006507,0.006778,4,0.000234,0,14,0.635632,0.057281
16041,Franklin County,,ID,931,13214,14145,7,4,11,1849,1642,3491,6,0.317179,0.329305,0,0.001013,0.000496,4,0.000121,0,14,1,0.00892
16043,Fremont County,,ID,1258,13282,14540,6,7,13,2143,2690,4833,6,0.318456,0.331663,13.869596,0.000298,0.000753,4,0.000129,0,14,0.892857,0.003601
16045,Gem County,,ID,1413,16490,17903,5,4,9,3172,3383,6555,6,0.291029,0.302924,0.916667,0.000255,0.000323,4,0.000136,0,14,0.7,0.003269
16047,Gooding County,,ID,1351,14430,15781,6,6,12,2560,3372,5932,6,0.291142,0.303368,73.830315,0.000329,0.000388,4,0.000129,0,14,0.761905,0.004083
16049,Idaho County,,ID,992,14684,15676,8,9,17,1366,1991,3357,6,0.298638,0.312028,632.027871,0.000363,0.000637,4,0.000175,0,14,0.611111,0.004652
16051,Jefferson County,,ID,2086,23323,25409,10,9,19,7193,6013,13206,6,0.319608,0.333056,79.127092,0.001696,0.001011,4,0.000158,0,14,0.9,0.015877
16053,Jerome County,,ID,1937,19439,21376,9,10,19,5134,5530,10664,6,0.318659,0.332329,415.355871,0.000946,0.000828,4,0.000169,0,14,0.672727,0.009817
16055,Kootenai County,,ID,8051,130010,138061,81,52,133,33669,22025,55694,5,0.365272,0.389725,5773.324558,0.015424,0.010614,4,0.000829,0,14,0.481497,0.136882
16057,Latah County,,ID,4323,33266,37589,24,27,51,6955,8888,15843,5,0.356389,0.377042,1199.569179,0.004359,0.005431,4,0.000334,0,14,0.591398,0.041454
16059,Lemhi County,,ID,578,7893,8471,3,2,5,299,241,540,6,0.290803,0.302369,0,0.000261,0.000269,4,0.000085,0,14,1,0.003002
16061,Lewis County,,ID,388,4073,4461,2,2,4,567,696,1263,7,0.249688,0.256028,0,0.00002,0.000015,4,0.000077,0,14,1,0.00029
16063,Lincoln County,,ID,442,4511,4953,4,4,8,1145,1140,2285,6,0.266005,0.27429,0.2,0.000067,0.000074,4,0.000105,0,14,0.916667,0.000947
16065,Madison County,,ID,3511,23891,27402,22,24,46,8310,11243,19553,5,0.357491,0.377996,641.992452,0.004683,0.004811,4,0.000282,0,14,0.632275,0.043692
16067,Minidoka County,,ID,1837,21250,23087,8,8,16,3549,4637,8186,6,0.318558,0.331941,47.611365,0.001386,0.000856,4,0.000138,0,14,0.861111,0.01387
16069,Nez Perce County,,ID,3072,40385,43457,13,17,30,7533,8283,15816,6,0.332706,0.348447,5741.741138,0.002192,0.002674,4,0.000225,0,14,0.627451,0.020991
16071,Oneida County,,ID,266,4409,4675,3,3,6,354,477,831,6,0.273713,0.283261,0,0.000141,0.000101,4,0.000086,0,14,1,0.001585
16073,Owyhee County,,ID,1304,10338,11642,3,3,6,2867,3292,6159,6,0.292417,0.304372,0,0.000289,0.000353,4,0.00008,0,14,1,0.003387
16075,Payette County,,ID,1890,21825,23715,6,5,11,5257,4562,9819,6,0.291057,0.30309,1.416667,0.000263,0.000324,4,0.000163,0,14,0.733333,0.003409
16077,Power County,,ID,671,8152,8823,2,2,4,1033,1291,2324,6,0.264716,0.27303,0,0.000051,0.000051,4,0.000074,0,14,1,0.000632
16079,Shoshone County,,ID,847,12325,13172,2,2,4,1560,1638,3198,6,0.290719,0.302369,0,0.000264,0.000274,4,0.000072,0,14,1,0.002651
16081,Teton County,,ID,750,7687,8437,6,5,11,1686,1037,2723,6,0.291113,0.303201,8.334745,0.000707,0.000334,4,0.000115,0,14,0.833333,0.007127
16083,Twin Falls County,,ID,5348,72072,77420,37,29,66,16389,13765,30154,5,0.361971,0.38305,4555.788064,0.00819,0.005719,4,0.0004,0,14,0.556707,0.072002
16085,Valley County,,ID,1016,8847,9863,5,6,11,2385,2156,4541,6,0.291113,0.303312,94.66857,0.000803,0.000322,4,0.00011,0,14,0.571429,0.008226
16087,Washington County,,ID,806,9947,10753,5,4,9,1647,1891,3538,6,0.291029,0.302924,0.583333,0.000261,0.000323,4,0.000136,0,14,0.8,0.003294
17001,Adams County,,IL,2846,78783,81629,15,22,37,4438,5231,9669,5,0.362758,0.383128,12004.392978,0.001756,0.00331,31,0.000248,0,14,0.454545,0.014548
17003,Alexander County,,IL,829,8208,9037,3,4,7,851,1231,2082,6,0.27926,0.28897,674.11933,0.000024,0.000052,31,0.000097,0,14,0.833333,0.000417
17005,Bond County,,IL,1204,18237,19441,6,6,12,2644,2567,5211,6,0.322872,0.335142,48.461623,0.000724,0.00067,31,0.000112,0,14,0.733333,0.006015
17007,Boone County,,IL,4344,56899,61243,15,14,29,20097,13683,33780,5,0.358644,0.377275,7.405017,0.003786,0.003186,105,0.000142,0,14,0.766667,0.028893
17009,Brown County,,IL,354,5835,6189,4,5,9,457,567,1024,6,0.266525,0.274922,13.989523,0.00003,0.000017,31,0.000107,0,14,0.5,0.000422
17011,Bureau County,,IL,2216,42481,44697,14,14,28,5658,5350,11008,6,0.342727,0.359504,777.936241,0.001994,0.00155,105,0.000178,0,14,0.595833,0.015779
17013,Calhoun County,,IL,174,6004,6178,2,2,4,355,366,721,6,0.288098,0.297559,0,0.000111,0.000091,31,0.000078,0,14,1,0.000922
17015,Carroll County,,IL,1123,19662,20785,10,8,18,2244,2325,4569,6,0.342453,0.35845,64.238031,0.001548,0.000711,105,0.000131,0,14,0.627273,0.012549
17017,Cass County,,IL,1039,15488,16527,5,4,9,1649,1712,3361,6,0.289375,0.299207,96.582462,0.000115,0.000074,105,0.000121,0,14,0.3,0.000999
17019,Champaign County,,IL,14078,188013,202091,96,113,209,32380,38048,70428,5,0.425797,0.456991,29385.704394,0.026664,0.036922,105,0.000828,0,14,0.50155,0.221552
17021,Christian County,,IL,2002,41017,43019,8,12,20,4020,4414,8434,6,0.345248,0.362528,209.178029,0.000813,0.001496,105,0.000136,0,14,0.615385,0.007028
17023,Clark County,,IL,1012,19689,20701,5,6,11,1949,2060,4009,6,0.318592,0.331236,328.440532,0.000075,0.000446,105,0.000127,0,14,0.4,0.000692
17025,Clay County,,IL,893,16547,17440,5,7,12,1377,1590,2967,7,0.259458,0.268523,42.174664,0.000023,0.00003,28,0.000119,0,14,0.333333,0.0005
17027,Clinton County,,IL,2082,42649,44731,8,9,17,5166,4917,10083,6,0.323011,0.335669,22.468586,0.00095,0.000893,31,0.000136,0,14,0.708333,0.007966
17029,Coles County,,IL,3805,51046,54851,20,21,41,7458,7916,15374,6,0.348209,0.367466,7943.149415,0.001961,0.002747,105,0.000284,0,14,0.393333,0.01537
17031,Cook County,,IL,277837,5767919,6045756,593,614,1207,681095,985222,1666317,5,0.519723,0.581292,527573.178175,0.106494,0.105911,105,0.004817,0,14,0.121628,0.882776
17033,Crawford County,,IL,949,22915,23864,5,7,12,1044,1160,2204,6,0.280067,0.290441,249.855757,0.00006,0.000041,105,0.000126,0,14,0.333333,0.000579
17035,Cumberland County,,IL,848,12287,13135,5,4,9,1967,1876,3843,7,0.258698,0.266753,4.267004,0.00003,0.000023,105,0.000119,0,14,0.55,0.000548
17037,DeKalb County,,IL,8196,97056,105252,25,27,52,30243,23565,53808,5,0.37419,0.396693,217.616327,0.005376,0.006861,105,0.00023,0,14,0.674713,0.043824
17039,De Witt County,,IL,1097,19536,20633,5,7,12,2785,2668,5453,6,0.302762,0.314015,1.830685,0.000422,0.000387,105,0.0001,0,14,0.857143,0.002727
17041,Douglas County,,IL,1545,25499,27044,6,7,13,3183,3390,6573,6,0.299711,0.310608,6.812499,0.000261,0.00022,105,0.000125,0,14,0.690476,0.001973
17043,DuPage County,,IL,88283,1074759,1163042,229,265,494,257933,300850,558783,5,0.461728,0.503407,32095.947308,0.066458,0.072901,105,0.001703,0,14,0.352805,0.545305
17045,Edgar County,,IL,1033,21822,22855,8,7,15,2058,2243,4301,6,0.30016,0.311568,137.254694,0.000317,0.000213,105,0.000148,0,14,0.446429,0.002338
17047,Edwards County,,IL,430,8027,8457,4,5,9,769,731,1500,6,0.284012,0.293969,23.05783,0.000001,0.000052,28,0.000136,0,14,0.6,0.000297
17049,Effingham County,,IL,2308,43296,45604,12,16,28,3614,4131,7745,6,0.345963,0.363887,11542.464157,0.001085,0.001525,105,0.000199,0,14,0.454167,0.009057
17051,Fayette County,,IL,1137,24352,25489,9,10,19,2301,2284,4585,6,0.323428,0.336363,374.614078,0.000193,0.000693,31,0.000156,0,14,0.481818,0.001908
17053,Ford County,,IL,1212,16863,18075,8,7,15,3178,3024,6202,6,0.34257,0.358505,0.662165,0.001349,0.000936,105,0.00011,0,14,0.946429,0.010487
17055,Franklin County,,IL,2062,43465,45527,12,10,22,4850,4693,9543,6,0.343589,0.360198,2809.307792,0.000998,0.000951,31,0.000228,0,14,0.545455,0.008939
17057,Fulton County,,IL,1886,42259,44145,10,9,19,4125,4471,8596,6,0.342922,0.359227,1374.345054,0.001076,0.000934,105,0.000154,0,14,0.633333,0.008673
17059,Gallatin County,,IL,357,6663,7020,2,2,4,497,690,1187,7,0.223113,0.228591,0,0.000001,0.000005,31,0.000102,0,14,1,0.000192
17061,Greene County,,IL,837,16464,17301,6,6,12,1851,2039,3890,6,0.294828,0.305298,312.391468,0.000234,0.000174,31,0.000133,0,14,0.633333,0.001916
17063,Grundy County,,IL,3403,51617,55020,11,11,22,19344,10725,30069,5,0.357534,0.375499,7.818163,0.002456,0.002397,105,0.000121,0,14,0.871795,0.018774
17065,Hamilton County,,IL,461,9400,9861,4,4,8,635,716,1351,7,0.257611,0.265255,9.594821,0.000015,0.000019,31,0.000135,0,14,0.5,0.000464
17067,Hancock County,,IL,1311,23826,25137,5,5,10,2054,2566,4620,6,0.269007,0.277818,30.88558,0.000049,0.000031,18,0.000129,0,14,0.55,0.000627
17069,Hardin County,,IL,203,4579,4782,1,1,2,196,284,480,7,0.222948,0.228048,0,0.000001,0.000005,31,0.000078,0,14,0,0.000115
17071,Henderson County,,IL,542,8945,9487,4,3,7,806,948,1754,6,0.266407,0.274085,6.422598,0.000032,0.000008,18,0.000106,0,14,0.416667,0.00048
17073,Henry County,,IL,3370,61950,65320,13,13,26,7879,8361,16240,5,0.358003,0.376332,370.483597,0.00184,0.001813,105,0.000179,0,14,0.628571,0.015099
17075,Iroquois County,,IL,2040,37112,39152,9,10,19,5278,4878,10156,6,0.342727,0.35906,6.760798,0.001353,0.001583,105,0.000127,0,14,0.766667,0.010609
17077,Jackson County,,IL,5790,52186,57976,32,41,73,10681,13073,23754,5,0.383947,0.408455,20122.636223,0.005278,0.010103,31,0.000392,0,14,0.436869,0.041898
17079,Jasper County,,IL,595,12624,13219,3,5,8,699,994,1693,7,0.258876,0.267252,6.376453,0.000009,0.000019,105,0.000089,0,14,0.55,0.000272
17081,Jefferson County,,IL,2115,42375,44490,13,14,27,4287,4216,8503,6,0.346243,0.363943,6587.34323,0.001436,0.001413,31,0.000222,0,14,0.494505,0.012403
17083,Jersey County,,IL,1420,26007,27427,7,6,13,4304,3654,7958,6,0.321146,0.333405,192.957169,0.00091,0.000709,31,0.000146,0,14,0.571429,0.007778
17085,Jo Daviess County,,IL,1415,27560,28975,12,10,22,3450,3165,6615,6,0.343393,0.360003,102.90769,0.002074,0.001723,105,0.000148,0,14,0.589744,0.016231
17087,Johnson County,,IL,734,12238,12972,6,7,13,1499,1597,3096,6,0.2813,0.291561,105.794466,0.000074,0.00008,31,0.000166,0,14,0.482143,0.000894
17089,Kane County,,IL,38766,511729,550495,111,136,247,136706,123858,260564,5,0.434858,0.467299,5931.882043,0.035653,0.043305,105,0.00085,0,14,0.521655,0.296847
17091,Kankakee County,,IL,6188,120741,126929,20,31,51,18433,13290,31723,5,0.369814,0.392283,373.075335,0.005509,0.006682,105,0.0002,0,14,0.59879,0.044799
17093,Kendall County,,IL,7092,90623,97715,21,16,37,60031,22211,82242,5,0.364165,0.383172,83.589038,0.005759,0.004247,105,0.000188,0,14,0.802381,0.046535
17095,Knox County,,IL,3040,59209,62249,14,16,30,5566,6006,11572,5,0.358473,0.377275,2710.029463,0.002353,0.002407,105,0.000184,0,14,0.6125,0.020229
17097,Lake County,,IL,49275,771885,821160,183,229,412,150913,154168,305081,5,0.451187,0.491239,11963.965511,0.060013,0.066934,105,0.001267,0,14,0.419483,0.488471
17099,LaSalle County,,IL,6335,136165,142500,28,29,57,19278,16089,35367,5,0.363021,0.384099,2873.86181,0.005156,0.004904,105,0.000283,0,14,0.577011,0.042172
17101,Lawrence County,,IL,852,16699,17551,4,5,9,1396,1654,3050,6,0.284066,0.294052,42.414404,0.000006,0.000056,28,0.000124,0,14,0.45,0.000331
17103,Lee County,,IL,2546,41129,43675,12,13,25,7064,6275,13339,5,0.357704,0.375943,28.412054,0.001892,0.002272,105,0.000144,0,14,0.835165,0.015249
17105,Livingston County,,IL,2395,45020,47415,12,13,25,5336,5857,11193,6,0.342766,0.359449,8.720661,0.001846,0.001737,105,0.000148,0,14,0.730769,0.014491
17107,Logan County,,IL,1847,32628,34475,11,10,21,3697,4145,7842,6,0.342883,0.359282,479.199954,0.001321,0.001101,105,0.00016,0,14,0.627273,0.01014
17109,McDonough County,,IL,2164,30041,32205,16,17,33,3555,3929,7484,5,0.358858,0.377802,4202.368338,0.001767,0.002416,105,0.000228,0,14,0.507895,0.01447
17111,McHenry County,,IL,20497,351904,372401,47,74,121,76653,58969,135622,5,0.404307,0.432496,893.276249,0.016524,0.025104,105,0.000359,0,14,0.620301,0.135959
17113,McLean County,,IL,10762,174905,185667,75,83,158,28527,26680,55207,5,0.413774,0.442443,11371.218917,0.014587,0.023987,105,0.000699,0,14,0.406426,0.122547
17115,Macon County,,IL,5829,128415,134244,30,37,67,10601,12664,23265,5,0.380494,0.404461,4054.411886,0.005244,0.008703,105,0.00033,0,14,0.460133,0.042472
17117,Macoupin County,,IL,3210,55984,59194,10,11,21,8084,8315,16399,6,0.345208,0.362334,300.642528,0.001669,0.001582,31,0.00016,0,14,0.581818,0.013979
17119,Madison County,,IL,15398,309877,325275,67,72,139,41712,40718,82430,5,0.404579,0.432374,25068.885359,0.014518,0.018141,31,0.000721,0,14,0.3821,0.123147
17121,Marion County,,IL,2382,46098,48480,13,14,27,4036,4310,8346,6,0.345565,0.363083,2730.897535,0.001446,0.001574,31,0.000199,0,14,0.549451,0.012459
17123,Marshall County,,IL,979,16087,17066,7,8,15,2352,2643,4995,6,0.294915,0.305814,139.750844,0.000838,0.000265,105,0.000128,0,14,0.680556,0.007327
17125,Mason County,,IL,1172,18285,19457,6,8,14,2350,2862,5212,6,0.296603,0.307751,27.034421,0.000286,0.000296,105,0.000125,0,14,0.607143,0.002185
17127,Massac County,,IL,914,17594,18508,4,4,8,1341,1549,2890,7,0.261809,0.270348,960.936781,0.000018,0.000018,28,0.000155,0,14,0.166667,0.000448
17129,Menard County,,IL,1047,15223,16270,3,3,6,2502,2228,4730,6,0.28918,0.298707,0,0.000112,0.000078,105,0.000084,0,14,1,0.000874
17131,Mercer County,,IL,1314,21368,22682,6,7,13,2987,3100,6087,6,0.342531,0.35845,15.127478,0.000217,0.000887,105,0.000114,0,14,0.738095,0.002558
17133,Monroe County,,IL,1930,38473,40403,7,7,14,7010,5052,12062,6,0.322941,0.335364,1.161707,0.001155,0.001109,31,0.000112,0,14,0.880952,0.009781
17135,Montgomery County,,IL,1634,33991,35625,7,8,15,3618,3698,7316,6,0.303526,0.314708,43.184178,0.00067,0.000367,31,0.000124,0,14,0.694444,0.005394
17137,Morgan County,,IL,2289,40230,42519,10,14,24,4122,4627,8749,6,0.345526,0.36311,5488.353824,0.000867,0.00149,105,0.000196,0,14,0.456044,0.007569
17139,Moultrie County,,IL,1103,17223,18326,5,6,11,2543,2580,5123,6,0.299591,0.310275,2.481987,0.000288,0.000208,105,0.000104,0,14,0.733333,0.00206
17141,Ogle County,,IL,3788,63513,67301,16,17,33,12310,10097,22407,5,0.357875,0.376609,60.402754,0.003124,0.002651,105,0.00017,0,14,0.754902,0.025525
17143,Peoria County,,IL,12283,211102,223385,61,74,135,32083,36457,68540,5,0.411169,0.439225,12309.154895,0.015598,0.02159,105,0.00057,0,14,0.487829,0.129067
17145,Perry County,,IL,1175,23042,24217,7,8,15,2753,2754,5507,6,0.300701,0.311862,5.290135,0.000269,0.000321,31,0.000138,0,14,0.821429,0.002466
17147,Piatt County,,IL,1261,19832,21093,6,6,12,3591,3020,6611,6,0.342453,0.358228,119.030867,0.000415,0.000906,105,0.000112,0,14,0.642857,0.002754
17149,Pike County,,IL,911,19080,19991,6,7,13,1213,1428,2641,6,0.295262,0.306131,136.066762,0.000141,0.000178,31,0.000133,0,14,0.47619,0.001221
17151,Pope County,,IL,278,4353,4631,2,2,4,266,321,587,7,0.223529,0.229035,7.220891,0.000001,0.000005,28,0.000111,0,14,0,0.000185
17153,Pulaski County,,IL,509,7086,7595,3,6,9,528,1038,1566,6,0.279338,0.289359,81.728377,0.000001,0.000053,31,0.00012,0,14,0.566667,0.000214
17155,Putnam County,,IL,479,7491,7970,4,3,7,1254,1237,2491,6,0.266454,0.274534,0,0.000664,0.000047,105,0.000089,0,14,0.916667,0.006024
17157,Randolph County,,IL,1851,36331,38182,10,11,21,3772,4591,8363,6,0.323428,0.336446,72.78115,0.000806,0.000951,31,0.000166,0,14,0.575758,0.006789
17159,Richland County,,IL,957,19045,20002,7,10,17,1361,1334,2695,6,0.278742,0.289486,311.038112,0.000011,0.000043,28,0.000168,0,14,0.222222,0.000547
17161,Rock Island County,,IL,9146,173416,182562,49,47,96,21726,24452,46178,5,0.398303,0.423729,5777.680693,0.014764,0.013641,105,0.000438,0,14,0.580947,0.122644
17163,St. Clair County,,IL,18400,294748,313148,107,100,207,46831,47409,94240,5,0.420964,0.450976,22565.405722,0.027596,0.029275,31,0.000945,0,14,0.409524,0.231556
17165,Saline County,,IL,1369,26665,28034,11,10,21,2254,2282,4536,6,0.286888,0.298313,18105.255026,0.00078,0.000109,31,0.000337,0,14,0.254545,0.007071
17167,Sangamon County,,IL,10452,233477,243929,58,68,126,25635,25684,51319,5,0.406605,0.43401,32003.210013,0.011588,0.017666,105,0.000628,0,14,0.421233,0.097672
17169,Schuyler County,,IL,484,8271,8755,4,5,9,766,1033,1799,6,0.289347,0.299262,36.18355,0.00002,0.000086,105,0.000119,0,14,0.45,0.000426
17171,Scott County,,IL,357,6450,6807,2,3,5,721,930,1651,6,0.289236,0.298818,0,0.00001,0.000075,105,0.00008,0,14,1,0.000196
17173,Shelby County,,IL,1461,25941,27402,9,9,18,3531,3625,7156,6,0.302213,0.313654,1014.300688,0.000819,0.000282,105,0.000156,0,14,0.588889,0.007054
17175,Stark County,,IL,431,7440,7871,5,3,8,1044,834,1878,6,0.291537,0.301259,0.266667,0.000191,0.000137,105,0.000101,0,14,0.85,0.001633
17177,Stephenson County,,IL,2869,57563,60432,15,15,30,5797,6284,12081,5,0.358644,0.377386,81.031889,0.003122,0.002595,105,0.000165,0,14,0.694853,0.025813
17179,Tazewell County,,IL,8366,157724,166090,33,32,65,25799,22253,48052,5,0.374844,0.397165,3277.898638,0.005838,0.007149,105,0.000363,0,14,0.465465,0.048012
17181,Union County,,IL,936,19929,20865,6,7,13,1719,1778,3497,6,0.279624,0.28983,1821.971476,0.000097,0.000079,31,0.000141,0,14,0.547619,0.001051
17183,Vermilion County,,IL,4113,92312,96425,19,22,41,6854,8270,15124,5,0.361014,0.381103,1360.442927,0.002414,0.003253,105,0.000246,0,14,0.474026,0.018586
17185,Wabash County,,IL,672,14519,15191,6,5,11,1149,1227,2376,6,0.283717,0.293536,1562.74949,0.000081,0.000055,28,0.000167,0,14,0.433333,0.00093
17187,Warren County,,IL,1255,19580,20835,6,10,16,1784,2529,4313,6,0.342844,0.359199,975.102429,0.000115,0.000986,105,0.000148,0,14,0.481818,0.001363
17189,Washington County,,IL,1152,18511,19663,7,8,15,2481,2830,5311,6,0.322976,0.335503,12.370998,0.00031,0.000689,31,0.000132,0,14,0.785714,0.002842
17191,Wayne County,,IL,815,19058,19873,5,6,11,1223,1345,2568,6,0.284443,0.294857,267.148845,0.000009,0.00006,28,0.000139,0,14,0.333333,0.000437
17193,White County,,IL,732,17447,18179,8,9,17,1467,1598,3065,6,0.284174,0.294746,2888.40674,0.000081,0.00006,28,0.000255,0,14,0.305556,0.001077
17195,Whiteside County,,IL,3271,72462,75733,16,19,35,7397,7464,14861,5,0.358302,0.377386,107.237453,0.002456,0.002977,105,0.000189,0,14,0.660526,0.021608
17197,Will County,,IL,44765,717282,762047,130,165,295,215230,151412,366642,5,0.439953,0.474695,10767.013041,0.042176,0.048786,105,0.000971,0,14,0.456712,0.347861
17199,Williamson County,,IL,4115,68348,72463,22,20,42,10771,9040,19811,6,0.347565,0.366384,4217.834375,0.00347,0.002266,31,0.000302,0,14,0.436594,0.028013
17201,Winnebago County,,IL,14957,335152,350109,69,85,154,46853,38730,85583,5,0.412581,0.441761,3283.727908,0.019153,0.026132,105,0.000552,0,14,0.482818,0.157896
17203,Woodford County,,IL,2535,43778,46313,7,8,15,7689,6517,14206,6,0.34257,0.358616,38.638614,0.000976,0.001043,105,0.000111,0,14,0.875,0.008025
18001,Adams County,,IN,1817,41394,43211,6,8,14,2922,3841,6763,6,0.318659,0.331735,19.180721,0.000264,0.000612,28,0.000112,0,14,0.553571,0.001873
18003,Allen County,,IN,17870,406454,424324,108,132,240,44249,48108,92357,5,0.429634,0.462389,33719.8939,0.02706,0.040242,28,0.000862,0,14,0.432019,0.219318
18005,Bartholomew County,,IN,4935,84961,89896,27,23,50,11756,11773,23529,5,0.366163,0.3874,1023.853025,0.004478,0.003887,28,0.000308,0,14,0.452688,0.035305
18007,Benton County,,IN,915,10559,11474,5,5,10,1831,2167,3998,6,0.297632,0.307734,3.320635,0.000195,0.000138,28,0.000117,0,14,0.65,0.001491
18009,Blackford County,,IN,950,16117,17067,5,7,12,1961,2284,4245,6,0.318456,0.331292,26.221437,0.000488,0.000608,28,0.000097,0,14,0.809524,0.004044
18011,Boone County,,IN,3954,59255,63209,16,16,32,13224,10073,23297,5,0.360494,0.379771,201.682943,0.002267,0.002584,28,0.000195,0,14,0.716374,0.018384
18013,Brown County,,IN,1517,18186,19703,6,5,11,3379,3793,7172,6,0.317917,0.330182,0.142857,0.000663,0.000619,28,0.00011,0,14,0.933333,0.00564
18015,Carroll County,,IN,1569,23945,25514,6,6,12,4214,4368,8582,6,0.318086,0.33057,0.47619,0.000633,0.00056,28,0.00011,0,14,0.9,0.005079
18017,Cass County,,IN,2555,46194,48749,11,13,24,4746,6036,10782,6,0.345089,0.362611,172.26946,0.0017,0.00166,28,0.000156,0,14,0.608974,0.014119
18019,Clark County,,IN,8219,114260,122479,22,23,45,27303,23229,50532,6,0.359373,0.379672,1382.440343,0.003076,0.002934,28,0.000315,0,14,0.403077,0.027018
18021,Clay County,,IN,1822,31694,33516,9,11,20,4710,4930,9640,6,0.318322,0.33143,8.847558,0.000542,0.00065,28,0.000163,0,14,0.654545,0.005043
18023,Clinton County,,IN,2158,38378,40536,11,9,20,4864,5429,10293,6,0.31822,0.331125,6.445772,0.000909,0.000885,28,0.000163,0,14,0.636364,0.008192
18025,Crawford County,,IN,806,11889,12695,7,8,15,1950,2350,4300,6,0.312461,0.325044,74.654271,0.000412,0.000432,28,0.000143,0,14,0.571429,0.004148
18027,Daviess County,,IN,1374,34153,35527,11,9,20,2426,2911,5337,6,0.31893,0.331957,144.616827,0.000731,0.00059,28,0.000199,0,14,0.636364,0.006013
18029,Dearborn County,,IN,3611,58039,61650,12,13,25,11424,9578,21002,6,0.321077,0.335469,81.002154,0.001389,0.001434,71,0.000169,0,14,0.564103,0.011629
18031,Decatur County,,IN,1731,31151,32882,10,11,21,4322,4563,8885,6,0.320666,0.33472,48.305893,0.000527,0.001132,28,0.000173,0,14,0.477273,0.005118
18033,DeKalb County,,IN,3120,49924,53044,8,10,18,8229,8104,16333,6,0.319065,0.332429,20.717144,0.000348,0.000679,28,0.00013,0,14,0.622222,0.002575
18035,Delaware County,,IN,7450,120475,127925,31,38,69,13712,18222,31934,5,0.382091,0.406059,2121.482332,0.004478,0.009228,28,0.000321,0,14,0.473573,0.037306
18037,Dubois County,,IN,2290,51870,54160,13,16,29,4704,5030,9734,6,0.321938,0.336823,470.101969,0.000681,0.001259,28,0.000252,0,14,0.433333,0.006022
18039,Elkhart County,,IN,10152,219244,229396,41,48,89,27500,28158,55658,5,0.389523,0.415224,3770.412723,0.009521,0.012607,28,0.000352,0,14,0.467156,0.076507
18041,Fayette County,,IN,1590,27955,29545,8,11,19,3275,3711,6986,6,0.31893,0.33239,59.320234,0.000466,0.000883,28,0.000142,0,14,0.6,0.004265
18043,Floyd County,,IN,6581,81650,88231,15,16,31,19918,20321,40239,6,0.347163,0.365551,377.447978,0.001348,0.001992,28,0.00024,0,14,0.479167,0.012505
18045,Fountain County,,IN,1491,20790,22281,7,8,15,3506,3650,7156,6,0.31849,0.331375,62.328,0.000613,0.000569,28,0.000138,0,14,0.642857,0.005006
18047,Franklin County,,IN,1485,28352,29837,10,11,21,4365,4134,8499,6,0.320837,0.334887,100.380285,0.001057,0.001133,71,0.000157,0,14,0.518182,0.008862
18049,Fulton County,,IN,1640,24512,26152,13,13,26,3872,4035,7907,6,0.319167,0.332928,84.998946,0.001635,0.000975,28,0.00016,0,14,0.652381,0.013379
18051,Gibson County,,IN,2020,39040,41060,12,9,21,4521,4934,9455,6,0.318964,0.332013,419.132668,0.000528,0.000481,28,0.000253,0,14,0.469697,0.004934
18053,Grant County,,IN,3943,77716,81659,13,17,30,5944,8076,14020,5,0.360538,0.379938,278.698646,0.001089,0.002538,28,0.000166,0,14,0.647059,0.00904
18055,Greene County,,IN,2105,36916,39021,11,13,24,5684,6103,11787,6,0.319201,0.33279,51.210658,0.00066,0.000694,28,0.000192,0,14,0.570513,0.00563
18057,Hamilton County,,IN,19386,260332,279718,145,109,254,92947,60259,153206,5,0.425435,0.45587,21235.162161,0.041372,0.034211,28,0.001166,0,14,0.438132,0.341509
18059,Hancock County,,IN,4997,74733,79730,17,14,31,21076,15208,36284,6,0.344851,0.362389,122.255199,0.001458,0.001732,28,0.000212,0,14,0.676471,0.012046
18061,Harrison County,,IN,2484,44112,46596,8,8,16,7069,6893,13962,6,0.32118,0.33487,38.017591,0.00084,0.00085,28,0.000145,0,14,0.666667,0.007693
18063,Hendricks County,,IN,10460,138768,149228,50,37,87,45466,31564,77030,5,0.383261,0.407041,3545.633555,0.012514,0.00858,28,0.000459,0,14,0.493106,0.101922
18065,Henry County,,IN,3072,57257,60329,10,15,25,7328,7475,14803,6,0.320119,0.334526,25.301731,0.00075,0.001175,28,0.000153,0,14,0.585714,0.006893
18067,Howard County,,IN,4974,102919,107893,22,28,50,11348,12549,23897,5,0.36545,0.387178,611.179965,0.003243,0.004778,28,0.000241,0,14,0.494624,0.026017
18069,Huntington County,,IN,2386,46001,48387,11,11,22,4935,5420,10355,6,0.318625,0.332013,64.71825,0.000795,0.000885,28,0.000158,0,14,0.570513,0.006307
18071,Jackson County,,IN,2529,49055,51584,11,14,25,6070,6980,13050,6,0.325319,0.340984,58.185744,0.001053,0.001677,28,0.000175,0,14,0.582418,0.009475
18073,Jasper County,,IN,2234,36697,38931,12,11,23,7100,5424,12524,6,0.344812,0.361945,306.882774,0.001842,0.001425,105,0.000163,0,14,0.636364,0.014715
18075,Jay County,,IN,1399,25523,26922,7,8,15,2453,2960,5413,6,0.318625,0.33168,77.851139,0.000489,0.000607,28,0.000122,0,14,0.517857,0.004205
18077,Jefferson County,,IN,1837,36646,38483,13,14,27,3967,3926,7893,6,0.321112,0.335575,193.366049,0.000914,0.001051,28,0.000218,0,14,0.467033,0.008766
18079,Jennings County,,IN,2236,32217,34453,8,9,17,5230,5819,11049,6,0.318187,0.33107,4.881131,0.000524,0.000637,28,0.000143,0,14,0.694444,0.004928
18081,Johnson County,,IN,12071,144337,156408,53,37,90,46537,36517,83054,5,0.385326,0.409277,4098.947709,0.011065,0.009079,28,0.000505,0,14,0.399749,0.090142
18083,Knox County,,IN,1990,41157,43147,13,12,25,3707,3961,7668,6,0.319303,0.332817,3174.403033,0.000725,0.000859,28,0.000242,0,14,0.423077,0.00612
18085,Kosciusko County,,IN,5014,91215,96229,25,24,49,11977,11842,23819,5,0.367147,0.388454,1226.45174,0.003705,0.004314,28,0.000265,0,14,0.486453,0.031101
18087,LaGrange County,,IN,2365,43696,46061,9,10,19,6366,6971,13337,6,0.319065,0.332429,14.783219,0.000584,0.000843,28,0.000124,0,14,0.666667,0.004113
18089,Lake County,,IN,27350,546441,573791,82,117,199,91455,87259,178714,5,0.424114,0.455648,6997.298264,0.028464,0.037337,105,0.000623,0,14,0.538183,0.231144
18091,LaPorte County,,IN,5151,122099,127250,17,21,38,14438,12567,27005,5,0.367777,0.388221,132.712968,0.004182,0.005397,105,0.000165,0,14,0.774892,0.031984
18093,Lawrence County,,IN,2347,52968,55315,10,15,25,5211,5540,10751,6,0.321593,0.336241,89.750929,0.000661,0.001161,28,0.00017,0,14,0.541667,0.005585
18095,Madison County,,IN,7390,148698,156088,27,29,56,18333,18397,36730,5,0.365762,0.387289,1156.283335,0.00528,0.005357,28,0.000279,0,14,0.507576,0.045164
18097,Marion County,,IN,66020,967648,1033668,296,278,574,208169,233193,441362,5,0.465736,0.507734,224558.084002,0.068996,0.069865,28,0.00256,0,14,0.271203,0.570914
18099,Marshall County,,IN,3127,54362,57489,12,13,25,7858,8028,15886,6,0.345089,0.362611,85.248772,0.001916,0.00189,28,0.000141,0,14,0.769231,0.014941
18101,Martin County,,IN,684,12066,12750,6,6,12,1183,1431,2614,6,0.295611,0.30602,2.185263,0.000437,0.000135,28,0.000127,0,14,0.785714,0.003993
18103,Miami County,,IN,2748,40219,42967,10,11,21,5639,6825,12464,6,0.318761,0.332235,3.076348,0.000972,0.001023,28,0.000136,0,14,0.8,0.008242
18105,Monroe County,,IN,10604,112066,122670,78,86,164,24795,27446,52241,5,0.418618,0.447392,18382.314934,0.019249,0.026869,28,0.00075,0,14,0.446768,0.163263
18107,Montgomery County,,IN,2186,43006,45192,10,11,21,4851,5238,10089,6,0.31849,0.331708,7.649759,0.000924,0.000957,28,0.000159,0,14,0.727273,0.008094
18109,Morgan County,,IN,5604,80063,85667,17,16,33,17933,15846,33779,6,0.318659,0.33254,24.284683,0.001186,0.001114,28,0.000235,0,14,0.613971,0.0105
18111,Newton County,,IN,1212,16746,17958,9,8,17,3669,3169,6838,6,0.344693,0.361446,195.041077,0.001147,0.001393,105,0.000135,0,14,0.633333,0.009211
18113,Noble County,,IN,3249,53613,56862,10,10,20,8948,9710,18658,6,0.319099,0.332484,63.198822,0.001275,0.00093,28,0.000144,0,14,0.643939,0.00936
18115,Ohio County,,IN,552,6847,7399,4,5,9,1690,1553,3243,6,0.312364,0.324251,0.142857,0.00041,0.000453,71,0.000089,0,14,0.9,0.00337
18117,Orange County,,IN,1130,21482,22612,10,9,19,2423,2542,4965,6,0.318322,0.331264,77.101042,0.000984,0.000551,28,0.00017,0,14,0.618182,0.008682
18119,Owen County,,IN,2005,23087,25092,10,10,20,5361,5349,10710,6,0.318288,0.331264,3.158039,0.000759,0.000709,28,0.000154,0,14,0.822222,0.00664
18121,Parke County,,IN,1161,16873,18034,8,8,16,2706,2957,5663,6,0.318254,0.330986,3.824242,0.000541,0.000527,28,0.000144,0,14,0.732143,0.004953
18123,Perry County,,IN,1014,20782,21796,7,7,14,1901,2069,3970,6,0.319269,0.332074,596.45722,0.00011,0.000479,28,0.000158,0,14,0.535714,0.001183
18125,Pike County,,IN,954,14476,15430,6,6,12,2193,2107,4300,6,0.283664,0.293592,1.042483,0.000106,0.000076,28,0.000147,0,14,0.866667,0.00112
18127,Porter County,,IN,11172,179600,190772,34,41,75,39147,30584,69731,5,0.386516,0.411091,1091.080455,0.010335,0.011338,105,0.000286,0,14,0.6,0.082941
18129,Posey County,,IN,1903,31236,33139,5,5,10,4325,4694,9019,6,0.318896,0.33143,73.36386,0.000097,0.00047,28,0.000133,0,14,0.7,0.000966
18131,Pulaski County,,IN,997,15421,16418,9,8,17,2651,2564,5215,6,0.318187,0.330959,5.384431,0.000509,0.000575,28,0.000131,0,14,0.655556,0.003836
18133,Putnam County,,IN,2665,38928,41593,13,13,26,7632,7083,14715,6,0.318558,0.332041,9.401196,0.001141,0.001075,28,0.000186,0,14,0.74359,0.00986
18135,Randolph County,,IN,1928,30820,32748,7,7,14,4448,4580,9028,6,0.318288,0.331014,18.42307,0.00054,0.000492,28,0.000111,0,14,0.619048,0.004602
18137,Ripley County,,IN,2004,31883,33887,11,13,24,5245,5160,10405,6,0.320974,0.335414,108.182398,0.000971,0.001314,71,0.000174,0,14,0.456044,0.00842
18139,Rush County,,IN,1330,20914,22244,7,7,14,3392,3664,7056,6,0.318018,0.33057,2.649524,0.000454,0.000437,28,0.000127,0,14,0.738095,0.004143
18141,St. Joseph County,,IN,15564,298497,314061,81,98,179,37228,43544,80772,5,0.424054,0.453678,6180.332814,0.027039,0.034903,28,0.000603,0,14,0.611141,0.218644
18143,Scott County,,IN,1530,25693,27223,9,9,18,4500,4514,9014,6,0.320837,0.334576,17.188771,0.000851,0.000864,28,0.000155,0,14,0.763889,0.007881
18145,Shelby County,,IN,3308,50743,54051,13,14,27,8725,8589,17314,6,0.318423,0.332013,15.350904,0.000833,0.001099,28,0.000189,0,14,0.652381,0.008294
18147,Spencer County,,IN,1387,24653,26040,5,7,12,3555,3965,7520,6,0.319269,0.332074,2.012932,0.000107,0.000482,28,0.000121,0,14,0.809524,0.001024
18149,Starke County,,IN,1611,26162,27773,9,11,20,5158,4677,9835,6,0.344851,0.362001,67.977634,0.001177,0.001538,28,0.000124,0,14,0.763636,0.009532
18151,Steuben County,,IN,2685,38037,40722,11,10,21,6284,5912,12196,6,0.319133,0.33254,76.936993,0.001034,0.000826,28,0.000138,0,14,0.522727,0.007512
18153,Sullivan County,,IN,1316,22963,24279,5,5,10,2768,2760,5528,6,0.318187,0.330543,1.040812,0.000482,0.000443,28,0.000107,0,14,0.9,0.004056
18155,Switzerland County,,IN,680,9931,10611,5,8,13,1542,1818,3360,6,0.312689,0.325139,32.539724,0.000416,0.000462,71,0.000106,0,14,0.5,0.003493
18157,Tippecanoe County,,IN,12380,149817,162197,81,97,178,31862,32596,64458,5,0.423337,0.452763,24266.122339,0.018689,0.028791,28,0.000753,0,14,0.433786,0.154538
18159,Tipton County,,IN,1296,20155,21451,4,6,10,2990,3304,6294,6,0.318119,0.330626,0.142857,0.000673,0.000816,28,0.000082,0,14,0.933333,0.006075
18161,Union County,,IN,694,8545,9239,5,5,10,1557,1684,3241,6,0.296809,0.307557,2.892972,0.000244,0.000221,28,0.000098,0,14,0.75,0.00213
18163,Vanderburgh County,,IN,10947,195577,206524,52,55,107,27517,30040,57557,5,0.395315,0.421593,62213.567688,0.00864,0.012987,28,0.000736,0,14,0.301683,0.075827
18165,Vermillion County,,IN,1236,19041,20277,7,7,14,2896,3005,5901,6,0.318355,0.331042,39.781819,0.000499,0.000458,28,0.000135,0,14,0.642857,0.004306
18167,Vigo County,,IN,6934,110359,117293,33,44,77,12934,15645,28579,5,0.386565,0.411507,13177.067734,0.004245,0.009636,28,0.000411,0,14,0.388529,0.035454
18169,Wabash County,,IN,2082,40294,42376,10,12,22,4137,4990,9127,6,0.319031,0.332595,5.894162,0.000812,0.000965,28,0.000143,0,14,0.734848,0.006439
18171,Warren County,,IN,663,10128,10791,4,4,8,1813,1698,3511,6,0.298016,0.308178,4.695241,0.000193,0.000129,28,0.0001,0,14,0.666667,0.001352
18173,Warrick County,,IN,4461,65259,69720,12,15,27,14072,11946,26018,6,0.326273,0.34226,1611.166282,0.001511,0.001749,28,0.000226,0,14,0.4625,0.013469
18175,Washington County,,IN,1853,31221,33074,10,10,20,4584,4720,9304,6,0.320872,0.334743,35.548087,0.000836,0.000847,28,0.000173,0,14,0.666667,0.007805
18177,Wayne County,,IN,4034,80163,84197,18,24,42,6342,8666,15008,5,0.365139,0.386057,925.95442,0.002466,0.003928,28,0.000219,0,14,0.507246,0.020185
18179,Wells County,,IN,1877,32130,34007,6,8,14,4312,4328,8640,6,0.31849,0.331458,5.006574,0.000268,0.000589,28,0.000112,0,14,0.642857,0.001868
18181,White County,,IN,2126,29613,31739,11,11,22,4316,4943,9259,6,0.344614,0.361723,361.157671,0.001524,0.001429,28,0.000168,0,14,0.570513,0.012511
18183,Whitley County,,IN,2205,38815,41020,9,7,16,6845,5960,12805,6,0.318423,0.331236,23.027287,0.000773,0.000607,28,0.000136,0,14,0.694444,0.006108
19001,Adair County,,IA,581,9313,9894,6,6,12,1034,1373,2407,6,0.306031,0.316977,7.558766,0.000249,0.000239,18,0.000162,0,14,0.6,0.002554
19003,Adams County,,IA,336,4961,5297,2,2,4,231,314,545,7,0.239764,0.245174,2.320635,0.000004,0.000003,18,0.000095,0,14,0,0.00017
19005,Allamakee County,,IA,835,16896,17731,7,8,15,1104,1441,2545,6,0.285932,0.297598,56.130248,0.000094,0.000178,18,0.000143,0,14,0.446429,0.001236
19007,Appanoose County,,IA,749,14436,15185,4,6,10,693,1098,1791,6,0.306,0.316922,301.994203,0.00023,0.000222,18,0.000131,0,14,0.533333,0.00223
19009,Audubon County,,IA,367,7614,7981,3,4,7,431,574,1005,6,0.305969,0.316644,1.670707,0.000011,0.000217,18,0.000097,0,14,0.583333,0.000287
19011,Benton County,,IA,1844,30511,32355,8,8,16,5191,5159,10350,6,0.308419,0.31999,36.702474,0.000517,0.00048,18,0.000147,0,14,0.694444,0.00463
19013,Black Hawk County,,IA,7462,135955,143417,44,45,89,15522,18110,33632,5,0.384487,0.409321,25043.139432,0.005405,0.007204,18,0.000594,0,14,0.27079,0.04859
19015,Boone County,,IA,1840,30543,32383,6,6,12,3903,4079,7982,6,0.306,0.316894,1.428211,0.000325,0.000272,18,0.000147,0,14,0.833333,0.002898
19017,Bremer County,,IA,1545,26801,28346,8,8,16,3643,3626,7269,6,0.308419,0.319962,194.978961,0.000371,0.000481,18,0.000149,0,14,0.544444,0.003677
19019,Buchanan County,,IA,1321,24363,25684,5,9,14,2659,2984,5643,6,0.308387,0.320045,2.274242,0.000142,0.000457,18,0.000113,0,14,0.708333,0.001612
19021,Buena Vista County,,IA,1655,22732,24387,13,17,30,1932,2751,4683,5,0.358259,0.377153,6701.04525,0.002075,0.001541,18,0.000212,0,14,0.28655,0.018446
19023,Butler County,,IA,893,18096,18989,6,7,13,2093,2033,4126,6,0.306406,0.317726,10.007179,0.000056,0.000257,18,0.000139,0,14,0.553571,0.000812
19025,Calhoun County,,IA,731,12136,12867,5,5,10,1152,1217,2369,6,0.306031,0.316839,127.243757,0.000239,0.000248,18,0.000127,0,14,0.533333,0.002295
19027,Carroll County,,IA,1225,26186,27411,9,11,20,1655,2314,3969,6,0.315579,0.328096,1629.990142,0.000607,0.000655,18,0.000195,0,14,0.409091,0.005273
19029,Cass County,,IA,895,16184,17079,7,9,16,1256,1421,2677,6,0.31822,0.330321,1237.739651,0.000554,0.000655,18,0.000168,0,14,0.472222,0.004985
19031,Cedar County,,IA,1484,21814,23298,7,6,13,3736,3329,7065,6,0.29775,0.308494,5.657063,0.000438,0.000366,18,0.000124,0,14,0.809524,0.004342
19033,Cerro Gordo County,,IA,2709,51551,54260,17,18,35,5113,6020,11133,5,0.36421,0.384182,13485.374411,0.001722,0.002453,18,0.000293,0,14,0.373684,0.015577
19035,Cherokee County,,IA,827,14963,15790,5,7,12,994,1289,2283,6,0.30675,0.318115,4.95524,0.000064,0.000282,18,0.000122,0,14,0.595238,0.000752
19037,Chickasaw County,,IA,797,15301,16098,4,8,12,1147,1492,2639,6,0.306593,0.31817,87.775168,0.000051,0.000351,18,0.000106,0,14,0.589286,0.000649
19039,Clarke County,,IA,971,10315,11286,6,5,11,1486,1401,2887,6,0.305906,0.316644,6.65,0.000232,0.000217,18,0.000186,0,14,0.533333,0.00236
19041,Clay County,,IA,1291,20314,21605,6,7,13,1781,2027,3808,6,0.309467,0.321222,75.905353,0.00029,0.000335,18,0.000133,0,14,0.642857,0.002677
19043,Clayton County,,IA,1147,22084,23231,10,9,19,2104,2621,4725,6,0.308641,0.320462,89.35024,0.000184,0.00048,18,0.000173,0,14,0.507576,0.002306
19045,Clinton County,,IA,2748,57621,60369,12,15,27,5614,6472,12086,5,0.360451,0.379466,445.629717,0.001312,0.002082,105,0.000187,0,14,0.6,0.012216
19047,Crawford County,,IA,1046,19345,20391,8,11,19,1163,1913,3076,6,0.315414,0.327874,1449.774399,0.001218,0.000586,18,0.000155,0,14,0.474359,0.010642
19049,Dallas County,,IA,5093,57371,62464,27,19,46,23710,14510,38220,5,0.367687,0.387861,3173.842078,0.004002,0.003008,18,0.000431,0,14,0.415954,0.035244
19051,Davis County,,IA,533,9457,9990,2,1,3,657,621,1278,7,0.236424,0.241956,0,0.000005,0.000009,18,0.000085,0,14,1,0.000236
19053,Decatur County,,IA,644,8028,8672,3,3,6,586,639,1225,6,0.305813,0.316256,0.666667,0.000226,0.00021,18,0.000118,0,14,0.666667,0.002075
19055,Delaware County,,IA,1049,21757,22806,6,8,14,2115,2847,4962,6,0.308451,0.320045,4.736277,0.000163,0.000479,18,0.000123,0,14,0.75,0.001902
19057,Des Moines County,,IA,2364,47252,49616,13,16,29,4331,4513,8844,5,0.362364,0.381453,5366.666897,0.001218,0.002034,18,0.000244,0,14,0.422794,0.011356
19059,Dickinson County,,IA,1220,19961,21181,9,11,20,2146,2062,4208,5,0.354622,0.372587,6159.807901,0.000372,0.001046,18,0.000204,0,14,0.363636,0.003541
19061,Dubuque County,,IA,4187,106821,111008,24,21,45,9352,9556,18908,5,0.36505,0.385569,2285.98353,0.004406,0.003646,18,0.000305,0,14,0.466667,0.03779
19063,Emmet County,,IA,691,11848,12539,3,4,7,609,754,1363,6,0.264227,0.27237,10.983529,0.000014,0.000009,18,0.000094,0,14,0.333333,0.000277
19065,Fayette County,,IA,1235,23420,24655,8,10,18,2298,2763,5061,6,0.308672,0.320628,32.941396,0.00015,0.000481,18,0.000153,0,14,0.590909,0.001845
19067,Floyd County,,IA,1074,19047,20121,6,8,14,1544,2060,3604,6,0.345287,0.361973,1703.208783,0.000685,0.00088,18,0.000127,0,14,0.517857,0.00619
19069,Franklin County,,IA,644,12302,12946,5,5,10,970,1170,2140,6,0.306187,0.317088,4.080579,0.000062,0.000251,18,0.000121,0,14,0.666667,0.000796
19071,Fremont County,,IA,521,8710,9231,6,6,12,1286,1311,2597,6,0.316111,0.326881,145.756747,0.00093,0.00042,18,0.000143,0,14,0.571429,0.008611
19073,Greene County,,IA,688,11532,12220,7,7,14,1041,1460,2501,6,0.306093,0.317172,4.540512,0.000329,0.000275,18,0.000161,0,14,0.738095,0.002996
19075,Grundy County,,IA,918,15050,15968,5,7,12,1965,2008,3973,6,0.306343,0.317588,2.628371,0.000056,0.000278,18,0.00012,0,14,0.714286,0.000739
19077,Guthrie County,,IA,929,13225,14154,5,7,12,1828,2175,4003,6,0.306031,0.317061,3.08236,0.000248,0.00027,18,0.000138,0,14,0.714286,0.002478
19079,Hamilton County,,IA,1119,18999,20118,6,6,12,1976,2418,4394,6,0.306125,0.317116,4.02964,0.00031,0.00025,18,0.00014,0,14,0.7,0.002693
19081,Hancock County,,IA,905,13994,14899,4,5,9,1363,1632,2995,6,0.306156,0.317061,2.068687,0.000024,0.000221,18,0.000108,0,14,0.75,0.000409
19083,Hardin County,,IA,1290,20407,21697,7,9,16,1863,2232,4095,6,0.308356,0.319962,210.113012,0.00035,0.000384,18,0.000155,0,14,0.555556,0.003015
19085,Harrison County,,IA,983,17746,18729,7,8,15,1986,2487,4473,6,0.316644,0.327907,16.332562,0.000461,0.000456,18,0.000148,0,14,0.535714,0.004186
19087,Henry County,,IA,1389,22250,23639,10,10,20,2807,2784,5591,6,0.308546,0.320323,870.915748,0.000486,0.000445,18,0.000213,0,14,0.577778,0.004657
19089,Howard County,,IA,641,12049,12690,5,6,11,741,953,1694,6,0.284847,0.295168,24.929604,0.000022,0.000103,18,0.000115,0,14,0.404762,0.000457
19091,Humboldt County,,IA,684,12095,12779,4,5,9,831,1005,1836,6,0.306,0.316811,6.472162,0.000016,0.000217,18,0.000112,0,14,0.55,0.000375
19093,Ida County,,IA,487,8829,9316,5,5,10,741,761,1502,6,0.306593,0.317643,17.252267,0.000063,0.00025,18,0.000115,0,14,0.666667,0.000786
19095,Iowa County,,IA,1032,20079,21111,6,7,13,2382,2502,4884,6,0.308103,0.319324,1.9,0.000252,0.000428,18,0.00013,0,14,0.785714,0.002363
19097,Jackson County,,IA,1179,24386,25565,6,7,13,2635,2916,5551,6,0.308451,0.319879,20.468165,0.000227,0.000592,18,0.000121,0,14,0.732143,0.002847
19099,Jasper County,,IA,2425,43450,45875,12,12,24,5417,5795,11212,6,0.310138,0.322653,20.586955,0.000618,0.000588,18,0.000228,0,14,0.621795,0.005622
19101,Jefferson County,,IA,1087,16689,17776,7,8,15,1771,2026,3797,6,0.308197,0.319602,743.164709,0.000183,0.000433,18,0.000166,0,14,0.569444,0.001853
19103,Johnson County,,IA,11754,119278,131032,87,88,175,30086,30837,60923,5,0.412921,0.442305,41310.50112,0.01824,0.024821,18,0.001007,0,14,0.377726,0.156368
19105,Jones County,,IA,1275,22534,23809,7,9,16,2876,2860,5736,6,0.308387,0.320045,18.912797,0.000279,0.000462,18,0.000138,0,14,0.625,0.002685
19107,Keokuk County,,IA,781,12635,13416,7,9,16,1508,1825,3333,6,0.308229,0.319768,8.893225,0.000251,0.000437,18,0.000155,0,14,0.694444,0.002491
19109,Kossuth County,,IA,899,20198,21097,7,9,16,822,1208,2030,5,0.327697,0.342327,1311.571275,0.000246,0.000718,18,0.000165,0,14,0.388889,0.002444
19111,Lee County,,IA,2041,40854,42895,9,12,21,3370,4182,7552,6,0.309563,0.321987,7605.29645,0.000495,0.000619,18,0.000227,0,14,0.378788,0.004505
19113,Linn County,,IA,11153,232904,244057,78,71,149,31913,28742,60655,5,0.396934,0.424839,38399.364913,0.017294,0.015382,18,0.000895,0,14,0.349847,0.150715
19115,Louisa County,,IA,994,13257,14251,7,5,12,1720,2165,3885,6,0.292816,0.303168,54.183849,0.000894,0.000128,18,0.000136,0,14,0.690476,0.008116
19117,Lucas County,,IA,602,9943,10545,4,5,9,867,1141,2008,6,0.305844,0.316534,2.666667,0.00023,0.000218,18,0.000131,0,14,0.6,0.00221
19119,Lyon County,,IA,721,14143,14864,5,4,9,942,1337,2279,6,0.287052,0.297243,289.472848,0.000107,0.000098,18,0.000167,0,14,0.45,0.00129
19121,Madison County,,IA,1220,16845,18065,7,7,14,3354,2818,6172,6,0.306031,0.317061,6.794981,0.000249,0.000271,18,0.000197,0,14,0.607143,0.002656
19123,Mahaska County,,IA,1374,24757,26131,8,9,17,2805,2956,5761,6,0.308229,0.319768,18.793678,0.000334,0.000438,18,0.000177,0,14,0.680556,0.003515
19125,Marion County,,IA,2082,37422,39504,11,10,21,4152,4488,8640,6,0.308134,0.319685,22.63044,0.000421,0.000392,18,0.00024,0,14,0.568182,0.004274
19127,Marshall County,,IA,2679,45547,48226,11,13,24,3861,5254,9115,5,0.353162,0.371255,298.587218,0.000596,0.001217,18,0.000198,0,14,0.634615,0.005278
19129,Mills County,,IA,1150,16044,17194,6,5,11,3082,2664,5746,6,0.315944,0.326548,7.305166,0.000458,0.000419,18,0.000143,0,14,0.766667,0.00409
19131,Mitchell County,,IA,565,12655,13220,5,6,11,783,783,1566,6,0.278432,0.288388,60.363372,0.00003,0.000053,18,0.000125,0,14,0.333333,0.000541
19133,Monona County,,IA,601,10910,11511,3,4,7,865,956,1821,6,0.313145,0.323685,1.833309,0.000351,0.000313,18,0.000086,0,14,0.75,0.002882
19135,Monroe County,,IA,528,8871,9399,5,5,10,890,1207,2097,6,0.305969,0.316755,0.916667,0.000233,0.000222,18,0.000135,0,14,0.85,0.00234
19137,Montgomery County,,IA,784,12599,13383,6,7,13,1207,1432,2639,6,0.315083,0.326875,3919.899383,0.000331,0.000515,18,0.000173,0,14,0.547619,0.0031
19139,Muscatine County,,IA,2429,49737,52166,11,14,25,5191,5803,10994,5,0.355377,0.373741,444.999533,0.001283,0.001757,18,0.000192,0,14,0.585714,0.011841
19141,O'Brien County,,IA,1006,17276,18282,7,8,15,1519,1741,3260,6,0.309755,0.321693,383.747733,0.000071,0.000327,18,0.000163,0,14,0.541667,0.000948
19143,Osceola County,,IA,456,8127,8583,4,4,8,507,600,1107,6,0.263047,0.270689,7.977417,0.000013,0.000008,18,0.000129,0,14,0.3,0.000343
19145,Page County,,IA,917,17375,18292,7,8,15,1632,1620,3252,6,0.315248,0.327264,1871.25692,0.00056,0.000519,18,0.000172,0,14,0.482143,0.005035
19147,Palo Alto County,,IA,641,11154,11795,5,6,11,887,1042,1929,6,0.306218,0.317255,680.415411,0.000236,0.000243,18,0.000129,0,14,0.533333,0.002244
19149,Plymouth County,,IA,1619,30768,32387,7,9,16,3163,3395,6558,6,0.317078,0.329788,161.251031,0.00038,0.00064,18,0.000162,0,14,0.597222,0.003529
19151,Pocahontas County,,IA,507,9333,9840,4,5,9,555,786,1341,6,0.306156,0.317033,17.557322,0.000021,0.000228,18,0.000113,0,14,0.55,0.000468
19153,Polk County,,IA,23501,452254,475755,180,155,335,85336,74997,160333,5,0.440276,0.473668,231601.932412,0.035248,0.037872,18,0.002238,0,14,0.251942,0.305384
19155,Pottawattamie County,,IA,5917,100089,106006,23,22,45,15422,15338,30760,5,0.368228,0.388776,2915.666724,0.004191,0.003511,18,0.000362,0,14,0.421538,0.036216
19157,Poweshiek County,,IA,1374,20923,22297,10,12,22,2101,2645,4746,6,0.345446,0.362639,191.904344,0.000524,0.001123,18,0.000184,0,14,0.602564,0.00484
19159,Ringgold County,,IA,422,5710,6132,3,4,7,350,516,866,6,0.305969,0.316589,644.451556,0.000226,0.00021,18,0.00012,0,14,0.583333,0.002076
19161,Sac County,,IA,697,12743,13440,4,5,9,759,971,1730,6,0.306156,0.317033,4.677544,0.000018,0.000225,18,0.000106,0,14,0.6,0.000485
19163,Scott County,,IA,10363,183343,193706,78,55,133,28911,24500,53411,5,0.404089,0.430071,10797.107717,0.023717,0.016221,105,0.000696,0,14,0.523529,0.195223
19165,Shelby County,,IA,838,14971,15809,6,7,13,1354,1577,2931,6,0.314984,0.326764,696.482148,0.000333,0.000519,18,0.000138,0,14,0.619048,0.003136
19167,Sioux County,,IA,1611,37199,38810,9,10,19,2170,2869,5039,6,0.317581,0.33062,1318.295546,0.000838,0.000744,18,0.000221,0,14,0.480769,0.007586
19169,Story County,,IA,8201,77829,86030,55,49,104,16820,19200,36020,5,0.39135,0.416811,15386.109679,0.005134,0.012299,18,0.000831,0,14,0.25964,0.046626
19171,Tama County,,IA,1260,21473,22733,7,8,15,2544,2939,5483,6,0.308324,0.319824,79.036118,0.000375,0.000459,18,0.00014,0,14,0.785714,0.003643
19173,Taylor County,,IA,507,7317,7824,3,4,7,351,620,971,6,0.306218,0.317033,14.871429,0.000006,0.000215,18,0.000117,0,14,0.55,0.00026
19175,Union County,,IA,857,13706,14563,7,8,15,1537,1462,2999,6,0.306125,0.31731,2783.544813,0.00023,0.000237,18,0.000231,0,14,0.357143,0.002378
19177,Van Buren County,,IA,522,8525,9047,5,4,9,897,870,1767,7,0.237189,0.243587,19.042352,0.000027,0.000016,18,0.000125,0,14,0.4,0.000593
19179,Wapello County,,IA,2396,38740,41136,17,18,35,3883,4658,8541,6,0.309595,0.322986,8821.327416,0.001499,0.000659,18,0.000372,0,14,0.330952,0.013392
19181,Warren County,,IA,3482,49329,52811,11,10,21,10430,9439,19869,6,0.308261,0.319907,99.68424,0.000903,0.000481,18,0.000239,0,14,0.572727,0.007955
19183,Washington County,,IA,1490,25312,26802,9,9,18,3105,3224,6329,6,0.308229,0.319768,61.167507,0.000482,0.000437,18,0.000183,0,14,0.611111,0.004501
19185,Wayne County,,IA,439,7346,7785,3,3,6,518,533,1051,6,0.305813,0.316256,1.083333,0.000226,0.00021,18,0.000102,0,14,0.666667,0.002074
19187,Webster County,,IA,2291,42373,44664,13,17,30,3364,4399,7763,5,0.355419,0.374417,4622.630118,0.001109,0.001518,18,0.000255,0,14,0.411765,0.010608
19189,Winnebago County,,IA,788,13628,14416,5,8,13,1170,1524,2694,5,0.327197,0.341467,398.496052,0.000026,0.000663,18,0.000132,0,14,0.464286,0.000508
19191,Winneshiek County,,IA,1045,22899,23944,8,10,18,1577,1843,3420,5,0.327769,0.342577,599.413391,0.000291,0.000891,18,0.000151,0,14,0.481818,0.002768
19193,Woodbury County,,IA,7585,113081,120666,31,40,71,12859,16640,29499,5,0.390434,0.41473,14676.098125,0.004927,0.008107,18,0.000472,0,14,0.348837,0.042386
19195,Worth County,,IA,546,8985,9531,4,4,8,1229,1024,2253,6,0.267403,0.27561,4.602453,0.000024,0.000015,18,0.000107,0,14,0.5,0.000427
19197,Wright County,,IA,915,15917,16832,6,8,14,1192,1764,2956,6,0.306312,0.317643,521.328541,0.000251,0.000257,18,0.000145,0,14,0.482143,0.002446
20001,Allen County,,KS,985,14962,15947,6,10,16,1141,1786,2927,6,0.317112,0.329688,6181.023491,0.000258,0.000695,31,0.000182,0,14,0.411111,0.002428
20003,Anderson County,,KS,580,9249,9829,4,4,8,1066,963,2029,6,0.312982,0.32394,18.620533,0.00036,0.000353,31,0.000101,0,14,0.583333,0.003269
20005,Atchison County,,KS,1161,17976,19137,9,10,19,1685,2261,3946,6,0.318288,0.331059,745.953161,0.000875,0.000931,31,0.000175,0,14,0.622222,0.008122
20007,Barber County,,KS,345,5671,6016,2,3,5,136,327,463,6,0.308071,0.318431,12.773378,0.00024,0.000217,31,0.000083,0,14,0.333333,0.002014
20009,Barton County,,KS,1669,30445,32114,15,15,30,2672,3205,5877,6,0.31849,0.331896,5339.037937,0.00085,0.00079,31,0.00038,0,14,0.392157,0.007564
20011,Bourbon County,,KS,1042,16474,17516,5,7,12,1331,1578,2909,6,0.319915,0.332479,42.202909,0.000366,0.000866,31,0.000114,0,14,0.571429,0.003363
20013,Brown County,,KS,830,11602,12432,7,8,15,1065,1512,2577,6,0.313701,0.325522,242.515272,0.00011,0.00043,31,0.000169,0,14,0.410714,0.001331
20015,Butler County,,KS,4745,66801,71546,15,15,30,12926,12211,25137,6,0.327948,0.343043,647.156206,0.00189,0.001487,31,0.000239,0,14,0.552288,0.016878
20017,Chase County,,KS,224,3168,3392,1,1,2,278,275,553,6,0.268622,0.276315,0,0.000022,0.000014,31,0.00006,0,14,0,0.000198
20019,Chautauqua County,,KS,367,4137,4504,3,3,6,351,583,934,6,0.267474,0.276021,1.130751,0.000252,0.000032,31,0.000085,0,14,0.666667,0.002148
20021,Cherokee County,,KS,1587,22890,24477,5,6,11,3541,3909,7450,6,0.312396,0.324051,6.143954,0.000072,0.000404,31,0.000119,0,14,0.766667,0.001133
20023,Cheyenne County,,KS,145,3463,3608,0,0,0,0,0,0,0,0,0,0,0,0,19,0.000049,14,32,0,0
20025,Clark County,,KS,255,2408,2663,1,1,2,225,200,425,6,0.262358,0.269513,0,0.000011,0.00001,31,0.000067,0,14,0,0.000162
20027,Clay County,,KS,625,10033,10658,4,6,10,993,1020,2013,6,0.316044,0.327608,173.878934,0.000195,0.000515,31,0.000113,0,14,0.733333,0.001675
20029,Cloud County,,KS,653,10573,11226,5,6,11,817,866,1683,6,0.309467,0.320356,6287.868377,0.000018,0.000302,31,0.000238,0,14,0.333333,0.000501
20031,Coffey County,,KS,662,10232,10894,4,6,10,743,1019,1762,6,0.313439,0.324883,1.839811,0.000037,0.000489,31,0.000108,0,14,0.785714,0.000507
20033,Comanche County,,KS,118,2206,2324,1,0,1,47,0,47,0,0,0,0,0.000001,0,31,0.00006,0,6,0,0.000065
20035,Cowley County,,KS,2634,38117,40751,9,11,20,3858,4597,8455,6,0.32308,0.33649,483.569463,0.000375,0.001111,31,0.000164,0,14,0.471429,0.003497
20037,Crawford County,,KS,2955,37799,40754,20,19,39,5594,6453,12047,6,0.325778,0.341123,767.793798,0.001491,0.001785,31,0.000322,0,14,0.373518,0.013899
20039,Decatur County,,KS,243,3743,3986,0,0,0,0,0,0,0,0,0,0,0,0,20,0.000049,15,33,0,0
20041,Dickinson County,,KS,1655,21851,23506,7,11,18,3100,3626,6726,6,0.318964,0.331774,62.282407,0.000518,0.000864,31,0.000145,0,14,0.590909,0.004473
20043,Doniphan County,,KS,703,8525,9228,4,4,8,1304,1237,2541,6,0.266454,0.274728,2.413333,0.00003,0.000029,31,0.000118,0,14,0.666667,0.000564
20045,Douglas County,,KS,10418,97399,107817,57,55,112,23302,26144,49446,5,0.398726,0.424761,11586.514851,0.010546,0.016163,31,0.000735,0,14,0.384585,0.094887
20047,Edwards County,,KS,277,3607,3884,2,2,4,125,111,236,6,0.262404,0.269735,10.536884,0.000012,0.00001,31,0.000077,0,14,0.166667,0.000227
20049,Elk County,,KS,227,3288,3515,2,2,4,144,228,372,6,0.307818,0.317987,0,0.000245,0.000219,31,0.000072,0,14,1,0.002056
20051,Ellis County,,KS,2395,29261,31656,19,18,37,3825,4121,7946,6,0.33867,0.354411,50589.134307,0.000918,0.001626,31,0.000671,0,14,0.248918,0.008376
20053,Ellsworth County,,KS,455,6731,7186,2,3,5,350,432,782,6,0.264088,0.271915,0.62549,0.000018,0.000023,31,0.000091,0,14,0.666667,0.000345
20055,Finney County,,KS,3578,41767,45345,18,29,47,3605,6019,9624,5,0.373818,0.396677,35158.077491,0.002988,0.005145,31,0.000416,0,14,0.324597,0.026562
20057,Ford County,,KS,2702,34093,36795,15,19,34,3090,4084,7174,5,0.355629,0.374617,23616.287486,0.001763,0.001838,31,0.000388,0,14,0.354978,0.015174
20059,Franklin County,,KS,2050,28160,30210,12,11,23,5237,4889,10126,6,0.320358,0.333561,600.884178,0.001139,0.001056,31,0.000201,0,14,0.590909,0.010001
20061,Geary County,,KS,8445,31917,40362,49,58,107,14040,16948,30988,5,0.403005,0.429422,5746.723019,0.014554,0.016455,31,0.000445,0,14,0.604372,0.1255
20063,Gove County,,KS,209,3572,3781,0,0,0,0,0,0,0,0,0,0,0,0,21,0.000049,16,34,0,0
20065,Graham County,,KS,188,3201,3389,0,1,1,0,134,134,7,0.253053,0.259193,0,0,0.000005,31,0.000049,0,35,0,0
20067,Grant County,,KS,716,8777,9493,2,2,4,380,267,647,6,0.272175,0.28067,3067.978454,0.00003,0.000018,31,0.000103,0,14,0,0.000292
20069,Gray County,,KS,665,7190,7855,2,2,4,639,706,1345,6,0.272249,0.280837,0,0.000041,0.000028,31,0.000079,0,14,1,0.000391
20071,Greeley County,,KS,164,1653,1817,0,0,0,0,0,0,0,0,0,0,0,0,22,0.000049,17,36,0,0
20073,Greenwood County,,KS,585,7529,8114,3,4,7,771,1068,1839,6,0.308103,0.318653,1.786447,0.000268,0.00024,31,0.000083,0,14,0.666667,0.002301
20075,Hamilton County,,KS,258,2699,2957,1,0,1,133,0,133,0,0,0,0,0.00003,0,31,0.000061,0,5,0,0.000229
20077,Harper County,,KS,516,6885,7401,3,2,5,647,654,1301,6,0.307787,0.317932,0.5,0.000242,0.000215,31,0.000093,0,14,0.666667,0.002088
20079,Harvey County,,KS,2364,38029,40393,7,11,18,5153,5934,11087,6,0.318018,0.330759,26.709115,0.000626,0.000796,31,0.000156,0,14,0.754545,0.005635
20081,Haskell County,,KS,480,4761,5241,2,3,5,253,494,747,6,0.273414,0.282263,63.978454,0.000051,0.000021,31,0.000077,0,14,0.666667,0.000332
20083,Hodgeman County,,KS,176,2312,2488,1,1,2,167,133,300,6,0.262358,0.269513,0,0.000011,0.00001,31,0.000067,0,14,0,0.000162
20085,Jackson County,,KS,1017,15515,16532,5,8,13,2382,2786,5168,6,0.31505,0.326731,5.468049,0.000091,0.000547,31,0.000124,0,14,0.625,0.001021
20087,Jefferson County,,KS,1674,21410,23084,7,8,15,4107,4242,8349,6,0.316077,0.327813,53.796479,0.000631,0.000673,31,0.000131,0,14,0.75,0.005703
20089,Jewell County,,KS,249,4037,4286,0,1,1,0,171,171,7,0.235575,0.240239,0,0,0,31,0.000049,0,37,0,0
20091,Johnson County,,KS,40432,576402,616834,229,206,435,149024,132017,281041,5,0.455014,0.491173,134465.773709,0.057475,0.0582,31,0.002273,0,14,0.326388,0.487195
20093,Kearny County,,KS,445,4711,5156,1,1,2,405,498,903,6,0.272126,0.280448,0,0.00003,0.000018,31,0.000061,0,14,0,0.000229
20095,Kingman County,,KS,742,9486,10228,3,4,7,1113,1525,2638,6,0.307945,0.318403,1,0.000254,0.000228,31,0.000099,0,14,0.666667,0.0022
20097,Kiowa County,,KS,310,3478,3788,1,6,7,90,665,755,6,0.308292,0.319208,3042.759524,0.000003,0.000237,31,0.000073,0,14,0.366667,0.000084
20099,Labette County,,KS,1266,24138,25404,7,7,14,2184,2525,4709,6,0.316911,0.32905,57.749396,0.000311,0.000623,31,0.000145,0,14,0.642857,0.003066
20101,Lane County,,KS,155,2212,2367,0,0,0,0,0,0,0,0,0,0,0,0,23,0.000049,18,38,0,0
20103,Leavenworth County,,KS,9804,70994,80798,51,44,95,21899,20779,42678,5,0.378815,0.403051,2020.772307,0.013089,0.011125,31,0.00048,0,14,0.516604,0.113148
20105,Lincoln County,,KS,280,3915,4195,1,1,2,199,264,463,6,0.263879,0.271261,0,0.000013,0.000016,31,0.000069,0,14,0,0.000225
20107,Linn County,,KS,711,10404,11115,4,7,11,1485,1777,3262,6,0.313276,0.324773,1.783333,0.000397,0.000422,31,0.000096,0,14,0.595238,0.003692
20109,Logan County,,KS,247,3379,3626,1,1,2,171,85,256,8,0.20199,0.205216,0,0,0,31,0.000167,0,14,0,0.000069
20111,Lyon County,,KS,3127,38258,41385,17,24,41,3734,6474,10208,5,0.367237,0.388132,9735.526411,0.002423,0.00376,31,0.000302,0,14,0.384615,0.021153
20113,McPherson County,,KS,1969,34571,36540,10,12,22,3375,4254,7629,5,0.353745,0.371455,223.734215,0.000715,0.001488,31,0.000214,0,14,0.653846,0.00646
20115,Marion County,,KS,886,14374,15260,5,4,9,1376,1531,2907,6,0.309181,0.319663,0.414286,0.000264,0.000293,31,0.000111,0,14,0.766667,0.002409
20117,Marshall County,,KS,639,12880,13519,6,6,12,683,921,1604,6,0.31505,0.326509,3119.065353,0.000178,0.000477,31,0.000169,0,14,0.404762,0.001709
20119,Meade County,,KS,341,5260,5601,2,2,4,267,260,527,6,0.268358,0.276759,0,0.000032,0.000014,31,0.000082,0,14,1,0.000265
20121,Miami County,,KS,2364,33485,35849,10,13,23,7730,6536,14266,6,0.320427,0.333921,68.118201,0.001062,0.001198,31,0.000175,0,14,0.615385,0.009503
20123,Mitchell County,,KS,501,7580,8081,4,3,7,456,345,801,6,0.308071,0.318514,6008,0.000015,0.000229,31,0.000186,0,14,0.25,0.000422
20125,Montgomery County,,KS,2654,36844,39498,12,16,28,4135,5248,9383,6,0.325496,0.340169,892.754592,0.000994,0.001466,31,0.000259,0,14,0.408333,0.00934
20127,Morris County,,KS,380,6740,7120,4,4,8,467,553,1020,6,0.290185,0.299994,0.704266,0.000287,0.000153,31,0.000091,0,14,0.8,0.002359
20129,Morton County,,KS,361,3926,4287,1,1,2,88,48,136,7,0.245104,0.251033,0,0.000008,0.000005,31,0.000068,0,14,0,0.000112
20131,Nemaha County,,KS,606,12964,13570,4,6,10,858,1207,2065,6,0.315017,0.326454,5.714726,0.000085,0.000476,31,0.000116,0,14,0.666667,0.000884
20133,Neosho County,,KS,1183,17957,19140,8,8,16,2100,2277,4377,6,0.316811,0.328995,73.390417,0.000612,0.000634,31,0.000172,0,14,0.527778,0.005564
20135,Ness County,,KS,220,3820,4040,0,1,1,0,132,132,7,0.253053,0.259193,0,0,0.000005,31,0.000049,0,39,0,0
20137,Norton County,,KS,416,5959,6375,1,1,2,129,137,266,7,0.253053,0.259193,0,0,0.000005,31,0.00007,0,40,0.5,0.000063
20139,Osage County,,KS,1317,18878,20195,7,7,14,3006,3285,6291,6,0.316978,0.329078,267.274224,0.000547,0.000699,31,0.000142,0,14,0.696429,0.004703
20141,Osborne County,,KS,287,4874,5161,0,1,1,0,111,111,7,0.235575,0.240239,0,0,0,31,0.000049,0,41,0,0
20143,Ottawa County,,KS,542,7237,7779,1,2,3,1003,990,1993,6,0.263949,0.271538,0,0.000013,0.000016,31,0.000069,0,14,1,0.000225
20145,Pawnee County,,KS,502,7136,7638,3,2,5,418,468,886,6,0.307913,0.318154,231.396247,0.000014,0.000218,31,0.000135,0,14,0.5,0.000317
20147,Phillips County,,KS,448,6847,7295,0,2,2,0,265,265,7,0.253116,0.25944,0,0,0.000005,31,0.000049,0,42,0.5,0
20149,Pottawatomie County,,KS,1793,21772,23565,9,9,18,3710,3599,7309,6,0.318761,0.331247,234.980673,0.000919,0.000838,31,0.000151,0,14,0.590909,0.007998
20151,Pratt County,,KS,678,10582,11260,7,6,13,1139,977,2116,6,0.316711,0.328579,6107.664365,0.000261,0.000566,31,0.000169,0,14,0.446429,0.002522
20153,Rawlins County,,KS,221,3102,3323,0,1,1,0,57,57,8,0.20203,0.205314,0,0,0,31,0.000049,0,43,0,0
20155,Reno County,,KS,3713,69929,73642,22,21,43,7152,7794,14946,5,0.358216,0.377863,4441.10938,0.001943,0.00237,31,0.000392,0,14,0.406667,0.017724
20157,Republic County,,KS,352,6237,6589,1,1,2,186,264,450,7,0.236349,0.241079,0,0.000002,0,31,0.000083,0,14,0,0.000071
20159,Rice County,,KS,761,11072,11833,5,4,9,1159,1391,2550,6,0.307976,0.318486,139.879196,0.000264,0.000234,31,0.000137,0,14,0.65,0.002413
20161,Riley County,,KS,8442,47464,55906,68,58,126,18446,20048,38494,5,0.398991,0.425011,26177.014519,0.012114,0.015397,31,0.000839,0,14,0.35463,0.105059
20163,Rooks County,,KS,351,6100,6451,1,1,2,252,361,613,7,0.253011,0.259113,0,0.00001,0.000005,31,0.000081,0,14,0,0.000129
20165,Rush County,,KS,288,3984,4272,2,2,4,262,417,679,7,0.253182,0.259601,0,0.000014,0.00001,31,0.000102,0,14,1,0.00025
20167,Russell County,,KS,630,7691,8321,1,4,5,360,670,1030,6,0.313504,0.324706,0,0.00001,0.000365,31,0.000081,0,14,1,0.000129
20169,Saline County,,KS,3996,62628,66624,25,22,47,8121,8692,16813,5,0.35843,0.378196,27308.99953,0.002704,0.002251,31,0.000515,0,14,0.35582,0.024148
20171,Scott County,,KS,411,5809,6220,1,1,2,262,265,527,6,0.272126,0.280448,0,0.00003,0.000018,31,0.000061,0,14,0,0.000229
20173,Sedgwick County,,KS,25763,518455,544218,151,160,311,68350,68983,137333,5,0.44451,0.477719,146244.387497,0.036183,0.040142,31,0.001797,0,14,0.33622,0.314884
20175,Seward County,,KS,2410,23680,26090,9,17,26,2634,3807,6441,5,0.365184,0.386157,13817.995274,0.000634,0.003537,31,0.000317,0,14,0.422794,0.005579
20177,Shawnee County,,KS,10231,195034,205265,60,57,117,24873,24179,49052,5,0.39186,0.418215,28435.984972,0.01085,0.013047,31,0.000796,0,14,0.339991,0.095102
20179,Sheridan County,,KS,181,3222,3403,0,0,0,0,0,0,0,0,0,0,0,0,24,0.000049,19,44,0,0
20181,Sherman County,,KS,547,6557,7104,2,1,3,188,139,327,8,0.20199,0.205216,20.722435,0.000005,0,31,0.000179,0,14,0,0.000169
20183,Smith County,,KS,239,5078,5317,0,0,0,0,0,0,0,0,0,0,0,0,25,0.000049,20,45,0,0
20185,Stafford County,,KS,325,5106,5431,2,4,6,252,543,795,6,0.308039,0.31857,0,0.000019,0.000231,31,0.000087,0,14,0.916667,0.000307
20187,Stanton County,,KS,243,2466,2709,0,1,1,0,82,82,7,0.214001,0.218171,0,0,0,31,0.000049,0,46,0,0
20189,Stevens County,,KS,544,6387,6931,3,1,4,304,302,606,6,0.267522,0.275388,5.631702,0.000021,0.000004,31,0.000131,0,14,0.333333,0.000237
20191,Sumner County,,KS,2074,27933,30007,4,8,12,4213,4997,9210,6,0.317749,0.33001,14.213107,0.000253,0.000715,31,0.000124,0,14,0.589286,0.002273
20193,Thomas County,,KS,854,8647,9501,4,3,7,386,474,860,7,0.253096,0.259557,12096.08363,0.00001,0.000005,31,0.000416,0,14,0,0.000323
20195,Trego County,,KS,272,3737,4009,1,1,2,166,184,350,7,0.253011,0.259113,0,0.00001,0.000005,31,0.000081,0,14,0,0.000129
20197,Wabaunsee County,,KS,549,7815,8364,3,4,7,1360,1355,2715,6,0.287574,0.297309,1.50082,0.000173,0.000144,31,0.000088,0,14,0.666667,0.001478
20199,Wallace County,,KS,131,1862,1993,0,0,0,0,0,0,0,0,0,0,0,0,26,0.000049,21,47,0,0
20201,Washington County,,KS,385,7512,7897,1,2,3,158,312,470,6,0.285334,0.294435,0,0.000003,0.000072,31,0.000073,0,14,1,0.000079
20203,Wichita County,,KS,234,2962,3196,0,0,0,0,0,0,0,0,0,0,0,0,27,0.000049,22,48,0,0
20205,Wilson County,,KS,746,10590,11336,5,4,9,1298,1404,2702,6,0.308008,0.318542,2.479167,0.000261,0.000232,31,0.000123,0,14,0.7,0.002397
20207,Woodson County,,KS,227,3692,3919,1,1,2,207,204,411,7,0.240782,0.246034,0,0.000004,0.000002,31,0.000065,0,14,0,0.000083
20209,Wyandotte County,,KS,13502,151335,164837,36,30,66,36539,43048,79587,5,0.380639,0.403429,2375.065342,0.009187,0.007025,31,0.000421,0,14,0.548364,0.080777
21001,Adair County,,KY,853,16554,17407,5,6,11,1268,1407,2675,6,0.312169,0.324434,325.592764,0.000372,0.000431,28,0.000148,0,14,0.5,0.003662
21003,Allen County,,KY,1082,18704,19786,6,6,12,2528,2410,4938,6,0.284012,0.294002,21.339327,0.000119,0.000155,28,0.000152,0,14,0.52381,0.001871
21005,Anderson County,,KY,1468,23216,24684,9,9,18,4811,3904,8715,6,0.313865,0.326886,5.270971,0.000637,0.000632,28,0.000203,0,14,0.733333,0.006164
21007,Ballard County,,KY,498,9155,9653,2,2,4,982,1019,2001,7,0.26124,0.269167,0,0.000017,0.000018,28,0.000102,0,14,1,0.00031
21009,Barren County,,KY,2236,42881,45117,9,10,19,5406,5120,10526,6,0.324546,0.33897,1127.065639,0.000495,0.001208,28,0.000242,0,14,0.390909,0.005101
21011,Bath County,,KY,674,11555,12229,6,6,12,1826,1822,3648,6,0.302487,0.313804,1478.739386,0.00024,0.000225,28,0.00017,0,14,0.595238,0.002357
21013,Bell County,,KY,1563,24799,26362,8,10,18,2569,3448,6017,6,0.316844,0.331147,561.369395,0.00054,0.000957,0,0.000194,0,14,0.522222,0.005376
21015,Boone County,,KY,10443,116137,126580,41,36,77,40928,31937,72865,5,0.390383,0.414586,9814.958389,0.012172,0.010857,71,0.000464,0,14,0.489855,0.10305
21017,Bourbon County,,KY,1456,21218,22674,9,9,18,3976,4219,8195,6,0.302548,0.314248,11.074464,0.000272,0.000251,28,0.000219,0,14,0.652778,0.002873
21019,Boyd County,,KY,3044,51133,54177,11,12,23,6830,6961,13791,6,0.329386,0.345445,2006.941525,0.001152,0.001157,71,0.000246,0,14,0.454545,0.010347
21021,Boyle County,,KY,2174,28681,30855,10,10,20,5455,5407,10862,6,0.314029,0.327247,513.457385,0.000632,0.00064,28,0.000233,0,14,0.655556,0.006197
21023,Bracken County,,KY,714,10194,10908,6,6,12,1561,1480,3041,6,0.312461,0.324501,11.022481,0.000541,0.00051,71,0.000126,0,14,0.8,0.004598
21025,Breathitt County,,KY,564,12554,13118,3,3,6,447,612,1059,6,0.302365,0.313249,2073.65928,0.00023,0.000218,28,0.000109,0,14,0.333333,0.002091
21027,Breckinridge County,,KY,1184,19786,20970,7,8,15,3230,2988,6218,6,0.313276,0.326049,985.157182,0.000491,0.000555,28,0.000153,0,14,0.571429,0.00487
21029,Bullitt County,,KY,5377,77724,83101,14,13,27,21370,16906,38276,6,0.31321,0.326492,71.720759,0.000798,0.000565,28,0.000262,0,14,0.429167,0.007991
21031,Butler County,,KY,719,13480,14199,4,5,9,1469,1865,3334,6,0.276255,0.285331,2.32439,0.000054,0.000053,28,0.00012,0,14,0.6,0.000766
21033,Caldwell County,,KY,685,13956,14641,6,6,12,1459,1422,2881,6,0.293991,0.304217,1812.21284,0.00015,0.000151,28,0.000162,0,14,0.466667,0.001734
21035,Calloway County,,KY,2250,33598,35848,11,11,22,3879,3798,7677,6,0.33208,0.348569,2746.378954,0.001408,0.001924,28,0.000213,0,14,0.457143,0.011852
21037,Campbell County,,KY,7200,96995,104195,17,15,32,21298,22634,43932,6,0.33011,0.346649,291.54629,0.002416,0.002285,71,0.000242,0,14,0.602941,0.020178
21039,Carlisle County,,KY,398,5839,6237,4,4,8,626,866,1492,7,0.261376,0.269694,975.824193,0.000024,0.000018,28,0.000148,0,14,0.583333,0.00045
21041,Carroll County,,KY,976,12523,13499,10,9,19,2306,2283,4589,6,0.312428,0.325183,119.711956,0.000514,0.000538,71,0.000209,0,14,0.4,0.00525
21043,Carter County,,KY,1086,28214,29300,9,7,16,2407,2306,4713,6,0.30264,0.314192,3345.576649,0.00025,0.000233,71,0.000243,0,14,0.375,0.002703
21045,Casey County,,KY,649,15333,15982,6,7,13,1170,1636,2806,6,0.30264,0.314164,17.478993,0.000022,0.00024,28,0.000168,0,14,0.52381,0.00064
21047,Christian County,,KY,16151,70022,86173,66,72,138,23431,32804,56235,5,0.412581,0.440085,17672.304705,0.021063,0.020184,0,0.000642,0,14,0.532253,0.183917
21049,Clark County,,KY,2487,37079,39566,13,11,24,6726,5780,12506,6,0.314029,0.327386,1902.972269,0.000634,0.000641,28,0.000316,0,14,0.461538,0.006399
21051,Clay County,,KY,858,17813,18671,4,5,9,1366,2009,3375,6,0.302426,0.313582,660.028888,0.000005,0.000242,28,0.000149,0,14,0.6,0.000392
21053,Clinton County,,KY,447,9582,10029,3,2,5,594,493,1087,7,0.232724,0.238029,22.827768,0.000002,0,28,0.000148,0,14,0,0.000201
21055,Crittenden County,,KY,502,9315,9817,5,5,10,740,721,1461,7,0.261445,0.269971,24.007027,0.000002,0.000019,28,0.000159,0,14,0.4,0.000368
21057,Cumberland County,,KY,387,6620,7007,0,4,4,0,410,410,6,0.276398,0.285363,0,0,0.00004,28,0.000049,0,49,0.5,0
21059,Daviess County,,KY,4443,105785,110228,17,18,35,8959,8748,17707,6,0.32935,0.346477,7190.891774,0.001289,0.001706,28,0.000318,0,14,0.376316,0.012398
21061,Edmonson County,,KY,660,12103,12763,5,4,9,2059,1993,4052,6,0.312039,0.32399,59.188208,0.000413,0.000428,28,0.000134,0,14,0.65,0.003998
21063,Elliott County,,KY,269,5986,6255,3,3,6,446,509,955,7,0.239477,0.245682,2.431046,0.000005,0.000003,28,0.00012,0,14,0.833333,0.00025
21065,Estill County,,KY,766,14676,15442,4,4,8,1623,1775,3398,6,0.302365,0.31336,0,0.000249,0.000236,28,0.000131,0,14,1,0.002354
21067,Fayette County,,KY,22041,275127,297168,159,149,308,60280,64820,125100,5,0.43304,0.467199,229499.607347,0.036787,0.03881,28,0.002034,0,14,0.316769,0.316024
21069,Fleming County,,KY,719,15461,16180,6,6,12,1511,1465,2976,6,0.302609,0.314026,389.608474,0.000239,0.000224,71,0.000169,0,14,0.566667,0.002374
21071,Floyd County,,KY,1616,37235,38851,5,9,14,3013,3790,6803,6,0.302975,0.314886,1793.560973,0.000237,0.000242,28,0.000141,0,14,0.375,0.002275
21073,Franklin County,,KY,3324,55336,58660,13,13,26,6936,7806,14742,6,0.319099,0.333605,163.470451,0.001035,0.001013,28,0.000277,0,14,0.472527,0.009463
21075,Fulton County,,KY,702,6707,7409,4,5,9,1244,1554,2798,7,0.261581,0.270304,513.029494,0.000022,0.00003,0,0.000115,0,14,0.6,0.000398
21077,Gallatin County,,KY,758,5926,6684,6,5,11,2028,2048,4076,6,0.282703,0.292144,1.98872,0.000144,0.000137,71,0.000135,0,14,0.666667,0.001596
21079,Garrard County,,KY,1378,16375,17753,7,7,14,4488,3803,8291,6,0.302579,0.314053,0.805195,0.000267,0.000253,28,0.000179,0,14,0.952381,0.00274
21081,Grant County,,KY,2721,26672,29393,11,11,22,7775,7602,15377,6,0.315679,0.329167,140.27489,0.000981,0.000803,71,0.000203,0,14,0.575758,0.008399
21083,Graves County,,KY,1926,38953,40879,7,11,18,3674,4387,8061,6,0.324476,0.338981,3090.100461,0.00004,0.001104,28,0.000191,0,14,0.418182,0.000779
21085,Grayson County,,KY,1164,26754,27918,7,8,15,2524,2454,4978,6,0.31321,0.325938,106.457818,0.0005,0.000535,28,0.000169,0,14,0.553571,0.005035
21087,Green County,,KY,601,11439,12040,5,4,9,989,1012,2001,6,0.312851,0.324883,2.50697,0.000375,0.00049,28,0.00014,0,14,0.733333,0.003694
21089,Greenup County,,KY,2259,39257,41516,9,10,19,5732,5616,11348,6,0.329242,0.345001,2092.167529,0.000787,0.00114,71,0.000199,0,14,0.5,0.006931
21091,Hancock County,,KY,581,9652,10233,4,4,8,1610,1525,3135,7,0.247937,0.255344,3.767931,0.000019,0.000015,28,0.000122,0,14,0.5,0.000427
21093,Hardin County,,KY,11305,104051,115356,61,58,119,24688,25044,49732,5,0.397512,0.423757,12093.985669,0.01672,0.014582,28,0.000641,0,14,0.456522,0.140863
21095,Harlan County,,KY,1074,26876,27950,6,9,15,1112,1445,2557,6,0.302975,0.314913,623.673776,0.000242,0.000252,0,0.000164,0,14,0.444444,0.002454
21097,Harrison County,,KY,1021,19941,20962,6,7,13,2429,2326,4755,6,0.313865,0.326664,47.032161,0.000247,0.000619,28,0.000149,0,14,0.5,0.002451
21099,Hart County,,KY,955,18387,19342,7,7,14,2647,2513,5160,6,0.313112,0.32566,204.518916,0.000502,0.000529,28,0.000177,0,14,0.535714,0.005012
21101,Henderson County,,KY,2610,51052,53662,8,12,20,5390,5905,11295,6,0.323846,0.338748,486.061902,0.000509,0.001124,28,0.000167,0,14,0.537879,0.004843
21103,Henry County,,KY,1293,16700,17993,7,6,13,3771,3555,7326,6,0.312007,0.324157,4.787374,0.000399,0.000415,28,0.000167,0,14,0.619048,0.004161
21105,Hickman County,,KY,331,5091,5422,3,5,8,558,708,1266,7,0.261536,0.270193,3.227579,0.000007,0.000024,28,0.000115,0,14,0.7,0.000215
21107,Hopkins County,,KY,2483,50794,53277,14,16,30,4576,4947,9523,6,0.327233,0.343242,4144.215398,0.001073,0.001531,28,0.000274,0,14,0.3875,0.010087
21109,Jackson County,,KY,502,12683,13185,3,3,6,1003,1302,2305,7,0.248141,0.255876,7.664567,0.00002,0.000025,28,0.000115,0,14,0.833333,0.000458
21111,Jefferson County,,KY,37592,790662,828254,259,226,485,112697,118483,231180,5,0.452887,0.49221,213732.855978,0.06542,0.061438,28,0.002638,0,14,0.322066,0.553097
21113,Jessamine County,,KY,4169,42962,47131,14,14,28,12497,10033,22530,6,0.314193,0.327968,75.867723,0.000654,0.00066,28,0.000311,0,14,0.60989,0.006684
21115,Johnson County,,KY,1115,21603,22718,6,7,13,2480,2150,4630,6,0.302884,0.314497,2777.68861,0.000236,0.000227,28,0.000176,0,14,0.452381,0.002364
21117,Kenton County,,KY,15253,170548,185801,36,39,75,47939,47357,95296,5,0.387663,0.411745,8894.818328,0.009145,0.01135,71,0.000441,0,14,0.480066,0.076881
21119,Knott County,,KY,641,13889,14530,4,4,8,1466,1560,3026,6,0.302518,0.313582,4.495948,0.000233,0.000221,28,0.000115,0,14,0.666667,0.002187
21121,Knox County,,KY,1592,28317,29909,6,6,12,3676,3725,7401,6,0.302548,0.313915,294.922496,0.00026,0.000247,28,0.000152,0,14,0.738095,0.0026
21123,Larue County,,KY,1015,14635,15650,6,6,12,3008,2811,5819,6,0.312949,0.325272,4.018372,0.000464,0.000498,28,0.000145,0,14,0.666667,0.004643
21125,Laurel County,,KY,2974,56763,59737,17,14,31,7713,6913,14626,6,0.314325,0.32819,9272.253985,0.00196,0.000641,28,0.000337,0,14,0.339869,0.016643
21127,Lawrence County,,KY,807,14618,15425,8,5,13,1751,1498,3249,7,0.248552,0.256059,896.246165,0.000533,0.000014,28,0.00021,0,14,0.357143,0.004896
21129,Lee County,,KY,390,6078,6468,1,2,3,44,311,355,7,0.248081,0.255567,3005,0,0.000014,28,0.000142,0,50,0,0.000065
21131,Leslie County,,KY,403,10470,10873,3,4,7,604,866,1470,7,0.239553,0.245987,2.957806,0.000007,0.000014,28,0.000117,0,14,0.5,0.000323
21133,Letcher County,,KY,867,22783,23650,6,7,13,1302,1668,2970,6,0.303159,0.314913,335.327001,0.000238,0.000239,28,0.000159,0,14,0.380952,0.002374
21135,Lewis County,,KY,627,13404,14031,5,6,11,1232,1420,2652,7,0.249357,0.257441,23.434753,0.000021,0.000017,71,0.000149,0,14,0.366667,0.000497
21137,Lincoln County,,KY,1517,25485,27002,9,9,18,4773,4720,9493,6,0.30267,0.314442,166.833714,0.00027,0.000255,28,0.000223,0,14,0.708333,0.002893
21139,Livingston County,,KY,782,10247,11029,4,5,9,1701,1903,3604,7,0.261399,0.26986,145.861562,0.000021,0.000026,28,0.000141,0,14,0.65,0.000456
21141,Logan County,,KY,1568,28406,29974,11,12,23,3406,3728,7134,6,0.324301,0.33907,709.879786,0.001244,0.001374,28,0.000203,0,14,0.515152,0.012438
21143,Lyon County,,KY,575,7391,7966,6,6,12,1057,1175,2232,7,0.261559,0.270332,181.568178,0.000031,0.000025,28,0.000177,0,14,0.5,0.000664
21145,McCracken County,,KY,4471,71341,75812,26,20,46,9834,9101,18935,6,0.353495,0.373929,42331.645853,0.003012,0.002927,28,0.000502,0,14,0.244709,0.027334
21147,McCreary County,,KY,648,14063,14711,2,4,6,726,999,1725,7,0.243732,0.250947,19.476339,0.00001,0.000013,28,0.000092,0,14,0.25,0.000245
21149,McLean County,,KY,652,10789,11441,4,4,8,1577,1799,3376,7,0.248717,0.256437,1.273893,0.000025,0.000021,28,0.000123,0,14,0.833333,0.000489
21151,Madison County,,KY,5098,74071,79169,37,31,68,13930,12746,26676,6,0.329711,0.348557,12438.11526,0.002326,0.002516,28,0.000739,0,14,0.201829,0.021202
21153,Magoffin County,,KY,416,11326,11742,3,4,7,445,730,1175,6,0.302518,0.313637,337.762767,0.000003,0.00022,28,0.000103,0,14,0.5,0.000232
21155,Marion County,,KY,783,19207,19990,6,6,12,1973,2035,4008,6,0.313766,0.326387,2.746703,0.000607,0.000618,28,0.000154,0,14,0.7,0.005678
21157,Marshall County,,KY,1929,33601,35530,5,7,12,4169,4139,8308,6,0.314555,0.32758,486.011849,0.000035,0.000629,28,0.000151,0,14,0.571429,0.000597
21159,Martin County,,KY,553,9862,10415,5,4,9,577,925,1502,7,0.247834,0.254867,13.912267,0.000007,0.000012,28,0.000152,0,14,0.5,0.000468
21161,Mason County,,KY,1128,18199,19327,9,8,17,2764,2529,5293,6,0.302853,0.314692,605.502365,0.000416,0.0003,71,0.000176,0,14,0.402778,0.003747
21163,Meade County,,KY,4072,29501,33573,16,20,36,8056,7815,15871,6,0.350976,0.369396,498.248195,0.003267,0.004447,28,0.00019,0,14,0.662055,0.028296
21165,Menifee County,,KY,502,6035,6537,3,4,7,687,997,1684,6,0.302396,0.313415,331.131021,0.000005,0.000221,28,0.000113,0,14,0.75,0.000245
21167,Mercer County,,KY,1384,24152,25536,12,12,24,3719,3655,7374,6,0.326273,0.342149,200.425119,0.000641,0.001043,28,0.000273,0,14,0.564103,0.006428
21169,Metcalfe County,,KY,630,10181,10811,5,4,9,1341,1513,2854,6,0.276255,0.285192,2.972201,0.000051,0.000043,28,0.000159,0,14,0.6,0.000759
21171,Monroe County,,KY,482,11735,12217,6,4,10,823,1062,1885,6,0.276459,0.285514,72.02656,0.000054,0.000043,28,0.000193,0,14,0.466667,0.000864
21173,Montgomery County,,KY,1630,25865,27495,12,12,24,4930,4180,9110,6,0.314127,0.327663,2629.983853,0.000267,0.000633,28,0.0003,0,14,0.397436,0.003044
21175,Morgan County,,KY,643,11902,12545,4,7,11,641,887,1528,7,0.239725,0.246819,35.956382,0.000005,0.000005,28,0.000154,0,14,0.261905,0.000296
21177,Muhlenberg County,,KY,1331,33398,34729,10,8,18,2139,2526,4665,6,0.313865,0.326881,841.41643,0.000554,0.000571,28,0.000209,0,14,0.533333,0.005613
21179,Nelson County,,KY,2368,47303,49671,12,11,23,7199,6027,13226,6,0.315083,0.328667,55.461965,0.000722,0.000777,28,0.000259,0,14,0.50641,0.007291
21181,Nicholas County,,KY,498,7739,8237,4,6,10,929,1149,2078,6,0.302426,0.313693,2.162933,0.000238,0.000227,28,0.000121,0,14,0.733333,0.002205
21183,Ohio County,,KY,1285,24522,25807,9,8,17,2856,2993,5849,6,0.312299,0.324878,1844.268376,0.000639,0.000436,28,0.000207,0,14,0.388889,0.005695
21185,Oldham County,,KY,4476,56391,60867,13,11,24,12907,10522,23429,6,0.31393,0.327219,359.563594,0.002314,0.000652,28,0.000224,0,14,0.452381,0.020077
21187,Owen County,,KY,842,10453,11295,8,8,16,2299,2164,4463,6,0.302823,0.314636,54.841555,0.000382,0.000363,71,0.000176,0,14,0.642857,0.003691
21189,Owsley County,,KY,187,3820,4007,1,1,2,122,44,166,8,0.198783,0.202557,0,0,0,28,0.00011,0,50,0,0.000065
21191,Pendleton County,,KY,1089,15079,16168,7,7,14,3456,3399,6855,6,0.312493,0.324667,17.13611,0.000547,0.000515,71,0.000142,0,14,0.714286,0.004706
21193,Perry County,,KY,1252,28612,29864,6,7,13,2143,2384,4527,6,0.302609,0.314081,794.187864,0.000237,0.000246,28,0.000181,0,14,0.404762,0.002419
21195,Pike County,,KY,2477,58497,60974,9,14,23,3770,4269,8039,6,0.31548,0.329882,6425.071374,0.000614,0.000715,28,0.000206,0,14,0.197802,0.005974
21197,Powell County,,KY,896,13394,14290,6,6,12,1616,2215,3831,6,0.302487,0.313804,2154.206836,0.000253,0.000237,28,0.000181,0,14,0.633333,0.002511
21199,Pulaski County,,KY,2610,61004,63614,18,17,35,5080,4754,9834,6,0.321765,0.337783,9106.024313,0.001632,0.00142,28,0.000367,0,14,0.321429,0.014241
21201,Robertson County,,KY,141,1916,2057,0,0,0,0,0,0,0,0,0,0,0,0,29,0.000049,23,51,0,0
21203,Rockcastle County,,KY,784,16311,17095,5,5,10,1677,1892,3569,6,0.302579,0.313832,0.942857,0.000257,0.000253,28,0.000141,0,14,0.9,0.002577
21205,Rowan County,,KY,1456,19538,20994,13,12,25,3103,3048,6151,6,0.314621,0.328357,8245.312537,0.000252,0.000627,28,0.000322,0,14,0.2875,0.002962
21207,Russell County,,KY,686,16931,17617,4,5,9,1049,1027,2076,6,0.302579,0.313832,311.528038,0.000374,0.000233,28,0.000119,0,14,0.7,0.003625
21209,Scott County,,KY,3062,41606,44668,18,17,35,11313,7815,19128,6,0.325355,0.342061,280.804913,0.000783,0.001332,28,0.000357,0,14,0.378947,0.008058
21211,Shelby County,,KY,2738,39021,41759,11,11,22,8774,7088,15862,6,0.313963,0.327275,49.810133,0.00072,0.000671,28,0.000235,0,14,0.545455,0.007216
21213,Simpson County,,KY,1193,18672,19865,6,7,13,2996,3007,6003,6,0.32211,0.335558,104.52596,0.000536,0.001013,28,0.000141,0,14,0.785714,0.005831
21215,Spencer County,,KY,1211,15427,16638,5,4,9,5616,3450,9066,6,0.311845,0.323657,0,0.000378,0.000399,28,0.000132,0,14,0.95,0.003843
21217,Taylor County,,KY,1267,24397,25664,9,10,19,2632,2706,5338,6,0.315083,0.328556,630.128351,0.000692,0.000753,28,0.000214,0,14,0.445455,0.006672
21219,Todd County,,KY,857,12620,13477,3,5,8,1664,1794,3458,6,0.301485,0.312905,1.258968,0.000351,0.000406,0,0.000079,0,14,0.9,0.003304
21221,Trigg County,,KY,1054,14492,15546,4,5,9,1641,1580,3221,6,0.314984,0.328018,36.303486,0.000353,0.000754,0,0.000102,0,14,0.7,0.003374
21223,Trimble County,,KY,737,9346,10083,5,5,10,1947,1888,3835,6,0.312039,0.324101,1.801651,0.000378,0.00041,28,0.000133,0,14,0.8,0.003812
21225,Union County,,KY,930,16499,17429,5,5,10,1285,1822,3107,6,0.284066,0.293958,619.012412,0.000093,0.000061,28,0.000129,0,14,0.65,0.00091
21227,Warren County,,KY,6422,102545,108967,44,37,81,16254,14435,30689,5,0.381315,0.40496,27335.378089,0.00618,0.00676,28,0.000712,0,14,0.254252,0.056819
21229,Washington County,,KY,605,12317,12922,6,5,11,1561,1453,3014,6,0.313701,0.326165,1.75,0.000609,0.000614,28,0.000151,0,14,0.733333,0.005679
21231,Wayne County,,KY,843,19383,20226,3,3,6,1133,1335,2468,6,0.302548,0.313499,3409.545262,0.000008,0.000226,28,0.00015,0,14,0.333333,0.000293
21233,Webster County,,KY,1053,14918,15971,4,6,10,2158,2833,4991,6,0.284201,0.294346,557.139725,0.000093,0.000068,28,0.000109,0,14,0.666667,0.000841
21235,Whitley County,,KY,1788,33344,35132,8,9,17,4592,4457,9049,6,0.316844,0.331036,1029.57551,0.000258,0.000971,28,0.000197,0,14,0.490909,0.002781
21237,Wolfe County,,KY,371,6667,7038,3,4,7,461,568,1029,7,0.239343,0.245765,10.573648,0.000003,0.000007,28,0.000125,0,14,0.166667,0.00023
21239,Woodford County,,KY,1978,26677,28655,9,9,18,5031,5084,10115,6,0.313865,0.326886,18.821278,0.000624,0.00063,28,0.000209,0,14,0.805556,0.006034
22001,Acadia Parish,,LA,3100,62099,65199,16,12,28,9628,9339,18967,6,0.34183,0.359293,119.779303,0.002236,0.001591,89,0.000174,0,14,0.729167,0.016649
22003,Allen Parish,,LA,1444,22381,23825,11,10,21,3688,3787,7475,6,0.338937,0.35582,68.754005,0.001428,0.001139,89,0.000146,0,14,0.727273,0.011469
22005,Ascension Parish,,LA,5391,95779,101170,30,27,57,30001,17422,47423,5,0.360841,0.382118,630.8707,0.003888,0.003445,89,0.000298,0,14,0.519328,0.030603
22007,Assumption Parish,,LA,1306,24935,26241,9,9,18,4135,4265,8400,6,0.341674,0.358738,9.137971,0.001239,0.001443,89,0.000108,0,14,0.877778,0.007724
22009,Avoyelles Parish,,LA,1681,41951,43632,12,12,24,4508,4318,8826,6,0.341908,0.359404,71.489075,0.00198,0.001688,89,0.000148,0,14,0.725275,0.014508
22011,Beauregard Parish,,LA,2458,32476,34934,9,8,17,6167,5453,11620,6,0.343471,0.360503,101.912137,0.002035,0.001527,89,0.000113,0,14,0.704545,0.015068
22013,Bienville Parish,,LA,1135,14882,16017,9,7,16,2630,2675,5305,6,0.288874,0.299656,6.527924,0.000334,0.000239,89,0.000154,0,14,0.652778,0.00318
22015,Bossier Parish,,LA,12206,109322,121528,54,51,105,35995,32667,68662,5,0.389978,0.415823,7852.667608,0.013606,0.013379,89,0.000512,0,14,0.513393,0.115375
22017,Caddo Parish,,LA,16648,264026,280674,73,71,144,47383,48846,96229,5,0.399044,0.42753,15816.27082,0.017761,0.019909,89,0.0007,0,14,0.411389,0.151579
22019,Calcasieu Parish,,LA,9407,201339,210746,53,57,110,26348,26709,53057,5,0.381606,0.408494,4102.991723,0.009698,0.01249,89,0.000495,0,14,0.417308,0.08723
22021,Caldwell Parish,,LA,748,9872,10620,3,3,6,958,1247,2205,6,0.278406,0.288366,0.72549,0.000082,0.000069,89,0.000101,0,14,0.666667,0.000805
22023,Cameron Parish,,LA,716,10364,11080,3,7,10,1305,3341,4646,6,0.281563,0.292421,1.04127,0.000164,0.000211,89,0.000078,0,14,0.52381,0.00167
22025,Catahoula Parish,,LA,639,9975,10614,6,5,11,1209,1140,2349,6,0.279442,0.29003,48.710735,0.000867,0.000109,89,0.000125,0,14,0.642857,0.005412
22027,Claiborne Parish,,LA,917,15368,16285,9,8,17,1941,2277,4218,6,0.289236,0.300433,25.178573,0.000337,0.000232,89,0.000152,0,14,0.597222,0.003144
22029,Concordia Parish,,LA,1211,19657,20868,8,7,15,2365,2485,4850,6,0.324021,0.338149,82.878709,0.001195,0.000598,89,0.000132,0,14,0.642857,0.007815
22031,De Soto Parish,,LA,1784,28382,30166,8,8,16,5566,5296,10862,6,0.342024,0.358489,90.296812,0.000839,0.001424,89,0.000136,0,14,0.638889,0.008035
22033,East Baton Rouge Parish,,LA,27055,422552,449607,134,149,283,98511,100564,199075,5,0.435425,0.469585,39534.447447,0.033319,0.041459,89,0.001247,0,14,0.386857,0.293367
22035,East Carroll Parish,,LA,478,7428,7906,4,4,8,613,866,1479,6,0.330619,0.34524,208.725561,0.000534,0.000637,89,0.000116,0,14,0.65,0.003314
22037,East Feliciana Parish,,LA,1522,20121,21643,5,4,9,4240,4135,8375,6,0.303465,0.314414,0.45,0.000738,0.00025,89,0.000097,0,14,0.9,0.005
22039,Evangeline Parish,,LA,1484,33295,34779,13,12,25,4438,4969,9407,6,0.341908,0.359404,10.202185,0.002031,0.001605,89,0.000156,0,14,0.820513,0.015012
22041,Franklin Parish,,LA,1189,21206,22395,8,6,14,1901,2308,4209,6,0.333001,0.348374,612.672585,0.001676,0.000823,89,0.000159,0,14,0.5,0.012239
22043,Grant Parish,,LA,1306,18968,20274,7,6,13,4588,3889,8477,6,0.303926,0.315441,273.166932,0.000779,0.000259,89,0.000123,0,14,0.589286,0.006711
22045,Iberia Parish,,LA,4004,80978,84982,17,18,35,11188,12256,23444,6,0.345168,0.363582,24.74544,0.002703,0.002482,89,0.000176,0,14,0.776316,0.021173
22047,Iberville Parish,,LA,2024,32583,34607,11,9,20,6230,6344,12574,6,0.324371,0.338704,32.514266,0.001915,0.000896,89,0.000144,0,14,0.827273,0.014171
22049,Jackson Parish,,LA,1034,15867,16901,7,7,14,2390,2545,4935,6,0.338593,0.355016,156.812078,0.000683,0.000822,89,0.000126,0,14,0.607143,0.004605
22051,Jefferson Parish,,LA,34656,484590,519246,142,243,385,130753,167761,298514,5,0.45716,0.497636,38647.375842,0.041751,0.059825,89,0.001161,0,14,0.316695,0.361421
22053,Jefferson Davis Parish,,LA,1958,32993,34951,11,10,21,5094,5599,10693,6,0.338555,0.355293,178.95431,0.001641,0.001041,89,0.000147,0,14,0.795455,0.01271
22055,Lafayette Parish,,LA,13958,210675,224633,69,68,137,49901,44975,94876,5,0.391452,0.419319,3654.206746,0.015757,0.018615,89,0.000622,0,14,0.460539,0.140205
22057,Lafourche Parish,,LA,4576,99164,103740,18,21,39,13874,13912,27786,6,0.345208,0.364525,42.313323,0.002534,0.002528,89,0.000168,0,14,0.681818,0.018522
22059,La Salle Parish,,LA,791,13654,14445,6,6,12,1301,1395,2696,6,0.279416,0.290113,12.994515,0.000128,0.000102,89,0.000148,0,14,0.5,0.001304
22061,Lincoln Parish,,LA,3289,38327,41616,19,20,39,6654,7461,14115,6,0.358987,0.379316,1620.812196,0.003295,0.004673,89,0.000238,0,14,0.565217,0.02652
22063,Livingston Parish,,LA,6657,111490,118147,32,25,57,34405,20763,55168,6,0.344812,0.364192,537.862437,0.004119,0.002264,89,0.000333,0,14,0.475379,0.03321
22065,Madison Parish,,LA,845,11944,12789,7,5,12,1093,1381,2474,6,0.279052,0.289614,63.884778,0.000559,0.000083,89,0.000168,0,14,0.428571,0.003708
22067,Morehouse Parish,,LA,1941,31769,33710,7,10,17,3107,4325,7432,6,0.342102,0.359304,873.219236,0.000978,0.001581,89,0.00015,0,14,0.527273,0.007968
22069,Natchitoches Parish,,LA,2435,37023,39458,19,19,38,5318,5851,11169,6,0.346682,0.365551,1112.942511,0.002865,0.003026,89,0.000229,0,14,0.563158,0.022777
22071,Orleans Parish,,LA,34426,435795,470221,184,362,546,119374,281255,400629,5,0.477508,0.525821,116479.670285,0.04898,0.077553,89,0.001609,0,14,0.231146,0.427268
22073,Ouachita Parish,,LA,9552,157385,166937,51,63,114,22799,24619,47418,5,0.385573,0.413377,33327.685992,0.009896,0.012973,89,0.000637,0,14,0.354865,0.08551
22075,Plaquemines Parish,,LA,3281,30326,33607,17,38,55,6634,11992,18626,5,0.36877,0.392665,212.569801,0.004612,0.00677,89,0.000165,0,14,0.523617,0.037632
22077,Pointe Coupee Parish,,LA,1228,23740,24968,11,8,19,3772,3544,7316,6,0.323567,0.337567,16.30727,0.00182,0.000655,89,0.000144,0,14,0.848485,0.013507
22079,Rapides Parish,,LA,6738,136788,143526,39,41,80,18409,17869,36278,5,0.37419,0.398535,5391.007169,0.005583,0.008133,89,0.000412,0,14,0.41284,0.046338
22081,Red River Parish,,LA,647,9276,9923,3,5,8,1006,1572,2578,6,0.28868,0.299101,0,0.000214,0.000209,89,0.000076,0,14,0.9,0.001931
22083,Richland Parish,,LA,1402,20745,22147,7,5,12,3218,3201,6419,6,0.278483,0.288726,30.319361,0.000337,0.000078,89,0.000168,0,14,0.5,0.002889
22085,Sabine Parish,,LA,1115,23343,24458,8,8,16,2119,2301,4420,6,0.339243,0.355587,2.220402,0.00132,0.001008,89,0.000117,0,14,0.875,0.010739
22087,St. Bernard Parish,,LA,3920,71091,75011,22,91,113,12887,44000,56887,5,0.38927,0.420267,968.556213,0.003586,0.017188,89,0.000211,0,14,0.342979,0.029437
22089,St. Charles Parish,,LA,3997,56255,60252,15,20,35,15499,13068,28567,6,0.346043,0.364941,18.032161,0.002761,0.003759,89,0.000146,0,14,0.745238,0.021129
22091,St. Helena Parish,,LA,1057,13183,14240,6,4,10,3113,2771,5884,6,0.323393,0.336845,0,0.001691,0.000541,89,0.000092,0,14,1,0.012711
22093,St. James Parish,,LA,1118,25113,26231,9,9,18,3910,3696,7606,6,0.341674,0.358738,0,0.001832,0.001458,89,0.000104,0,14,0.966667,0.013175
22095,St. John the Baptist Parish,,LA,3501,48943,52444,12,16,28,14488,12648,27136,6,0.348775,0.36776,28.62483,0.002587,0.00322,89,0.000129,0,14,0.816667,0.019761
22097,St. Landry Parish,,LA,4036,86742,90778,23,21,44,14438,13160,27598,6,0.342297,0.360958,48.662032,0.002458,0.001962,89,0.000241,0,14,0.6,0.019034
22099,St. Martin Parish,,LA,3325,54183,57508,13,9,22,11146,9832,20978,6,0.341558,0.358572,0.294444,0.002039,0.001281,89,0.000142,0,14,0.916667,0.015034
22101,St. Mary Parish,,LA,3551,60119,63670,15,18,33,6786,8961,15747,6,0.345406,0.363915,34.400511,0.00226,0.002554,89,0.000154,0,14,0.730994,0.016564
22103,St. Tammany Parish,,LA,13609,224610,238219,89,115,204,62925,48336,111261,5,0.415548,0.448225,4647.069176,0.026503,0.033431,89,0.000741,0,14,0.485355,0.232034
22105,Tangipahoa Parish,,LA,5719,102288,108007,28,26,54,25896,17276,43172,6,0.352128,0.372714,357.406427,0.005322,0.004001,89,0.000268,0,14,0.589655,0.043175
22107,Tensas Parish,,LA,392,5467,5859,4,4,8,331,481,812,6,0.304387,0.315829,1.198522,0.000781,0.000265,89,0.000085,0,14,0.75,0.005056
22109,Terrebonne Parish,,LA,5333,119259,124592,19,30,49,15508,15254,30762,6,0.351839,0.372908,70.335314,0.002628,0.004805,89,0.00018,0,14,0.61828,0.019423
22111,Union Parish,,LA,1410,23083,24493,7,8,15,3560,3791,7351,6,0.286888,0.298241,21.716805,0.000487,0.000206,89,0.000127,0,14,0.5,0.003447
22113,Vermilion Parish,,LA,2792,59258,62050,16,13,29,9592,8681,18273,6,0.341869,0.35946,121.990085,0.002073,0.001621,89,0.000171,0,14,0.745833,0.015439
22115,Vernon Parish,,LA,12026,47695,59721,51,62,113,13372,21613,34985,5,0.394536,0.421538,1844.979977,0.013231,0.017323,89,0.00044,0,14,0.53029,0.113794
22117,Washington Parish,,LA,1881,42645,44526,15,12,27,6608,4828,11436,6,0.344931,0.362583,182.803819,0.002868,0.0022,89,0.000166,0,14,0.691667,0.021884
22119,Webster Parish,,LA,2444,42341,44785,13,11,24,6071,6178,12249,6,0.342609,0.359654,1667.637142,0.001972,0.001468,89,0.000188,0,14,0.551282,0.016381
22121,West Baton Rouge Parish,,LA,2198,24195,26393,9,7,16,6894,6361,13255,6,0.323498,0.337345,0.111111,0.00121,0.000647,89,0.000125,0,14,0.911111,0.007802
22123,West Carroll Parish,,LA,721,12133,12854,5,5,10,1172,1616,2788,6,0.278458,0.288671,2.333333,0.00009,0.000073,89,0.000152,0,14,0.7,0.000966
22125,West Feliciana Parish,,LA,629,10977,11606,5,5,10,1823,1882,3705,6,0.323428,0.337012,16.909946,0.001069,0.000518,89,0.000096,0,14,0.7,0.006891
22127,Winn Parish,,LA,778,14491,15269,6,8,14,1231,1710,2941,6,0.286888,0.298269,12.642683,0.000149,0.000242,89,0.00013,0,14,0.607143,0.001438
23001,Androscoggin County,,ME,6866,116091,122957,25,30,55,19525,18796,38321,5,0.359933,0.38082,1091.123145,0.004779,0.007815,62,0.000229,0,14,0.614583,0.036826
23003,Aroostook County,,ME,2917,80853,83770,21,17,38,4981,5283,10264,6,0.319371,0.334526,62.582616,0.003494,0.002239,62,0.000204,0,14,0.664502,0.025299
23005,Cumberland County,,ME,20638,315407,336045,123,124,247,62636,61998,124634,5,0.413831,0.447503,17074.502487,0.039576,0.042042,62,0.000824,0,14,0.550745,0.318735
23007,Franklin County,,ME,1972,31426,33398,7,8,15,3953,4252,8205,6,0.293359,0.305154,0.125,0.000562,0.000506,62,0.000103,0,14,0.964286,0.004323
23009,Hancock County,,ME,3164,59483,62647,15,14,29,5868,5862,11730,6,0.319031,0.333666,44.511026,0.00196,0.001702,62,0.000171,0,14,0.74183,0.014798
23011,Kennebec County,,ME,6971,136641,143612,34,35,69,21387,19295,40682,5,0.364298,0.386024,2283.840671,0.007312,0.008955,62,0.000285,0,14,0.607317,0.055512
23013,Knox County,,ME,2412,45287,47699,13,13,26,4580,5251,9831,6,0.318964,0.333444,10.881376,0.001837,0.001464,62,0.000149,0,14,0.868132,0.014493
23015,Lincoln County,,ME,2445,41103,43548,14,12,26,5941,5781,11722,6,0.31893,0.333278,20.999313,0.001809,0.001444,62,0.000158,0,14,0.795238,0.013797
23017,Oxford County,,ME,3310,61536,64846,19,13,32,9828,8267,18095,6,0.318998,0.3335,31.995084,0.003305,0.001838,62,0.000166,0,14,0.742105,0.02323
23019,Penobscot County,,ME,8530,162915,171445,40,47,87,22256,21340,43596,5,0.368499,0.39221,3312.653079,0.009924,0.01311,62,0.000321,0,14,0.600765,0.077698
23021,Piscataquis County,,ME,1188,18524,19712,5,7,12,2114,2634,4748,6,0.293331,0.304988,0.071429,0.000303,0.00048,62,0.000086,0,14,0.982143,0.002214
23023,Sagadahoc County,,ME,4262,41117,45379,13,14,27,10124,9695,19819,5,0.352789,0.371011,158.780478,0.002754,0.002771,62,0.000148,0,14,0.675824,0.022847
23025,Somerset County,,ME,3192,53421,56613,21,14,35,9677,9008,18685,6,0.318558,0.33315,123.019051,0.002996,0.001057,62,0.000205,0,14,0.67381,0.021652
23027,Waldo County,,ME,2603,42028,44631,14,10,24,6512,6069,12581,6,0.293417,0.305487,0.992507,0.002027,0.00053,62,0.000151,0,14,0.846154,0.014939
23029,Washington County,,ME,1753,35998,37751,7,6,13,2019,2881,4900,6,0.293302,0.304821,0.090909,0.000827,0.000462,62,0.000098,0,14,0.97619,0.006042
23031,York County,,ME,13311,227542,240853,60,67,127,40458,38183,78641,5,0.374938,0.401714,6220.587026,0.016162,0.020513,62,0.000432,0,14,0.570526,0.126674
24001,Allegany County,,MD,3048,75444,78492,17,20,37,6012,6340,12352,6,0.328378,0.346083,1509.567558,0.002857,0.003467,104,0.00022,0,14,0.535714,0.023049
24003,Anne Arundel County,,MD,48919,586656,635575,228,249,477,154513,160654,315167,5,0.442155,0.486496,19678.829779,0.071314,0.072587,104,0.00155,0,14,0.393775,0.582612
24005,Baltimore County,,MD,64430,890577,955007,199,220,419,234951,236204,471155,5,0.444379,0.484804,18998.788464,0.064859,0.069734,104,0.001336,0,14,0.469186,0.518338
24009,Calvert County,,MD,6366,100785,107151,19,25,44,19028,13619,32647,5,0.356812,0.376698,26.742078,0.006966,0.007406,104,0.000166,0,14,0.78,0.058538
24011,Caroline County,,MD,2281,34134,36415,14,11,25,9540,7094,16634,6,0.318828,0.333172,2.843209,0.00305,0.00195,104,0.000147,0,14,0.879121,0.024637
24013,Carroll County,,MD,10867,197340,208207,25,41,66,34121,29521,63642,5,0.369678,0.392904,168.631356,0.00669,0.01244,104,0.000213,0,14,0.671776,0.055024
24015,Cecil County,,MD,6220,106280,112500,26,21,47,21951,16142,38093,5,0.358131,0.377708,60.692348,0.007046,0.006394,76,0.000195,0,14,0.822751,0.053822
24017,Charles County,,MD,13340,157498,170838,48,63,111,45563,37551,83114,5,0.387463,0.415058,480.816679,0.017487,0.0226,104,0.000353,0,14,0.661754,0.14439
24019,Dorchester County,,MD,1832,34723,36555,11,11,22,5948,4820,10768,6,0.318828,0.333172,0.194763,0.002418,0.001985,104,0.000126,0,14,0.962121,0.019748
24021,Frederick County,,MD,19878,256608,276486,89,90,179,61957,55200,117157,5,0.402897,0.433356,3540.122201,0.032866,0.032676,104,0.000635,0,14,0.628637,0.271426
24023,Garrett County,,MD,1514,33401,34915,12,9,21,2368,2301,4669,6,0.31001,0.323585,3762.120716,0.002447,0.000678,104,0.000162,0,14,0.474359,0.019338
24025,Harford County,,MD,17283,281978,299261,79,91,170,57445,51047,108492,5,0.398461,0.428862,822.549078,0.028026,0.033105,104,0.000523,0,14,0.638095,0.225815
24027,Howard County,,MD,30298,301176,331474,128,133,261,95201,94659,189860,5,0.415721,0.450333,3936.083858,0.047917,0.047687,104,0.000832,0,14,0.608044,0.384541
24029,Kent County,,MD,1220,21238,22458,10,8,18,2701,2130,4831,6,0.313865,0.327624,0.826231,0.002334,0.00137,104,0.000118,0,14,0.9,0.01844
24031,Montgomery County,,MD,84088,1047437,1131525,294,305,599,247059,293387,540446,5,0.466315,0.511296,41845.770961,0.083793,0.084049,104,0.00199,0,14,0.318742,0.672427
24033,Prince George's County,,MD,80563,925842,1006405,226,264,490,244268,297851,542119,5,0.454945,0.498297,34578.830126,0.069093,0.074328,104,0.00159,0,14,0.365473,0.559248
24035,Queen Anne's County,,MD,3811,49817,53628,17,18,35,11746,9031,20777,6,0.328629,0.345173,22.867829,0.003716,0.00373,104,0.000167,0,14,0.777778,0.030055
24037,St. Mary's County,,MD,8353,109040,117393,42,46,88,24096,17295,41391,5,0.379676,0.404766,119.930906,0.012828,0.016784,104,0.00031,0,14,0.65487,0.106816
24039,Somerset County,,MD,1538,21226,22764,9,9,18,3970,3978,7948,6,0.322318,0.336723,3.738942,0.002288,0.00228,76,0.000111,0,14,0.875,0.018463
24041,Talbot County,,MD,2656,40499,43155,17,17,34,7763,6518,14281,6,0.333259,0.350976,34.72585,0.003995,0.004352,104,0.00017,0,14,0.795322,0.032784
24043,Washington County,,MD,8942,156692,165634,33,39,72,32247,24673,56920,5,0.369087,0.392155,4169.398754,0.008229,0.011095,104,0.000313,0,14,0.625264,0.069553
24045,Wicomico County,,MD,5980,96126,102106,31,30,61,18648,15505,34153,6,0.359201,0.380237,218.652942,0.007097,0.007271,76,0.000252,0,14,0.621429,0.055979
24047,Worcester County,,MD,4781,57319,62100,31,23,54,12632,11194,23826,6,0.35458,0.374595,199.944407,0.00758,0.006905,76,0.000243,0,14,0.656303,0.059903
24510,Baltimore city,,MD,48670,577649,626319,169,157,326,156460,181720,338180,5,0.431857,0.467421,7207.128412,0.057281,0.054148,104,0.001109,0,14,0.575029,0.45638
25001,Barnstable County,,MA,14693,266947,281640,74,93,167,35602,38755,74357,5,0.391146,0.421843,1323.189635,0.025353,0.030699,62,0.000434,0,14,0.617216,0.196122
25003,Berkshire County,,MA,5873,150411,156284,37,53,90,10338,12130,22468,5,0.376866,0.401909,235.631046,0.012275,0.019141,62,0.000224,0,14,0.792498,0.089406
25005,Bristol County,,MA,28392,617686,646078,69,116,185,80144,88780,168924,5,0.400587,0.434021,1296.008319,0.024744,0.03985,62,0.000427,0,14,0.625338,0.197151
25007,Dukes County,,MA,1086,18794,19880,6,8,14,958,1322,2280,6,0.321627,0.336191,0,0.001885,0.002565,62,0.000076,0,14,1,0.013576
25009,Essex County,,MA,45785,825739,871524,142,178,320,129570,145230,274800,5,0.420905,0.459876,6912.148802,0.050171,0.057646,62,0.00086,0,14,0.538875,0.401347
25011,Franklin County,,MA,4852,81975,86827,14,20,34,12545,11988,24533,5,0.357449,0.376742,9.128899,0.003583,0.006192,62,0.000112,0,14,0.921429,0.024842
25013,Hampden County,,MA,19431,512335,531766,77,116,193,48512,60726,109238,5,0.402196,0.435658,619.908691,0.027924,0.04065,62,0.000446,0,14,0.676602,0.216076
25015,Hampshire County,,MA,12312,159965,172277,44,62,106,32599,35467,68066,5,0.387713,0.414741,181.142455,0.016144,0.02331,62,0.000272,0,14,0.806796,0.124453
25017,Middlesex County,,MA,120739,1645180,1765919,311,313,624,356481,410219,766700,5,0.465232,0.511329,72010.924407,0.085415,0.084648,62,0.002106,0,14,0.323497,0.68726
25019,Nantucket County,,MA,1067,11317,12384,3,6,9,432,978,1410,6,0.323045,0.337511,0,0.000932,0.002058,62,0.000063,0,14,1,0.007095
25021,Norfolk County,,MA,58376,739029,797405,164,180,344,188124,197251,385375,5,0.425677,0.464536,7596.713,0.056975,0.059121,62,0.000991,0,14,0.541369,0.448455
25023,Plymouth County,,MA,30394,561372,591766,72,109,181,92911,96011,188922,5,0.39746,0.430027,1516.337718,0.025484,0.037147,62,0.000443,0,14,0.609766,0.202163
25025,Suffolk County,,MA,85483,654347,739830,230,217,447,236749,296045,532794,5,0.444116,0.484315,19038.378404,0.070201,0.068325,62,0.00145,0,14,0.439727,0.553976
25027,Worcester County,,MA,40094,895178,935272,153,204,357,118284,129056,247340,5,0.429388,0.47024,7407.243754,0.05336,0.064101,62,0.000915,0,14,0.487561,0.424142
26001,Alcona County,,MI,712,12438,13150,6,4,10,1975,1138,3113,6,0.324511,0.338804,0.166667,0.001559,0.000814,72,0.000081,0,14,0.966667,0.009494
26003,Alger County,,MI,566,10039,10605,2,2,4,597,604,1201,6,0.26879,0.27687,0,0.00004,0.000036,105,0.000076,0,14,1,0.000416
26005,Allegan County,,MI,8176,129860,138036,22,18,40,24335,23319,47654,5,0.361666,0.381269,258.71524,0.005199,0.003344,72,0.000178,0,14,0.712121,0.037656
26007,Alpena County,,MI,1673,35613,37286,9,16,25,2267,2807,5074,6,0.326628,0.342688,22.447035,0.001888,0.001916,72,0.000127,0,14,0.654167,0.011561
26009,Antrim County,,MI,1904,26961,28865,12,8,20,4366,3719,8085,6,0.321249,0.335403,1.682909,0.00229,0.000863,72,0.00013,0,14,0.848485,0.013798
26011,Arenac County,,MI,1125,18898,20023,8,10,18,2913,2708,5621,6,0.325108,0.340219,0.225,0.001689,0.001212,72,0.000094,0,14,0.944444,0.010027
26013,Baraga County,,MI,429,8926,9355,2,2,4,481,640,1121,6,0.268838,0.276981,0,0.000048,0.000041,105,0.000077,0,14,1,0.000446
26015,Barry County,,MI,3776,69633,73409,13,13,26,12126,10919,23045,5,0.353911,0.372198,14.973578,0.002073,0.002156,72,0.000121,0,14,0.804762,0.012822
26017,Bay County,,MI,5094,132936,138030,22,28,50,12729,12662,25391,5,0.369496,0.390968,564.398839,0.003658,0.006534,72,0.00018,0,14,0.629032,0.024093
26019,Benzie County,,MI,1443,20170,21613,9,6,15,3539,3145,6684,6,0.321009,0.334876,1.011091,0.001935,0.00069,72,0.000112,0,14,0.847222,0.011869
26021,Berrien County,,MI,9247,177808,187055,40,49,89,19134,21523,40657,5,0.393554,0.41943,1113.323206,0.011703,0.016478,28,0.000299,0,14,0.660269,0.088782
26023,Branch County,,MI,3056,49731,52787,11,13,24,5989,7193,13182,6,0.346043,0.363832,99.0296,0.001835,0.002146,72,0.000117,0,14,0.692308,0.011259
26025,Calhoun County,,MI,8196,154738,162934,28,38,66,16784,19490,36274,5,0.376724,0.400372,398.348386,0.006637,0.008996,72,0.000204,0,14,0.619872,0.047319
26027,Cass County,,MI,3732,57172,60904,8,9,17,11032,10424,21456,6,0.344022,0.360752,0.197876,0.001566,0.001407,28,0.000094,0,14,0.944444,0.010873
26029,Charlevoix County,,MI,1945,31182,33127,11,9,20,3973,3869,7842,6,0.325284,0.340246,1.934312,0.002193,0.001257,72,0.000128,0,14,0.936364,0.01341
26031,Cheboygan County,,MI,1764,31079,32843,13,12,25,3607,3297,6904,6,0.325778,0.341162,17.553853,0.002266,0.001572,72,0.000142,0,14,0.714286,0.013614
26033,Chippewa County,,MI,2020,38417,40437,11,18,29,2244,2549,4793,5,0.354496,0.373502,2083.141798,0.002174,0.002491,72,0.000136,0,14,0.637255,0.013217
26035,Clare County,,MI,2244,32335,34579,20,18,38,5534,4698,10232,6,0.325919,0.342049,13.627276,0.002858,0.001707,72,0.00017,0,14,0.716667,0.017352
26037,Clinton County,,MI,5781,82679,88460,21,24,45,18452,17331,35783,5,0.360798,0.380937,146.178358,0.00384,0.003517,72,0.000157,0,14,0.746667,0.024091
26039,Crawford County,,MI,901,14904,15805,7,5,12,1680,1079,2759,6,0.321009,0.334765,0.325,0.001564,0.000681,72,0.000095,0,14,0.916667,0.009678
26041,Delta County,,MI,1706,45247,46953,9,12,21,2045,2619,4664,6,0.345645,0.363332,4120.159286,0.001246,0.001852,105,0.000181,0,14,0.435897,0.010021
26043,Dickinson County,,MI,1506,32395,33901,8,9,17,2304,2555,4859,6,0.282543,0.293781,34.894221,0.000149,0.000153,105,0.000163,0,14,0.513889,0.001489
26045,Eaton County,,MI,10192,125425,135617,31,34,65,30895,29906,60801,5,0.369678,0.392061,468.427802,0.004845,0.007456,72,0.000221,0,14,0.600285,0.032866
26047,Emmet County,,MI,2350,37869,40219,17,16,33,5594,5047,10641,6,0.346163,0.364109,117.497683,0.002707,0.002464,72,0.000173,0,14,0.690476,0.016642
26049,Genesee County,,MI,20733,502389,523122,74,134,208,51684,64843,116527,5,0.424414,0.458017,12736.09299,0.017919,0.035422,72,0.000549,0,14,0.371458,0.147666
26051,Gladwin County,,MI,1751,28926,30677,11,11,22,4321,3835,8156,6,0.325672,0.340884,1.686728,0.001754,0.001438,72,0.000114,0,14,0.878788,0.010662
26053,Gogebic County,,MI,865,16959,17824,5,3,8,772,716,1488,6,0.268838,0.277092,6062.588582,0.00004,0.000029,105,0.000229,0,14,0.15,0.000662
26055,Grand Traverse County,,MI,6124,97710,103834,44,38,82,18364,14581,32945,5,0.371002,0.39388,2343.599836,0.006638,0.006944,72,0.000391,0,14,0.411791,0.049565
26057,Gratiot County,,MI,2355,44377,46732,14,14,28,6009,6156,12165,6,0.321559,0.336512,2.786393,0.001864,0.001066,72,0.000128,0,14,0.829167,0.011827
26059,Hillsdale County,,MI,3033,53207,56240,14,16,30,7328,7531,14859,6,0.327626,0.344202,73.045961,0.002356,0.001995,72,0.000133,0,14,0.665441,0.014218
26061,Houghton County,,MI,2057,35531,37588,11,14,25,2131,2347,4478,5,0.364829,0.384404,12899.289253,0.002159,0.003159,105,0.000233,0,14,0.456044,0.015323
26063,Huron County,,MI,1735,43460,45195,11,12,23,3489,3818,7307,6,0.325707,0.341051,0.700722,0.001823,0.0016,72,0.0001,0,14,0.901099,0.01079
26065,Ingham County,,MI,25319,285035,310354,105,140,245,61070,77564,138634,5,0.430372,0.46412,16486.235763,0.026648,0.042246,72,0.000772,0,14,0.438499,0.21689
26067,Ionia County,,MI,4149,68300,72449,14,18,32,11194,11832,23026,5,0.35412,0.37303,34.38091,0.002045,0.002325,72,0.00013,0,14,0.79085,0.012732
26069,Iosco County,,MI,1794,29408,31202,13,11,24,4803,3375,8178,6,0.325955,0.34119,6.385807,0.002146,0.001666,72,0.000128,0,14,0.730769,0.012959
26071,Iron County,,MI,624,13623,14247,4,4,8,524,648,1172,6,0.279676,0.289947,22.567253,0.00011,0.000082,105,0.000104,0,14,0.6,0.00099
26073,Isabella County,,MI,4714,58933,63647,33,31,64,12151,12032,24183,5,0.362277,0.383489,327.428633,0.0035,0.004352,72,0.00025,0,14,0.52834,0.021279
26075,Jackson County,,MI,7643,177909,185552,25,34,59,19529,19347,38876,5,0.38287,0.406625,338.529553,0.00547,0.009503,72,0.000181,0,14,0.688438,0.037689
26077,Kalamazoo County,,MI,16886,261483,278369,68,106,174,44771,48064,92835,5,0.421732,0.452413,5191.558851,0.015642,0.034584,72,0.000484,0,14,0.509703,0.12215
26079,Kalkaska County,,MI,1370,18592,19962,7,8,15,2749,2654,5403,6,0.325249,0.34008,2.569095,0.00191,0.001094,72,0.000092,0,14,0.822222,0.011565
26081,Kent County,,MI,34352,679387,713739,143,190,333,95085,110645,205730,5,0.441246,0.478867,39265.971508,0.036012,0.055312,72,0.001099,0,14,0.393308,0.29591
26083,Keweenaw County,,MI,172,2239,2411,1,1,2,317,314,631,6,0.267331,0.274689,0,0.000019,0.000013,105,0.000063,0,14,0,0.000159
26085,Lake County,,MI,899,10648,11547,10,8,18,2312,1901,4213,6,0.306406,0.318614,2.931025,0.001039,0.000323,72,0.000133,0,14,0.755556,0.006944
26087,Lapeer County,,MI,5919,107286,113205,12,20,32,17457,16372,33829,5,0.362802,0.382878,79.15866,0.003047,0.004505,72,0.000103,0,14,0.794737,0.019502
26089,Leelanau County,,MI,1661,25491,27152,8,8,16,3101,3310,6411,6,0.345089,0.361945,28.28874,0.002299,0.00211,72,0.0001,0,14,0.888889,0.01415
26091,Lenawee County,,MI,5468,116833,122301,18,23,41,12932,12720,25652,5,0.366297,0.387372,309.988598,0.003944,0.005291,72,0.000146,0,14,0.70751,0.025136
26093,Livingston County,,MI,11681,208728,220409,32,56,88,40956,31436,72392,5,0.391503,0.41822,755.93741,0.007642,0.016663,72,0.000229,0,14,0.560491,0.056277
26095,Luce County,,MI,393,6579,6972,2,3,5,137,366,503,6,0.271831,0.280398,1.756826,0.000022,0.000055,72,0.000066,0,14,0.666667,0.000304
26097,Mackinac County,,MI,947,13685,14632,7,8,15,1034,1305,2339,6,0.328198,0.344613,3777.415641,0.0023,0.00122,72,0.000098,0,14,0.477273,0.016445
26099,Macomb County,,MI,44390,999018,1043408,113,197,310,154039,153457,307496,5,0.439246,0.478007,20917.126523,0.034273,0.05595,72,0.000804,0,14,0.407264,0.282407
26101,Manistee County,,MI,1650,27905,29555,12,11,23,2990,2838,5828,6,0.32546,0.34069,23.566364,0.002,0.001286,72,0.000146,0,14,0.772727,0.012464
26103,Marquette County,,MI,3481,71078,74559,29,28,57,5879,5771,11650,5,0.367462,0.389065,28452.554568,0.004871,0.004994,105,0.000451,0,14,0.35873,0.035146
26105,Mason County,,MI,1796,33196,34992,13,10,23,3319,2890,6209,6,0.321455,0.335902,61.701692,0.002621,0.00103,72,0.000148,0,14,0.75,0.017799
26107,Mecosta County,,MI,3230,40178,43408,19,23,42,8094,8181,16275,6,0.346083,0.364802,145.549003,0.002725,0.00277,72,0.000171,0,14,0.679348,0.016187
26109,Menominee County,,MI,1530,28183,29713,6,7,13,2974,3313,6287,6,0.28241,0.293281,40.749862,0.000505,0.000142,105,0.000116,0,14,0.732143,0.00395
26111,Midland County,,MI,5742,99957,105699,25,26,51,11879,12114,23993,5,0.37059,0.392615,850.262045,0.00453,0.005506,72,0.000206,0,14,0.558065,0.031502
26113,Missaukee County,,MI,1077,16175,17252,8,5,13,2224,2252,4476,6,0.306562,0.31842,0.853128,0.001721,0.00029,72,0.000106,0,14,0.857143,0.010928
26115,Monroe County,,MI,8981,182081,191062,20,27,47,27600,23873,51473,5,0.375688,0.39772,186.340101,0.005624,0.008494,72,0.000152,0,14,0.73908,0.039429
26117,Montcalm County,,MI,4473,69350,73823,14,17,31,13186,12333,25519,6,0.322007,0.337372,8.562689,0.001871,0.001191,72,0.000139,0,14,0.719298,0.012123
26119,Montmorency County,,MI,710,11177,11887,6,5,11,1391,1014,2405,6,0.324932,0.339386,0,0.001559,0.000922,72,0.000084,0,14,1,0.009517
26121,Muskegon County,,MI,7126,189882,197008,28,31,59,19619,19117,38736,5,0.370818,0.392798,1177.584179,0.005759,0.007253,72,0.000237,0,14,0.601604,0.041697
26123,Newaygo County,,MI,3486,54242,57728,13,13,26,9123,8859,17982,6,0.323916,0.338915,25.577486,0.001512,0.001054,72,0.000148,0,14,0.642857,0.009447
26125,Oakland County,,MI,85374,1405914,1491288,249,343,592,260703,304348,565051,5,0.470846,0.518914,92424.096783,0.06773,0.084155,72,0.001829,0,14,0.284027,0.556052
26127,Oceana County,,MI,1944,29713,31657,7,6,13,4127,4682,8809,6,0.312656,0.325527,10.875409,0.001178,0.000561,72,0.000101,0,14,0.785714,0.008356
26129,Ogemaw County,,MI,1463,23730,25193,11,11,22,3394,2788,6182,6,0.325143,0.340385,1324.622425,0.001708,0.001226,72,0.000136,0,14,0.765152,0.010433
26131,Ontonagon County,,MI,480,8107,8587,2,3,5,234,510,744,6,0.268887,0.277203,4.142857,0.000019,0.000042,105,0.000128,0,14,0.666667,0.000231
26133,Osceola County,,MI,1910,26045,27955,12,11,23,4233,4283,8516,6,0.323812,0.338526,27.174089,0.001647,0.000778,72,0.00015,0,14,0.686813,0.010805
26135,Oscoda County,,MI,637,9484,10121,4,2,6,650,117,767,7,0.24633,0.253169,0,0.001538,0.000025,72,0.000065,0,14,0.933333,0.009212
26137,Otsego County,,MI,1899,28447,30346,18,15,33,4041,3428,7469,6,0.326451,0.342299,1714.313265,0.002578,0.001634,72,0.000215,0,14,0.523392,0.01637
26139,Ottawa County,,MI,16792,290849,307641,54,66,120,51296,49594,100890,5,0.398938,0.426653,4273.686004,0.012085,0.019663,72,0.000417,0,14,0.4689,0.094423
26141,Presque Isle County,,MI,759,16537,17296,6,5,11,1357,1168,2525,6,0.320427,0.334154,0.337302,0.001559,0.000642,72,0.000081,0,14,0.880952,0.009497
26143,Roscommon County,,MI,1820,27454,29274,17,17,34,4513,3544,8057,6,0.325919,0.341939,39.412154,0.002515,0.001714,72,0.000163,0,14,0.663158,0.015028
26145,Saginaw County,,MI,10035,238403,248438,35,64,99,20820,28826,49646,5,0.397775,0.425311,2508.173959,0.005524,0.016123,72,0.000263,0,14,0.446178,0.039104
26147,St. Clair County,,MI,9347,199614,208961,20,40,60,23964,23954,47918,5,0.371644,0.395095,462.361651,0.005909,0.011495,72,0.000156,0,14,0.616463,0.043136
26149,St. Joseph County,,MI,3597,71345,74942,13,18,31,8280,9071,17351,6,0.346442,0.364886,1330.380614,0.002154,0.002443,72,0.000132,0,14,0.611111,0.014973
26151,Sanilac County,,MI,2775,51943,54718,9,12,21,7247,7154,14401,6,0.325707,0.341051,0.111111,0.001752,0.001597,72,0.000089,0,14,0.94697,0.010311
26153,Schoolcraft County,,MI,433,9447,9880,2,2,4,180,386,566,6,0.26879,0.27687,2.787337,0.000018,0.000036,105,0.000072,0,14,0.333333,0.000286
26155,Shiawassee County,,MI,4978,86238,91216,15,21,36,11562,12442,24004,5,0.361841,0.381824,72.745445,0.002773,0.004043,72,0.000124,0,14,0.779221,0.016445
26157,Tuscola County,,MI,3445,69454,72899,12,16,28,8872,9148,18020,5,0.353995,0.372642,21.530038,0.002143,0.002608,72,0.000106,0,14,0.870833,0.012596
26159,Van Buren County,,MI,5478,85104,90582,16,18,34,15140,15555,30695,5,0.361841,0.381491,50.870718,0.003495,0.003524,72,0.000145,0,14,0.75731,0.025223
26161,Washtenaw County,,MI,29652,347085,376737,142,186,328,84353,97619,181972,5,0.442872,0.479588,11000.371918,0.046259,0.059308,72,0.000951,0,14,0.500259,0.368041
26163,Wayne County,,MI,95423,2063138,2158561,243,370,613,208216,361138,569354,5,0.476372,0.525849,93517.191395,0.066309,0.085454,72,0.001747,0,14,0.257373,0.546001
26165,Wexford County,,MI,2416,35946,38362,18,14,32,6679,5220,11899,6,0.325884,0.341495,55.884487,0.002444,0.001643,72,0.000194,0,14,0.627451,0.015077
27001,Aitkin County,,MN,908,14677,15585,12,9,21,2342,1836,4178,5,0.324581,0.338066,2.722926,0.001216,0.000808,18,0.000178,0,14,0.810606,0.010319
27003,Anoka County,,MN,26889,368821,395710,62,79,141,91220,88661,179881,5,0.396254,0.425017,8538.088437,0.009078,0.016193,18,0.000717,0,14,0.324149,0.081139
27005,Becker County,,MN,2096,36520,38616,11,13,24,4602,4754,9356,5,0.354789,0.373058,2226.380127,0.000868,0.001481,18,0.000205,0,14,0.685714,0.007493
27007,Beltrami County,,MN,2614,42063,44677,22,23,45,6157,6109,12266,5,0.355503,0.375083,5339.90196,0.001989,0.001913,18,0.000364,0,14,0.528986,0.017918
27009,Benton County,,MN,4431,40632,45063,17,15,32,14258,14251,28509,5,0.354915,0.373419,77.780123,0.001218,0.001781,18,0.000236,0,14,0.74269,0.01066
27011,Big Stone County,,MN,312,6215,6527,1,1,2,77,68,145,7,0.222964,0.227658,0,0.000001,0.000001,18,0.000096,0,14,0,0.000074
27013,Blue Earth County,,MN,5263,60418,65681,34,30,64,15373,15256,30629,5,0.365184,0.386512,1405.187212,0.00228,0.003273,18,0.000415,0,14,0.382883,0.021292
27015,Brown County,,MN,1537,32270,33807,9,12,21,2219,2880,5099,5,0.328917,0.343409,36.211514,0.000946,0.001148,18,0.000143,0,14,0.606061,0.008611
27017,Carlton County,,MN,1983,37212,39195,10,11,21,5275,4517,9792,5,0.324616,0.338343,4.004243,0.001123,0.001017,18,0.000153,0,14,0.712121,0.009237
27019,Carver County,,MN,6858,94360,101218,25,22,47,25375,19339,44714,5,0.366878,0.387084,471.861448,0.003927,0.003559,18,0.000299,0,14,0.623077,0.035117
27021,Cass County,,MN,2221,31881,34102,16,16,32,6553,5812,12365,5,0.354999,0.373641,47.374895,0.001338,0.001774,18,0.000234,0,14,0.783626,0.011658
27023,Chippewa County,,MN,772,15222,15994,7,9,16,1503,1630,3133,5,0.324687,0.338232,1529.508988,0.000487,0.000728,18,0.000137,0,14,0.588889,0.00441
27025,Chisago County,,MN,4236,59893,64129,15,18,33,14789,12594,27383,5,0.353953,0.37267,103.121701,0.001278,0.001842,18,0.000206,0,14,0.609524,0.011028
27027,Clay County,,MN,4008,55497,59505,23,22,45,13203,11219,24422,5,0.358131,0.37804,2794.706773,0.00199,0.002116,18,0.000399,0,14,0.445,0.017924
27029,Clearwater County,,MN,593,9147,9740,2,2,4,782,839,1621,6,0.262404,0.270007,0,0.000016,0.000016,18,0.00008,0,14,1,0.000305
27031,Cook County,,MN,425,5971,6396,2,2,4,307,289,596,5,0.324196,0.336707,0,0.000501,0.000472,18,0.000069,0,14,1,0.004207
27033,Cottonwood County,,MN,885,14665,15550,4,8,12,614,984,1598,5,0.325955,0.339897,67.390773,0.000011,0.000544,18,0.00011,0,14,0.553571,0.000344
27035,Crow Wing County,,MN,3954,68043,71997,30,26,56,12720,9927,22647,5,0.355461,0.375361,341.726959,0.002224,0.002039,18,0.000402,0,14,0.55914,0.020708
27037,Dakota County,,MN,35213,451173,486386,139,149,288,117634,114584,232218,5,0.437454,0.470439,48413.704889,0.031465,0.037172,18,0.001374,0,14,0.328403,0.266792
27039,Dodge County,,MN,1403,22458,23861,8,9,17,3588,3681,7269,5,0.324827,0.338399,2.615115,0.000791,0.000962,18,0.000126,0,14,0.8,0.006828
27041,Douglas County,,MN,2110,41496,43606,21,20,41,5978,5235,11213,5,0.355125,0.374251,253.128019,0.001364,0.001893,18,0.000321,0,14,0.539526,0.012174
27043,Faribault County,,MN,1118,18695,19813,6,7,13,1371,1842,3213,5,0.324546,0.337816,5.682418,0.000494,0.000716,18,0.000117,0,14,0.696429,0.004412
27045,Fillmore County,,MN,1370,25584,26954,9,9,18,3055,3351,6406,5,0.32546,0.339397,1064.081166,0.00057,0.000796,18,0.000155,0,14,0.518182,0.005224
27047,Freeborn County,,MN,1750,37695,39445,11,12,23,3097,3695,6792,5,0.325073,0.339092,1726.025129,0.000809,0.000973,18,0.000178,0,14,0.590909,0.007143
27049,Goodhue County,,MN,3230,54012,57242,13,18,31,7627,7805,15432,5,0.35412,0.372892,47.227367,0.001323,0.001935,18,0.000174,0,14,0.702614,0.01112
27051,Grant County,,MN,482,7447,7929,3,3,6,623,823,1446,5,0.324301,0.336984,0,0.000473,0.000455,18,0.000085,0,14,1,0.004104
27053,Hennepin County,,MN,96896,1253417,1350313,363,352,715,295893,340593,636486,4,0.479566,0.525799,381261.047001,0.07392,0.076607,18,0.003548,0,14,0.203666,0.616916
27055,Houston County,,MN,1086,24346,25432,6,7,13,2334,2777,5111,5,0.327912,0.341595,156.268151,0.000577,0.000868,105,0.000117,0,14,0.690476,0.0052
27057,Hubbard County,,MN,1405,21617,23022,14,13,27,3073,2916,5989,5,0.325672,0.340036,6.069393,0.00124,0.001069,18,0.000222,0,14,0.828571,0.010623
27059,Isanti County,,MN,3023,39878,42901,13,15,28,11944,8881,20825,5,0.324757,0.339009,3.018301,0.001257,0.001141,18,0.000184,0,14,0.814286,0.010722
27061,Itasca County,,MN,2119,50385,52504,16,13,29,4786,4482,9268,5,0.354873,0.373141,57.190832,0.001319,0.001763,18,0.000224,0,14,0.767974,0.011447
27063,Jackson County,,MN,672,12838,13510,4,6,10,762,963,1725,5,0.32599,0.33973,27.068341,0.00002,0.000527,18,0.000099,0,14,0.5,0.000365
27065,Kanabec County,,MN,1191,18056,19247,10,10,20,3694,3184,6878,5,0.324581,0.338177,0.96912,0.001105,0.000802,18,0.000152,0,14,0.881818,0.009235
27067,Kandiyohi County,,MN,2620,48860,51480,19,22,41,4644,6034,10678,5,0.357704,0.377552,327.909388,0.001358,0.002102,18,0.000254,0,14,0.492754,0.012195
27069,Kittson County,,MN,253,5826,6079,0,1,1,0,131,131,6,0.280579,0.289268,0,0,0.000036,18,0.000049,0,52,0,0
27071,Koochiching County,,MN,701,15412,16113,3,5,8,493,853,1346,5,0.324406,0.337372,0.333333,0.000513,0.000495,18,0.000083,0,14,0.85,0.004396
27073,Lac qui Parle County,,MN,476,9239,9715,2,3,5,244,359,603,5,0.324266,0.336929,0,0.000007,0.000441,18,0.000076,0,14,1,0.000187
27075,Lake County,,MN,631,12569,13200,2,3,5,1048,1218,2266,5,0.324336,0.337012,0,0.000501,0.000708,18,0.000069,0,14,1,0.004207
27077,Lake of the Woods County,,MN,268,5105,5373,1,1,2,187,241,428,6,0.246008,0.251742,0,0.000003,0.000004,18,0.000067,0,14,0,0.000103
27079,Le Sueur County,,MN,2146,30015,32161,11,11,22,6230,5358,11588,5,0.324651,0.338399,2.743818,0.001056,0.001017,18,0.000157,0,14,0.833333,0.0091
27081,Lincoln County,,MN,358,6851,7209,3,3,6,473,555,1028,6,0.263786,0.271838,1.119048,0.000014,0.000011,18,0.000115,0,14,0.666667,0.000339
27083,Lyon County,,MN,1915,28984,30899,16,15,31,2884,3500,6384,5,0.326238,0.341117,4803.754536,0.001121,0.00101,18,0.000271,0,14,0.375817,0.009895
27085,McLeod County,,MN,2688,44111,46799,15,17,32,6996,6654,13650,5,0.326699,0.34155,17.324947,0.001324,0.001228,18,0.000195,0,14,0.637255,0.011308
27087,Mahnomen County,,MN,343,4928,5271,2,4,6,487,679,1166,6,0.281326,0.29135,0.580952,0.000014,0.000064,18,0.00008,0,14,0.833333,0.000233
27089,Marshall County,,MN,619,12097,12716,4,6,10,1118,1322,2440,5,0.326061,0.339525,0,0.000074,0.000525,18,0.000116,0,14,1,0.000734
27091,Martin County,,MN,1291,26266,27557,7,11,18,1334,2135,3469,5,0.326167,0.340535,3766.706669,0.0007,0.001031,18,0.000143,0,14,0.509091,0.005989
27093,Meeker County,,MN,1695,27016,28711,6,9,15,3820,3873,7693,5,0.324546,0.33801,0.1,0.000788,0.000937,18,0.000109,0,14,0.944444,0.006762
27095,Mille Lacs County,,MN,1854,27996,29850,15,14,29,6796,5275,12071,5,0.324722,0.338843,5.269528,0.001236,0.000874,18,0.000212,0,14,0.783088,0.01077
27097,Morrison County,,MN,2031,38857,40888,14,15,29,5585,5344,10929,5,0.325672,0.340257,5.197487,0.001192,0.001092,18,0.000207,0,14,0.847619,0.010239
27099,Mower County,,MN,2592,44454,47046,11,16,27,3816,5294,9110,5,0.354705,0.373419,2670.794581,0.001064,0.001696,18,0.000172,0,14,0.475,0.009156
27101,Murray County,,MN,493,10894,11387,4,5,9,604,833,1437,6,0.287162,0.297714,7.460294,0.000014,0.000092,18,0.000111,0,14,0.7,0.000381
27103,Nicollet County,,MN,3575,33987,37562,16,19,35,9200,9784,18984,5,0.325003,0.339841,34.567444,0.001124,0.001224,18,0.000222,0,14,0.540476,0.009987
27105,Nobles County,,MN,1292,24633,25925,7,12,19,1462,2217,3679,5,0.326132,0.340618,5605.391439,0.000561,0.000735,18,0.000154,0,14,0.314103,0.005071
27107,Norman County,,MN,502,8425,8927,3,4,7,630,1139,1769,6,0.281326,0.29135,0.266667,0.000074,0.000064,18,0.000101,0,14,0.833333,0.000835
27109,Olmsted County,,MN,9418,163497,172915,57,50,107,23190,22614,45804,5,0.391962,0.417099,7214.525974,0.011197,0.011458,18,0.000624,0,14,0.384382,0.09656
27111,Otter Tail County,,MN,3419,65516,68935,20,20,40,7535,7750,15285,5,0.355209,0.374362,1287.118723,0.001947,0.001804,18,0.000323,0,14,0.599567,0.017462
27113,Pennington County,,MN,965,15571,16536,9,9,18,1901,2323,4224,5,0.326167,0.340024,2771.160052,0.000606,0.000546,18,0.000206,0,14,0.708333,0.005443
27115,Pine County,,MN,1883,28456,30339,12,12,24,5771,4921,10692,5,0.324651,0.33851,4.093651,0.001203,0.001097,18,0.000173,0,14,0.782051,0.01017
27117,Pipestone County,,MN,726,11405,12131,6,6,12,875,973,1848,6,0.287134,0.29777,336.977119,0.000104,0.000093,18,0.000168,0,14,0.5,0.001289
27119,Polk County,,MN,2101,35125,37226,14,15,29,4647,4907,9554,5,0.326486,0.341162,6539.298416,0.00075,0.000846,18,0.0003,0,14,0.466667,0.006659
27121,Pope County,,MN,754,13328,14082,5,6,11,1363,1455,2818,5,0.324441,0.337511,1.383333,0.000503,0.000713,18,0.000118,0,14,0.8,0.004474
27123,Ramsey County,,MN,54433,532208,586641,172,171,343,152354,182465,334819,5,0.443657,0.478124,66446.675476,0.039886,0.04476,18,0.001654,0,14,0.318925,0.340913
27125,Red Lake County,,MN,365,4926,5291,2,2,4,480,528,1008,6,0.246169,0.252203,0,0.000008,0.000008,18,0.000086,0,14,1,0.000219
27127,Redwood County,,MN,1098,19386,20484,7,9,16,1498,1900,3398,5,0.324651,0.338177,4.149708,0.00075,0.000922,18,0.000122,0,14,0.755556,0.006466
27129,Renville County,,MN,1147,20473,21620,7,15,22,1741,2768,4509,5,0.329133,0.344075,53.517017,0.000672,0.001182,18,0.000119,0,14,0.580952,0.006362
27131,Rice County,,MN,4338,64230,68568,19,22,41,11263,10419,21682,5,0.361841,0.381741,334.392746,0.00204,0.002581,18,0.000237,0,14,0.649351,0.01823
27133,Rock County,,MN,567,11052,11619,3,4,7,828,1023,1851,6,0.286942,0.297187,2.12549,0.000098,0.000086,18,0.000103,0,14,0.583333,0.001021
27135,Roseau County,,MN,859,20117,20976,9,11,20,1124,1734,2858,5,0.326238,0.340357,6205.5517,0.000596,0.00059,18,0.000227,0,14,0.545455,0.005343
27137,St. Louis County,,MN,10144,216397,226541,57,53,110,24525,25901,50426,5,0.378958,0.403967,5039.015412,0.00623,0.008448,18,0.000712,0,14,0.302331,0.056444
27139,Scott County,,MN,10063,132412,142475,29,34,63,41481,29968,71449,5,0.375923,0.398485,1191.441707,0.005012,0.006291,18,0.00035,0,14,0.515873,0.045049
27141,Sherburne County,,MN,7784,88956,96740,27,26,53,31138,23432,54570,5,0.355419,0.375305,329.475474,0.002186,0.002038,18,0.000351,0,14,0.583744,0.020152
27143,Sibley County,,MN,1133,18283,19416,9,10,19,2505,2496,5001,5,0.324476,0.338038,4.228571,0.000763,0.000717,18,0.000135,0,14,0.755556,0.006696
27145,Stearns County,,MN,10396,156222,166618,55,43,98,32473,32598,65071,5,0.374004,0.397376,3884.107537,0.004794,0.00569,18,0.000708,0,14,0.316729,0.04383
27147,Steele County,,MN,2512,43330,45842,13,15,28,6005,5566,11571,5,0.354496,0.37303,192.156035,0.001751,0.001837,18,0.000177,0,14,0.643382,0.015645
27149,Stevens County,,MN,712,10231,10943,4,4,8,354,640,994,5,0.324266,0.33704,0,0.000471,0.000475,18,0.0001,0,14,0.95,0.004107
27151,Swift County,,MN,773,12032,12805,5,8,13,787,1187,1974,5,0.324546,0.337899,2.866667,0.000506,0.000724,18,0.000111,0,14,0.732143,0.004476
27153,Todd County,,MN,1604,26342,27946,13,15,28,3399,4026,7425,5,0.325672,0.340257,3.042291,0.000941,0.00092,18,0.000203,0,14,0.852381,0.008343
27155,Traverse County,,MN,258,4400,4658,0,1,1,0,96,96,7,0.224555,0.229803,0,0,0.000001,18,0.000049,0,53,0,0
27157,Wabasha County,,MN,1564,26487,28051,9,9,18,3293,3643,6936,5,0.324757,0.338343,244.357785,0.001051,0.000952,18,0.000136,0,14,0.636364,0.008853
27159,Wadena County,,MN,1085,15799,16884,12,10,22,2121,2357,4478,5,0.325425,0.339342,4.091208,0.000672,0.000568,18,0.000193,0,14,0.763736,0.006202
27161,Waseca County,,MN,1386,22690,24076,9,11,20,3134,3349,6483,5,0.328953,0.343353,30.146468,0.00092,0.001194,18,0.00014,0,14,0.772727,0.008345
27163,Washington County,,MN,19813,257395,277208,61,64,125,73241,60684,133925,5,0.394174,0.421471,5274.630966,0.014837,0.014347,18,0.000615,0,14,0.395249,0.125865
27165,Watonwan County,,MN,811,12565,13376,7,6,13,874,1315,2189,5,0.324476,0.337594,1683.504211,0.000679,0.000466,18,0.000121,0,14,0.547619,0.006381
27167,Wilkin County,,MN,593,8488,9081,4,4,8,1306,1400,2706,6,0.281273,0.291239,0,0.000083,0.000066,18,0.000117,0,14,1,0.000982
27169,Winona County,,MN,2908,52014,54922,16,19,35,5711,7293,13004,5,0.362627,0.382407,1123.124849,0.002196,0.003155,18,0.00021,0,14,0.565789,0.018857
27171,Wright County,,MN,8576,126758,135334,26,31,57,36164,25318,61482,5,0.360019,0.381325,617.969226,0.002845,0.003369,18,0.000334,0,14,0.558468,0.025661
27173,Yellow Medicine County,,MN,781,12556,13337,5,7,12,1014,1161,2175,5,0.325425,0.339009,1531.806588,0.000471,0.0005,18,0.000114,0,14,0.571429,0.004168
28001,Adams County,,MS,1941,31663,33604,14,15,29,3295,3903,7198,6,0.347404,0.365624,3562.237296,0.001995,0.002368,89,0.000201,0,14,0.555147,0.01429
28003,Alcorn County,,MS,1858,34760,36618,9,9,18,3922,3810,7732,6,0.322802,0.336124,542.524471,0.000531,0.000574,0,0.000195,0,14,0.488889,0.005433
28005,Amite County,,MS,764,12684,13448,7,7,14,1771,1791,3562,6,0.323533,0.3374,708.168116,0.001068,0.000539,0,0.000129,0,14,0.625,0.006954
28007,Attala County,,MS,1002,18593,19595,8,9,17,1971,1853,3824,6,0.288402,0.299956,173.924592,0.000262,0.000209,0,0.000166,0,14,0.583333,0.002403
28009,Benton County,,MS,616,7998,8614,6,6,12,2001,1849,3850,6,0.322491,0.335292,2.23658,0.000516,0.000545,0,0.00014,0,14,0.8,0.005112
28011,Bolivar County,,MS,2491,36276,38767,10,10,20,3589,4598,8187,6,0.346163,0.363637,72.694446,0.00135,0.001372,0,0.000147,0,14,0.718182,0.012098
28013,Calhoun County,,MS,829,15831,16660,7,7,14,1307,1536,2843,7,0.257148,0.265824,24.880904,0.000035,0.000033,0,0.000171,0,14,0.452381,0.000812
28015,Carroll County,,MS,882,9881,10763,3,5,8,1770,1865,3635,6,0.323358,0.33654,69.534138,0.000009,0.000528,0,0.000084,0,14,0.8,0.000323
28017,Chickasaw County,,MS,1249,19712,20961,5,6,11,2535,3355,5890,7,0.261081,0.270271,6.035211,0.00002,0.000036,0,0.000134,0,14,0.666667,0.000544
28019,Choctaw County,,MS,574,7732,8306,4,4,8,865,1114,1979,7,0.260854,0.269494,3.317849,0.000025,0.000022,0,0.000118,0,14,0.666667,0.000473
28021,Claiborne County,,MS,622,9819,10441,3,3,6,1004,1425,2429,6,0.28796,0.29843,0,0.000139,0.000103,0,0.00009,0,14,1,0.001097
28023,Clarke County,,MS,1083,18134,19217,5,7,12,3230,3523,6753,6,0.281142,0.29195,8.516537,0.000506,0.000125,0,0.00011,0,14,0.714286,0.003252
28025,Clay County,,MS,1385,21707,23092,7,9,16,2288,2907,5195,6,0.323812,0.337705,583.104959,0.000107,0.000616,0,0.000149,0,14,0.566667,0.001122
28027,Coahoma County,,MS,1696,29151,30847,9,13,22,2587,4098,6685,6,0.346322,0.364192,1408.306587,0.001157,0.001333,0,0.000153,0,14,0.5,0.010726
28029,Copiah County,,MS,1697,30260,31957,8,6,14,3799,4100,7899,6,0.288153,0.299151,7.755048,0.001047,0.00019,0,0.000124,0,14,0.767857,0.006826
28031,Covington County,,MS,1362,19582,20944,11,8,19,3593,3312,6905,6,0.308008,0.320229,34.615752,0.000969,0.000304,0,0.000168,0,14,0.763636,0.006678
28033,DeSoto County,,MS,11044,144827,155871,73,47,120,53375,29915,83290,5,0.384487,0.410109,11770.737524,0.015645,0.009148,0,0.000807,0,14,0.328597,0.136043
28035,Forrest County,,MS,6855,66654,73509,41,42,83,20221,19458,39679,6,0.35933,0.3833,7716.049155,0.003897,0.00652,0,0.000502,0,14,0.349796,0.031629
28037,Franklin County,,MS,491,8255,8746,4,4,8,880,975,1855,7,0.25812,0.265882,1.135354,0.000027,0.000037,0,0.000101,0,14,0.5,0.000537
28039,George County,,MS,996,20660,21656,5,5,10,3180,2297,5477,6,0.309022,0.321089,11.188659,0.000615,0.000492,0,0.000097,0,14,0.8,0.004719
28041,Greene County,,MS,565,10974,11539,6,6,12,1265,1225,2490,6,0.296603,0.308483,53.032132,0.000346,0.00032,0,0.00013,0,14,0.566667,0.003132
28043,Grenada County,,MS,1510,24375,25885,10,14,24,2864,3215,6079,6,0.323881,0.338371,2811.968172,0.000593,0.00074,0,0.000193,0,14,0.445055,0.005357
28045,Hancock County,,MS,3469,43593,47062,15,30,45,7986,9738,17724,6,0.360711,0.383195,663.836006,0.002757,0.005032,0,0.000165,0,14,0.6,0.020763
28047,Harrison County,,MS,19463,196874,216337,122,185,307,41665,59361,101026,5,0.443657,0.480243,48955.944729,0.033681,0.046028,0,0.001076,0,14,0.340542,0.292995
28049,Hinds County,,MS,18187,258342,276529,75,88,163,46437,58120,104557,5,0.404144,0.434632,47934.660499,0.013684,0.020106,0,0.000851,0,14,0.33482,0.117917
28051,Holmes County,,MS,1289,20735,22024,9,8,17,2167,3100,5267,6,0.346043,0.363249,266.139368,0.001769,0.001257,0,0.000138,0,14,0.736111,0.013905
28053,Humphreys County,,MS,697,10287,10984,4,5,9,687,970,1657,6,0.288153,0.299012,1.658333,0.000159,0.000127,0,0.000089,0,14,0.7,0.001297
28055,Issaquena County,,MS,84,928,1012,0,0,0,0,0,0,0,0,0,0,0,0,30,0.000049,24,54,0,0
28057,Itawamba County,,MS,1687,26069,27756,8,8,16,4729,4531,9260,7,0.250208,0.258478,305.177509,0.000473,0.000036,0,0.000175,0,14,0.513889,0.004588
28059,Jackson County,,MS,11007,143697,154704,60,67,127,26556,28219,54775,5,0.396411,0.424201,7969.120972,0.016734,0.018904,0,0.000538,0,14,0.498335,0.140409
28061,Jasper County,,MS,1280,18960,20240,9,7,16,3048,3175,6223,6,0.273738,0.284227,18.724932,0.000818,0.000079,0,0.000157,0,14,0.583333,0.005492
28063,Jefferson County,,MS,459,7997,8456,5,4,9,544,903,1447,6,0.288043,0.298707,25.362959,0.00061,0.000112,0,0.000107,0,14,0.8,0.003797
28065,Jefferson Davis County,,MS,817,12113,12930,8,8,16,1639,2273,3912,6,0.288347,0.299761,6.869231,0.000634,0.000187,0,0.00014,0,14,0.791667,0.004269
28067,Jones County,,MS,3193,65609,68802,16,17,33,7993,8064,16057,6,0.343197,0.361318,1343.551655,0.001713,0.001391,0,0.000242,0,14,0.562092,0.013592
28069,Kemper County,,MS,588,8965,9553,2,2,4,787,1009,1796,6,0.271242,0.28026,0,0.000042,0.000033,0,0.000077,0,14,1,0.00042
28071,Lafayette County,,MS,3208,34906,38114,23,20,43,6672,6152,12824,6,0.345208,0.364153,2633.876075,0.00207,0.002288,0,0.000332,0,14,0.44,0.015985
28073,Lamar County,,MS,4465,44694,49159,28,23,51,15830,11914,27744,6,0.335343,0.35359,1238.927268,0.002679,0.002116,0,0.000349,0,14,0.446573,0.020595
28075,Lauderdale County,,MS,5159,81224,86383,34,41,75,9913,11119,21032,5,0.372058,0.396677,13680.587883,0.005402,0.006699,0,0.000439,0,14,0.373728,0.043522
28077,Lawrence County,,MS,904,14651,15555,9,10,19,1764,1991,3755,6,0.288513,0.300316,10.471019,0.000649,0.000206,0,0.000154,0,14,0.7,0.00455
28079,Leake County,,MS,1306,21863,23169,9,8,17,2940,3236,6176,6,0.288264,0.299595,9.720069,0.000276,0.000187,0,0.000177,0,14,0.722222,0.002567
28081,Lee County,,MS,5387,84218,89605,27,23,50,15434,13785,29219,6,0.332706,0.349994,9444.156767,0.00185,0.001723,0,0.000407,0,14,0.346059,0.016493
28083,Leflore County,,MS,2175,33521,35696,13,15,28,3415,4802,8217,6,0.323951,0.338593,4945.2197,0.00171,0.000783,0,0.000186,0,14,0.480392,0.013594
28085,Lincoln County,,MS,1737,35263,37000,12,12,24,4488,4164,8652,6,0.324371,0.339231,851.392657,0.001372,0.000535,0,0.000178,0,14,0.571429,0.008676
28087,Lowndes County,,MS,5293,61487,66780,23,34,57,7008,8793,15801,5,0.372566,0.396155,7879.83628,0.003824,0.007008,0,0.000309,0,14,0.469417,0.032754
28089,Madison County,,MS,7992,85863,93855,51,44,95,30757,23052,53809,5,0.38287,0.407906,9598.728523,0.008116,0.009521,0,0.000558,0,14,0.380771,0.06831
28091,Marion County,,MS,1313,26897,28210,12,11,23,2785,2846,5631,6,0.309499,0.322309,43.122609,0.001335,0.00038,0,0.000168,0,14,0.642857,0.00896
28093,Marshall County,,MS,2657,37132,39789,9,9,18,8495,7636,16131,6,0.322629,0.335847,154.779831,0.001157,0.000557,0,0.000182,0,14,0.511111,0.010749
28095,Monroe County,,MS,2145,40153,42298,10,11,21,4421,4901,9322,6,0.323812,0.337927,1244.773418,0.000532,0.000542,0,0.000201,0,14,0.454545,0.004981
28097,Montgomery County,,MS,742,12079,12821,3,6,9,1084,1310,2394,6,0.277557,0.287628,2.638696,0.000012,0.00008,0,0.000086,0,14,0.5,0.000323
28099,Neshoba County,,MS,1536,30342,31878,9,9,18,3177,3211,6388,6,0.309531,0.322143,230.141859,0.000219,0.000369,0,0.000199,0,14,0.577778,0.002145
28101,Newton County,,MS,1235,23353,24588,10,7,17,3132,2603,5735,6,0.289069,0.300422,75.509927,0.000948,0.000169,0,0.000174,0,14,0.588889,0.006409
28103,Noxubee County,,MS,618,13065,13683,3,4,7,635,1108,1743,6,0.27766,0.287794,1.762227,0.000065,0.000074,0,0.000085,0,14,0.75,0.000583
28105,Oktibbeha County,,MS,3690,36145,39835,30,26,56,6870,7286,14156,6,0.352458,0.373796,16065.637751,0.003093,0.003834,0,0.000397,0,14,0.394444,0.024728
28107,Panola County,,MS,2210,36623,38833,10,8,18,5249,5092,10341,6,0.322595,0.33568,1302.245539,0.001163,0.000552,0,0.000185,0,14,0.577778,0.010852
28109,Pearl River County,,MS,2715,48698,51413,19,17,36,12442,7071,19513,6,0.344851,0.36336,188.683546,0.002666,0.001913,89,0.000196,0,14,0.597619,0.019319
28111,Perry County,,MS,865,12795,13660,5,4,9,1754,1830,3584,7,0.264506,0.27376,3.166861,0.000332,0.000051,0,0.000108,0,14,0.7,0.002504
28113,Pike County,,MS,2364,39790,42154,19,17,36,6368,5661,12029,6,0.328342,0.344108,1453.041998,0.00176,0.00122,0,0.000252,0,14,0.481579,0.01214
28115,Pontotoc County,,MS,1800,29564,31364,11,10,21,5524,5013,10537,6,0.322872,0.336346,1506.936436,0.000537,0.000562,0,0.000225,0,14,0.536364,0.005634
28117,Prentiss County,,MS,1405,25430,26835,6,8,14,3361,3657,7018,6,0.322733,0.335902,468.284199,0.000021,0.000463,0,0.000154,0,14,0.714286,0.000692
28119,Quitman County,,MS,627,8547,9174,3,6,9,847,1511,2358,6,0.322491,0.335292,0.45,0.000016,0.000548,0,0.000097,0,14,0.9,0.000383
28121,Rankin County,,MS,10406,131498,141904,58,56,114,39399,28883,68282,5,0.3818,0.408638,15358.207435,0.00791,0.009424,0,0.000689,0,14,0.315528,0.068004
28123,Scott County,,MS,1694,29601,31295,9,8,17,3642,4051,7693,6,0.289096,0.300588,6.640431,0.000278,0.000218,0,0.000175,0,14,0.680556,0.002589
28125,Sharkey County,,MS,417,6208,6625,2,0,2,360,0,360,0,0,0,0,0.000048,0,0,0.000065,0,0,1,0.00045
28127,Simpson County,,MS,1522,26935,28457,11,13,24,4301,4460,8761,6,0.309499,0.322531,62.955463,0.000554,0.000446,0,0.000185,0,14,0.608974,0.004498
28129,Smith County,,MS,818,14816,15634,8,8,16,2170,2273,4443,6,0.288347,0.299761,22.838662,0.00046,0.000176,0,0.000152,0,14,0.708333,0.003623
28131,Stone County,,MS,950,14528,15478,8,5,13,3689,2136,5825,6,0.307692,0.319341,1.075809,0.000579,0.000352,0,0.000117,0,14,0.75,0.003875
28133,Sunflower County,,MS,1868,27414,29282,8,11,19,3109,3831,6940,6,0.338022,0.354821,335.620799,0.001234,0.001263,0,0.00013,0,14,0.651515,0.010666
28135,Tallahatchie County,,MS,946,14716,15662,8,10,18,1468,2445,3913,6,0.322802,0.336235,15.65645,0.00048,0.000577,0,0.000151,0,14,0.536364,0.00458
28137,Tate County,,MS,2163,27944,30107,6,6,12,6454,5765,12219,6,0.322525,0.335347,1.876879,0.000525,0.000557,0,0.000141,0,14,0.8,0.005203
28139,Tippah County,,MS,1037,23097,24134,9,10,19,2396,2794,5190,6,0.322768,0.33618,314.038032,0.00053,0.000562,0,0.000195,0,14,0.6,0.005449
28141,Tishomingo County,,MS,936,18973,19909,8,8,16,2463,2437,4900,7,0.250793,0.259494,306.021543,0.000479,0.000049,0,0.000178,0,14,0.458333,0.004611
28143,Tunica County,,MS,1279,12041,13320,10,8,18,3882,3937,7819,6,0.327126,0.340712,673.060684,0.00091,0.000745,0,0.000167,0,14,0.511111,0.007945
28145,Union County,,MS,1457,27780,29237,11,11,22,4492,4278,8770,6,0.322872,0.336457,656.482065,0.000595,0.000571,0,0.000219,0,14,0.560606,0.006112
28147,Walthall County,,MS,877,14562,15439,8,7,15,2067,2061,4128,6,0.323777,0.337733,10.132005,0.000975,0.000371,0,0.000119,0,14,0.680556,0.005848
28149,Warren County,,MS,3249,55950,59199,17,21,38,4835,5922,10757,6,0.351386,0.371161,3323.192835,0.003244,0.003342,0,0.000233,0,14,0.547101,0.024969
28151,Washington County,,MS,3676,59164,62840,15,24,39,3788,7304,11092,6,0.37027,0.392682,3374.923671,0.003312,0.004837,0,0.000189,0,14,0.513846,0.027452
28153,Wayne County,,MS,964,21287,22251,10,9,19,1865,1974,3839,6,0.285037,0.296327,48.122995,0.000558,0.000191,0,0.000176,0,14,0.522727,0.004678
28155,Webster County,,MS,778,11923,12701,6,5,11,1393,1160,2553,7,0.260968,0.269882,19.774012,0.000031,0.000023,0,0.000146,0,14,0.3,0.000625
28157,Wilkinson County,,MS,484,9159,9643,5,5,10,793,998,1791,6,0.323463,0.337067,1.550505,0.000715,0.000514,89,0.000105,0,14,0.666667,0.004716
28159,Winston County,,MS,1009,20664,21673,7,9,16,1395,1846,3241,6,0.289263,0.301032,275.510876,0.000299,0.000182,0,0.000164,0,14,0.555556,0.002405
28161,Yalobusha County,,MS,871,13601,14472,7,7,14,2099,2192,4291,6,0.322698,0.335736,517.971228,0.000525,0.000551,0,0.000151,0,14,0.666667,0.005229
28163,Yazoo County,,MS,1519,26204,27723,9,8,17,2362,3144,5506,6,0.327554,0.341378,233.012664,0.0016,0.000838,0,0.000137,0,14,0.736111,0.013182
29001,Adair County,,MO,1917,21372,23289,12,13,25,2396,3130,5526,5,0.355041,0.373269,22615.383001,0.001292,0.002045,31,0.000366,0,14,0.338235,0.011263
29003,Andrew County,,MO,1770,19107,20877,8,8,16,5053,5055,10108,6,0.311877,0.323552,483.15637,0.000502,0.000501,31,0.000185,0,14,0.597222,0.004891
29005,Atchison County,,MO,442,6788,7230,1,1,2,130,181,311,7,0.244845,0.250694,0,0.000008,0.000003,31,0.000069,0,14,0,0.000103
29007,Audrain County,,MO,1562,27201,28763,9,12,21,3232,3822,7054,6,0.323045,0.33689,161.302457,0.000609,0.001061,31,0.000186,0,14,0.560606,0.005369
29009,Barry County,,MO,2781,35328,38109,13,12,25,6468,6707,13175,6,0.314489,0.327574,53.008472,0.001007,0.000958,31,0.000257,0,14,0.705128,0.011289
29011,Barton County,,MO,968,14131,15099,6,7,13,1637,2310,3947,6,0.297426,0.308333,6.919313,0.00021,0.000249,31,0.000145,0,14,0.642857,0.002571
29013,Bates County,,MO,1265,18353,19618,9,10,19,2970,2748,5718,6,0.317951,0.330698,26.97015,0.000804,0.000935,31,0.000164,0,14,0.606061,0.007502
29015,Benton County,,MO,1240,17836,19076,12,8,20,3339,2757,6096,6,0.312949,0.324773,4.283794,0.001067,0.000677,31,0.0002,0,14,0.742424,0.010343
29017,Bollinger County,,MO,765,12580,13345,5,5,10,1858,1930,3788,7,0.266714,0.27568,3.753458,0.000044,0.000033,31,0.000132,0,14,0.55,0.000668
29019,Boone County,,MO,11839,145255,157094,96,88,184,32517,29683,62200,5,0.420493,0.449073,55130.966951,0.018434,0.022219,31,0.001184,0,14,0.323562,0.159744
29021,Buchanan County,,MO,5579,90198,95777,34,28,62,13454,14218,27672,5,0.362846,0.383761,19502.981382,0.003379,0.003168,31,0.000542,0,14,0.290476,0.030914
29023,Butler County,,MO,2621,42149,44770,15,16,31,5691,5571,11262,6,0.323533,0.338177,10355.623369,0.000952,0.000985,31,0.000318,0,14,0.382353,0.008844
29025,Caldwell County,,MO,805,9895,10700,9,8,17,1878,1995,3873,6,0.311748,0.323358,4.7524,0.000511,0.000442,31,0.000183,0,14,0.763889,0.005075
29027,Callaway County,,MO,3285,43812,47097,14,15,29,8767,8479,17246,6,0.323567,0.337916,197.411539,0.001285,0.001469,31,0.000228,0,14,0.571429,0.011855
29029,Camden County,,MO,3481,39348,42829,29,21,50,9219,7733,16952,5,0.357066,0.376337,787.421956,0.004495,0.002624,31,0.000386,0,14,0.510345,0.040743
29031,Cape Girardeau County,,MO,4870,77423,82293,31,29,60,12378,11303,23681,6,0.363328,0.385741,23015.312089,0.003521,0.00394,31,0.000464,0,14,0.324421,0.032038
29033,Carroll County,,MO,538,11079,11617,6,6,12,925,1102,2027,6,0.311554,0.322803,2.611977,0.000434,0.000424,31,0.000129,0,14,0.7,0.004093
29035,Carter County,,MO,515,6383,6898,2,2,4,560,569,1129,7,0.244486,0.250533,0,0.000006,0.000006,31,0.000108,0,14,1,0.000198
29037,Cass County,,MO,7753,100890,108643,30,28,58,28390,20960,49350,5,0.365762,0.387256,1465.379475,0.006269,0.00403,31,0.00039,0,14,0.471591,0.055241
29039,Cedar County,,MO,927,13324,14251,8,8,16,1683,2029,3712,6,0.312493,0.32444,41.209346,0.00051,0.000532,31,0.000183,0,14,0.660714,0.005279
29041,Chariton County,,MO,504,9179,9683,3,5,8,545,922,1467,6,0.296282,0.306253,19.984855,0.000314,0.000118,31,0.000087,0,14,0.733333,0.002824
29043,Christian County,,MO,6591,67687,74278,39,24,63,26716,19766,46482,5,0.359804,0.379888,3648.048072,0.007289,0.003109,31,0.000567,0,14,0.423077,0.066259
29045,Clark County,,MO,400,8179,8579,1,1,2,412,400,812,7,0.236405,0.241651,0,0.000004,0.000003,18,0.000065,0,14,0,0.000098
29047,Clay County,,MO,18600,227959,246559,81,74,155,70273,57382,127655,5,0.401658,0.429683,26874.748716,0.018039,0.01828,31,0.000966,0,14,0.37798,0.15516
29049,Clinton County,,MO,2052,22816,24868,11,9,20,5641,5285,10926,6,0.316744,0.329089,30.135114,0.000855,0.000842,31,0.000212,0,14,0.690909,0.008085
29051,Cole County,,MO,5224,82135,87359,29,28,57,14524,14284,28808,5,0.364121,0.384948,1854.613147,0.003001,0.003513,31,0.000401,0,14,0.433468,0.027227
29053,Cooper County,,MO,1115,17772,18887,7,7,14,2688,2707,5395,6,0.312071,0.323663,49.439191,0.000458,0.000437,31,0.000154,0,14,0.690476,0.004297
29055,Crawford County,,MO,1658,24323,25981,12,11,23,4542,4118,8660,6,0.321903,0.335153,18.806882,0.001045,0.001065,31,0.0002,0,14,0.685897,0.009209
29057,Dade County,,MO,630,8381,9011,6,6,12,1375,1489,2864,6,0.297161,0.307779,2.015258,0.000203,0.000237,31,0.000153,0,14,0.733333,0.002602
29059,Dallas County,,MO,1285,15972,17257,8,7,15,3167,3272,6439,6,0.297043,0.307668,3.555187,0.000502,0.000262,31,0.000181,0,14,0.732143,0.005537
29061,Daviess County,,MO,722,9094,9816,7,9,16,1121,1548,2669,6,0.311812,0.32358,51.534136,0.000428,0.00044,31,0.000168,0,14,0.666667,0.0041
29063,DeKalb County,,MO,858,10281,11139,7,8,15,2064,2154,4218,6,0.311748,0.323358,2.405121,0.000445,0.000504,31,0.000161,0,14,0.839286,0.004311
29065,Dent County,,MO,952,14453,15405,8,6,14,1539,1709,3248,6,0.321593,0.334099,449.666752,0.000727,0.0006,31,0.000156,0,14,0.589286,0.006587
29067,Douglas County,,MO,891,12510,13401,7,7,14,1512,1992,3504,6,0.297102,0.307779,2.629748,0.000178,0.000257,31,0.000178,0,14,0.75,0.002582
29069,Dunklin County,,MO,2009,31226,33235,12,12,24,4542,4954,9496,6,0.310587,0.324007,997.314427,0.000703,0.000454,0,0.000226,0,14,0.397436,0.006829
29071,Franklin County,,MO,5750,115577,121327,21,22,43,18102,15746,33848,5,0.362321,0.382545,1204.803719,0.002495,0.003101,31,0.000297,0,14,0.51087,0.022703
29073,Gasconade County,,MO,1098,17662,18760,10,13,23,3081,3115,6196,6,0.322248,0.33593,142.160677,0.000922,0.000988,31,0.000169,0,14,0.648352,0.008215
29075,Gentry County,,MO,458,7624,8082,3,4,7,473,711,1184,6,0.311683,0.322803,6.237673,0.000029,0.000323,31,0.000106,0,14,0.666667,0.000455
29077,Greene County,,MO,19984,267569,287553,134,107,241,65063,58248,123311,5,0.422029,0.452486,78421.108674,0.028184,0.025257,31,0.001627,0,14,0.30906,0.25139
29079,Grundy County,,MO,650,10956,11606,5,7,12,703,858,1561,6,0.311877,0.323413,6180.334358,0.000116,0.00043,31,0.000169,0,14,0.47619,0.001324
29081,Harrison County,,MO,524,9327,9851,3,4,7,373,306,679,6,0.311489,0.32247,134.594545,0.00031,0.000407,31,0.000097,0,14,0.583333,0.002792
29083,Henry County,,MO,1775,24050,25825,11,11,22,3979,4077,8056,6,0.318322,0.331281,19.356643,0.000996,0.001106,31,0.000196,0,14,0.75,0.009491
29085,Hickory County,,MO,603,8702,9305,5,6,11,1164,1342,2506,6,0.312201,0.323718,9.945111,0.000483,0.000484,31,0.000129,0,14,0.714286,0.004861
29087,Holt County,,MO,397,5910,6307,2,3,5,599,773,1372,6,0.266407,0.274478,0,0.000027,0.000026,31,0.000085,0,14,1,0.000374
29089,Howard County,,MO,734,10674,11408,5,4,9,1835,1736,3571,6,0.296223,0.306031,2.511111,0.000144,0.000121,31,0.000126,0,14,0.55,0.001444
29091,Howell County,,MO,2216,39728,41944,13,14,27,4107,4053,8160,6,0.300942,0.313304,5411.951758,0.000226,0.000413,31,0.000321,0,14,0.351648,0.003709
29093,Iron County,,MO,854,10641,11495,9,7,16,1790,1820,3610,6,0.320666,0.332851,320.056079,0.000711,0.000476,31,0.000183,0,14,0.611111,0.006347
29095,Jackson County,,MO,45935,710788,756723,210,198,408,135100,151450,286550,5,0.451933,0.487927,151625.48145,0.050544,0.051789,31,0.002234,0,14,0.322718,0.434005
29097,Jasper County,,MO,7659,112781,120440,44,38,82,21308,18997,40305,5,0.374097,0.397498,8326.875408,0.008806,0.006917,31,0.000609,0,14,0.386216,0.079929
29099,Jefferson County,,MO,14190,244815,259005,36,41,77,50478,43244,93722,5,0.379245,0.403218,8403.733416,0.006456,0.00661,31,0.000473,0,14,0.355708,0.058204
29101,Johnson County,,MO,6266,49927,56193,24,27,51,10094,11018,21112,5,0.37597,0.397975,1219.146677,0.004206,0.006699,31,0.00032,0,14,0.53871,0.038772
29103,Knox County,,MO,319,4772,5091,2,3,5,288,399,687,6,0.262404,0.269824,23.247176,0.000012,0.000008,31,0.000104,0,14,0,0.000205
29105,Laclede County,,MO,2072,36701,38773,12,12,24,4886,4441,9327,6,0.314852,0.327635,93.615225,0.001034,0.00077,31,0.000222,0,14,0.587912,0.009852
29107,Lafayette County,,MO,2623,36963,39586,11,13,24,6897,7010,13907,6,0.317749,0.330726,27.147313,0.000903,0.001019,31,0.000192,0,14,0.626374,0.008596
29109,Lawrence County,,MO,2708,38588,41296,11,11,22,6820,7320,14140,6,0.31321,0.325854,48.008299,0.001136,0.000833,31,0.000217,0,14,0.641026,0.011666
29111,Lewis County,,MO,645,10909,11554,3,3,6,955,1139,2094,6,0.266477,0.274534,51.245306,0.000024,0.000015,31,0.000108,0,14,0.333333,0.000339
29113,Lincoln County,,MO,3302,50985,54287,10,11,21,16223,9168,25391,6,0.322629,0.336207,16.868387,0.001141,0.001245,31,0.00016,0,14,0.736364,0.009822
29115,Linn County,,MO,1012,15107,16119,6,10,16,1020,1629,2649,6,0.312624,0.324856,210.136141,0.000553,0.000614,31,0.000133,0,14,0.511111,0.004941
29117,Livingston County,,MO,1004,15409,16413,8,11,19,1605,1808,3413,6,0.317346,0.330199,85.771554,0.000446,0.000952,31,0.000172,0,14,0.575758,0.004358
29119,McDonald County,,MO,1867,19133,21000,8,8,16,4797,5229,10026,6,0.30482,0.317427,19.536683,0.000462,0.00061,0,0.00016,0,14,0.714286,0.005967
29121,Macon County,,MO,1057,18235,19292,7,6,13,1833,1873,3706,6,0.312201,0.323774,1059.159664,0.000458,0.00042,31,0.000168,0,14,0.52381,0.004153
29123,Madison County,,MO,719,12340,13059,8,7,15,1715,1623,3338,6,0.320872,0.333156,286.179086,0.000499,0.000486,31,0.000167,0,14,0.680556,0.004541
29125,Maries County,,MO,599,8849,9448,6,6,12,1288,1264,2552,6,0.282145,0.292471,32.072377,0.000559,0.000114,31,0.000115,0,14,0.714286,0.004706
29127,Marion County,,MO,1885,31408,33293,11,10,21,3816,3957,7773,6,0.321627,0.334598,3229.460521,0.000784,0.000738,31,0.000238,0,14,0.4,0.007012
29129,Mercer County,,MO,326,3958,4284,1,1,2,121,106,227,7,0.237752,0.242699,0,0.000003,0.000001,31,0.00007,0,14,0,0.000076
29131,Miller County,,MO,1967,24652,26619,10,12,22,4731,5189,9920,6,0.324371,0.338377,116.480378,0.001147,0.001119,31,0.000169,0,14,0.666667,0.010284
29133,Mississippi County,,MO,750,13037,13787,3,4,7,1242,1627,2869,7,0.266596,0.275292,0,0.000034,0.000027,31,0.000095,0,14,1,0.00045
29135,Moniteau County,,MO,996,16597,17593,7,8,15,2453,2687,5140,6,0.312136,0.323885,2.629304,0.000183,0.000463,31,0.000144,0,14,0.785714,0.00199
29137,Monroe County,,MO,723,10300,11023,6,6,12,1384,1590,2974,6,0.296457,0.306641,242.23441,0.000148,0.000121,31,0.000164,0,14,0.566667,0.001503
29139,Montgomery County,,MO,912,13804,14716,8,8,16,2418,2385,4803,6,0.321077,0.333627,4.586559,0.000784,0.00075,31,0.000141,0,14,0.696429,0.006888
29141,Morgan County,,MO,1503,20156,21659,12,11,23,4006,3543,7549,6,0.313014,0.325466,97.863549,0.001564,0.000752,31,0.000193,0,14,0.681319,0.013893
29143,New Madrid County,,MO,1479,19049,20528,7,7,14,2584,3208,5792,7,0.267403,0.276829,12.041024,0.000052,0.00004,31,0.00016,0,14,0.714286,0.000878
29145,Newton County,,MO,4559,57777,62336,17,16,33,12321,12680,25001,6,0.320803,0.335347,774.631093,0.002491,0.001465,31,0.000275,0,14,0.518421,0.023822
29147,Nodaway County,,MO,1470,21234,22704,11,14,25,2091,2874,4965,6,0.324196,0.33866,13249.856695,0.0005,0.001426,31,0.000325,0,14,0.366667,0.005086
29149,Oregon County,,MO,740,9503,10243,2,3,5,778,1258,2036,6,0.297132,0.307307,65.736624,0.000003,0.000168,31,0.000093,0,14,0.666667,0.000173
29151,Osage County,,MO,674,15244,15918,6,6,12,1579,1812,3391,6,0.296399,0.306558,13.865818,0.000173,0.000157,31,0.000125,0,14,0.642857,0.00177
29153,Ozark County,,MO,662,9223,9885,4,5,9,976,1394,2370,6,0.29722,0.307695,2.086734,0.000158,0.000237,31,0.000126,0,14,0.75,0.002127
29155,Pemiscot County,,MO,1258,18657,19915,6,9,15,1942,2799,4741,6,0.330437,0.344818,566.434979,0.000485,0.00091,0,0.000132,0,14,0.5,0.004505
29157,Perry County,,MO,961,21078,22039,8,8,16,2286,2166,4452,6,0.320974,0.333433,290.703765,0.000522,0.000491,31,0.000158,0,14,0.607143,0.004712
29159,Pettis County,,MO,2908,43393,46301,16,17,33,6441,6578,13019,6,0.325919,0.340624,331.33962,0.002184,0.001573,31,0.00025,0,14,0.564327,0.019583
29161,Phelps County,,MO,3695,42445,46140,19,23,42,6841,7300,14141,6,0.361318,0.382512,1306.074134,0.001624,0.003698,31,0.000292,0,14,0.487319,0.015005
29163,Pike County,,MO,995,18514,19509,7,8,15,2206,2417,4623,6,0.321318,0.33396,138.511046,0.000639,0.000737,31,0.000149,0,14,0.571429,0.005734
29165,Platte County,,MO,11634,89794,101428,45,38,83,35010,34127,69137,5,0.388164,0.41225,5608.980098,0.011217,0.00993,31,0.000542,0,14,0.505714,0.098671
29167,Polk County,,MO,2073,29206,31279,14,10,24,5995,5305,11300,6,0.312559,0.324773,317.476724,0.001312,0.000582,31,0.000278,0,14,0.514286,0.013564
29169,Pulaski County,,MO,7913,39390,47303,44,49,93,13277,14347,27624,5,0.389877,0.415213,5300.292029,0.011068,0.012977,31,0.00042,0,14,0.589797,0.095137
29171,Putnam County,,MO,309,5866,6175,2,1,3,314,278,592,6,0.262038,0.268997,0,0.000012,0.000008,31,0.000094,0,14,1,0.000208
29173,Ralls County,,MO,625,11448,12073,5,5,10,1751,1726,3477,6,0.296399,0.306419,9.781554,0.000202,0.000122,31,0.00013,0,14,0.766667,0.002154
29175,Randolph County,,MO,1728,25349,27077,9,10,19,3102,3574,6676,6,0.322837,0.336335,193.55519,0.000476,0.000853,31,0.000197,0,14,0.477778,0.004488
29177,Ray County,,MO,1930,27072,29002,9,8,17,5274,5228,10502,6,0.316544,0.328645,18.467243,0.000872,0.000825,31,0.000174,0,14,0.680556,0.008197
29179,Reynolds County,,MO,449,6459,6908,3,3,6,192,411,603,6,0.262427,0.270001,0.948718,0.000449,0.000016,31,0.000089,0,14,0.666667,0.003732
29181,Ripley County,,MO,783,13378,14161,4,3,7,1275,1248,2523,7,0.244526,0.250755,131.073685,0.000045,0.000006,31,0.000146,0,14,0.5,0.000691
29183,St. Charles County,,MO,22693,383401,406094,118,110,228,94490,69614,164104,5,0.429204,0.459243,28929.878402,0.033976,0.031639,31,0.001111,0,14,0.421277,0.289457
29185,St. Clair County,,MO,635,8814,9449,8,7,15,1390,1328,2718,6,0.312234,0.323885,6.463093,0.000499,0.000522,31,0.000174,0,14,0.660714,0.005194
29186,Ste. Genevieve County,,MO,1320,21359,22679,6,8,14,3324,3511,6835,6,0.321009,0.333489,1.425943,0.000886,0.00089,31,0.00011,0,14,0.839286,0.007674
29187,St. Francois County,,MO,3253,60759,64012,16,21,37,11035,9102,20137,5,0.355545,0.374767,2630.339486,0.00136,0.002157,31,0.00027,0,14,0.485714,0.012448
29189,St. Louis County,,MO,79124,1180591,1259715,270,286,556,237529,275654,513183,5,0.471364,0.512561,169716.968891,0.069806,0.073469,31,0.002427,0,14,0.301044,0.582474
29195,Saline County,,MO,1463,24246,25709,9,10,19,2188,2754,4942,6,0.313537,0.325827,236.108575,0.00117,0.000728,31,0.000175,0,14,0.590909,0.010273
29197,Schuyler County,,MO,297,4197,4494,1,1,2,299,328,627,6,0.262038,0.268997,0,0.000012,0.000008,31,0.000073,0,14,0,0.000137
29199,Scotland County,,MO,240,5446,5686,0,1,1,0,43,43,6,0.262079,0.269074,0,0,0.000008,31,0.000049,0,55,0,0
29201,Scott County,,MO,2793,43291,46084,10,14,24,6863,7133,13996,6,0.333001,0.348913,2303.866094,0.000513,0.001858,31,0.000206,0,14,0.516667,0.004826
29203,Shannon County,,MO,436,8107,8543,2,2,4,503,663,1166,7,0.233031,0.238691,0,0.000004,0.000006,31,0.000086,0,14,1,0.000209
29205,Shelby County,,MO,410,7543,7953,4,4,8,537,718,1255,6,0.296369,0.306253,126.275103,0.000008,0.000117,31,0.000146,0,14,0.4,0.000351
29207,Stoddard County,,MO,1845,32285,34130,10,9,19,4024,4104,8128,6,0.322179,0.335292,799.395954,0.000518,0.000616,31,0.000204,0,14,0.554545,0.004838
29209,Stone County,,MO,3199,29912,33111,18,12,30,6659,7437,14096,6,0.329061,0.343886,367.83897,0.004753,0.001535,31,0.000288,0,14,0.681579,0.043833
29211,Sullivan County,,MO,665,7587,8252,4,5,9,434,661,1095,6,0.267712,0.276964,129.653852,0.000037,0.000037,31,0.000121,0,14,0.2,0.00058
29213,Taney County,,MO,4150,43421,47571,30,20,50,8900,8380,17280,5,0.360928,0.380776,2206.299225,0.00585,0.003562,31,0.000457,0,14,0.492944,0.054404
29215,Texas County,,MO,1736,23306,25042,11,11,22,2883,3347,6230,6,0.30007,0.31184,3567.255579,0.000714,0.000308,31,0.00023,0,14,0.474359,0.006703
29217,Vernon County,,MO,1360,21473,22833,8,10,18,2438,2687,5125,6,0.317514,0.33031,62.919125,0.000534,0.000912,31,0.000162,0,14,0.6,0.00554
29219,Warren County,,MO,2376,31252,33628,9,8,17,10517,7135,17652,6,0.321112,0.333683,1.320238,0.001037,0.00099,31,0.000144,0,14,0.861111,0.009035
29221,Washington County,,MO,1505,21726,23231,8,6,14,4331,3804,8135,6,0.320598,0.332629,0.775961,0.00091,0.000483,31,0.000143,0,14,0.892857,0.008021
29223,Wayne County,,MO,936,12046,12982,8,8,16,1694,1812,3506,6,0.32118,0.333655,10.424254,0.000707,0.000494,31,0.000158,0,14,0.708333,0.006415
29225,Webster County,,MO,2673,35916,38589,13,14,27,8415,7934,16349,6,0.312754,0.325522,741.657243,0.001693,0.000604,31,0.000266,0,14,0.429167,0.015908
29227,Worth County,,MO,162,2429,2591,1,1,2,71,169,240,7,0.244845,0.250694,0,0.000008,0.000003,31,0.000069,0,14,0,0.000103
29229,Wright County,,MO,1423,18305,19728,7,7,14,2564,3501,6065,6,0.297102,0.307779,1.553307,0.000181,0.000232,31,0.000173,0,14,0.857143,0.002632
29510,St. Louis city,,MO,38617,309603,348220,108,105,213,107125,134152,241277,5,0.435804,0.46447,18397.690489,0.034936,0.035889,31,0.000964,0,14,0.526387,0.293736
30001,Beaverhead County,,MT,799,8859,9658,4,8,12,727,1129,1856,6,0.284685,0.296089,12.104389,0.000164,0.000405,4,0.000114,0,14,0.821429,0.001931
30003,Big Horn County,,MT,866,12232,13098,3,4,7,1104,1561,2665,6,0.278716,0.288748,1.514596,0.000081,0.000175,4,0.000102,0,14,0.75,0.001017
30005,Blaine County,,MT,477,6718,7195,3,2,5,428,616,1044,6,0.274815,0.284404,0,0.000145,0.000078,4,0.000104,0,14,1,0.001415
30007,Broadwater County,,MT,452,4658,5110,3,2,5,795,672,1467,6,0.273588,0.282418,0,0.000172,0.000125,4,0.000103,0,14,1,0.002129
30009,Carbon County,,MT,870,10081,10951,3,5,8,1287,1559,2846,6,0.279937,0.290746,4.136004,0.000078,0.000262,4,0.000113,0,14,0.7,0.001109
30011,Carter County,,MT,58,1479,1537,0,0,0,0,0,0,0,0,0,0,0,0,32,0.000049,25,56,0,0
30013,Cascade County,,MT,7597,89450,97047,38,49,87,11363,13539,24902,5,0.378242,0.403046,28339.249724,0.008121,0.012503,4,0.000504,0,14,0.44775,0.075462
30015,Chouteau County,,MT,368,5182,5550,1,3,4,266,462,728,6,0.280433,0.290002,0,0.000074,0.000143,4,0.000058,0,14,1,0.000518
30017,Custer County,,MT,997,12635,13632,4,3,7,807,869,1676,6,0.278638,0.288471,7.087687,0.000137,0.000168,4,0.000122,0,14,0.583333,0.001878
30019,Daniels County,,MT,118,2292,2410,0,0,0,0,0,0,0,0,0,0,0,0,33,0.000049,26,57,0,0
30021,Dawson County,,MT,635,9885,10520,1,4,5,211,512,723,6,0.276713,0.287289,0,0.000069,0.000093,4,0.000066,0,14,0.5,0.000799
30023,Deer Lodge County,,MT,612,9621,10233,5,6,11,895,1191,2086,6,0.279884,0.290746,12.209662,0.000203,0.000284,4,0.000128,0,14,0.9,0.002187
30025,Fallon County,,MT,283,3287,3570,0,1,1,0,66,66,6,0.274831,0.284309,0,0,0.000075,4,0.000049,0,58,0,0
30027,Fergus County,,MT,911,13061,13972,5,6,11,970,1253,2223,6,0.284685,0.295839,6100.378695,0.000289,0.000325,4,0.000127,0,14,0.7,0.003106
30029,Flathead County,,MT,5165,91963,97128,47,35,82,14600,10446,25046,5,0.365095,0.387506,4524.003244,0.012395,0.009219,4,0.000518,0,14,0.650935,0.112251
30031,Gallatin County,,MT,7202,80577,87779,84,49,133,20947,15625,36572,5,0.376441,0.400971,38228.80655,0.01569,0.011302,4,0.001194,0,14,0.321429,0.144277
30033,Garfield County,,MT,88,1386,1474,0,0,0,0,0,0,0,0,0,0,0,0,34,0.000049,27,59,0,0
30035,Glacier County,,MT,820,13851,14671,4,8,12,817,1437,2254,6,0.284685,0.296089,30.725578,0.000209,0.000377,4,0.000101,0,14,0.678571,0.002101
30037,Golden Valley County,,MT,81,1060,1141,0,1,1,0,48,48,6,0.274831,0.284309,0,0,0.000075,4,0.000049,0,60,0,0
30039,Granite County,,MT,301,2800,3101,1,1,2,199,241,440,6,0.273938,0.282873,0,0.00008,0.000076,4,0.000062,0,14,0,0.000786
30041,Hill County,,MT,1238,18059,19297,10,7,17,1957,2269,4226,6,0.284658,0.295922,64.97549,0.000382,0.000399,4,0.000242,0,14,0.444444,0.004439
30043,Jefferson County,,MT,1015,11294,12309,5,4,9,2432,2146,4578,6,0.274739,0.284471,0,0.000268,0.000208,4,0.00013,0,14,1,0.003051
30045,Judith Basin County,,MT,133,2342,2475,1,3,4,85,197,282,6,0.274589,0.28365,3038,0.000002,0.00005,4,0.000067,0,14,0.333333,0.000086
30047,Lake County,,MT,1949,26446,28395,11,9,20,3096,3385,6481,6,0.293876,0.307462,206.519401,0.001762,0.000613,4,0.000186,0,14,0.780303,0.017186
30049,Lewis and Clark County,,MT,4496,66165,70661,31,26,57,10608,9396,20004,5,0.362977,0.383955,7793.980488,0.005574,0.006222,4,0.000506,0,14,0.473485,0.053476
30051,Liberty County,,MT,143,2231,2374,0,0,0,0,0,0,0,0,0,0,0,0,35,0.000049,28,61,0,0
30053,Lincoln County,,MT,1274,18789,20063,5,5,10,1420,1719,3139,6,0.328917,0.342349,0,0.000918,0.000995,4,0.000105,0,14,1,0.009004
30055,McCone County,,MT,97,2022,2119,1,0,1,48,0,48,0,0,0,0,0,0,4,0.000068,0,2,0,0.000065
30057,Madison County,,MT,521,7113,7634,2,4,6,660,697,1357,6,0.274739,0.284471,0,0.000069,0.000176,4,0.000082,0,14,1,0.001017
30059,Meagher County,,MT,159,2350,2509,0,0,0,0,0,0,0,0,0,0,0,0,36,0.000049,29,62,0,0
30061,Mineral County,,MT,281,4058,4339,1,1,2,463,460,923,6,0.273938,0.282873,0,0.00008,0.000076,4,0.000062,0,14,0,0.000786
30063,Missoula County,,MT,8916,103705,112621,61,58,119,22478,22172,44650,5,0.377245,0.402941,35452.983316,0.012976,0.013582,4,0.000847,0,14,0.430946,0.120753
30065,Musselshell County,,MT,527,4354,4881,1,1,2,385,667,1052,6,0.27479,0.284238,0,0.000069,0.000075,4,0.000066,0,14,0,0.000799
30067,Park County,,MT,1454,16686,18140,6,4,10,2102,1982,4084,6,0.279832,0.290413,3.691921,0.000262,0.000277,4,0.000149,0,14,0.633333,0.003184
30069,Petroleum County,,MT,-2,-2,-4,0,0,0,0,0,0,0,0,0,0,0,0,37,0.000049,30,63,0,0
30071,Phillips County,,MT,353,4716,5069,1,2,3,40,202,242,6,0.274815,0.284404,0,0.000069,0.000078,4,0.000066,0,14,1,0.000799
30073,Pondera County,,MT,474,7027,7501,4,5,9,570,626,1196,6,0.280538,0.290446,3.094712,0.000078,0.000175,4,0.000105,0,14,0.533333,0.000734
30075,Powder River County,,MT,119,1617,1736,0,0,0,0,0,0,0,0,0,0,0,0,38,0.000049,31,64,0,0
30077,Powell County,,MT,518,5761,6279,4,5,9,586,896,1482,6,0.274764,0.284637,0,0.000134,0.000209,4,0.000111,0,14,0.95,0.001394
30079,Prairie County,,MT,131,1311,1442,0,0,0,0,0,0,0,0,0,0,0,0,39,0.000049,32,65,0,0
30081,Ravalli County,,MT,3234,39893,43127,18,17,35,6060,5860,11920,5,0.358302,0.378124,129.686361,0.005257,0.004303,4,0.000246,0,14,0.871345,0.048304
30083,Richland County,,MT,608,10817,11425,4,3,7,565,616,1181,6,0.279442,0.289475,28.380154,0.000071,0.000169,4,0.000121,0,14,0.45,0.001022
30085,Roosevelt County,,MT,601,11177,11778,2,5,7,271,697,968,6,0.275672,0.285908,24.977623,0.00007,0.00008,4,0.000092,0,14,0.45,0.000883
30087,Rosebud County,,MT,855,10504,11359,3,5,8,928,1418,2346,6,0.279858,0.290579,4.750561,0.000071,0.000246,4,0.000122,0,14,0.65,0.000949
30089,Sanders County,,MT,860,10600,11460,4,6,10,884,1315,2199,6,0.291283,0.303856,2.496837,0.000153,0.000474,4,0.000113,0,14,0.733333,0.002104
30091,Sheridan County,,MT,274,4393,4667,0,1,1,0,119,119,6,0.274831,0.284309,0,0,0.000075,4,0.000049,0,66,0,0
30093,Silver Bow County,,MT,2503,35150,37653,13,15,28,3894,4421,8315,5,0.354789,0.373685,1334.300957,0.001036,0.00272,4,0.000251,0,14,0.610294,0.010577
30095,Stillwater County,,MT,873,9542,10415,4,3,7,1444,1406,2850,6,0.278638,0.288471,128.173288,0.00076,0.000168,4,0.000114,0,14,0.75,0.007488
30097,Sweet Grass County,,MT,381,3845,4226,1,3,4,162,391,553,6,0.278638,0.288471,0,0.000069,0.000169,4,0.000066,0,14,1,0.000799
30099,Teton County,,MT,488,7391,7879,1,4,5,463,800,1263,6,0.280669,0.290613,0,0.000074,0.000158,4,0.000058,0,14,0.75,0.000518
30101,Toole County,,MT,400,5487,5887,3,3,6,209,302,511,6,0.280433,0.290002,0,0.000077,0.000141,4,0.000087,0,14,0.833333,0.000668
30103,Treasure County,,MT,-2,-2,-4,0,0,0,0,0,0,0,0,0,0,0,0,40,0.000049,33,67,0,0
30105,Valley County,,MT,550,8376,8926,2,2,4,235,328,563,6,0.278613,0.288304,2.555392,0.000069,0.000168,4,0.000082,0,14,0.666667,0.000869
30107,Wheatland County,,MT,158,2168,2326,0,1,1,0,78,78,6,0.274831,0.284309,0,0,0.000075,4,0.000049,0,68,0,0
30109,Wibaux County,,MT,73,1094,1167,0,0,0,0,0,0,0,0,0,0,0,0,41,0.000049,34,69,0,0
30111,Yellowstone County,,MT,8549,154204,162753,76,65,141,24635,20094,44729,5,0.378862,0.406164,88602.678793,0.012785,0.011674,4,0.001303,0,14,0.276573,0.119971
31001,Adams County,,NE,1886,33723,35609,13,9,22,3378,3632,7010,5,0.353412,0.370894,6529.797646,0.000656,0.001206,18,0.000292,0,14,0.412088,0.005653
31003,Antelope County,,NE,469,8257,8726,2,3,5,349,698,1047,6,0.314127,0.324906,0,0.000191,0.000391,18,0.000072,0,14,1,0.001252
31005,Arthur County,,NE,-2,-2,-4,0,0,0,0,0,0,0,0,0,0,0,0,42,0.000049,35,70,0,0
31007,Banner County,,NE,71,710,781,0,0,0,0,0,0,0,0,0,0,0,0,43,0.000049,36,71,0,0
31009,Blaine County,,NE,-2,-2,-4,0,0,0,0,0,0,0,0,0,0,0,0,44,0.000049,37,72,0,0
31011,Boone County,,NE,314,6737,7051,3,3,6,191,345,536,6,0.313766,0.324517,10.527276,0.000023,0.000383,18,0.000097,0,14,0.75,0.000334
31013,Box Butte County,,NE,946,14132,15078,4,5,9,686,893,1579,6,0.304233,0.315546,852.982689,0.000195,0.000203,18,0.000128,0,14,0.533333,0.001427
31015,Boyd County,,NE,110,2670,2780,0,0,0,0,0,0,0,0,0,0,0,0,45,0.000049,38,73,0,0
31017,Brown County,,NE,350,3742,4092,0,0,0,0,0,0,0,0,0,0,0,0,46,0.000049,39,74,0,0
31019,Buffalo County,,NE,3621,47540,51161,21,21,42,7603,7571,15174,5,0.357151,0.376542,18081.956828,0.000694,0.002279,18,0.000464,0,14,0.24,0.006437
31021,Burt County,,NE,616,8533,9149,3,5,8,880,1122,2002,6,0.313799,0.324795,0.35,0.000311,0.000391,18,0.000094,0,14,0.9,0.002661
31023,Butler County,,NE,717,10356,11073,5,8,13,1171,1626,2797,6,0.31393,0.32535,34.146952,0.00048,0.000396,18,0.000136,0,14,0.589286,0.003809
31025,Cass County,,NE,2566,29027,31593,6,6,12,6374,5989,12363,6,0.316978,0.328185,2.58356,0.000627,0.000524,18,0.000137,0,14,0.766667,0.005059
31027,Cedar County,,NE,576,11372,11948,4,6,10,429,1117,1546,6,0.314555,0.325821,54.723543,0.000198,0.000395,18,0.000114,0,14,0.566667,0.00143
31029,Chase County,,NE,319,4664,4983,0,1,1,0,101,101,6,0.29981,0.309956,0,0,0.000106,18,0.000049,0,75,0,0
31031,Cherry County,,NE,454,6841,7295,1,2,3,161,181,342,6,0.29995,0.310281,37.104929,0.000001,0.000107,18,0.000087,0,14,0,0.00007
31033,Cheyenne County,,NE,824,11720,12544,5,5,10,560,686,1246,6,0.304079,0.315146,90.54795,0.00021,0.000207,18,0.000129,0,14,0.466667,0.00163
31035,Clay County,,NE,582,7519,8101,2,4,6,518,963,1481,6,0.313865,0.324795,0,0.000179,0.000399,18,0.000089,0,14,1,0.001193
31037,Colfax County,,NE,852,11730,12582,6,6,12,1106,1843,2949,6,0.314259,0.32546,1.331532,0.000505,0.0004,18,0.000133,0,14,0.9,0.004005
31039,Cuming County,,NE,665,11529,12194,5,5,10,735,1216,1951,6,0.314193,0.325239,342.851213,0.000502,0.000395,18,0.000115,0,14,0.7,0.003895
31041,Custer County,,NE,723,13334,14057,5,6,11,634,1159,1793,6,0.314029,0.325294,0,0.000218,0.000416,18,0.00013,0,14,1,0.001718
31043,Dakota County,,NE,2407,22996,25403,11,10,21,4936,5350,10286,5,0.354999,0.372354,957.92425,0.001731,0.001272,18,0.000192,0,14,0.487179,0.014386
31045,Dawes County,,NE,849,8579,9428,4,9,13,649,1181,1830,5,0.317279,0.329416,4383.567053,0.000194,0.000501,18,0.000137,0,14,0.388889,0.001427
31047,Dawson County,,NE,2068,28068,30136,14,14,28,2848,3730,6578,5,0.358772,0.37743,9721.721451,0.002054,0.001732,18,0.000263,0,14,0.363971,0.018222
31049,Deuel County,,NE,223,2233,2456,0,0,0,0,0,0,0,0,0,0,0,0,47,0.000049,40,76,0,0
31051,Dixon County,,NE,405,7235,7640,4,4,8,620,705,1325,6,0.313178,0.323741,5.063688,0.00006,0.000316,18,0.000112,0,14,0.55,0.000655
31053,Dodge County,,NE,2529,41880,44409,12,12,24,5395,6120,11515,5,0.353828,0.37156,239.577995,0.000659,0.00124,18,0.000234,0,14,0.49359,0.005688
31055,Douglas County,,NE,33753,543653,577406,200,186,386,104518,107385,211903,5,0.454738,0.488648,188611.642505,0.046439,0.051043,18,0.002406,0,14,0.31275,0.403149
31057,Dundy County,,NE,173,2377,2550,0,0,0,0,0,0,0,0,0,0,0,0,48,0.000049,41,77,0,0
31059,Fillmore County,,NE,430,7692,8122,2,2,4,432,579,1011,6,0.2998,0.310059,0,0.000174,0.000109,18,0.000087,0,14,1,0.001177
31061,Franklin County,,NE,201,4059,4260,2,2,4,217,250,467,6,0.263209,0.270617,0,0.000014,0.000004,18,0.000089,0,14,1,0.000189
31063,Frontier County,,NE,301,2978,3279,2,2,4,142,286,428,6,0.267093,0.274806,0,0.00002,0.000017,18,0.000081,0,14,1,0.000301
31065,Furnas County,,NE,424,6095,6519,1,4,5,110,475,585,6,0.30004,0.310725,1.333333,0.000002,0.000113,18,0.000074,0,14,0.833333,0.000077
31067,Gage County,,NE,1709,26459,28168,8,6,14,2925,2954,5879,6,0.31393,0.3251,204.455599,0.000483,0.000388,18,0.000238,0,14,0.303571,0.004032
31069,Garden County,,NE,238,2360,2598,0,0,0,0,0,0,0,0,0,0,0,0,49,0.000049,42,78,0,0
31071,Garfield County,,NE,123,2121,2244,0,0,0,0,0,0,0,0,0,0,0,0,50,0.000049,43,79,0,0
31073,Gosper County,,NE,263,2571,2834,1,2,3,276,339,615,6,0.268238,0.276209,0,0.00001,0.000016,18,0.000065,0,14,1,0.000179
31075,Grant County,,NE,73,943,1016,0,0,0,0,0,0,0,0,0,0,0,0,51,0.000049,44,80,0,0
31077,Greeley County,,NE,194,3056,3250,1,1,2,72,43,115,7,0.23074,0.235484,0,0.000013,0.000001,18,0.000066,0,14,1,0.000212
31079,Hall County,,NE,4156,62133,66289,22,21,43,8004,8247,16251,5,0.359933,0.379611,10125.94606,0.002513,0.002283,18,0.000427,0,14,0.28,0.022205
31081,Hamilton County,,NE,819,11670,12489,5,6,11,1438,1580,3018,6,0.31393,0.325128,264.89324,0.000491,0.000402,18,0.000133,0,14,0.733333,0.003912
31083,Harlan County,,NE,271,3913,4184,1,2,3,80,259,339,6,0.263232,0.270672,0,0.000002,0.000005,18,0.000066,0,14,1,0.000079
31085,Hayes County,,NE,91,1120,1211,0,0,0,0,0,0,0,0,0,0,0,0,52,0.000049,45,81,0,0
31087,Hitchcock County,,NE,298,3450,3748,1,1,2,264,285,549,7,0.238982,0.243798,0,0.000002,0.000001,18,0.000074,0,14,0,0.000077
31089,Holt County,,NE,642,12250,12892,3,3,6,295,617,912,6,0.314127,0.324906,0,0.000492,0.000391,18,0.000083,0,14,1,0.003707
31091,Hooker County,,NE,76,1064,1140,0,0,0,0,0,0,0,0,0,0,0,0,53,0.000049,46,82,0,0
31093,Howard County,,NE,595,7525,8120,4,3,7,1041,1010,2051,6,0.29989,0.310336,3075.080192,0.000188,0.000121,18,0.000154,0,14,0.5,0.00143
31095,Jefferson County,,NE,505,9397,9902,4,3,7,653,916,1569,6,0.29989,0.310308,1.819048,0.000178,0.00011,18,0.000153,0,14,0.666667,0.001361
31097,Johnson County,,NE,435,5230,5665,3,3,6,587,852,1439,6,0.29992,0.310364,0.444444,0.000177,0.000112,18,0.000114,0,14,0.833333,0.001269
31099,Kearney County,,NE,654,7663,8317,3,5,8,1117,1462,2579,6,0.30007,0.310891,142.38961,0.000016,0.000116,18,0.000123,0,14,0.65,0.000266
31101,Keith County,,NE,705,9496,10201,3,4,7,482,799,1281,6,0.30001,0.310669,3038.25,0.000182,0.000116,18,0.000098,0,14,0.666667,0.001271
31103,Keya Paha County,,NE,75,1076,1151,0,0,0,0,0,0,0,0,0,0,0,0,54,0.000049,47,83,0,0
31105,Kimball County,,NE,337,4258,4595,3,3,6,268,398,666,6,0.27702,0.286524,4.224813,0.000097,0.000087,18,0.000096,0,14,0.833333,0.001019
31107,Knox County,,NE,501,10392,10893,3,5,8,318,876,1194,6,0.314489,0.325599,15.360926,0.000196,0.000393,18,0.000093,0,14,0.65,0.001339
31109,Lancaster County,,NE,17255,297856,315111,115,128,243,45189,46009,91198,5,0.428042,0.460308,179476.521759,0.01804,0.029129,18,0.001918,0,14,0.258641,0.16391
31111,Lincoln County,,NE,2307,41012,43319,14,15,29,3666,4003,7669,5,0.354412,0.372836,2831.198158,0.000893,0.00158,18,0.000288,0,14,0.385621,0.008072
31113,Logan County,,NE,81,1009,1090,0,0,0,0,0,0,0,0,0,0,0,0,55,0.000049,48,84,0,0
31115,Loup County,,NE,43,780,823,0,0,0,0,0,0,0,0,0,0,0,0,56,0.000049,49,85,0,0
31117,McPherson County,,NE,57,573,630,0,0,0,0,0,0,0,0,0,0,0,0,57,0.000049,50,86,0,0
31119,Madison County,,NE,3190,41537,44727,18,30,48,5261,7701,12962,5,0.372982,0.395756,8212.263566,0.001784,0.003286,18,0.000348,0,14,0.256989,0.015343
31121,Merrick County,,NE,785,9035,9820,3,6,9,918,1430,2348,6,0.31393,0.325128,23.318423,0.000017,0.000402,18,0.000129,0,14,0.733333,0.000377
31123,Morrill County,,NE,493,5481,5974,1,1,2,498,659,1157,6,0.263555,0.270911,0,0.000021,0.000013,18,0.000063,0,14,0,0.000201
31125,Nance County,,NE,235,4337,4572,1,3,4,236,357,593,6,0.29989,0.310336,0,0.000003,0.00011,18,0.000068,0,14,0.833333,0.000102
31127,Nemaha County,,NE,572,7854,8426,4,4,8,804,910,1714,6,0.313766,0.324628,18.341194,0.000478,0.000384,18,0.000113,0,14,0.75,0.003704
31129,Nuckolls County,,NE,271,5846,6117,1,2,3,54,325,379,6,0.29986,0.31017,0,0.000007,0.00011,18,0.000077,0,14,1,0.000108
31131,Otoe County,,NE,1267,18159,19426,6,8,14,2784,3148,5932,6,0.317112,0.328601,50.96082,0.000481,0.000509,18,0.000169,0,14,0.482143,0.003915
31133,Pawnee County,,NE,165,3153,3318,0,2,2,0,187,187,6,0.2999,0.310205,0,0,0.000109,18,0.000049,0,87,1,0
31135,Perkins County,,NE,269,3638,3907,1,3,4,67,275,342,6,0.29989,0.310336,0,0.000001,0.000113,18,0.00007,0,14,1,0.000074
31137,Phelps County,,NE,820,11240,12060,6,8,14,1073,1352,2425,6,0.314193,0.325793,3892.946153,0.000197,0.000415,18,0.000161,0,14,0.5,0.001581
31139,Pierce County,,NE,532,8977,9509,4,4,8,870,1035,1905,6,0.314193,0.325128,0.660256,0.000196,0.000394,18,0.000109,0,14,0.733333,0.001394
31141,Platte County,,NE,2220,38201,40421,12,12,24,3828,4728,8556,6,0.317816,0.330016,3564.616483,0.000537,0.000533,18,0.000268,0,14,0.416667,0.004605
31143,Polk County,,NE,376,6601,6977,4,3,7,665,698,1363,6,0.29989,0.310336,1.142857,0.00018,0.000112,18,0.00012,0,14,0.666667,0.001368
31145,Red Willow County,,NE,840,12834,13674,5,6,11,742,1139,1881,6,0.313996,0.325239,9085.831081,0.000195,0.000389,18,0.000176,0,14,0.466667,0.001457
31147,Richardson County,,NE,535,10214,10749,3,4,7,567,774,1341,6,0.313898,0.32485,51.129611,0.000176,0.000384,18,0.000104,0,14,0.5,0.00125
31149,Rock County,,NE,133,1675,1808,0,0,0,0,0,0,0,0,0,0,0,0,58,0.000049,51,88,0,0
31151,Saline County,,NE,1169,15884,17053,6,5,11,1753,2542,4295,6,0.313832,0.324822,245.091764,0.000873,0.000385,18,0.00016,0,14,0.553571,0.007374
31153,Sarpy County,,NE,17981,159239,177220,78,78,156,60237,49774,110011,5,0.419729,0.446649,20452.395469,0.019148,0.021744,18,0.00087,0,14,0.412323,0.163983
31155,Saunders County,,NE,1483,23901,25384,6,5,11,4158,4012,8170,6,0.316945,0.328018,2.187811,0.000613,0.0005,18,0.000133,0,14,0.766667,0.004875
31157,Scotts Bluff County,,NE,2492,39392,41884,20,23,43,3616,4153,7769,5,0.357832,0.377552,9126.793943,0.002216,0.003522,18,0.000376,0,14,0.445652,0.02104
31159,Seward County,,NE,1457,18284,19741,5,5,10,2660,2788,5448,6,0.313766,0.324739,4.338095,0.000192,0.000391,18,0.000147,0,14,0.566667,0.001499
31161,Sheridan County,,NE,528,6440,6968,2,2,4,330,399,729,6,0.240917,0.246183,3,0.000003,0.000002,18,0.000092,0,14,0.333333,0.000145
31163,Sherman County,,NE,241,3658,3899,1,2,3,118,430,548,6,0.265911,0.273746,0,0.000013,0.000019,18,0.000068,0,14,1,0.000121
31165,Sioux County,,NE,81,1306,1387,0,0,0,0,0,0,0,0,0,0,0,0,59,0.000049,52,89,0,0
31167,Stanton County,,NE,452,7524,7976,3,4,7,594,865,1459,6,0.31416,0.325072,0.809524,0.000024,0.000392,18,0.000099,0,14,0.8,0.000349
31169,Thayer County,,NE,394,6593,6987,2,3,5,152,458,610,6,0.313701,0.324406,10.638524,0.000172,0.000381,18,0.000105,0,14,0.666667,0.001159
31171,Thomas County,,NE,102,912,1014,0,0,0,0,0,0,0,0,0,0,0,0,60,0.000049,53,90,0,0
31173,Thurston County,,NE,397,7457,7854,3,4,7,548,874,1422,6,0.314127,0.325155,0,0.000356,0.000419,18,0.000086,0,14,1,0.002943
31175,Valley County,,NE,293,5119,5412,0,2,2,0,193,193,6,0.29993,0.310288,0,0,0.00011,18,0.000049,0,91,1,0
31177,Washington County,,NE,1557,22790,24347,7,7,14,4150,4084,8234,6,0.317011,0.328351,16.91195,0.000634,0.000526,18,0.000145,0,14,0.738095,0.005153
31179,Wayne County,,NE,776,9298,10074,6,6,12,941,1256,2197,6,0.314259,0.32546,478.214599,0.000498,0.000392,18,0.000146,0,14,0.547619,0.003929
31181,Webster County,,NE,265,4348,4613,1,2,3,183,347,530,6,0.29986,0.31017,0,0.000007,0.00011,18,0.000077,0,14,1,0.000108
31183,Wheeler County,,NE,69,964,1033,0,0,0,0,0,0,0,0,0,0,0,0,61,0.000049,54,92,0,0
31185,York County,,NE,1043,16153,17196,7,7,14,1691,2215,3906,6,0.313898,0.325183,81.315363,0.000492,0.000401,18,0.000205,0,14,0.452381,0.004065
32001,Churchill County,,NV,3029,25092,28121,20,16,36,5468,4840,10308,5,0.357449,0.376343,807.166118,0.005814,0.003746,4,0.000235,0,14,0.649351,0.051407
32003,Clark County,,NV,100325,1721219,1821544,621,570,1191,529530,362975,892505,5,0.514119,0.573053,294368.849787,0.110869,0.105674,4,0.005131,0,14,0.126442,0.925702
32005,Douglas County,,NV,5463,51508,56971,32,21,53,15005,12851,27856,5,0.360451,0.380387,1071.631625,0.009552,0.007475,4,0.000267,0,14,0.793561,0.080263
32007,Elko County,,NV,4067,47988,52055,29,26,55,9165,7970,17135,5,0.361145,0.381719,6560.733935,0.0061,0.005399,4,0.000404,0,14,0.527586,0.056646
32009,Esmeralda County,,NV,93,799,892,1,1,2,87,57,144,6,0.339589,0.35415,0,0.000623,0.000653,4,0.000057,0,14,0,0.005678
32011,Eureka County,,NV,192,1390,1582,1,1,2,123,102,225,6,0.265348,0.272953,0,0.000032,0.000036,4,0.000062,0,14,0,0.000405
32013,Humboldt County,,NV,1388,16697,18085,7,8,15,2197,2015,4212,5,0.352045,0.369396,273.642642,0.000968,0.00209,4,0.000145,0,14,0.652778,0.009454
32015,Lander County,,NV,497,5618,6115,4,3,7,635,707,1342,6,0.298638,0.310375,0,0.000915,0.000292,4,0.000093,0,14,1,0.008436
32017,Lincoln County,,NV,354,4007,4361,1,2,3,810,491,1301,6,0.339627,0.354316,0,0.000623,0.000688,4,0.000057,0,14,1,0.005678
32019,Lyon County,,NV,4936,43800,48736,36,23,59,25391,13656,39047,5,0.360754,0.38097,992.84894,0.009358,0.005863,4,0.000339,0,14,0.64359,0.078148
32021,Mineral County,,NV,522,4992,5514,4,3,7,479,545,1024,6,0.298995,0.310736,0,0.000928,0.00034,4,0.000089,0,14,1,0.008799
32023,Nye County,,NV,3638,36086,39724,19,15,34,15924,7682,23606,5,0.359287,0.378223,82.052663,0.007193,0.00457,4,0.00019,0,14,0.703557,0.061557
32027,Pershing County,,NV,496,5051,5547,3,4,7,551,861,1412,6,0.299024,0.310902,0.333333,0.000283,0.000346,4,0.000084,0,14,0.833333,0.002719
32029,Storey County,,NV,490,3581,4071,4,3,7,1929,1382,3311,6,0.298579,0.310264,0,0.000944,0.000352,4,0.000087,0,14,1,0.00888
32031,Washoe County,,NV,26029,416183,442212,164,167,331,94207,82614,176821,5,0.425496,0.462611,30675.907733,0.042484,0.04214,4,0.0014,0,14,0.396087,0.36979
32033,White Pine County,,NV,647,8409,9056,5,3,8,1536,845,2381,6,0.340011,0.354982,0,0.001318,0.00094,4,0.000096,0,14,0.95,0.012149
32510,Carson City,,NV,6510,58748,65258,25,19,44,16159,17030,33189,5,0.360321,0.379999,321.003195,0.007846,0.006413,4,0.000233,0,14,0.810541,0.065709
33001,Belknap County,,NH,5226,71668,76894,18,21,39,15721,13796,29517,5,0.354915,0.374234,32.387514,0.004359,0.006032,62,0.000136,0,14,0.898551,0.030278
33003,Carroll County,,NH,3603,54780,58383,21,19,40,10698,7786,18484,6,0.324476,0.341345,8.507492,0.004609,0.004188,62,0.000155,0,14,0.851779,0.032073
33005,Cheshire County,,NH,5091,87164,92255,29,30,59,12799,11701,24500,5,0.361579,0.382928,139.427532,0.008061,0.008036,62,0.000193,0,14,0.772269,0.058608
33007,Coos County,,NH,1956,39213,41169,12,13,25,3181,4193,7374,6,0.318355,0.332912,311.287589,0.002394,0.001484,62,0.000122,0,14,0.7375,0.016416
33009,Grafton County,,NH,7601,93954,101555,43,47,90,20562,19533,40095,5,0.375359,0.399662,6858.767954,0.010755,0.01471,62,0.000315,0,14,0.63522,0.083024
33011,Hillsborough County,,NH,29514,468352,497866,127,149,276,88645,92097,180742,5,0.421318,0.456991,6685.386819,0.04233,0.051806,62,0.000803,0,14,0.559543,0.342735
33013,Merrimack County,,NH,11664,165341,177005,35,52,87,36702,33502,70204,5,0.376158,0.400993,530.731255,0.010183,0.016753,62,0.000241,0,14,0.716282,0.078484
33015,Rockingham County,,NH,25532,351724,377256,74,98,172,81328,77594,158922,5,0.392988,0.424395,1890.372063,0.024468,0.033756,62,0.000471,0,14,0.620604,0.194453
33017,Strafford County,,NH,10149,130911,141060,35,47,82,29475,26925,56400,5,0.37091,0.395151,315.280472,0.009736,0.015749,62,0.000236,0,14,0.757255,0.073975
33019,Sullivan County,,NH,2966,48184,51150,13,13,26,7860,6728,14588,6,0.318794,0.333455,4.034554,0.00265,0.002075,62,0.000118,0,14,0.833333,0.018514
34001,Atlantic County,,NJ,14165,323902,338067,62,89,151,41092,42788,83880,5,0.394848,0.425144,319.041687,0.023422,0.034649,76,0.000337,0,14,0.790202,0.172264
34003,Bergen County,,NJ,62688,1031411,1094099,139,201,340,183623,210800,394423,5,0.42719,0.468048,2547.930158,0.051991,0.064737,13,0.000806,0,14,0.535156,0.406177
34005,Burlington County,,NJ,33247,528525,561772,128,166,294,99554,102242,201796,5,0.417803,0.456242,2406.314147,0.047076,0.056404,76,0.000789,0,14,0.577255,0.372277
34007,Camden County,,NJ,32343,586149,618492,100,130,230,102362,110463,212825,5,0.410214,0.444729,828.390468,0.038622,0.049069,76,0.000585,0,14,0.733259,0.300642
34009,Cape May County,,NJ,7687,113967,121654,27,44,71,16614,18244,34858,5,0.366968,0.390479,82.657173,0.00972,0.015801,76,0.000174,0,14,0.857005,0.071218
34011,Cumberland County,,NJ,6271,160792,167063,24,31,55,19114,16876,35990,5,0.360105,0.381142,38.845073,0.008423,0.011052,76,0.000158,0,14,0.904356,0.06082
34013,Essex County,,NJ,58670,818783,877453,123,183,306,152916,206136,359052,5,0.421792,0.461429,1885.605221,0.0468,0.059707,13,0.000714,0,14,0.562267,0.362271
34015,Gloucester County,,NJ,16282,322142,338424,46,64,110,66197,51082,117279,5,0.3818,0.409204,247.319751,0.017474,0.024376,76,0.000276,0,14,0.84482,0.131365
34017,Hudson County,,NJ,62837,637390,700227,167,179,346,180633,228620,409253,5,0.429388,0.467699,2685.87763,0.059164,0.061948,13,0.000985,0,14,0.571766,0.460769
34019,Hunterdon County,,NJ,9544,149026,158570,33,49,82,26543,22778,49321,5,0.378958,0.403795,10.741832,0.011499,0.018882,13,0.000176,0,14,0.879798,0.076055
34021,Mercer County,,NJ,24880,393857,418737,92,120,212,72850,80632,153482,5,0.408319,0.441816,338.185096,0.036596,0.045563,13,0.000538,0,14,0.747157,0.283702
34023,Middlesex County,,NJ,67417,903347,970764,163,233,396,211908,251188,463096,5,0.445037,0.48669,4745.501161,0.059083,0.073175,13,0.00098,0,14,0.469929,0.463037
34025,Monmouth County,,NJ,38853,727461,766314,101,172,273,110254,124233,234487,5,0.412581,0.451997,636.11237,0.039601,0.058038,13,0.000584,0,14,0.595435,0.309888
34027,Morris County,,NJ,37147,572527,609674,116,176,292,110421,121306,231727,5,0.424774,0.463055,1181.344177,0.044066,0.059823,13,0.000663,0,14,0.590462,0.338518
34029,Ocean County,,NJ,28745,634363,663108,91,145,236,110032,87868,197900,5,0.401068,0.4376,675.920451,0.032508,0.047357,13,0.000527,0,14,0.589183,0.252579
34031,Passaic County,,NJ,36402,563884,600286,73,142,215,91811,123093,214904,5,0.41145,0.447476,407.674934,0.028432,0.048564,13,0.0004,0,14,0.656678,0.212959
34033,Salem County,,NJ,3570,76486,80056,10,12,22,12113,9743,21856,6,0.314588,0.328867,0.151278,0.002513,0.002722,76,0.000092,0,14,0.954545,0.017357
34035,Somerset County,,NJ,29838,362753,392591,82,130,212,95539,95413,190952,5,0.413432,0.447864,455.33555,0.03329,0.047984,13,0.00047,0,14,0.713017,0.254537
34037,Sussex County,,NJ,10435,178220,188655,30,59,89,31609,27279,58888,5,0.373121,0.399118,10.304708,0.010332,0.020742,13,0.00016,0,14,0.81126,0.067266
34039,Union County,,NJ,43923,599207,643130,87,148,235,126825,152179,279004,5,0.409879,0.446699,690.41003,0.034201,0.05139,13,0.000498,0,14,0.652583,0.26198
34041,Warren County,,NJ,9148,127753,136901,27,38,65,27352,23281,50633,5,0.368137,0.390851,11.026112,0.008865,0.012827,13,0.000149,0,14,0.891986,0.057499
35001,Bernalillo County,,NM,38717,633202,671919,240,209,449,142715,129953,272668,5,0.455014,0.491911,53225.7347,0.067179,0.05811,4,0.002003,0,14,0.38053,0.568532
35003,Catron County,,NM,275,2800,3075,0,0,0,0,0,0,0,0,0,0,0,0,63,0.000049,55,93,0,0
35005,Chaves County,,NM,3903,59615,63518,24,26,50,7132,8148,15280,5,0.370498,0.392787,224.761083,0.007145,0.007655,4,0.000262,0,14,0.739418,0.064672
35006,Cibola County,,NM,1902,23291,25193,6,7,13,3935,4496,8431,5,0.350198,0.366927,0,0.0012,0.001415,4,0.000107,0,14,1,0.011898
35007,Colfax County,,NM,1199,14170,15369,3,6,9,522,1145,1667,6,0.330364,0.343359,4.091675,0.000374,0.001018,4,0.000081,0,14,0.6,0.003763
35009,Curry County,,NM,6053,45721,51774,29,39,68,7636,10147,17783,5,0.374424,0.398974,6455.605701,0.008381,0.008983,4,0.000332,0,14,0.497096,0.075432
35011,De Baca County,,NM,156,2121,2277,1,0,1,65,0,65,0,0,0,0,0.000053,0,4,0.000056,0,8,0,0.000508
35013,Dona Ana County,,NM,12118,185758,197876,67,64,131,37657,34274,71931,5,0.387563,0.414769,5455.081262,0.017973,0.019285,4,0.000662,0,14,0.506306,0.162212
35015,Eddy County,,NM,3496,52916,56412,20,19,39,5589,6144,11733,5,0.363153,0.384016,347.648693,0.004943,0.004928,4,0.000245,0,14,0.664502,0.046295
35017,Grant County,,NM,1941,29436,31377,14,13,27,3335,3828,7163,5,0.351921,0.369507,760.588425,0.004177,0.002452,4,0.000202,0,14,0.591912,0.038441
35019,Guadalupe County,,NM,315,4434,4749,2,2,4,272,445,717,6,0.312786,0.323657,0,0.000355,0.000408,4,0.000071,0,14,1,0.003547
35021,Harding County,,NM,74,720,794,0,0,0,0,0,0,0,0,0,0,0,0,64,0.000049,56,94,0,0
35023,Hidalgo County,,NM,398,5020,5418,2,4,6,291,509,800,6,0.324827,0.336773,0.125,0.000128,0.000796,4,0.000071,0,14,0.916667,0.001306
35025,Lea County,,NM,3188,58196,61384,26,21,47,6480,6635,13115,5,0.362452,0.383489,2248.576164,0.006447,0.003879,4,0.000309,0,14,0.595238,0.0587
35027,Lincoln County,,NM,1929,19378,21307,14,11,25,3333,3240,6573,5,0.356685,0.375222,5.054542,0.003553,0.002907,4,0.000175,0,14,0.847619,0.032301
35028,Los Alamos County,,NM,2049,22936,24985,8,8,16,2341,2952,5293,5,0.351798,0.369036,3.779274,0.002245,0.002374,4,0.000121,0,14,0.877778,0.020864
35029,Luna County,,NM,1714,25009,26723,8,6,14,2893,2776,5669,5,0.351633,0.368342,0,0.003252,0.002091,4,0.000117,0,14,0.964286,0.029758
35031,McKinley County,,NM,9075,84127,93202,14,17,31,23532,28405,51937,5,0.356812,0.376137,19.351236,0.003235,0.004529,4,0.00018,0,14,0.772059,0.030465
35033,Mora County,,NM,380,4949,5329,2,2,4,481,636,1117,6,0.312786,0.323657,0,0.000355,0.000408,4,0.000071,0,14,1,0.003547
35035,Otero County,,NM,6910,59479,66389,29,32,61,9430,10384,19814,5,0.372936,0.396172,135.064934,0.009299,0.009988,4,0.000283,0,14,0.679943,0.082006
35037,Quay County,,NM,730,9023,9753,2,4,6,455,878,1333,6,0.313963,0.32571,0,0.000395,0.000516,4,0.000065,0,14,0.833333,0.003875
35039,Rio Arriba County,,NM,2448,41535,43983,9,9,18,5233,6774,12007,5,0.35028,0.36726,7.408324,0.001973,0.001563,4,0.000138,0,14,0.818182,0.018854
35041,Roosevelt County,,NM,1872,17047,18919,7,8,15,2371,2941,5312,5,0.351756,0.369063,44.817429,0.00062,0.001456,4,0.000122,0,14,0.833333,0.006212
35043,Sandoval County,,NM,9801,108831,118632,55,42,97,47989,30863,78852,5,0.378338,0.402508,1330.750244,0.017823,0.013452,4,0.00051,0,14,0.593785,0.158227
35045,San Juan County,,NM,11958,139207,151165,45,44,89,32492,33619,66111,5,0.37252,0.397115,981.482863,0.010791,0.009965,4,0.000475,0,14,0.511373,0.099049
35047,San Miguel County,,NM,1757,26828,28585,10,11,21,3035,4269,7304,5,0.351551,0.369091,408.147419,0.002012,0.002155,4,0.000183,0,14,0.557692,0.019108
35049,Santa Fe County,,NM,10595,137862,148457,69,49,118,26253,26305,52558,5,0.384143,0.409537,1145.88422,0.02378,0.017801,4,0.00058,0,14,0.682294,0.207204
35051,Sierra County,,NM,877,10370,11247,7,4,11,1000,1095,2095,6,0.312982,0.324212,0.291667,0.002134,0.000558,4,0.000115,0,14,0.928571,0.019883
35053,Socorro County,,NM,1419,16363,17782,3,5,8,1597,2442,4039,6,0.31321,0.324656,0,0.000482,0.000702,4,0.000078,0,14,1,0.004727
35055,Taos County,,NM,1987,31865,33852,9,12,21,2520,3493,6013,5,0.358131,0.37642,154.606833,0.002384,0.003475,4,0.000139,0,14,0.719697,0.02253
35057,Torrance County,,NM,1506,13625,15131,5,4,9,3102,3284,6386,6,0.312851,0.32399,0,0.001219,0.000673,4,0.000099,0,14,1,0.012257
35059,Union County,,NM,317,4208,4525,0,1,1,0,88,88,7,0.215242,0.219868,0,0,0.000001,89,0.000049,0,95,0,0
35061,Valencia County,,NM,4990,68582,73572,21,18,39,15358,13060,28418,5,0.357576,0.376859,456.446182,0.005359,0.004316,4,0.000262,0,14,0.577899,0.047256
36001,Albany County,,NY,22750,333100,355850,103,129,232,68663,76176,144839,5,0.409376,0.443786,12535.194577,0.032374,0.042728,65,0.000629,0,14,0.556788,0.246504
36003,Allegany County,,NY,2791,49531,52322,11,11,22,5526,5599,11125,6,0.313603,0.327397,38.766985,0.001134,0.000844,65,0.000139,0,14,0.598485,0.007133
36005,Bronx County,,NY,95357,1270570,1365927,162,222,384,261379,356612,617991,5,0.437901,0.479905,5482.400357,0.05715,0.067766,13,0.000976,0,14,0.486729,0.450094
36007,Broome County,,NY,10394,220848,231242,62,86,148,21887,25099,46986,5,0.395523,0.425644,3643.530987,0.01897,0.028621,65,0.000397,0,14,0.611968,0.147185
36009,Cattaraugus County,,NY,4753,89870,94623,10,14,24,9725,10674,20399,6,0.349913,0.367882,193.427199,0.001113,0.002881,65,0.000132,0,14,0.566667,0.007017
36011,Cayuga County,,NY,3860,87441,91301,13,17,30,9033,9423,18456,5,0.357321,0.376326,58.862287,0.002047,0.003572,65,0.000117,0,14,0.757353,0.012966
36013,Chautauqua County,,NY,5756,147460,153216,18,33,51,8576,10780,19356,5,0.379101,0.401964,1197.398047,0.00604,0.01365,65,0.000172,0,14,0.696697,0.047651
36015,Chemung County,,NY,4706,97841,102547,13,23,36,7847,8954,16801,5,0.361492,0.381835,374.14934,0.001662,0.006363,65,0.000139,0,14,0.561265,0.01071
36017,Chenango County,,NY,3042,58892,61934,11,12,23,6607,6693,13300,6,0.313832,0.328146,10.209083,0.00244,0.001573,65,0.000101,0,14,0.754167,0.0153
36019,Clinton County,,NY,3270,89829,93099,19,22,41,5823,5468,11291,6,0.331421,0.350277,464.295294,0.003786,0.004696,65,0.000171,0,14,0.638333,0.024644
36021,Columbia County,,NY,3736,70481,74217,18,17,35,9193,8275,17468,6,0.35362,0.372115,9.496907,0.00504,0.004579,13,0.000122,0,14,0.876316,0.032823
36023,Cortland County,,NY,3018,50662,53680,12,13,25,5788,6011,11799,6,0.315414,0.330043,9.848652,0.002018,0.001559,65,0.000112,0,14,0.736264,0.012974
36025,Delaware County,,NY,2794,48320,51114,20,17,37,6876,6537,13413,6,0.324616,0.341717,42.004782,0.005055,0.003326,65,0.000143,0,14,0.748918,0.033368
36027,Dutchess County,,NY,17721,323172,340893,64,125,189,50245,51138,101383,5,0.403872,0.438293,1442.956839,0.023806,0.042282,13,0.000369,0,14,0.61711,0.179646
36029,Erie County,,NY,33409,1059122,1092531,172,233,405,75989,107866,183855,5,0.448626,0.489603,28326.209609,0.057019,0.072972,65,0.001115,0,14,0.451927,0.459389
36031,Essex County,,NY,2454,41211,43665,12,10,22,4593,4680,9273,6,0.29273,0.306097,15.949057,0.001715,0.00068,65,0.000122,0,14,0.659091,0.010747
36033,Franklin County,,NY,2075,50144,52219,10,11,21,3795,4287,8082,6,0.315745,0.330376,12.411253,0.001831,0.001652,65,0.000103,0,14,0.807692,0.012037
36035,Fulton County,,NY,2839,62158,64997,10,8,18,7104,6162,13266,6,0.292019,0.304699,3042.563341,0.000881,0.000619,65,0.000124,0,14,0.688889,0.005568
36037,Genesee County,,NY,3477,70740,74217,8,13,21,7657,8678,16335,5,0.351551,0.369369,80.228331,0.00108,0.001786,65,0.000104,0,14,0.685897,0.006728
36039,Greene County,,NY,2704,50525,53229,19,16,35,8986,6540,15526,6,0.324056,0.340829,44.676094,0.004866,0.003517,13,0.000138,0,14,0.777778,0.031826
36041,Hamilton County,,NY,437,5839,6276,1,4,5,142,420,562,6,0.283423,0.294441,0.2,0.000004,0.000213,65,0.000062,0,14,0.75,0.000104
36043,Herkimer County,,NY,3365,71765,75130,13,11,24,7856,8036,15892,6,0.309659,0.32404,47.196976,0.001171,0.001286,65,0.000142,0,14,0.557143,0.007658
36045,Jefferson County,,NY,13225,116302,129527,96,108,204,24894,29712,54606,5,0.417106,0.448741,8249.101318,0.031168,0.034286,65,0.000679,0,14,0.545293,0.256708
36047,Kings County,,NY,161137,2317952,2479089,304,313,617,421331,589258,1010589,5,0.464872,0.510991,34030.901345,0.085676,0.084533,13,0.002005,0,14,0.319073,0.690427
36049,Lewis County,,NY,1475,27411,28886,4,6,10,2466,2874,5340,6,0.311586,0.325227,1.919775,0.000735,0.000939,65,0.000068,0,14,0.833333,0.004723
36051,Livingston County,,NY,4199,69981,74180,9,10,19,9991,10314,20305,6,0.322837,0.337911,17.009172,0.001355,0.00159,65,0.000106,0,14,0.744444,0.008547
36053,Madison County,,NY,4853,74188,79041,13,17,30,11537,11564,23101,6,0.330509,0.348419,32.882446,0.001988,0.003393,65,0.000122,0,14,0.720588,0.013006
36055,Monroe County,,NY,33724,851881,885605,188,238,426,80860,105907,186767,5,0.445169,0.487522,40649.106933,0.060548,0.072493,65,0.001196,0,14,0.444504,0.481775
36057,Montgomery County,,NY,3374,57895,61269,14,10,24,8854,8543,17397,5,0.351099,0.368453,190.111401,0.003278,0.001345,65,0.000132,0,14,0.728571,0.022901
36059,Nassau County,,NY,82682,1587406,1670088,142,245,387,225130,284776,509906,5,0.439503,0.483694,4450.760661,0.052907,0.07282,13,0.000856,0,14,0.448117,0.420824
36061,New York County,,NY,163144,1507101,1670245,373,307,680,558364,615157,1173521,5,0.464512,0.510214,44505.668672,0.093716,0.08383,13,0.002508,0,14,0.281426,0.752623
36063,Niagara County,,NY,10476,252760,263236,24,51,75,25235,26680,51915,5,0.395471,0.421593,2116.715945,0.00848,0.019342,65,0.000196,0,14,0.666546,0.065408
36065,Oneida County,,NY,10451,259378,269829,54,70,124,21502,25752,47254,5,0.386864,0.415252,4087.082731,0.017122,0.023838,65,0.000368,0,14,0.612807,0.134047
36067,Onondaga County,,NY,23748,521789,545537,138,183,321,57159,70896,128055,5,0.431052,0.46953,17954.668451,0.045762,0.059165,65,0.000846,0,14,0.515071,0.35869
36069,Ontario County,,NY,6799,120878,127677,24,32,56,18751,17397,36148,5,0.374797,0.39722,1632.805481,0.003904,0.009873,65,0.000204,0,14,0.539039,0.029016
36071,Orange County,,NY,25274,400635,425909,90,170,260,75666,75516,151182,5,0.415606,0.454206,2472.279975,0.034145,0.052374,13,0.000532,0,14,0.514218,0.266229
36073,Orleans County,,NY,2749,47263,50012,5,5,10,5841,6315,12156,6,0.313145,0.32601,0,0.000987,0.000772,65,0.000077,0,14,1,0.006203
36075,Oswego County,,NY,7280,136270,143550,18,27,45,15319,16722,32041,5,0.364873,0.386385,143.382524,0.004099,0.007978,65,0.000144,0,14,0.685185,0.030136
36077,Otsego County,,NY,3708,66373,70081,22,23,45,7562,7801,15363,6,0.325143,0.343226,92.160072,0.005199,0.00447,65,0.000166,0,14,0.72,0.034543
36079,Putnam County,,NY,8043,113072,121115,16,33,49,22092,21271,43363,5,0.367507,0.389492,6.031981,0.006257,0.012285,13,0.000111,0,14,0.876894,0.042129
36081,Queens County,,NY,160783,2247662,2408445,245,301,546,419886,576731,996617,5,0.459468,0.50572,18491.802003,0.076527,0.083583,13,0.001544,0,14,0.357269,0.612336
36083,Rensselaer County,,NY,11393,176515,187908,42,63,105,35108,34971,70079,5,0.386914,0.414048,2873.499586,0.010235,0.022078,65,0.000291,0,14,0.643223,0.072192
36085,Richmond County,,NY,27129,493629,520758,57,113,170,78999,82918,161917,5,0.400801,0.433966,451.760235,0.023237,0.038236,13,0.000327,0,14,0.694584,0.174962
36087,Rockland County,,NY,18263,335432,353695,45,99,144,39726,53052,92778,5,0.398779,0.430415,119.6111,0.018448,0.035795,13,0.00025,0,14,0.756339,0.133562
36089,St. Lawrence County,,NY,4453,113077,117530,17,25,42,6149,7236,13385,5,0.366654,0.38816,329.248947,0.00348,0.007467,65,0.000138,0,14,0.678571,0.022502
36091,Saratoga County,,NY,16643,248715,265358,92,103,195,53386,48612,101998,5,0.395211,0.427197,11016.141198,0.02883,0.033085,65,0.000587,0,14,0.565427,0.220636
36093,Schenectady County,,NY,10286,172592,182878,39,58,97,31336,29883,61219,5,0.380109,0.405864,2580.019588,0.011941,0.019363,65,0.00027,0,14,0.668852,0.087016
36095,Schoharie County,,NY,1553,31480,33033,13,10,23,4279,3789,8068,6,0.291764,0.304683,21.974681,0.002816,0.000689,65,0.000114,0,14,0.785714,0.017447
36097,Schuyler County,,NY,1263,21057,22320,7,7,14,3119,3089,6208,6,0.308387,0.321638,1.318493,0.000664,0.000516,65,0.000098,0,14,0.857143,0.004412
36099,Seneca County,,NY,2327,37709,40036,10,11,21,4618,5006,9624,6,0.313341,0.32723,9.148634,0.001517,0.001155,65,0.00011,0,14,0.781818,0.00946
36101,Steuben County,,NY,5536,109864,115400,22,25,47,10560,11231,21791,5,0.361318,0.381863,514.589812,0.002428,0.005406,65,0.000196,0,14,0.422989,0.015131
36103,Suffolk County,,NY,74791,1769551,1844342,184,311,495,194220,252910,447130,5,0.449297,0.49909,16020.210774,0.062274,0.080777,13,0.001153,0,14,0.334173,0.502959
36105,Sullivan County,,NY,5009,79776,84785,20,30,50,14880,11380,26260,5,0.364652,0.385885,48.688207,0.006133,0.010178,13,0.000133,0,14,0.862069,0.040807
36107,Tioga County,,NY,3594,60484,64078,10,11,21,8102,8472,16574,6,0.313603,0.327674,22.453239,0.001195,0.001252,65,0.000117,0,14,0.636364,0.007671
36109,Tompkins County,,NY,8429,90088,98517,59,68,127,15219,19165,34384,5,0.397302,0.425117,4979.172605,0.019635,0.025425,65,0.00039,0,14,0.657595,0.152013
36111,Ulster County,,NY,10185,196644,206829,42,64,106,29577,26873,56450,5,0.377577,0.404627,675.687912,0.014221,0.022582,13,0.000243,0,14,0.740389,0.100757
36113,Warren County,,NY,4859,75602,80461,22,18,40,13972,12449,26421,5,0.362495,0.381974,838.173798,0.005308,0.004897,65,0.00017,0,14,0.624339,0.035086
36115,Washington County,,NY,4002,67343,71345,11,9,20,11692,10881,22573,6,0.291764,0.304544,3.342606,0.001511,0.000603,65,0.000113,0,14,0.7,0.009035
36117,Wayne County,,NY,5814,112338,118152,12,21,33,14890,15491,30381,5,0.362408,0.38264,232.673792,0.001596,0.006486,65,0.000124,0,14,0.606061,0.010465
36119,Westchester County,,NY,60513,1026013,1086526,149,218,367,165309,202889,368198,5,0.437263,0.478906,4032.086343,0.053891,0.068301,13,0.00087,0,14,0.508483,0.421358
36121,Wyoming County,,NY,2523,46473,48996,8,9,17,6488,6694,13182,6,0.313341,0.326787,2.800932,0.001071,0.000799,65,0.000101,0,14,0.777778,0.006684
36123,Yates County,,NY,1533,28175,29708,7,8,15,3313,3488,6801,6,0.308387,0.321749,1.162302,0.000603,0.000542,65,0.000096,0,14,0.857143,0.003736
37001,Alamance County,,NC,7137,149550,156687,35,29,64,23104,18965,42069,6,0.365139,0.386856,396.394786,0.00962,0.00731,66,0.000388,0,14,0.616144,0.086118
37003,Alexander County,,NC,2279,39121,41400,7,6,13,5611,5587,11198,6,0.32029,0.333677,0.274854,0.000676,0.000881,66,0.000142,0,14,0.928571,0.008273
37005,Alleghany County,,NC,562,11238,11800,6,4,10,838,838,1676,7,0.245345,0.252617,1008.066573,0.000756,0.000032,66,0.000144,0,14,0.666667,0.007989
37007,Anson County,,NC,1375,25891,27266,6,9,15,2538,3442,5980,6,0.32308,0.337633,3.327187,0.000921,0.002297,66,0.00012,0,14,0.805556,0.010699
37009,Ashe County,,NC,1114,26468,27582,7,9,16,1933,1853,3786,6,0.321559,0.335924,4920.243496,0.001233,0.001552,66,0.000167,0,14,0.533333,0.012837
37011,Avery County,,NC,1153,16507,17660,5,6,11,1253,1671,2924,6,0.320598,0.334204,51.630475,0.000065,0.00087,66,0.000139,0,14,0.52381,0.000995
37013,Beaufort County,,NC,2492,49017,51509,13,10,23,4918,5615,10533,6,0.319847,0.33401,324.105395,0.001326,0.001611,66,0.000253,0,14,0.525641,0.014854
37015,Bertie County,,NC,1164,21788,22952,6,7,13,2135,2617,4752,6,0.319506,0.333123,11.881073,0.000134,0.000718,66,0.000137,0,14,0.517857,0.001704
37017,Bladen County,,NC,1676,31409,33085,10,9,19,3958,4376,8334,6,0.326735,0.341861,0.444228,0.002025,0.002446,66,0.000166,0,14,0.933333,0.021158
37019,Brunswick County,,NC,5286,83900,89186,77,28,105,29157,12763,41920,6,0.331348,0.349684,276.004425,0.021078,0.006208,66,0.000662,0,14,0.517483,0.174094
37021,Buncombe County,,NC,14202,231797,245999,153,106,259,47421,39794,87215,5,0.414345,0.445534,41215.856385,0.043719,0.032235,66,0.00159,0,14,0.450004,0.390966
37023,Burke County,,NC,4679,94777,99456,16,19,35,11617,12541,24158,6,0.327661,0.344862,602.027957,0.001994,0.003041,66,0.000264,0,14,0.596491,0.022838
37025,Cabarrus County,,NC,11185,161072,172257,97,38,135,49981,33053,83034,5,0.379101,0.403035,1146.177484,0.033919,0.010727,66,0.000785,0,14,0.651342,0.280328
37027,Caldwell County,,NC,3886,89404,93290,18,18,36,9836,10186,20022,6,0.324231,0.340324,1031.370207,0.00377,0.003082,66,0.000259,0,14,0.640476,0.036964
37029,Camden County,,NC,825,9480,10305,7,5,12,3050,1839,4889,6,0.319608,0.332795,6.609799,0.001102,0.0007,104,0.00012,0,14,0.857143,0.008727
37031,Carteret County,,NC,4836,66608,71444,25,22,47,10715,9134,19849,5,0.356939,0.376875,173.677237,0.00589,0.006337,66,0.000288,0,14,0.635468,0.054353
37033,Caswell County,,NC,1494,24295,25789,9,9,18,4445,4531,8976,6,0.319642,0.333566,10.05483,0.001317,0.001561,66,0.000139,0,14,0.708333,0.013563
37035,Catawba County,,NC,9751,168228,177979,54,39,93,28484,25969,54453,5,0.36474,0.387095,1049.915944,0.015327,0.008773,66,0.000577,0,14,0.550435,0.143134
37037,Chatham County,,NC,4545,58182,62727,23,16,39,15351,12899,28250,6,0.327626,0.343858,9.667971,0.00661,0.003827,66,0.000259,0,14,0.766304,0.0591
37039,Cherokee County,,NC,1293,24627,25920,19,8,27,2911,1667,4578,6,0.29356,0.304949,5540.877638,0.005499,0.000374,13,0.000388,0,14,0.497368,0.049909
37041,Chowan County,,NC,918,15416,16334,8,7,15,1699,1576,3275,6,0.319439,0.333012,122.422341,0.001078,0.000713,104,0.000155,0,14,0.544444,0.008604
37043,Clay County,,NC,590,9368,9958,4,3,7,1199,992,2191,7,0.242356,0.248575,7.835384,0.000554,0.000081,13,0.000229,0,14,0.583333,0.005269
37045,Cleveland County,,NC,5554,105139,110693,21,20,41,13363,13924,27287,6,0.328306,0.345245,30.024954,0.003098,0.004629,66,0.000317,0,14,0.695652,0.038755
37047,Columbus County,,NC,2259,54280,56539,10,11,21,4976,5552,10528,6,0.326984,0.342443,27.988306,0.002213,0.003106,66,0.000171,0,14,0.787879,0.023628
37049,Craven County,,NC,12231,103038,115269,72,61,133,22988,23292,46280,5,0.393967,0.420955,3688.556473,0.025272,0.021892,66,0.000603,0,14,0.612918,0.211157
37051,Cumberland County,,NC,48523,310016,358539,301,277,578,114122,132436,246558,5,0.461161,0.504294,46474.276121,0.079671,0.075051,66,0.002342,0,14,0.318323,0.664864
37053,Currituck County,,NC,1843,22083,23926,7,10,17,6156,4187,10343,6,0.326344,0.341511,8.094126,0.00119,0.001792,104,0.000114,0,14,0.766667,0.009391
37055,Dare County,,NC,3354,35347,38701,18,19,37,3998,4334,8332,6,0.33568,0.355249,6407.571894,0.004328,0.004403,104,0.00023,0,14,0.493846,0.037725
37057,Davidson County,,NC,8567,174929,183496,34,30,64,27897,25866,53763,6,0.330946,0.349351,219.118472,0.005616,0.005525,66,0.000455,0,14,0.563492,0.058795
37059,Davie County,,NC,2232,41928,44160,12,10,22,7831,6077,13908,6,0.32315,0.337827,21.70051,0.001821,0.002344,66,0.000196,0,14,0.74359,0.019829
37061,Duplin County,,NC,2822,49376,52198,13,14,27,6522,7386,13908,6,0.328234,0.343775,4.335309,0.002989,0.003074,66,0.000181,0,14,0.866667,0.028542
37063,Durham County,,NC,23618,239147,262765,187,141,328,81660,77539,159199,5,0.430558,0.464481,15988.67314,0.057775,0.04749,66,0.001519,0,14,0.498283,0.482899
37065,Edgecombe County,,NC,4682,58875,63557,9,13,22,12499,14664,27163,6,0.325355,0.341395,18.472532,0.001466,0.002658,66,0.00015,0,14,0.75641,0.013922
37067,Forsyth County,,NC,20036,349290,369326,170,124,294,71019,63802,134821,5,0.416644,0.450222,37377.654252,0.050095,0.039133,66,0.00152,0,14,0.457263,0.427763
37069,Franklin County,,NC,3709,51743,55452,13,14,27,13040,10992,24032,6,0.326948,0.342749,26.856628,0.002956,0.002997,66,0.000179,0,14,0.7125,0.027129
37071,Gaston County,,NC,10786,210501,221287,59,38,97,38239,30877,69116,5,0.366565,0.388981,995.891593,0.017905,0.009261,66,0.000597,0,14,0.581845,0.160328
37073,Gates County,,NC,680,10888,11568,8,7,15,2485,1221,3706,6,0.319779,0.333294,13.812679,0.001221,0.000844,104,0.000124,0,14,0.642857,0.009748
37075,Graham County,,NC,394,8431,8825,1,2,3,112,328,440,7,0.227008,0.232292,1.265079,0.000002,0.000034,13,0.00009,0,14,0,0.00035
37077,Granville County,,NC,3165,52042,55207,13,14,27,10782,8804,19586,6,0.32315,0.338438,32.270194,0.002251,0.002589,66,0.000191,0,14,0.628571,0.022754
37079,Greene County,,NC,1336,18060,19396,5,5,10,3271,3844,7115,6,0.320017,0.333278,0,0.000694,0.000775,66,0.000101,0,14,1,0.006888
37081,Guilford County,,NC,29153,475657,504810,251,186,437,109635,95984,205619,5,0.437009,0.474928,55077.857018,0.064911,0.052103,66,0.002176,0,14,0.347261,0.541722
37083,Halifax County,,NC,2954,58245,61199,16,16,32,5765,7464,13229,6,0.328629,0.345495,5220.845601,0.003051,0.003192,66,0.000217,0,14,0.444737,0.026856
37085,Harnett County,,NC,9070,92307,101377,43,36,79,30095,24511,54606,6,0.370224,0.393237,730.814343,0.012775,0.010472,66,0.000419,0,14,0.565901,0.114347
37087,Haywood County,,NC,2942,60302,63244,21,12,33,6150,4775,10925,6,0.332558,0.348691,550.584397,0.00757,0.002915,66,0.000294,0,14,0.677536,0.069801
37089,Henderson County,,NC,6293,103603,109896,48,32,80,18887,13766,32653,6,0.344061,0.36473,1624.523618,0.015752,0.009295,66,0.000523,0,14,0.624579,0.144839
37091,Hertford County,,NC,1336,21843,23179,8,9,17,2413,2792,5205,6,0.319915,0.33401,134.71558,0.001129,0.001434,66,0.000141,0,14,0.490909,0.010484
37093,Hoke County,,NC,4939,34718,39657,18,18,36,15297,11697,26994,6,0.351798,0.370439,122.292985,0.005205,0.005217,66,0.000205,0,14,0.683983,0.048398
37095,Hyde County,,NC,307,5057,5364,3,2,5,278,400,678,6,0.274689,0.284038,0.142857,0.000128,0.000119,66,0.000093,0,14,0.666667,0.00147
37097,Iredell County,,NC,9040,153987,163027,90,44,134,34243,24444,58687,5,0.372936,0.397082,10735.065895,0.029001,0.010654,66,0.000796,0,14,0.565845,0.242966
37099,Jackson County,,NC,2481,29893,32374,14,8,22,4502,4165,8667,6,0.323011,0.337522,245.806302,0.003012,0.001577,66,0.000291,0,14,0.576923,0.030372
37101,Johnston County,,NC,8959,143589,152548,74,32,106,40104,26824,66928,6,0.336018,0.356292,598.545697,0.02175,0.006254,66,0.000635,0,14,0.550068,0.177278
37103,Jones County,,NC,813,9766,10579,3,4,7,1871,1914,3785,6,0.31439,0.327486,0,0.000609,0.000615,66,0.000073,0,14,1,0.004911
37105,Lee County,,NC,3700,56034,59734,14,14,28,9535,9286,18821,6,0.326948,0.342749,0.87001,0.003662,0.003292,66,0.000192,0,14,0.883333,0.035327
37107,Lenoir County,,NC,3219,63965,67184,13,16,29,6970,8882,15852,6,0.329603,0.345939,63.374309,0.001996,0.003554,66,0.000195,0,14,0.775,0.019516
37109,Lincoln County,,NC,4877,75667,80544,23,17,40,17754,14546,32300,6,0.354873,0.373164,71.004097,0.005697,0.004104,66,0.000285,0,14,0.685185,0.055442
37111,McDowell County,,NC,1998,44479,46477,9,12,21,4177,4279,8456,6,0.323324,0.33841,181.936931,0.000841,0.001673,66,0.000199,0,14,0.613636,0.009846
37113,Macon County,,NC,1821,33019,34840,20,8,28,3462,1725,5187,6,0.323254,0.337911,377.482758,0.006734,0.001497,66,0.000308,0,14,0.688312,0.061139
37115,Madison County,,NC,1206,19666,20872,3,4,7,2865,2692,5557,6,0.293245,0.303867,1.61456,0.000262,0.000366,66,0.000097,0,14,0.45,0.003675
37117,Martin County,,NC,1408,26807,28215,6,6,12,2770,3374,6144,6,0.319269,0.332623,107.409214,0.000603,0.000691,66,0.000143,0,14,0.633333,0.006219
37119,Mecklenburg County,,NC,61016,826515,887531,467,325,792,310173,236490,546663,5,0.470036,0.516151,164276.845398,0.096962,0.082775,66,0.003881,0,14,0.199744,0.802448
37121,Mitchell County,,NC,842,16633,17475,4,4,8,1293,1250,2543,6,0.29313,0.303673,48.07436,0.000207,0.000264,66,0.000131,0,14,0.583333,0.0026
37123,Montgomery County,,NC,1528,26993,28521,10,12,22,3227,3744,6971,6,0.323185,0.338132,1.458125,0.001094,0.002465,66,0.000178,0,14,0.863636,0.014125
37125,Moore County,,NC,5170,87686,92856,36,24,60,12296,9876,22172,6,0.348371,0.366722,290.280113,0.010608,0.00564,66,0.000363,0,14,0.591026,0.09269
37127,Nash County,,NC,7593,99764,107357,25,19,44,22151,21395,43546,6,0.331275,0.34863,70.291493,0.005965,0.004283,66,0.00028,0,14,0.61396,0.053551
37129,New Hanover County,,NC,14832,174713,189545,162,100,262,53355,46494,99849,5,0.40507,0.43649,7714.691786,0.045844,0.032565,66,0.001344,0,14,0.459866,0.376654
37131,Northampton County,,NC,1486,21787,23273,5,8,13,2620,3425,6045,6,0.319881,0.333844,84.971844,0.000601,0.001118,66,0.000112,0,14,0.589286,0.006188
37133,Onslow County,,NC,34401,154298,188699,246,278,524,71324,83065,154389,5,0.457927,0.502241,28918.050321,0.071134,0.07792,66,0.001794,0,14,0.359792,0.586107
37135,Orange County,,NC,13230,114578,127808,94,66,160,35878,39024,74902,5,0.398726,0.42642,2938.748113,0.032306,0.024809,66,0.000801,0,14,0.621386,0.2737
37137,Pamlico County,,NC,864,13181,14045,3,4,7,1274,1674,2948,6,0.319269,0.332401,0,0.000615,0.000829,66,0.000089,0,14,1,0.006161
37139,Pasquotank County,,NC,2843,37381,40224,19,18,37,8286,6097,14383,6,0.335755,0.353617,341.274149,0.004274,0.004107,104,0.000241,0,14,0.516304,0.036084
37141,Pender County,,NC,3544,42321,45865,14,14,28,12669,9474,22143,6,0.329494,0.34555,10.811174,0.003931,0.003439,66,0.000189,0,14,0.753676,0.036566
37143,Perquimans County,,NC,828,11880,12708,8,5,13,2750,1626,4376,6,0.319337,0.332623,7.835681,0.001129,0.000711,104,0.000134,0,14,0.711111,0.00907
37145,Person County,,NC,1731,40804,42535,9,9,18,5049,4632,9681,6,0.322907,0.337494,19.582129,0.001303,0.002132,66,0.000145,0,14,0.677778,0.013583
37147,Pitt County,,NC,9621,138922,148543,80,62,142,30216,25108,55324,5,0.378576,0.405088,15398.174136,0.018866,0.01567,66,0.000878,0,14,0.431796,0.164406
37149,Polk County,,NC,1262,20535,21797,6,6,12,2792,2921,5713,6,0.320495,0.334121,0,0.001121,0.001506,66,0.000124,0,14,1,0.013113
37151,Randolph County,,NC,7438,148209,155647,27,24,51,21541,20544,42085,6,0.330291,0.347742,93.00715,0.005512,0.004474,66,0.000352,0,14,0.648276,0.056475
37153,Richmond County,,NC,2251,47636,49887,15,20,35,4278,5250,9528,6,0.327554,0.344191,53.510432,0.002186,0.003981,66,0.000219,0,14,0.62381,0.023985
37155,Robeson County,,NC,5023,121803,126826,27,21,48,11599,12816,24415,6,0.327697,0.344524,240.207593,0.006151,0.003834,66,0.000324,0,14,0.58547,0.05853
37157,Rockingham County,,NC,4299,102237,106536,13,18,31,11239,11785,23024,6,0.323846,0.339825,1219.396369,0.001677,0.002885,66,0.000195,0,14,0.522876,0.017384
37159,Rowan County,,NC,7568,142544,150112,30,25,55,21330,19761,41091,6,0.331129,0.349018,77.622169,0.008017,0.005832,66,0.000372,0,14,0.738636,0.078696
37161,Rutherford County,,NC,2860,66848,69708,16,15,31,5497,6251,11748,6,0.323777,0.339492,28.739601,0.003281,0.003008,66,0.000233,0,14,0.679739,0.033141
37163,Sampson County,,NC,3231,61558,64789,14,16,30,7780,8487,16267,6,0.329603,0.345939,5.947765,0.0029,0.003609,66,0.000198,0,14,0.858333,0.028831
37165,Scotland County,,NC,2335,37861,40196,9,13,22,4696,5718,10414,6,0.327055,0.342776,21.818009,0.001838,0.0032,66,0.000141,0,14,0.826923,0.018394
37167,Stanly County,,NC,2811,64456,67267,13,14,27,7197,6838,14035,6,0.323463,0.338771,6.954825,0.001666,0.002893,66,0.000214,0,14,0.783333,0.020788
37169,Stokes County,,NC,2945,50840,53785,8,9,17,8596,8568,17164,6,0.323115,0.337689,13.83676,0.000727,0.001882,66,0.000148,0,14,0.766667,0.007638
37171,Surry County,,NC,3452,77007,80459,15,15,30,8096,8743,16839,6,0.323812,0.339409,4246.6034,0.001739,0.002662,66,0.000277,0,14,0.54902,0.019564
37173,Swain County,,NC,966,17635,18601,5,4,9,1829,1813,3642,6,0.293102,0.303617,1497.479564,0.000225,0.00036,66,0.000185,0,14,0.6,0.003497
37175,Transylvania County,,NC,1763,31501,33264,7,7,14,2399,2855,5254,6,0.320529,0.334288,1.561577,0.001383,0.001555,66,0.000156,0,14,0.736111,0.015255
37177,Tyrrell County,,NC,257,3781,4038,2,2,4,369,354,723,7,0.251423,0.259344,0.5,0.00003,0.000026,66,0.000083,0,14,0.5,0.000363
37179,Union County,,NC,9840,166751,176591,123,43,166,60542,28515,89057,5,0.369359,0.392504,2283.10707,0.043377,0.011702,66,0.000902,0,14,0.633921,0.351939
37181,Vance County,,NC,2810,47357,50167,8,12,20,5880,7396,13276,6,0.32308,0.338105,8.799302,0.001465,0.002526,66,0.00013,0,14,0.692308,0.013624
37183,Wake County,,NC,50044,794741,844785,438,315,753,284344,183293,467637,5,0.468204,0.513793,154690.416207,0.095257,0.080911,66,0.003605,0,14,0.220589,0.787422
37185,Warren County,,NC,1307,17274,18581,7,9,16,2614,3414,6028,6,0.319779,0.333788,6.478564,0.000832,0.001387,66,0.000125,0,14,0.722222,0.008524
37187,Washington County,,NC,816,14018,14834,6,6,12,1204,1591,2795,6,0.319337,0.332734,402.167723,0.000136,0.000691,66,0.000167,0,14,0.47619,0.001758
37189,Watauga County,,NC,3503,36909,40412,24,23,47,6396,7377,13773,6,0.325849,0.34307,2394.531293,0.00428,0.004219,66,0.000359,0,14,0.534483,0.045738
37191,Wayne County,,NC,8652,119470,128122,44,46,90,14337,16910,31247,5,0.382724,0.408123,1558.754023,0.01115,0.013649,66,0.000438,0,14,0.528651,0.101155
37193,Wilkes County,,NC,2730,73451,76181,16,14,30,5597,5882,11479,6,0.323567,0.338881,1148.532249,0.002426,0.002186,66,0.00027,0,14,0.6125,0.025327
37195,Wilson County,,NC,4198,81935,86133,21,19,40,10215,10573,20788,6,0.330037,0.346799,53.381407,0.004184,0.003894,66,0.00026,0,14,0.707792,0.039524
37197,Yadkin County,,NC,1981,41452,43433,9,10,19,6201,6143,12344,6,0.323185,0.337883,6.475707,0.001164,0.002054,66,0.00017,0,14,0.9,0.013056
37199,Yancey County,,NC,782,17980,18762,4,3,7,1512,1320,2832,6,0.293073,0.303451,1,0.000204,0.000264,66,0.000124,0,14,0.666667,0.002611
38001,Adams County,,ND,168,2893,3061,0,0,0,0,0,0,0,0,0,0,0,0,67,0.000049,57,96,0,0
38003,Barnes County,,ND,707,12867,13574,3,4,7,860,1345,2205,6,0.281194,0.291256,6.2,0.00006,0.00006,18,0.000131,0,14,0.666667,0.000681
38005,Benson County,,ND,458,7168,7626,1,4,5,436,955,1391,6,0.285959,0.296344,0,0.000001,0.000095,18,0.000071,0,14,0.916667,0.000079
38007,Billings County,,ND,84,956,1040,0,0,0,0,0,0,0,0,0,0,0,0,68,0.000049,58,97,0,0
38009,Bottineau County,,ND,439,8064,8503,2,3,5,405,666,1071,6,0.287299,0.297747,0,0.000051,0.000097,18,0.000076,0,14,1,0.000496
38011,Bowman County,,ND,229,3830,4059,0,1,1,0,61,61,6,0.262308,0.269318,0,0,0.000001,18,0.000049,0,98,0,0
38013,Burke County,,ND,173,2634,2807,1,1,2,85,215,300,6,0.277224,0.285836,0,0.000051,0.000039,18,0.000061,0,14,0,0.000419
38015,Burleigh County,,ND,5032,86298,91330,39,30,69,16316,12835,29151,5,0.362671,0.384437,59519.269926,0.002707,0.003933,18,0.001042,0,14,0.170202,0.025342
38017,Cass County,,ND,11167,150141,161308,81,72,153,34610,29790,64400,5,0.390485,0.41827,115598.006018,0.007211,0.009629,18,0.001663,0,14,0.16518,0.067637
38019,Cavalier County,,ND,243,5736,5979,0,2,2,0,336,336,6,0.285674,0.295591,0,0,0.000078,18,0.000049,0,99,1,0
38021,Dickey County,,ND,406,6121,6527,2,3,5,189,374,563,6,0.281142,0.291045,4.827778,0.000061,0.000047,18,0.000102,0,14,0.666667,0.000651
38023,Divide County,,ND,138,2621,2759,0,1,1,0,59,59,7,0.225381,0.23096,0,0,0.000001,18,0.000049,0,100,0,0
38025,Dunn County,,ND,209,3840,4049,1,1,2,189,271,460,6,0.262266,0.269241,0,0.000007,0.000001,18,0.000082,0,14,0,0.000084
38027,Eddy County,,ND,170,2925,3095,0,1,1,0,114,114,6,0.280894,0.290338,0,0,0.000043,18,0.000049,0,101,0,0
38029,Emmons County,,ND,261,4696,4957,1,1,2,129,370,499,6,0.26617,0.274168,0,0.000023,0.000016,18,0.000079,0,14,0,0.000248
38031,Foster County,,ND,223,4191,4414,1,2,3,102,290,392,6,0.280931,0.290546,0,0.000003,0.000044,18,0.000072,0,14,1,0.000081
38033,Golden Valley County,,ND,141,1955,2096,0,1,1,0,62,62,6,0.262308,0.269318,0,0,0.000001,18,0.000049,0,102,0,0
38035,Grand Forks County,,ND,7617,69474,77091,41,49,90,12089,14953,27042,5,0.389877,0.414814,35010.446522,0.006058,0.010532,18,0.000727,0,14,0.317043,0.055153
38037,Grant County,,ND,127,3110,3237,0,2,2,0,169,169,6,0.266235,0.274409,0,0,0.00002,18,0.000049,0,103,1,0
38039,Griggs County,,ND,184,3162,3346,1,1,2,92,191,283,6,0.280853,0.290269,0,0.000057,0.000043,18,0.000069,0,14,0,0.000529
38041,Hettinger County,,ND,157,3067,3224,1,1,2,125,176,301,6,0.262266,0.269241,0,0.000007,0.000001,18,0.000082,0,14,0,0.000084
38043,Kidder County,,ND,192,3117,3309,1,1,2,135,264,399,6,0.26617,0.274168,0,0.000023,0.000016,18,0.000079,0,14,0,0.000248
38045,LaMoure County,,ND,318,5303,5621,1,2,3,64,354,418,6,0.280931,0.290546,0,0.000003,0.000044,18,0.000072,0,14,1,0.000081
38047,Logan County,,ND,111,2369,2480,0,1,1,0,65,65,6,0.266212,0.274243,0,0,0.000016,18,0.000049,0,104,0,0
38049,McHenry County,,ND,420,6518,6938,1,2,3,542,801,1343,6,0.278923,0.28816,0,0.000051,0.000055,18,0.000061,0,14,1,0.000419
38051,McIntosh County,,ND,171,3762,3933,1,1,2,48,173,221,6,0.26617,0.274168,0,0.000023,0.000016,18,0.000079,0,14,0,0.000248
38053,McKenzie County,,ND,361,5556,5917,1,3,4,180,390,570,6,0.266288,0.274667,0.9,0.000001,0.000018,18,0.000075,0,14,0.666667,0.000084
38055,McLean County,,ND,766,10693,11459,4,5,9,957,1470,2427,6,0.287354,0.29808,0.25,0.000134,0.000102,18,0.000145,0,14,0.9,0.001306
38057,Mercer County,,ND,527,10612,11139,4,4,8,598,1031,1629,6,0.281194,0.291256,0,0.000085,0.000063,18,0.000159,0,14,1,0.00086
38059,Morton County,,ND,2266,29784,32050,12,8,20,6871,6126,12997,5,0.32734,0.341206,1450.29228,0.000656,0.000571,18,0.00033,0,14,0.401515,0.005883
38061,Mountrail County,,ND,599,8113,8712,5,3,8,622,842,1464,6,0.287299,0.297747,45.130739,0.000131,0.000097,18,0.000156,0,14,0.65,0.001336
38063,Nelson County,,ND,255,4087,4342,1,2,3,138,314,452,6,0.285633,0.295523,0,0.000062,0.000078,18,0.000062,0,14,1,0.000412
38065,Oliver County,,ND,178,2410,2588,1,2,3,95,221,316,6,0.266194,0.274334,0,0.000023,0.00002,18,0.000079,0,14,1,0.000248
38067,Pembina County,,ND,611,10004,10615,3,3,6,571,1030,1601,6,0.28566,0.295689,0,0.000122,0.000079,18,0.000105,0,14,1,0.001014
38069,Pierce County,,ND,317,5102,5419,2,3,5,220,267,487,6,0.287299,0.297747,0,0.000051,0.000097,18,0.000076,0,14,1,0.000496
38071,Ramsey County,,ND,910,13479,14389,6,6,12,1281,1700,2981,6,0.288292,0.299284,6094.908427,0.000171,0.000133,18,0.000154,0,14,0.571429,0.001567
38073,Ransom County,,ND,485,6679,7164,3,3,6,532,765,1297,6,0.280905,0.290601,1,0.000057,0.000043,18,0.000141,0,14,0.666667,0.000671
38075,Renville County,,ND,272,3012,3284,1,1,2,383,508,891,6,0.277224,0.285836,0,0.000051,0.000039,18,0.000061,0,14,0,0.000419
38077,Richland County,,ND,1474,19604,21078,6,8,14,2008,3187,5195,5,0.326273,0.340013,180.938338,0.000131,0.000554,18,0.000179,0,14,0.597222,0.001468
38079,Rolette County,,ND,674,14033,14707,4,7,11,833,1464,2297,6,0.288319,0.299451,97.266732,0.000193,0.000135,18,0.000123,0,14,0.642857,0.001609
38081,Sargent County,,ND,336,5100,5436,4,3,7,439,509,948,6,0.280905,0.290601,2,0.000061,0.000044,18,0.000157,0,14,0.5,0.000747
38083,Sheridan County,,ND,84,1723,1807,0,0,0,0,0,0,0,0,0,0,0,0,69,0.000049,59,105,0,0
38085,Sioux County,,ND,293,3677,3970,2,3,5,336,542,878,6,0.266288,0.274639,6072.625,0.000023,0.00002,18,0.000108,0,14,0.5,0.000314
38087,Slope County,,ND,-2,-2,-4,0,0,0,0,0,0,0,0,0,0,0,0,70,0.000049,60,106,0,0
38089,Stark County,,ND,1500,26371,27871,10,11,21,1928,2562,4490,5,0.355461,0.373657,18501.555113,0.000136,0.001268,18,0.000428,0,14,0.346154,0.001718
38091,Steele County,,ND,199,2522,2721,0,1,1,0,196,196,6,0.280894,0.290338,0,0,0.000043,18,0.000049,0,107,0,0
38093,Stutsman County,,ND,1366,24144,25510,7,8,15,1661,2355,4016,5,0.326344,0.340124,6357.346307,0.000194,0.000534,18,0.000212,0,14,0.486111,0.001808
38095,Towner County,,ND,188,3200,3388,1,2,3,61,213,274,6,0.280931,0.290546,0,0.000001,0.000044,18,0.000071,0,14,1,0.000079
38097,Traill County,,ND,575,9506,10081,2,2,4,1050,1222,2272,6,0.285633,0.295523,0,0.000119,0.000078,18,0.000081,0,14,1,0.000941
38099,Walsh County,,ND,729,13902,14631,3,4,7,959,1453,2412,5,0.325849,0.33897,43.056797,0.000119,0.000515,18,0.000111,0,14,0.833333,0.001014
38101,Ward County,,ND,7072,67019,74091,33,44,77,8379,10420,18799,5,0.383506,0.407973,48233.793611,0.006586,0.008594,18,0.00062,0,14,0.349734,0.058072
38103,Wells County,,ND,288,5641,5929,1,2,3,60,375,435,6,0.281089,0.290812,0,0.000057,0.000058,18,0.000069,0,14,1,0.000529
38105,Williams County,,ND,1156,23068,24224,9,9,18,1727,1827,3554,6,0.29086,0.303445,6390.406044,0.000202,0.00021,18,0.000269,0,14,0.311111,0.001964
39001,Adams County,,OH,1473,30604,32077,10,11,21,3813,3963,7776,6,0.326557,0.341345,57.764356,0.000856,0.00144,71,0.000157,0,14,0.666667,0.00715
39003,Allen County,,OH,5899,123185,129084,18,27,45,11038,13804,24842,5,0.368815,0.390607,538.155086,0.002903,0.005333,72,0.000178,0,14,0.515873,0.020595
39005,Ashland County,,OH,3310,59321,62631,12,13,25,8900,7818,16718,6,0.325672,0.340807,7.189457,0.00183,0.001603,71,0.000125,0,14,0.736264,0.012705
39007,Ashtabula County,,OH,5014,118325,123339,15,21,36,11798,11870,23668,5,0.361666,0.382018,92.344507,0.003435,0.005722,71,0.000122,0,14,0.795238,0.024305
39009,Athens County,,OH,4294,52801,57095,27,26,53,7294,8425,15719,5,0.369678,0.390635,2248.053921,0.003692,0.005066,71,0.000316,0,14,0.43908,0.028301
39011,Auglaize County,,OH,2821,58102,60923,13,15,28,7913,8075,15988,6,0.327019,0.34251,23.652828,0.001229,0.00154,72,0.000151,0,14,0.616667,0.009166
39013,Belmont County,,OH,3125,77048,80173,13,16,29,6834,7277,14111,6,0.329422,0.346127,276.937604,0.001653,0.002204,76,0.000172,0,14,0.455882,0.012228
39015,Brown County,,OH,3272,49611,52883,9,12,21,10583,10399,20982,6,0.325884,0.340884,39.610905,0.00091,0.001435,71,0.000141,0,14,0.75,0.00744
39017,Butler County,,OH,24456,387049,411505,104,100,204,83387,75105,158492,5,0.420375,0.450638,17019.969213,0.031734,0.033758,71,0.000817,0,14,0.499672,0.259012
39019,Carroll County,,OH,2122,32938,35060,9,7,16,5842,6011,11853,6,0.324266,0.338366,24.130016,0.001696,0.000881,71,0.000105,0,14,0.847222,0.01167
39021,Champaign County,,OH,2939,45978,48917,10,9,19,8340,7898,16238,6,0.325566,0.339858,4.520649,0.001084,0.000962,71,0.000134,0,14,0.733333,0.008577
39023,Clark County,,OH,7507,162717,170224,19,26,45,16695,19032,35727,5,0.372843,0.394879,829.687353,0.003716,0.006712,71,0.000211,0,14,0.57265,0.030834
39025,Clermont County,,OH,14363,219346,233709,37,42,79,45725,42089,87814,5,0.395003,0.419901,2476.794927,0.011758,0.014572,71,0.000343,0,14,0.640408,0.094959
39027,Clinton County,,OH,3378,47442,50820,15,13,28,10875,9711,20586,6,0.326628,0.341678,32.205893,0.002006,0.001708,71,0.000182,0,14,0.685714,0.015989
39029,Columbiana County,,OH,5415,123251,128666,14,21,35,11798,13071,24869,5,0.363372,0.38386,287.664009,0.003077,0.005502,71,0.00014,0,14,0.671429,0.022877
39031,Coshocton County,,OH,1848,42891,44739,11,11,22,4163,4727,8890,6,0.325602,0.340474,4.821995,0.001612,0.001352,71,0.000134,0,14,0.763636,0.011637
39033,Crawford County,,OH,2878,55203,58081,9,12,21,6693,7944,14637,6,0.324546,0.339364,8.716997,0.000736,0.000865,71,0.000121,0,14,0.583333,0.006147
39035,Cuyahoga County,,OH,67916,1503884,1571800,245,294,539,151305,234687,385992,5,0.466532,0.510214,40749.396078,0.072436,0.082282,71,0.001676,0,14,0.353188,0.585991
39037,Darke County,,OH,2873,65738,68611,10,12,22,6237,7438,13675,6,0.326841,0.3419,61.033119,0.001071,0.001507,71,0.000133,0,14,0.651515,0.008486
39039,Defiance County,,OH,2643,48540,51183,10,16,26,6082,6476,12558,6,0.328737,0.345007,144.680367,0.00111,0.001993,72,0.000134,0,14,0.5625,0.007908
39041,Delaware County,,OH,12581,167254,179835,68,58,126,56814,36844,93658,5,0.397354,0.424257,5105.311429,0.017963,0.018172,71,0.00052,0,14,0.494146,0.14387
39043,Erie County,,OH,5387,93991,99378,16,21,37,12088,12822,24910,5,0.367507,0.388304,116.029537,0.003055,0.00505,71,0.00014,0,14,0.731602,0.020707
39045,Fairfield County,,OH,10342,155347,165689,30,33,63,35640,30301,65941,5,0.370087,0.392227,1478.659676,0.005535,0.007358,71,0.000306,0,14,0.485736,0.04342
39047,Fayette County,,OH,2022,32211,34233,9,9,18,5491,5529,11020,6,0.325637,0.339969,4.655348,0.001061,0.000958,71,0.000134,0,14,0.763889,0.008473
39049,Franklin County,,OH,78471,1247042,1325513,376,378,754,252026,273442,525468,5,0.47903,0.528484,305401.338895,0.086265,0.086842,71,0.002995,0,14,0.22679,0.703496
39051,Fulton County,,OH,2976,54013,56989,9,9,18,7939,7996,15935,6,0.325919,0.340751,19.198373,0.000955,0.001188,72,0.000111,0,14,0.666667,0.006947
39053,Gallia County,,OH,1556,32459,34015,7,9,16,2910,3143,6053,6,0.324862,0.339176,16.858436,0.000577,0.000565,71,0.00015,0,14,0.569444,0.005032
39055,Geauga County,,OH,6059,110310,116369,10,19,29,16943,15717,32660,5,0.373818,0.39453,6.257863,0.002281,0.006697,71,0.000096,0,14,0.913158,0.015521
39057,Greene County,,OH,16452,170371,186823,74,76,150,43444,45403,88847,5,0.408485,0.437045,7278.275391,0.019727,0.024663,71,0.000608,0,14,0.457111,0.162489
39059,Guernsey County,,OH,2183,47134,49317,12,11,23,4544,4835,9379,6,0.325707,0.34064,13.724055,0.001593,0.001347,71,0.000156,0,14,0.608974,0.011654
39061,Hamilton County,,OH,53986,925442,979428,216,221,437,129640,178900,308540,5,0.453434,0.491988,67050.265071,0.061903,0.066397,71,0.001679,0,14,0.388652,0.509175
39063,Hancock County,,OH,5203,86847,92050,22,26,48,11967,11091,23058,5,0.368906,0.390441,772.809017,0.00315,0.005294,72,0.000202,0,14,0.44086,0.021734
39065,Hardin County,,OH,2012,34438,36450,8,10,18,4527,5145,9672,6,0.324266,0.338698,6.207937,0.000617,0.000626,72,0.000119,0,14,0.577778,0.005244
39067,Harrison County,,OH,1034,17533,18567,6,8,14,2504,2690,5194,6,0.324301,0.338532,1.09787,0.00054,0.000888,71,0.000096,0,14,0.857143,0.003355
39069,Henry County,,OH,1957,36570,38527,8,9,17,4943,5608,10551,6,0.324511,0.338976,42.698834,0.000902,0.00075,72,0.000109,0,14,0.763889,0.006587
39071,Highland County,,OH,3092,47283,50375,15,14,29,9473,8987,18460,6,0.326699,0.3419,46.177199,0.001853,0.001698,71,0.000194,0,14,0.619048,0.014894
39073,Hocking County,,OH,1980,31544,33524,8,8,16,5716,5414,11130,6,0.324161,0.33831,1.708333,0.000651,0.000619,71,0.000136,0,14,0.839286,0.005632
39075,Holmes County,,OH,1691,42017,43708,7,7,14,3594,4762,8356,6,0.324161,0.338199,0.922619,0.000758,0.000666,71,0.000102,0,14,0.833333,0.005874
39077,Huron County,,OH,4121,74371,78492,14,19,33,10555,10987,21542,5,0.355167,0.374001,54.504781,0.002013,0.002527,71,0.000133,0,14,0.707602,0.013666
39079,Jackson County,,OH,1780,35739,37519,10,10,20,4345,4213,8558,6,0.324371,0.338837,14.461887,0.000581,0.000571,71,0.000182,0,14,0.577778,0.005385
39081,Jefferson County,,OH,3642,80783,84425,15,19,34,6340,7339,13679,5,0.358858,0.378412,463.166474,0.002277,0.003675,76,0.00018,0,14,0.523684,0.016338
39083,Knox County,,OH,3244,64319,67563,15,14,29,8632,7197,15829,6,0.325707,0.340973,18.552836,0.001789,0.00141,71,0.000165,0,14,0.6,0.013211
39085,Lake County,,OH,12966,280313,293279,31,52,83,38197,36328,74525,5,0.391299,0.417099,132.006731,0.011176,0.019959,71,0.000214,0,14,0.777778,0.086152
39087,Lawrence County,,OH,2814,66301,69115,10,10,20,7659,7065,14724,6,0.325566,0.34023,138.164309,0.001053,0.000586,71,0.000184,0,14,0.454545,0.008517
39089,Licking County,,OH,10068,185431,195499,34,34,68,32156,27487,59643,5,0.373492,0.395961,2209.531407,0.006119,0.007829,71,0.000341,0,14,0.434146,0.048322
39091,Logan County,,OH,3099,56149,59248,14,15,29,7870,7803,15673,6,0.326628,0.3419,23.206965,0.001265,0.001475,71,0.000165,0,14,0.62381,0.009986
39093,Lorain County,,OH,14996,343444,358440,51,80,131,47240,41995,89235,5,0.405781,0.434881,1557.051801,0.016969,0.02818,71,0.000351,0,14,0.638698,0.13574
39095,Lucas County,,OH,24387,499510,523897,97,133,230,52945,71593,124538,5,0.426281,0.45982,13094.226476,0.026206,0.042829,72,0.000689,0,14,0.480721,0.208927
39097,Madison County,,OH,3476,44091,47567,12,12,24,10628,9482,20110,6,0.325672,0.340357,9.180178,0.00125,0.001126,71,0.000161,0,14,0.69697,0.010022
39099,Mahoning County,,OH,12172,279339,291511,37,69,106,27486,34876,62362,5,0.396672,0.4247,741.744923,0.012126,0.02363,71,0.000253,0,14,0.641615,0.094242
39101,Marion County,,OH,3405,72796,76201,11,13,24,7424,7913,15337,5,0.354873,0.372947,151.705203,0.000732,0.001985,71,0.00015,0,14,0.542857,0.006463
39103,Medina County,,OH,11932,199615,211547,34,47,81,39762,32650,72412,5,0.388566,0.413948,570.72904,0.009057,0.014706,71,0.000239,0,14,0.676418,0.068342
39105,Meigs County,,OH,1136,23971,25107,7,7,14,2479,2655,5134,6,0.324581,0.338754,13.915065,0.000565,0.000553,71,0.000146,0,14,0.607143,0.005008
39107,Mercer County,,OH,2094,52441,54535,10,14,24,4372,4778,9150,6,0.327876,0.343675,157.066069,0.000933,0.001633,72,0.000137,0,14,0.587912,0.007506
39109,Miami County,,OH,6558,122621,129179,16,23,39,18459,17986,36445,5,0.366029,0.387001,271.742763,0.002093,0.004443,71,0.000175,0,14,0.612648,0.015918
39111,Monroe County,,OH,788,17596,18384,5,6,11,1168,1524,2692,6,0.324441,0.338476,381.349461,0.000539,0.000539,76,0.000108,0,14,0.566667,0.00467
39113,Montgomery County,,OH,34783,625858,660641,159,183,342,87451,108652,196103,5,0.442807,0.479366,32839.778238,0.045557,0.055051,71,0.001209,0,14,0.404214,0.37481
39115,Morgan County,,OH,1029,17405,18434,6,7,13,1922,2311,4233,6,0.324161,0.338199,0.859524,0.000618,0.000618,71,0.000109,0,14,0.928571,0.005205
39117,Morrow County,,OH,2634,36713,39347,7,7,14,7975,6993,14968,6,0.324126,0.338144,0.869048,0.000729,0.000696,71,0.000106,0,14,0.880952,0.006147
39119,Muskingum County,,OH,3972,100773,104745,14,19,33,9376,9967,19343,5,0.356009,0.374972,242.181222,0.001281,0.002809,71,0.000191,0,14,0.526316,0.010542
39121,Noble County,,OH,647,13654,14301,6,6,12,1453,1587,3040,6,0.324266,0.338255,2.615205,0.000563,0.000546,71,0.000114,0,14,0.766667,0.00487
39123,Ottawa County,,OH,2896,50849,53745,12,13,25,7630,7368,14998,5,0.356304,0.374778,13.592951,0.001942,0.00273,72,0.000117,0,14,0.818681,0.013151
39125,Paulding County,,OH,1290,24035,25325,6,7,13,2647,3127,5774,6,0.325672,0.34023,5.928068,0.000271,0.000846,72,0.000103,0,14,0.785714,0.001931
39127,Perry County,,OH,2359,38508,40867,7,8,15,7266,6916,14182,6,0.324161,0.33831,1.591667,0.000655,0.000618,71,0.000119,0,14,0.821429,0.005505
39129,Pickaway County,,OH,3593,55812,59405,12,14,26,13697,11048,24745,6,0.324476,0.339475,20.334557,0.000752,0.00076,71,0.000187,0,14,0.514286,0.006779
39131,Pike County,,OH,1793,29519,31312,8,7,15,3827,3981,7808,6,0.324266,0.338366,12.161011,0.00088,0.000546,71,0.000136,0,14,0.732143,0.007238
39133,Portage County,,OH,11717,171426,183143,30,36,66,35392,33400,68792,5,0.383947,0.407706,270.010926,0.00894,0.012404,71,0.000207,0,14,0.732869,0.066243
39135,Preble County,,OH,2856,50242,53098,10,10,20,7991,7633,15624,6,0.326699,0.341456,106.693339,0.001769,0.001615,71,0.000129,0,14,0.733333,0.013828
39137,Putnam County,,OH,1653,44729,46382,9,12,21,3779,4578,8357,6,0.326026,0.340912,49.026702,0.000929,0.001152,72,0.00012,0,14,0.636364,0.006735
39139,Richland County,,OH,6589,148202,154791,23,33,56,13844,16721,30565,5,0.368906,0.39119,985.991894,0.004406,0.006603,71,0.000203,0,14,0.561497,0.033204
39141,Ross County,,OH,3817,82254,86071,18,17,35,10104,9694,19798,6,0.326735,0.342288,74.240589,0.00145,0.001411,71,0.00025,0,14,0.488304,0.012025
39143,Sandusky County,,OH,3594,75710,79304,10,12,22,8656,9477,18133,5,0.354873,0.372836,10.68118,0.001595,0.002214,72,0.000108,0,14,0.878788,0.011049
39145,Scioto County,,OH,3012,77899,80911,14,18,32,5461,6280,11741,6,0.327626,0.343403,2535.414853,0.000956,0.001597,71,0.000234,0,14,0.415205,0.008129
39147,Seneca County,,OH,3538,68762,72300,12,15,27,7821,9053,16874,6,0.327804,0.343509,17.342825,0.001025,0.001975,72,0.00013,0,14,0.666667,0.007421
39149,Shelby County,,OH,3050,60440,63490,12,13,25,7217,7544,14761,6,0.326913,0.342122,12.739468,0.001512,0.001497,71,0.000142,0,14,0.75,0.011755
39151,Stark County,,OH,17112,448996,466108,64,89,153,44607,47400,92007,5,0.407654,0.437822,7052.572426,0.017674,0.02835,71,0.000494,0,14,0.501568,0.144144
39153,Summit County,,OH,30927,626836,657763,119,160,279,89464,98230,187694,5,0.431609,0.467477,13555.746448,0.037694,0.052817,71,0.000831,0,14,0.500306,0.306827
39155,Trumbull County,,OH,10533,260277,270810,26,49,75,22915,28279,51194,5,0.388566,0.414142,316.218125,0.007366,0.017726,71,0.000187,0,14,0.718367,0.05686
39157,Tuscarawas County,,OH,4757,113681,118438,15,18,33,10918,10921,21839,5,0.361841,0.381724,220.242484,0.001874,0.003753,71,0.000162,0,14,0.535714,0.013047
39159,Union County,,OH,3583,51621,55204,14,11,25,11561,9340,20901,5,0.354496,0.372254,118.402658,0.001782,0.001428,71,0.000163,0,14,0.590476,0.013467
39161,Van Wert County,,OH,1595,36758,38353,9,9,18,3332,3687,7019,6,0.325778,0.340618,115.377673,0.000826,0.000861,72,0.000124,0,14,0.6,0.006417
39163,Vinton County,,OH,921,13651,14572,8,7,15,2540,2508,5048,6,0.324126,0.338144,2.35,0.000608,0.000582,71,0.000142,0,14,0.722222,0.00537
39165,Warren County,,OH,16169,216473,232642,71,67,138,65100,49528,114628,5,0.407377,0.434854,4471.792945,0.022996,0.023247,71,0.000573,0,14,0.587252,0.189462
39167,Washington County,,OH,3696,68490,72186,13,15,28,6256,6886,13142,6,0.327411,0.343131,3425.873891,0.001285,0.001743,71,0.000224,0,14,0.466667,0.010025
39169,Wayne County,,OH,6683,136196,142879,14,23,37,16015,16050,32065,5,0.369632,0.39059,231.591803,0.001907,0.005305,71,0.000143,0,14,0.639493,0.013337
39171,Williams County,,OH,2405,47249,49654,12,12,24,4770,5279,10049,6,0.325884,0.341117,159.604103,0.001157,0.000929,72,0.000147,0,14,0.522727,0.008285
39173,Wood County,,OH,10635,134901,145536,40,48,88,30767,29593,60360,5,0.390739,0.416378,2481.411598,0.007228,0.012873,72,0.000309,0,14,0.476415,0.053597
39175,Wyandot County,,OH,1677,27800,29477,7,8,15,3919,4194,8113,6,0.324406,0.338698,2.842636,0.000614,0.000742,72,0.000104,0,14,0.694444,0.005135
40001,Adair County,,OK,1175,21423,22598,6,7,13,3057,3323,6380,6,0.313047,0.324939,0.976925,0.000526,0.000657,89,0.000132,0,14,0.833333,0.006093
40003,Alfalfa County,,OK,463,5172,5635,3,2,5,482,540,1022,6,0.270753,0.279522,0.333333,0.000052,0.000054,89,0.000115,0,14,0.666667,0.000709
40005,Atoka County,,OK,838,13492,14330,7,8,15,1751,1744,3495,6,0.314984,0.327391,642.622205,0.000413,0.000419,89,0.000152,0,14,0.535714,0.004101
40007,Beaver County,,OK,522,5643,6165,2,2,4,499,420,919,6,0.267641,0.275749,0,0.000028,0.000009,31,0.000083,0,14,1,0.000215
40009,Beckham County,,OK,1384,18899,20283,10,7,17,2932,2622,5554,6,0.315414,0.32753,6253.929036,0.000719,0.000539,89,0.000243,0,14,0.388889,0.006544
40011,Blaine County,,OK,801,10524,11325,6,8,14,1233,1690,2923,6,0.314819,0.327114,4.565796,0.000431,0.000598,89,0.000136,0,14,0.714286,0.004251
40013,Bryan County,,OK,2572,32683,35255,18,18,36,6891,6026,12917,6,0.337111,0.35491,349.668923,0.002732,0.002959,89,0.000278,0,14,0.506536,0.026614
40015,Caddo County,,OK,2016,28442,30458,7,8,15,3926,4704,8630,6,0.316978,0.329494,4.005425,0.000681,0.000648,89,0.000139,0,14,0.732143,0.00618
40017,Canadian County,,OK,8329,102503,110832,36,29,65,34906,25537,60443,5,0.368002,0.390485,3705.994038,0.006995,0.005918,89,0.000511,0,14,0.399716,0.06535
40019,Carter County,,OK,2947,47720,50667,20,21,41,6690,6741,13431,6,0.345327,0.364481,4023.840403,0.003485,0.003767,89,0.000294,0,14,0.5,0.033273
40021,Cherokee County,,OK,3047,38604,41651,17,16,33,7406,7766,15172,6,0.319065,0.33305,41.454393,0.00115,0.001241,89,0.000276,0,14,0.578947,0.012454
40023,Choctaw County,,OK,937,14157,15094,6,5,11,1466,1893,3359,6,0.314819,0.326781,17.277175,0.000938,0.000369,89,0.000119,0,14,0.733333,0.008487
40025,Cimarron County,,OK,273,2955,3228,0,0,0,0,0,0,0,0,0,0,0,0,73,0.000049,61,108,0,0
40027,Cleveland County,,OK,21439,223934,245373,101,98,199,79997,68858,148855,5,0.405891,0.43694,23073.810639,0.023093,0.024241,89,0.001142,0,14,0.35757,0.206181
40029,Coal County,,OK,412,5100,5512,2,3,5,467,739,1206,7,0.252395,0.260043,0.2,0.000017,0.000023,89,0.00008,0,14,0.833333,0.000283
40031,Comanche County,,OK,15584,109921,125505,72,92,164,24588,32272,56860,5,0.411281,0.441239,13578.836839,0.021175,0.025525,89,0.000671,0,14,0.475366,0.183635
40033,Cotton County,,OK,480,6183,6663,3,3,6,967,1023,1990,6,0.297898,0.309221,0,0.00029,0.000251,89,0.000074,0,14,1,0.002409
40035,Craig County,,OK,1035,13842,14877,5,6,11,2371,2376,4747,6,0.317816,0.330138,0.253781,0.00034,0.000704,89,0.000116,0,14,0.966667,0.003684
40037,Creek County,,OK,6284,69225,75509,21,16,37,19258,18432,37690,6,0.341247,0.359304,492.695038,0.002967,0.00158,89,0.000321,0,14,0.554762,0.028143
40039,Custer County,,OK,2140,24285,26425,14,14,28,4561,4917,9478,6,0.321043,0.334709,2512.396607,0.001501,0.001026,89,0.000264,0,14,0.445833,0.014096
40041,Delaware County,,OK,2873,33061,35934,18,15,33,7539,7076,14615,6,0.319337,0.333383,217.452967,0.001863,0.001127,89,0.000286,0,14,0.46732,0.018357
40043,Dewey County,,OK,405,5066,5471,2,3,5,257,493,750,6,0.314588,0.326171,0,0.000011,0.000338,89,0.000088,0,14,1,0.000258
40045,Ellis County,,OK,302,4030,4332,1,1,2,343,398,741,7,0.241363,0.2468,0,0.000005,0.000003,89,0.000072,0,14,0,0.000103
40047,Garfield County,,OK,5297,61162,66459,34,33,67,7985,8866,16851,5,0.371185,0.394896,14100.72159,0.008719,0.007989,89,0.000494,0,14,0.447561,0.07912
40049,Garvin County,,OK,1928,27103,29031,9,10,19,4086,4452,8538,6,0.317985,0.330859,7.65442,0.00085,0.000898,89,0.000167,0,14,0.788889,0.00816
40051,Grady County,,OK,3315,46752,50067,11,10,21,11040,9030,20070,6,0.320085,0.333184,8.78495,0.001024,0.001013,89,0.000186,0,14,0.745455,0.00974
40053,Grant County,,OK,437,4907,5344,2,2,4,558,674,1232,6,0.27085,0.279744,0,0.000063,0.000066,89,0.000074,0,14,1,0.000735
40055,Greer County,,OK,396,4814,5210,1,3,4,403,452,855,6,0.271855,0.280676,0,0.000044,0.000032,89,0.000058,0,14,0.666667,0.000297
40057,Harmon County,,OK,177,2951,3128,1,1,2,134,222,356,6,0.271708,0.280121,0,0.000044,0.000025,89,0.000058,0,14,0,0.000297
40059,Harper County,,OK,270,3648,3918,1,1,2,119,252,371,7,0.241363,0.2468,0,0.000005,0.000003,89,0.000072,0,14,0,0.000103
40061,Haskell County,,OK,734,11920,12654,6,7,13,1136,1438,2574,6,0.312136,0.323774,2.346198,0.000393,0.000406,0,0.000121,0,14,0.738095,0.003936
40063,Hughes County,,OK,954,11880,12834,8,9,17,1800,2222,4022,6,0.31785,0.330526,2.486147,0.000693,0.000844,89,0.00016,0,14,0.819444,0.00678
40065,Jackson County,,OK,4097,28083,32180,23,32,55,3651,5723,9374,5,0.373029,0.396216,13656.538618,0.00425,0.007427,89,0.000336,0,14,0.469048,0.038632
40067,Jefferson County,,OK,477,5782,6259,2,3,5,607,856,1463,6,0.285226,0.296338,0.313188,0.000039,0.000146,89,0.000072,0,14,0.666667,0.000508
40069,Johnston County,,OK,930,9474,10404,7,7,14,1555,1858,3413,6,0.314753,0.326892,4.132784,0.000404,0.000387,89,0.000148,0,14,0.690476,0.003912
40071,Kay County,,OK,3550,49288,52838,14,16,30,5157,6742,11899,5,0.362015,0.382163,1746.057892,0.002435,0.002619,89,0.000236,0,14,0.53268,0.021965
40073,Kingfisher County,,OK,928,15852,16780,6,7,13,1968,2198,4166,6,0.314753,0.326892,0.616667,0.000575,0.000603,89,0.000128,0,14,0.904762,0.005519
40075,Kiowa County,,OK,791,9635,10426,6,6,12,1139,1546,2685,6,0.317615,0.329855,121.281987,0.000538,0.000491,89,0.000128,0,14,0.595238,0.004603
40077,Latimer County,,OK,892,11338,12230,4,5,9,1400,1605,3005,6,0.317749,0.329916,2.711924,0.000356,0.000665,89,0.000101,0,14,0.8,0.003298
40079,Le Flore County,,OK,2865,43969,46834,14,15,29,5813,6631,12444,6,0.319201,0.333161,289.807319,0.000986,0.001189,0,0.000237,0,14,0.466667,0.009794
40081,Lincoln County,,OK,2672,32126,34798,10,10,20,6681,7203,13884,6,0.31785,0.330637,3.79127,0.000918,0.00092,89,0.00019,0,14,0.766667,0.008855
40083,Logan County,,OK,3005,34741,37746,14,10,24,9521,7974,17495,6,0.334447,0.350416,192.006291,0.002849,0.00148,89,0.000213,0,14,0.741758,0.026344
40085,Love County,,OK,696,8984,9680,2,4,6,1250,1433,2683,6,0.319439,0.332229,1.995454,0.000039,0.000794,89,0.000075,0,14,0.75,0.000477
40087,McClain County,,OK,2907,31083,33990,12,9,21,10680,8622,19302,6,0.332374,0.348319,57.520003,0.002236,0.001445,89,0.000183,0,14,0.787879,0.020336
40089,McCurtain County,,OK,1667,31214,32881,14,15,29,2310,2532,4842,6,0.337036,0.354466,1192.707025,0.001421,0.002027,89,0.000243,0,14,0.370833,0.013565
40091,McIntosh County,,OK,1360,17257,18617,9,9,18,3026,3065,6091,6,0.317816,0.33047,9.147855,0.001064,0.000863,89,0.000153,0,14,0.636364,0.00961
40093,Major County,,OK,583,8223,8806,3,4,7,823,976,1799,6,0.314654,0.326393,66.783494,0.000388,0.00038,89,0.000085,0,14,0.666667,0.00354
40095,Marshall County,,OK,967,12919,13886,7,7,14,2202,2016,4218,6,0.333741,0.349085,32.12436,0.001111,0.001113,89,0.00013,0,14,0.833333,0.010215
40097,Mayes County,,OK,2731,39483,42214,13,13,26,7054,7225,14279,6,0.318625,0.332079,19.873971,0.000852,0.00098,89,0.000232,0,14,0.692308,0.009526
40099,Murray County,,OK,962,11919,12881,6,6,12,2127,1952,4079,6,0.314687,0.32667,0.833333,0.000525,0.000502,89,0.000127,0,14,0.866667,0.004868
40101,Muskogee County,,OK,4523,69453,73976,20,20,40,10259,11691,21950,6,0.337528,0.355715,254.193378,0.00165,0.002266,89,0.000312,0,14,0.498024,0.016236
40103,Noble County,,OK,1004,11966,12970,7,6,13,2355,2391,4746,6,0.317884,0.330249,1.614875,0.00077,0.000759,89,0.000139,0,14,0.809524,0.007186
40105,Nowata County,,OK,696,10743,11439,4,4,8,1832,1788,3620,6,0.311974,0.323136,0.970946,0.000345,0.000388,89,0.000104,0,14,0.833333,0.003686
40107,Okfuskee County,,OK,856,10499,11355,8,8,16,1894,2115,4009,6,0.317783,0.330304,1.856349,0.000685,0.000711,89,0.000163,0,14,0.803571,0.006799
40109,Oklahoma County,,OK,49641,686733,736374,243,236,479,153885,164535,318420,5,0.458556,0.497775,162638.020872,0.05531,0.057284,89,0.002506,0,14,0.285545,0.481049
40111,Okmulgee County,,OK,3101,37849,40950,16,16,32,6967,7724,14691,6,0.318052,0.331636,59.955591,0.001496,0.000962,89,0.000262,0,14,0.636029,0.014481
40113,Osage County,,OK,3521,40769,44290,12,11,23,12311,11808,24119,6,0.334447,0.350527,29.627296,0.000803,0.001495,89,0.000214,0,14,0.774725,0.008173
40115,Ottawa County,,OK,2446,33160,35606,10,17,27,4923,6179,11102,6,0.32149,0.336507,237.709668,0.000815,0.001403,89,0.000194,0,14,0.452206,0.00873
40117,Pawnee County,,OK,1524,16265,17789,6,7,13,3477,3867,7344,6,0.317749,0.330138,0.7,0.000733,0.000739,89,0.000129,0,14,0.857143,0.006889
40119,Payne County,,OK,6819,60016,66835,35,37,72,13111,15865,28976,5,0.379437,0.403179,3014.365734,0.004899,0.009837,89,0.000508,0,14,0.406763,0.046731
40121,Pittsburg County,,OK,2532,42585,45117,17,18,35,4904,4548,9452,6,0.332779,0.349928,1232.563852,0.001421,0.00153,89,0.000284,0,14,0.428571,0.013762
40123,Pontotoc County,,OK,2394,34325,36719,19,18,37,5670,5812,11482,6,0.336998,0.354744,4675.56055,0.002011,0.002494,89,0.000313,0,14,0.481579,0.019445
40125,Pottawatomie County,,OK,5139,66040,71179,21,20,41,13681,13424,27105,5,0.359115,0.379161,789.328599,0.003783,0.003217,89,0.000312,0,14,0.507246,0.035883
40127,Pushmataha County,,OK,726,10122,10848,7,8,15,1077,1468,2545,6,0.314951,0.327336,10.639621,0.000518,0.000375,89,0.000149,0,14,0.611111,0.004877
40129,Roger Mills County,,OK,244,3765,4009,1,1,2,366,394,760,7,0.239802,0.244952,0,0.000003,0.000004,89,0.000079,0,14,0,0.000109
40131,Rogers County,,OK,6163,82950,89113,29,22,51,21940,18174,40114,5,0.358344,0.379444,1540.19292,0.006035,0.003584,89,0.000406,0,14,0.488506,0.055764
40133,Seminole County,,OK,1932,22630,24562,10,8,18,4355,4858,9213,6,0.317816,0.33036,3.261905,0.000867,0.000832,89,0.000184,0,14,0.733333,0.008453
40135,Sequoyah County,,OK,2419,38790,41209,10,12,22,5598,5822,11420,6,0.318964,0.33244,28.545427,0.000837,0.001176,0,0.000179,0,14,0.689394,0.008261
40137,Stephens County,,OK,2784,43803,46587,15,17,32,5452,5579,11031,6,0.346123,0.364758,2145.954646,0.003143,0.002914,89,0.000225,0,14,0.604575,0.029479
40139,Texas County,,OK,2045,19927,21972,9,11,20,1761,2009,3770,6,0.324651,0.339153,8419.722988,0.000822,0.001274,31,0.000239,0,14,0.393939,0.007231
40141,Tillman County,,OK,719,7955,8674,3,5,8,635,1118,1753,6,0.319337,0.331719,3.473806,0.000202,0.00059,89,0.000078,0,14,0.8,0.001566
40143,Tulsa County,,OK,42050,593669,635719,227,199,426,130852,134869,265721,5,0.452682,0.488926,98055.341321,0.054607,0.050611,89,0.002286,0,14,0.31416,0.471526
40145,Wagoner County,,OK,6365,62130,68495,23,18,41,25489,19681,45170,6,0.344772,0.363399,527.871225,0.004244,0.002753,89,0.000327,0,14,0.568333,0.039709
40147,Washington County,,OK,3521,53493,57014,21,17,38,8608,8042,16650,5,0.36171,0.381885,2648.53305,0.004139,0.002808,89,0.000321,0,14,0.519481,0.039941
40149,Washita County,,OK,970,11214,12184,5,5,10,2066,2117,4183,6,0.314621,0.326448,2.05,0.000354,0.000383,89,0.000137,0,14,0.766667,0.003374
40151,Woods County,,OK,621,8364,8985,5,4,9,674,787,1461,6,0.314753,0.326559,181.381677,0.000392,0.000381,89,0.000166,0,14,0.4,0.003697
40153,Woodward County,,OK,1326,19749,21075,9,11,20,1946,2179,4125,6,0.318119,0.331192,12769.227616,0.000573,0.000917,89,0.000294,0,14,0.418182,0.005641
41001,Baker County,,OR,1257,15930,17187,11,9,20,1888,1793,3681,6,0.314029,0.327408,68.36036,0.001347,0.001296,4,0.000165,0,14,0.787879,0.014278
41003,Benton County,,OR,8164,77144,85308,46,40,86,20920,24002,44922,5,0.364342,0.387211,286.038314,0.012406,0.010684,4,0.000435,0,14,0.682504,0.112307
41005,Clackamas County,,OR,31792,377501,409293,101,102,203,118206,107250,225456,5,0.395367,0.426936,7121.849692,0.024687,0.025404,4,0.000913,0,14,0.487542,0.222808
41007,Clatsop County,,OR,2820,34473,37293,23,24,47,6080,6224,12304,5,0.35989,0.379888,92.562256,0.005475,0.006013,4,0.000261,0,14,0.846154,0.052777
41009,Columbia County,,OR,3391,49498,52889,17,18,35,12360,9405,21765,5,0.352169,0.370617,22.297547,0.003775,0.003234,4,0.000203,0,14,0.92381,0.036921
41011,Coos County,,OR,4033,61153,65186,41,25,66,10363,9206,19569,5,0.3566,0.376487,13.187504,0.010709,0.005714,4,0.000363,0,14,0.834848,0.095108
41013,Crook County,,OR,1656,19747,21403,10,10,20,4748,3628,8376,6,0.310909,0.32363,121.765968,0.001214,0.001192,4,0.000152,0,14,0.825758,0.01307
41015,Curry County,,OR,1957,22865,24822,22,16,38,3845,3903,7748,5,0.356727,0.3752,9.132231,0.004958,0.003152,4,0.000226,0,14,0.865,0.045591
41017,Deschutes County,,OR,10280,140192,150472,98,76,174,52290,32378,84668,5,0.366834,0.394136,12305.980796,0.0204,0.0157,4,0.000887,0,14,0.496154,0.183858
41019,Douglas County,,OR,6264,106514,112778,56,34,90,18065,15635,33700,5,0.362059,0.383744,122.275291,0.012714,0.008511,4,0.000476,0,14,0.722677,0.112612
41021,Gilliam County,,OR,190,1958,2148,0,0,0,0,0,0,0,0,0,0,0,0,74,0.000049,62,109,0,0
41023,Grant County,,OR,645,7332,7977,2,4,6,274,502,776,6,0.268574,0.278523,0.142857,0.0001,0.000174,4,0.000072,0,14,0.75,0.001306
41025,Harney County,,OR,687,7239,7926,1,2,3,270,336,606,6,0.283129,0.29428,0,0.000093,0.000295,4,0.000059,0,14,1,0.001162
41027,Hood River County,,OR,1574,22990,24564,10,9,19,2727,3777,6504,6,0.310973,0.32389,45.423095,0.002232,0.00138,4,0.000155,0,14,0.790909,0.021551
41029,Jackson County,,OR,10972,201551,212523,89,75,164,37557,31560,69117,5,0.37663,0.404311,1518.442256,0.018963,0.018738,4,0.000747,0,14,0.566581,0.169827
41031,Jefferson County,,OR,1760,19725,21485,11,9,20,4457,3927,8384,6,0.311295,0.324101,7.278344,0.002064,0.001456,4,0.00015,0,14,0.94697,0.020475
41033,Josephine County,,OR,4820,78726,83546,46,29,75,16014,11905,27919,5,0.361492,0.382496,35.749233,0.011604,0.007568,4,0.000371,0,14,0.778367,0.100458
41035,Klamath County,,OR,4347,64108,68455,45,31,76,11206,9815,21021,5,0.361058,0.382163,975.556732,0.011009,0.006817,4,0.000403,0,14,0.742772,0.097044
41037,Lake County,,OR,670,7258,7928,4,4,8,589,663,1252,6,0.283263,0.294779,0.079877,0.000335,0.000472,4,0.000089,0,14,0.9,0.003884
41039,Lane County,,OR,19221,338034,357255,129,115,244,64543,60300,124843,5,0.394588,0.427946,11253.057629,0.029648,0.027508,4,0.001151,0,14,0.443967,0.265752
41041,Lincoln County,,OR,3806,42750,46556,37,24,61,10421,9303,19724,5,0.360451,0.380609,70.684617,0.008727,0.006065,4,0.000382,0,14,0.812312,0.081765
41043,Linn County,,OR,7769,110109,117878,46,31,77,28906,22546,51452,5,0.361753,0.38305,344.534798,0.011331,0.00718,4,0.000437,0,14,0.714154,0.102592
41045,Malheur County,,OR,2194,27555,29749,11,11,22,3761,4895,8656,6,0.314029,0.32763,86.726148,0.00104,0.001377,4,0.000218,0,14,0.67033,0.011518
41047,Marion County,,OR,19909,300673,320582,88,77,165,67289,64109,131398,5,0.377529,0.405587,2292.848502,0.018528,0.017636,4,0.000776,0,14,0.522091,0.166281
41049,Morrow County,,OR,1098,11248,12346,2,3,5,1661,2258,3919,6,0.286313,0.29767,0,0.00013,0.000267,4,0.000068,0,14,1,0.001277
41051,Multnomah County,,OR,60921,682818,743739,275,214,489,220938,206770,427708,5,0.448961,0.487622,48343.205338,0.070019,0.056321,4,0.002258,0,14,0.33649,0.585652
41053,Polk County,,OR,6117,65503,71620,37,24,61,25997,20036,46033,5,0.360494,0.380665,122.520379,0.009218,0.005872,4,0.00037,0,14,0.793741,0.084593
41055,Sherman County,,OR,148,1760,1908,1,1,2,87,56,143,7,0.247508,0.253254,0,0.000013,0.000008,4,0.000063,0,14,0,0.000151
41057,Tillamook County,,OR,1818,25162,26980,14,14,28,4075,4040,8115,6,0.311554,0.3251,0.175,0.002631,0.001817,4,0.000181,0,14,0.975,0.026082
41059,Umatilla County,,OR,5267,73353,78620,37,38,75,11907,13367,25274,5,0.361058,0.383134,7882.690697,0.00657,0.006839,4,0.000447,0,14,0.570267,0.06302
41061,Union County,,OR,1984,26129,28113,13,17,30,3232,3725,6957,5,0.352831,0.371338,1125.434722,0.001448,0.002815,4,0.000209,0,14,0.736842,0.015877
41063,Wallowa County,,OR,535,7482,8017,2,2,4,226,378,604,6,0.265324,0.273474,0,0.000057,0.000047,4,0.00007,0,14,1,0.000611
41065,Wasco County,,OR,1780,23651,25431,11,13,24,3794,3695,7489,6,0.328881,0.343209,6046.853212,0.001336,0.002153,4,0.000204,0,14,0.717949,0.014122
41067,Washington County,,OR,40971,514959,555930,195,160,355,163279,147184,310463,5,0.426462,0.462628,17563.959561,0.052149,0.043949,4,0.001628,0,14,0.402383,0.449384
41069,Wheeler County,,OR,102,1288,1390,0,0,0,0,0,0,0,0,0,0,0,0,75,0.000049,63,110,0,0
41071,Yamhill County,,OR,6486,89474,95960,36,27,63,23962,18519,42481,5,0.361405,0.382163,75.992877,0.009229,0.006864,4,0.000361,0,14,0.834127,0.084797
42001,Adams County,,PA,5593,115684,121277,19,19,38,19249,15478,34727,6,0.325743,0.342782,2.3163,0.005328,0.004963,76,0.000156,0,14,0.904762,0.041852
42003,Allegheny County,,PA,57175,1436980,1494155,291,319,610,150789,190462,341251,5,0.461373,0.509271,128331.282482,0.079101,0.083237,76,0.00203,0,14,0.304137,0.633701
42005,Armstrong County,,PA,3658,80899,84557,6,9,15,8192,9238,17430,6,0.316044,0.330498,0.863095,0.000796,0.000795,76,0.000091,0,14,0.875,0.005707
42007,Beaver County,,PA,8088,208825,216913,24,43,67,18339,19665,38004,5,0.389069,0.413965,1134.402515,0.006365,0.01413,76,0.000198,0,14,0.609662,0.049883
42009,Bedford County,,PA,2044,59339,61383,14,12,26,4282,4058,8340,6,0.316644,0.33183,399.629123,0.001882,0.001203,76,0.000153,0,14,0.616667,0.015457
42011,Berks County,,PA,17030,468173,485203,93,108,201,61860,51847,113707,5,0.398461,0.430887,2105.692523,0.03167,0.035716,76,0.000535,0,14,0.625164,0.239248
42013,Blair County,,PA,4737,147813,152550,21,26,47,8520,9390,17910,5,0.362015,0.382862,353.42286,0.003572,0.006078,76,0.000187,0,14,0.641534,0.027493
42015,Bradford County,,PA,2931,72472,75403,15,17,32,5409,5670,11079,6,0.314325,0.330016,847.474298,0.002008,0.002184,65,0.000171,0,14,0.493464,0.014421
42017,Bucks County,,PA,38052,757444,795496,145,179,324,128173,126364,254537,5,0.417628,0.457157,5402.49771,0.050875,0.057929,76,0.000875,0,14,0.545412,0.401145
42019,Butler County,,PA,9997,216148,226145,39,49,88,28229,24726,52955,5,0.386565,0.411951,2768.170146,0.011204,0.016288,76,0.000296,0,14,0.588552,0.088715
42021,Cambria County,,PA,5590,168517,174107,25,28,53,10776,12873,23649,5,0.36368,0.384776,318.108407,0.005945,0.006694,76,0.000202,0,14,0.680871,0.046333
42023,Cameron County,,PA,308,6590,6898,1,3,4,123,378,501,7,0.24181,0.2485,0.587814,0.000004,0.000011,65,0.000062,0,14,0.666667,0.000097
42025,Carbon County,,PA,3420,71451,74871,24,10,34,14299,9190,23489,6,0.312819,0.326687,0.726443,0.00739,0.002061,76,0.000145,0,14,0.918478,0.048634
42027,Centre County,,PA,9025,132817,141842,68,80,148,17518,20156,37674,5,0.395993,0.425477,6021.407204,0.016993,0.026747,76,0.000474,0,14,0.522525,0.132407
42029,Chester County,,PA,29875,550463,580338,162,158,320,113363,95908,209271,5,0.423337,0.45992,4075.950447,0.05564,0.05535,76,0.000975,0,14,0.560017,0.437867
42031,Clarion County,,PA,1889,44478,46367,11,11,22,4742,4483,9225,6,0.316111,0.330831,729.346417,0.001032,0.000803,76,0.000133,0,14,0.672727,0.007055
42033,Clearfield County,,PA,3494,92540,96034,14,15,29,7223,7912,15135,6,0.316777,0.332385,29.34632,0.001792,0.001684,76,0.000145,0,14,0.683333,0.012662
42035,Clinton County,,PA,1916,41210,43126,6,10,16,3771,3971,7742,6,0.316644,0.331608,7.364202,0.001154,0.001449,76,0.000083,0,14,0.911111,0.008691
42037,Columbia County,,PA,3108,70645,73753,16,20,36,7706,7440,15146,6,0.320495,0.337089,117.927226,0.002656,0.003761,76,0.000142,0,14,0.790043,0.019204
42039,Crawford County,,PA,4291,99819,104110,11,17,28,8498,9137,17635,5,0.356897,0.375915,197.539879,0.001603,0.003324,76,0.000121,0,14,0.643382,0.010723
42041,Cumberland County,,PA,15474,265195,280669,100,81,181,51868,43794,95662,5,0.398039,0.42753,9035.599695,0.029055,0.025956,76,0.000651,0,14,0.52397,0.22593
42043,Dauphin County,,PA,17006,310422,327428,103,99,202,53118,52593,105711,5,0.401015,0.432579,11503.944623,0.031877,0.033565,76,0.000664,0,14,0.577617,0.248166
42045,Delaware County,,PA,33598,634667,668265,116,133,249,109375,113642,223017,5,0.414574,0.449085,2021.500857,0.043002,0.048095,76,0.000678,0,14,0.671776,0.331568
42047,Elk County,,PA,1385,42448,43833,6,7,13,1598,2126,3724,6,0.316177,0.330498,3981.629754,0.000704,0.000694,76,0.000108,0,14,0.571429,0.00508
42049,Erie County,,PA,10751,316215,326966,64,98,162,18453,24822,43275,5,0.406056,0.437378,8275.604874,0.0182,0.03256,76,0.000449,0,14,0.538904,0.141973
42051,Fayette County,,PA,4867,154842,159709,13,15,28,10669,11247,21916,6,0.33768,0.356968,1726.026045,0.002611,0.002568,76,0.000153,0,14,0.542484,0.020202
42053,Forest County,,PA,363,5560,5923,3,4,7,401,569,970,7,0.24057,0.247496,0.366667,0.0005,0.000023,76,0.000076,0,14,0.7,0.003986
42055,Franklin County,,PA,5830,172019,177849,41,36,77,22039,14367,36406,5,0.361971,0.38386,1916.706287,0.009269,0.008146,76,0.000322,0,14,0.588795,0.072702
42057,Fulton County,,PA,693,17578,18271,5,6,11,1957,1864,3821,6,0.285578,0.296682,12.788022,0.00013,0.000307,76,0.000107,0,14,0.633333,0.001429
42059,Greene County,,PA,1665,40073,41738,5,5,10,3617,3596,7213,6,0.316945,0.331086,0,0.000827,0.000676,76,0.000087,0,14,1,0.005759
42061,Huntingdon County,,PA,1947,48889,50836,13,13,26,4388,4502,8890,6,0.316711,0.332052,152.777086,0.00159,0.001509,76,0.000148,0,14,0.74359,0.012593
42063,Indiana County,,PA,4200,93989,98189,17,22,39,8151,9701,17852,6,0.330801,0.349029,55.071186,0.00228,0.003739,76,0.000155,0,14,0.675325,0.016258
42065,Jefferson County,,PA,2481,53938,56419,11,11,22,5768,5668,11436,6,0.316211,0.330998,814.03522,0.000976,0.000902,76,0.000137,0,14,0.608974,0.006822
42067,Juniata County,,PA,1042,28865,29907,7,8,15,2513,2423,4936,6,0.293359,0.306103,0.180221,0.000811,0.00092,76,0.000104,0,14,0.946429,0.006772
42069,Lackawanna County,,PA,8098,236130,244228,60,65,125,23539,21647,45186,5,0.381025,0.407668,3343.620103,0.018683,0.021706,76,0.000357,0,14,0.724386,0.133781
42071,Lancaster County,,PA,19670,611760,631430,133,127,260,63864,54954,118818,5,0.407156,0.441539,15622.185319,0.040686,0.03947,76,0.000816,0,14,0.518604,0.315912
42073,Lawrence County,,PA,3682,105802,109484,11,13,24,7572,8322,15894,5,0.356558,0.375028,46.318362,0.001448,0.0022,76,0.000106,0,14,0.807692,0.008609
42075,Lebanon County,,PA,5993,155117,161110,30,23,53,20223,15689,35912,5,0.358944,0.378756,148.698993,0.007847,0.007,76,0.000205,0,14,0.797348,0.056278
42077,Lehigh County,,PA,21721,385572,407293,96,122,218,82145,72395,154540,5,0.403546,0.437683,1582.179068,0.033589,0.043249,76,0.000542,0,14,0.682171,0.253181
42079,Luzerne County,,PA,11040,360390,371430,78,93,171,37509,32314,69823,5,0.394796,0.425588,9045.510639,0.025194,0.030852,76,0.000448,0,14,0.669018,0.182519
42081,Lycoming County,,PA,4831,134991,139822,27,36,63,9342,11579,20921,5,0.362015,0.384138,6782.337063,0.005218,0.007205,76,0.00024,0,14,0.574324,0.041233
42083,McKean County,,PA,2023,49647,51670,8,9,17,2634,2585,5219,6,0.318558,0.33345,1477.351173,0.000716,0.00097,65,0.000141,0,14,0.466667,0.005235
42085,Mercer County,,PA,5127,136280,141407,16,23,39,11027,11793,22820,5,0.363813,0.384665,356.192666,0.00195,0.005273,76,0.000147,0,14,0.626812,0.012507
42087,Mifflin County,,PA,1596,54317,55913,10,10,20,3614,3439,7053,6,0.293445,0.306491,3.640028,0.001013,0.00095,76,0.000125,0,14,0.822222,0.007988
42089,Monroe County,,PA,11713,170172,181885,55,81,136,47890,34053,81943,5,0.383751,0.413227,673.391698,0.017961,0.027406,76,0.000304,0,14,0.726813,0.126686
42091,Montgomery County,,PA,54534,926642,981176,192,217,409,183668,190013,373681,5,0.436818,0.47834,12155.667414,0.062824,0.068457,76,0.001174,0,14,0.479715,0.497296
42093,Montour County,,PA,1486,20714,22200,6,7,13,3274,3239,6513,6,0.287382,0.299434,0.800073,0.000282,0.000415,76,0.000089,0,14,0.904762,0.002069
42095,Northampton County,,PA,18174,332025,350199,71,96,167,72870,57447,130317,5,0.395471,0.426642,777.582563,0.024874,0.034331,76,0.0004,0,14,0.716117,0.18383
42097,Northumberland County,,PA,4716,106830,111546,20,22,42,12565,12832,25397,6,0.320563,0.337422,216.476684,0.003673,0.003323,76,0.000168,0,14,0.706522,0.027228
42099,Perry County,,PA,2720,55654,58374,10,9,19,8329,7709,16038,6,0.293045,0.305826,2.802266,0.00092,0.00092,76,0.000125,0,14,0.788889,0.007876
42101,Philadelphia County,,PA,80866,1427139,1508005,259,240,499,236692,300360,537052,5,0.450577,0.492027,25462.599808,0.077223,0.073308,76,0.001652,0,14,0.404135,0.614011
42103,Pike County,,PA,4287,56004,60291,35,32,67,21116,10448,31564,5,0.359373,0.380598,18.071096,0.010155,0.009388,13,0.000178,0,14,0.836538,0.063608
42105,Potter County,,PA,1191,20701,21892,7,5,12,1582,1719,3301,6,0.316211,0.330332,655.224853,0.000485,0.000498,65,0.000119,0,14,0.357143,0.004105
42107,Schuylkill County,,PA,5070,169311,174381,28,24,52,16955,13691,30646,6,0.349831,0.369019,45.124112,0.006754,0.005349,76,0.000189,0,14,0.803448,0.046322
42109,Snyder County,,PA,2012,42540,44552,11,13,24,5144,5026,10170,6,0.293589,0.307102,28.349167,0.000885,0.000995,76,0.000138,0,14,0.692308,0.007497
42111,Somerset County,,PA,3034,89923,92957,15,18,33,5941,6358,12299,6,0.32953,0.34681,57.006756,0.001899,0.002324,76,0.000155,0,14,0.642105,0.014284
42113,Sullivan County,,PA,480,7068,7548,2,2,4,466,722,1188,6,0.266147,0.274523,0,0.000055,0.000043,76,0.000063,0,14,1,0.000471
42115,Susquehanna County,,PA,2320,49663,51983,10,9,19,5339,5286,10625,6,0.311715,0.325383,65.213281,0.001701,0.001,76,0.000118,0,14,0.654545,0.012506
42117,Tioga County,,PA,2149,46512,48661,13,13,26,3637,3505,7142,6,0.320632,0.336535,65.504037,0.002483,0.002447,65,0.000136,0,14,0.62381,0.018829
42119,Union County,,PA,2462,41225,43687,10,11,21,5708,5776,11484,6,0.319813,0.335037,41.231442,0.000871,0.001695,76,0.000115,0,14,0.782051,0.006406
42121,Venango County,,PA,2375,64533,66908,12,11,23,4849,5159,10008,6,0.316144,0.330887,805.46722,0.001117,0.000853,76,0.000138,0,14,0.653846,0.007378
42123,Warren County,,PA,2168,48603,50771,7,7,14,2870,3083,5953,6,0.316111,0.330387,678.576371,0.000793,0.000695,76,0.000109,0,14,0.589286,0.005435
42125,Washington County,,PA,9121,244082,253203,39,52,91,28400,24849,53249,5,0.39084,0.416861,6144.811382,0.009897,0.016313,76,0.000342,0,14,0.533117,0.08045
42127,Wayne County,,PA,3543,56476,60019,28,19,47,10209,7045,17254,6,0.324827,0.342466,27.087918,0.008179,0.003976,76,0.000166,0,14,0.803226,0.053166
42129,Westmoreland County,,PA,15498,446456,461954,63,91,154,45922,45686,91608,5,0.396725,0.427197,6056.209467,0.018936,0.030128,76,0.000461,0,14,0.584926,0.154947
42131,Wyoming County,,PA,1882,33165,35047,4,4,8,4368,4514,8882,6,0.283396,0.294308,0,0.000329,0.00028,76,0.000078,0,14,1,0.002256
42133,York County,,PA,18757,496672,515429,115,113,228,83883,56583,140466,5,0.40507,0.438182,11281.378214,0.034714,0.035724,76,0.000742,0,14,0.53154,0.272756
44001,Bristol County,,RI,3605,55925,59530,9,12,21,7622,8839,16461,6,0.329892,0.346854,0.070238,0.002998,0.003894,62,0.000087,0,14,0.974359,0.020588
44003,Kent County,,RI,13426,200053,213479,28,57,85,38423,39845,78268,5,0.386715,0.413022,108.144963,0.010829,0.022428,62,0.000181,0,14,0.839266,0.081303
44005,Newport County,,RI,9410,94070,103480,43,61,104,14997,20098,35095,5,0.384783,0.411163,171.297698,0.015407,0.023868,62,0.000274,0,14,0.716539,0.119956
44007,Providence County,,RI,36456,673704,710160,126,170,296,88859,119626,208485,5,0.421555,0.459709,2735.56124,0.0458,0.05671,62,0.00074,0,14,0.576366,0.361327
44009,Washington County,,RI,8989,144498,153487,31,40,71,21901,23082,44983,5,0.374284,0.397415,39.258001,0.010906,0.015628,62,0.000188,0,14,0.884343,0.080321
45001,Abbeville County,,SC,1623,26816,28439,5,7,12,3319,4359,7678,6,0.312201,0.324961,16.762431,0.000353,0.001254,66,0.000121,0,14,0.761905,0.004698
45003,Aiken County,,SC,8760,160538,169298,60,45,105,23394,21783,45177,5,0.373307,0.398147,8897.884851,0.018966,0.011452,15,0.000602,0,14,0.531168,0.172133
45005,Allendale County,,SC,606,10026,10632,3,6,9,717,1308,2025,6,0.304665,0.317421,1.184444,0.000088,0.000973,15,0.000085,0,14,0.8,0.001333
45007,Anderson County,,SC,8836,188758,197594,57,31,88,28821,23491,52312,6,0.340127,0.360514,1947.934093,0.017272,0.008229,66,0.000596,0,14,0.620397,0.162485
45009,Bamberg County,,SC,914,15604,16518,6,7,13,1409,2363,3772,6,0.311651,0.323962,0.606759,0.000564,0.001091,66,0.000116,0,14,0.928571,0.006283
45011,Barnwell County,,SC,1249,24038,25287,8,9,17,2299,2753,5052,6,0.313766,0.326936,119.488842,0.001433,0.001601,15,0.000133,0,14,0.733333,0.013935
45013,Beaufort County,,SC,14394,140545,154939,166,111,277,43926,32232,76158,5,0.410832,0.443342,6855.689095,0.054572,0.039286,66,0.001193,0,14,0.535236,0.441894
45015,Berkeley County,,SC,18075,154154,172229,104,70,174,60025,51152,111177,5,0.39594,0.424118,2344.532295,0.036627,0.025083,66,0.000822,0,14,0.636744,0.309826
45017,Calhoun County,,SC,1044,15377,16421,4,3,7,2775,2959,5734,6,0.302518,0.314176,0,0.000806,0.000555,66,0.000091,0,14,1,0.008345
45019,Charleston County,,SC,30869,325185,356054,247,179,426,96384,98720,195104,5,0.444116,0.479988,33835.092068,0.069159,0.056722,66,0.002033,0,14,0.393339,0.578962
45021,Cherokee County,,SC,2464,56557,59021,9,11,20,6476,6579,13055,6,0.322007,0.336585,16.296456,0.001121,0.002315,66,0.000172,0,14,0.781818,0.01447
45023,Chester County,,SC,2234,37157,39391,8,9,17,4997,5908,10905,6,0.321938,0.336252,25.394457,0.001197,0.002101,66,0.000159,0,14,0.733333,0.014119
45025,Chesterfield County,,SC,2146,46218,48364,12,15,27,5214,5396,10610,6,0.322837,0.338221,24.728102,0.001338,0.002862,66,0.000192,0,14,0.685714,0.016425
45027,Clarendon County,,SC,1812,33118,34930,10,10,20,3933,4344,8277,6,0.322872,0.337611,0.563517,0.001445,0.002238,66,0.000151,0,14,0.945455,0.015855
45029,Colleton County,,SC,2265,40709,42974,10,12,22,4908,5264,10172,6,0.325672,0.341006,21.312539,0.001362,0.002613,66,0.000158,0,14,0.724359,0.015445
45031,Darlington County,,SC,3900,73587,77487,16,18,34,9771,11371,21142,6,0.325602,0.342038,91.031442,0.00202,0.003475,66,0.000224,0,14,0.637427,0.021523
45033,Dillon County,,SC,1545,33456,35001,8,11,19,2969,3807,6776,6,0.325566,0.340901,19.327681,0.001126,0.002398,66,0.000137,0,14,0.745455,0.011875
45035,Dorchester County,,SC,11245,115748,126993,78,48,126,48702,32817,81519,6,0.372566,0.397315,1052.246044,0.027538,0.015553,66,0.000628,0,14,0.620028,0.22948
45037,Edgefield County,,SC,1615,24825,26440,6,7,13,4746,4594,9340,6,0.305688,0.318536,5.984941,0.000532,0.000987,15,0.000122,0,14,0.833333,0.006036
45039,Fairfield County,,SC,1431,24995,26426,7,6,13,3116,3680,6796,6,0.302823,0.315063,5.531488,0.001065,0.000811,66,0.000141,0,14,0.738095,0.012096
45041,Florence County,,SC,7552,139791,147343,41,37,78,20249,20631,40880,6,0.33647,0.357817,781.85222,0.010319,0.008662,66,0.000442,0,14,0.594203,0.095912
45043,Georgetown County,,SC,3749,63527,67276,20,15,35,8323,8383,16706,6,0.328557,0.345301,34.325362,0.006112,0.004145,66,0.000226,0,14,0.78355,0.056501
45045,Greenville County,,SC,25324,430711,456035,228,139,367,98510,73830,172340,5,0.429204,0.463038,21700.132723,0.064609,0.044748,66,0.001864,0,14,0.413382,0.538832
45047,Greenwood County,,SC,3546,71269,74815,20,20,40,8535,9238,17773,6,0.326132,0.343298,306.638326,0.002872,0.003632,66,0.000313,0,14,0.583004,0.033111
45049,Hampton County,,SC,1151,21102,22253,7,9,16,1977,2294,4271,6,0.322768,0.337417,115.078895,0.001196,0.00187,66,0.000125,0,14,0.688889,0.011997
45051,Horry County,,SC,13807,231975,245782,236,122,358,71005,34982,105987,5,0.411169,0.444757,18450.524375,0.056637,0.036117,66,0.001797,0,14,0.332659,0.450895
45053,Jasper County,,SC,1417,15373,16790,6,6,12,3972,3494,7466,6,0.314456,0.327214,6.369661,0.000899,0.001409,66,0.000115,0,14,0.738095,0.009252
45055,Kershaw County,,SC,3588,61587,65175,16,15,31,10140,8364,18504,6,0.32308,0.338499,62.104614,0.002232,0.002857,66,0.000238,0,14,0.713235,0.02562
45057,Lancaster County,,SC,3139,67526,70665,14,13,27,10790,8309,19099,6,0.322768,0.337888,8.802035,0.003553,0.00305,66,0.0002,0,14,0.766667,0.035389
45059,Laurens County,,SC,3758,67967,71725,12,14,26,10315,11098,21413,6,0.322907,0.338221,28.947702,0.00139,0.002844,66,0.00021,0,14,0.769231,0.017134
45061,Lee County,,SC,1087,19308,20395,5,6,11,2847,3400,6247,6,0.304141,0.316345,0,0.000513,0.000696,66,0.000099,0,14,1,0.004736
45063,Lexington County,,SC,16988,254451,271439,108,71,179,61374,50386,111760,5,0.397617,0.425893,12294.002246,0.031807,0.02158,66,0.001042,0,14,0.498608,0.281574
45065,McCormick County,,SC,583,9646,10229,5,5,10,939,1160,2099,6,0.296486,0.308,11.447384,0.000409,0.000462,66,0.000106,0,14,0.55,0.004335
45067,Marion County,,SC,1884,36287,38171,6,8,14,3572,4795,8367,6,0.325355,0.34018,2.491361,0.000621,0.002199,66,0.000115,0,14,0.791667,0.006747
45069,Marlboro County,,SC,1569,30552,32121,9,12,21,2724,3951,6675,6,0.325531,0.340957,10.650198,0.000685,0.002241,66,0.000144,0,14,0.69697,0.007497
45071,Newberry County,,SC,1802,38239,40041,11,10,21,4079,4267,8346,6,0.312266,0.325405,21.801577,0.001258,0.001535,66,0.000196,0,14,0.672727,0.014633
45073,Oconee County,,SC,3625,76150,79775,24,15,39,8025,7535,15560,6,0.328953,0.345661,104.28517,0.006474,0.004103,66,0.000313,0,14,0.721667,0.063885
45075,Orangeburg County,,SC,4858,94791,99649,26,25,51,10804,13153,23957,6,0.33553,0.355415,294.93158,0.005305,0.006712,66,0.000315,0,14,0.637634,0.050324
45077,Pickens County,,SC,7676,113117,120793,32,26,58,21167,21081,42248,6,0.345248,0.366617,121.6397,0.0086,0.008981,66,0.000381,0,14,0.731982,0.084271
45079,Richland County,,SC,29501,341450,370951,202,173,375,105247,94670,199917,5,0.433415,0.470573,46923.355434,0.057097,0.051667,66,0.001766,0,14,0.420343,0.486387
45081,Saluda County,,SC,1053,18920,19973,6,6,12,2467,3267,5734,6,0.302945,0.315174,2.627171,0.000536,0.000663,66,0.000126,0,14,0.866667,0.006139
45083,Spartanburg County,,SC,12661,285566,298227,98,57,155,42813,34556,77369,5,0.390434,0.416961,3950.793856,0.031105,0.01816,66,0.000886,0,14,0.569574,0.270652
45085,Sumter County,,SC,9268,114110,123378,50,60,110,13591,18165,31756,5,0.397354,0.424284,2916.695278,0.01455,0.020347,66,0.000473,0,14,0.614024,0.131277
45087,Union County,,SC,1121,31932,33053,8,8,16,2664,3075,5739,6,0.30744,0.319896,3.71556,0.000834,0.001189,66,0.000156,0,14,0.714286,0.010464
45089,Williamsburg County,,SC,2036,36089,38125,8,12,20,3165,5055,8220,6,0.323011,0.338055,0.80092,0.001208,0.002637,66,0.000132,0,14,0.924242,0.012836
45091,York County,,SC,10792,203957,214749,138,62,200,58484,30572,89056,5,0.391146,0.417987,5423.832664,0.04395,0.018136,66,0.001137,0,14,0.551266,0.366416
46003,Aurora County,,SD,210,3400,3610,1,2,3,197,347,544,6,0.286833,0.296743,0,0.000001,0.000082,18,0.000081,0,14,1,0.000095
46005,Beadle County,,SD,1234,18166,19400,11,8,19,1381,1626,3007,6,0.28971,0.301126,9154.236585,0.000444,0.000153,18,0.00038,0,14,0.372727,0.004289
46007,Bennett County,,SD,233,3236,3469,2,2,4,255,188,443,6,0.279911,0.288998,0,0.000066,0.000058,18,0.000097,0,14,1,0.000688
46009,Bon Homme County,,SD,398,7213,7611,2,2,4,484,662,1146,6,0.286805,0.296688,0,0.000098,0.000082,18,0.00009,0,14,1,0.000932
46011,Brookings County,,SD,2352,28142,30494,20,19,39,4593,5116,9709,5,0.357449,0.376914,8076.620833,0.000721,0.001344,18,0.000594,0,14,0.284585,0.007338
46013,Brown County,,SD,2350,41050,43400,18,16,34,3921,3669,7590,5,0.328557,0.344202,21587.979644,0.000697,0.000663,18,0.000624,0,14,0.247368,0.007005
46015,Brule County,,SD,348,5209,5557,3,3,6,417,450,867,6,0.286888,0.296965,4045.839837,0.000094,0.000082,18,0.000137,0,14,0.333333,0.001004
46017,Buffalo County,,SD,154,1885,2039,0,0,0,0,0,0,0,0,0,0,0,0,77,0.000049,64,111,0,0
46019,Butte County,,SD,927,9698,10625,4,4,8,2057,1836,3893,6,0.280145,0.289692,0,0.000106,0.000096,18,0.000141,0,14,1,0.001205
46021,Campbell County,,SD,93,1915,2008,0,0,0,0,0,0,0,0,0,0,0,0,78,0.000049,65,112,0,0
46023,Charles Mix County,,SD,485,9824,10309,2,2,4,368,537,905,6,0.286833,0.296743,0,0.000094,0.000082,18,0.0001,0,14,1,0.00094
46025,Clark County,,SD,287,4199,4486,1,1,2,166,320,486,6,0.263278,0.270506,0,0.000008,0.000004,18,0.00008,0,14,0,0.000121
46027,Clay County,,SD,1610,11669,13279,8,8,16,2058,2814,4872,5,0.329458,0.344174,130.225532,0.000231,0.000893,18,0.000224,0,14,0.622222,0.002364
46029,Codington County,,SD,2010,30914,32924,17,16,33,3955,4302,8257,5,0.357321,0.376415,10740.010377,0.000694,0.001337,18,0.000578,0,14,0.326797,0.006956
46031,Corson County,,SD,308,3638,3946,2,3,5,235,405,640,6,0.266383,0.274778,3044.50806,0.000001,0.000016,18,0.000102,0,14,0.333333,0.000132
46033,Custer County,,SD,914,8033,8947,3,4,7,1133,1201,2334,6,0.279937,0.289275,36.968057,0.000159,0.000066,18,0.000115,0,14,0.55,0.001535
46035,Davison County,,SD,1740,21572,23312,16,15,31,2969,3367,6336,6,0.290017,0.302513,12320.605894,0.000185,0.000169,18,0.000556,0,14,0.228758,0.002587
46037,Day County,,SD,394,6856,7250,4,4,8,428,718,1146,6,0.28697,0.297243,2.366667,0.000105,0.00009,18,0.000171,0,14,0.833333,0.001164
46039,Deuel County,,SD,280,5494,5774,2,3,5,415,602,1017,6,0.28686,0.29691,0,0.000016,0.00009,18,0.000106,0,14,1,0.000247
46041,Dewey County,,SD,437,6634,7071,1,3,4,179,466,645,6,0.279963,0.28922,3038,0.000065,0.000059,18,0.000066,0,14,0.333333,0.000619
46043,Douglas County,,SD,185,3835,4020,0,2,2,0,243,243,6,0.286874,0.296811,0,0,0.000082,18,0.000049,0,113,1,0
46045,Edmunds County,,SD,279,4517,4796,1,1,2,379,464,843,6,0.247324,0.253556,0,0.000004,0.000004,18,0.000082,0,14,0,0.000122
46047,Fall River County,,SD,628,7492,8120,3,3,6,653,766,1419,6,0.279911,0.289109,1.583333,0.000069,0.000066,18,0.000104,0,14,0.5,0.00077
46049,Faulk County,,SD,172,2593,2765,0,1,1,0,96,96,6,0.247366,0.253638,0,0,0.000004,18,0.000049,0,114,0,0
46051,Grant County,,SD,533,9383,9916,4,4,8,545,848,1393,6,0.286915,0.297132,6040,0.000102,0.000086,18,0.000219,0,14,0.5,0.001107
46053,Gregory County,,SD,287,5301,5588,1,2,3,55,216,271,6,0.286833,0.296743,0,0.000093,0.000082,18,0.000068,0,14,1,0.000845
46055,Haakon County,,SD,181,2504,2685,1,1,2,45,71,116,6,0.279858,0.288776,0,0.000065,0.000058,18,0.000066,0,14,0,0.000619
46057,Hamlin County,,SD,439,6067,6506,3,3,6,775,834,1609,6,0.28686,0.29691,0,0.000109,0.00009,18,0.000126,0,14,1,0.001092
46059,Hand County,,SD,194,4141,4335,0,1,1,0,50,50,7,0.22469,0.229827,0,0,0.000003,18,0.000049,0,115,0,0
46061,Hanson County,,SD,129,3355,3484,1,2,3,232,375,607,6,0.286833,0.296743,0,0.000001,0.000082,18,0.000081,0,14,1,0.000095
46063,Harding County,,SD,140,1522,1662,0,0,0,0,0,0,0,0,0,0,0,0,79,0.000049,66,116,0,0
46065,Hughes County,,SD,1478,19538,21016,10,8,18,2220,2524,4744,6,0.289682,0.301071,11071.857551,0.000178,0.000165,18,0.000384,0,14,0.327273,0.002193
46067,Hutchinson County,,SD,438,8901,9339,2,3,5,350,687,1037,6,0.286915,0.297021,0,0.000094,0.000084,18,0.0001,0,14,1,0.00094
46069,Hyde County,,SD,137,1798,1935,0,0,0,0,0,0,0,0,0,0,0,0,80,0.000049,67,117,0,0
46071,Jackson County,,SD,201,2802,3003,0,1,1,0,231,231,6,0.279899,0.288846,0,0,0.000058,18,0.000049,0,118,0,0
46073,Jerauld County,,SD,154,2647,2801,1,1,2,70,53,123,7,0.224649,0.229737,0,0.000001,0.000003,18,0.00009,0,14,0,0.000099
46075,Jones County,,SD,97,1283,1380,0,0,0,0,0,0,0,0,0,0,0,0,81,0.000049,68,119,0,0
46077,Kingsbury County,,SD,278,6471,6749,3,4,7,476,657,1133,6,0.286915,0.297132,0,0.000102,0.000092,18,0.000135,0,14,1,0.00107
46079,Lake County,,SD,815,11903,12718,3,4,7,1127,1610,2737,6,0.28686,0.297021,0.333333,0.000101,0.000098,18,0.00013,0,14,0.833333,0.001043
46081,Lawrence County,,SD,2339,23877,26216,11,9,20,4064,4586,8650,5,0.353038,0.370312,2510.913113,0.000874,0.001136,18,0.000346,0,14,0.462121,0.008794
46083,Lincoln County,,SD,3516,35278,38794,22,15,37,16650,10114,26764,5,0.358173,0.377219,3920.490761,0.001947,0.001566,18,0.000543,0,14,0.329004,0.017844
46085,Lyman County,,SD,289,4130,4419,1,2,3,83,288,371,7,0.224699,0.230015,0.666667,0,0.000002,18,0.000088,0,14,0,0.000072
46087,McCook County,,SD,477,6665,7142,2,2,4,713,854,1567,6,0.286751,0.296577,0,0.000102,0.000093,18,0.000099,0,14,1,0.001033
46089,McPherson County,,SD,149,2850,2999,0,1,1,0,188,188,6,0.247366,0.253638,0,0,0.000004,18,0.000049,0,120,0,0
46091,Marshall County,,SD,235,4986,5221,2,2,4,273,211,484,6,0.247406,0.253862,2.366667,0.000005,0.000005,18,0.000121,0,14,0,0.000199
46093,Meade County,,SD,4525,28771,33296,13,11,24,7810,8879,16689,5,0.358515,0.37733,4945.078217,0.001285,0.002692,18,0.0003,0,14,0.418301,0.011934
46095,Mellette County,,SD,127,1824,1951,1,1,2,72,46,118,7,0.22443,0.229266,0,0.000001,0,18,0.000087,0,14,0,0.00007
46097,Miner County,,SD,187,2927,3114,0,1,1,0,77,77,6,0.286764,0.296478,0,0,0.000081,18,0.000049,0,121,0,0
46099,Minnehaha County,,SD,13327,192606,205933,98,84,182,40702,36292,76994,5,0.401927,0.431086,183281.051528,0.013782,0.015757,18,0.001885,0,14,0.189491,0.123067
46101,Moody County,,SD,520,7663,8183,3,3,6,747,929,1676,6,0.286833,0.296854,0,0.000101,0.000086,18,0.000122,0,14,1,0.001043
46103,Pennington County,,SD,9058,104134,113192,62,59,121,21725,19299,41024,5,0.388566,0.414531,86478.759506,0.009788,0.011112,18,0.001184,0,14,0.292645,0.08921
46105,Perkins County,,SD,264,3526,3790,0,1,1,0,42,42,6,0.263967,0.271187,0,0,0.000008,18,0.000049,0,122,0,0
46107,Potter County,,SD,242,3116,3358,0,0,0,0,0,0,0,0,0,0,0,0,82,0.000049,69,123,0,0
46109,Roberts County,,SD,712,11387,12099,6,6,12,731,945,1676,6,0.289486,0.301071,3726.5211,0.000102,0.000129,18,0.000275,0,14,0.333333,0.001243
46111,Sanborn County,,SD,229,3011,3240,1,1,2,135,173,308,7,0.224833,0.230237,0,0.000001,0.000001,18,0.000081,0,14,0,0.000095
46113,Shannon County,,SD,551,11161,11712,2,3,5,786,1118,1904,6,0.279989,0.289275,860.846477,0.000066,0.000058,18,0.000107,0,14,0.333333,0.000688
46115,Spink County,,SD,428,7529,7957,1,4,5,328,741,1069,6,0.286997,0.297298,0,0.000004,0.000092,18,0.000082,0,14,1,0.000122
46117,Stanley County,,SD,426,3490,3916,1,1,2,755,795,1550,7,0.224632,0.22971,0,0.000001,0.000001,18,0.00009,0,14,0,0.000086
46119,Sully County,,SD,118,1857,1975,0,1,1,0,117,117,7,0.224673,0.2298,0,0,0.000001,18,0.000049,0,124,0,0
46121,Todd County,,SD,510,8134,8644,3,4,7,335,618,953,6,0.289347,0.299961,9110.16358,0.000066,0.000139,18,0.000177,0,14,0.166667,0.000748
46123,Tripp County,,SD,368,7067,7435,0,3,3,0,325,325,6,0.289388,0.299917,0,0,0.00014,18,0.000049,0,125,1,0
46125,Turner County,,SD,726,9877,10603,2,3,5,1172,1493,2665,6,0.286778,0.296743,0,0.000102,0.000094,18,0.000099,0,14,1,0.001033
46127,Union County,,SD,1534,15841,17375,7,7,14,3871,2951,6822,6,0.315149,0.326709,28.874785,0.000467,0.000409,18,0.000175,0,14,0.714286,0.004152
46129,Walworth County,,SD,469,6505,6974,1,3,4,262,388,650,6,0.287052,0.297204,67.181759,0,0.000085,18,0.000078,0,14,0.333333,0.000066
46135,Yankton County,,SD,1416,24132,25548,10,11,21,2409,2638,5047,5,0.329639,0.344785,521.840256,0.000199,0.000869,18,0.00028,0,14,0.391026,0.002291
46137,Ziebach County,,SD,107,1176,1283,1,0,1,87,0,87,0,0,0,0,0,0,18,0.000068,0,3,0,0.000068
47001,Anderson County,,TN,5069,78243,83312,18,16,34,13370,13494,26864,6,0.327304,0.343176,491.451965,0.002053,0.001869,0,0.000398,0,14,0.447619,0.022218
47003,Bedford County,,TN,2535,43850,46385,12,11,23,7667,6508,14175,5,0.357576,0.375849,3000.126341,0.001945,0.002141,0,0.000238,0,14,0.557692,0.019096
47005,Benton County,,TN,1001,17074,18075,7,8,15,1447,1787,3234,6,0.318896,0.331325,218.41244,0.000482,0.000526,0,0.000176,0,14,0.666667,0.004539
47007,Bledsoe County,,TN,666,11105,11771,4,5,9,1622,1569,3191,6,0.293646,0.304633,200.261862,0.000188,0.000266,0,0.00014,0,14,0.4,0.002629
47009,Blount County,,TN,6806,125892,132698,47,20,67,20353,16139,36492,5,0.360581,0.380437,1935.395292,0.012651,0.003262,0,0.000641,0,14,0.510638,0.116299
47011,Bradley County,,TN,6050,97592,103642,29,20,49,13622,12669,26291,6,0.328486,0.345384,1160.25631,0.007861,0.003053,0,0.000426,0,14,0.510081,0.071008
47013,Campbell County,,TN,1724,37733,39457,7,6,13,3415,3943,7358,6,0.304573,0.316356,89.612883,0.001145,0.000414,0,0.000157,0,14,0.339286,0.008811
47015,Cannon County,,TN,1088,13882,14970,6,6,12,3100,2740,5840,6,0.318625,0.330687,0.913925,0.000596,0.000723,0,0.00015,0,14,0.866667,0.006645
47017,Carroll County,,TN,2065,31167,33232,8,9,17,4635,5392,10027,6,0.325637,0.339692,18.110554,0.000922,0.001148,0,0.000175,0,14,0.805556,0.008728
47019,Carter County,,TN,3297,56622,59919,8,8,16,7893,8690,16583,6,0.304758,0.316939,293.692653,0.000401,0.000482,0,0.000229,0,14,0.535714,0.004845
47021,Cheatham County,,TN,3181,41461,44642,9,11,20,10296,9537,19833,6,0.322214,0.33603,5.944486,0.001018,0.001647,0,0.000173,0,14,0.890909,0.011473
47023,Chester County,,TN,1208,15674,16882,7,7,14,2806,2678,5484,6,0.325496,0.339275,1.438095,0.000498,0.00094,0,0.000167,0,14,0.803571,0.004643
47025,Claiborne County,,TN,1626,32460,34086,8,8,16,3527,3660,7187,6,0.304696,0.3168,158.691889,0.00032,0.000351,0,0.000211,0,14,0.339286,0.003606
47027,Clay County,,TN,484,8177,8661,4,4,8,598,872,1470,7,0.257766,0.266159,18.906277,0.000026,0.000052,0,0.00015,0,14,0.5,0.000799
47029,Cocke County,,TN,1606,36159,37765,7,7,14,3550,4018,7568,6,0.304449,0.316328,9.509309,0.000799,0.000523,0,0.000192,0,14,0.839286,0.008459
47031,Coffee County,,TN,3645,54400,58045,15,16,31,8726,8714,17440,6,0.32211,0.336734,1615.954214,0.001666,0.00187,0,0.000306,0,14,0.503268,0.01792
47033,Crockett County,,TN,1065,15468,16533,6,6,12,2752,2648,5400,6,0.322491,0.335292,1.309524,0.000494,0.000481,0,0.000139,0,14,0.833333,0.004552
47035,Cumberland County,,TN,2592,54734,57326,36,14,50,6261,4273,10534,6,0.320769,0.334765,4589.879817,0.010338,0.001338,0,0.000467,0,14,0.534851,0.091756
47037,Davidson County,,TN,53411,606811,660222,344,267,611,177153,186565,363718,5,0.466895,0.507346,219543.615233,0.078624,0.071411,0,0.003518,0,14,0.257247,0.668742
47039,Decatur County,,TN,690,11562,12252,6,4,10,1451,1260,2711,7,0.261376,0.269988,53.150699,0.000898,0.000036,0,0.000149,0,14,0.533333,0.008379
47041,DeKalb County,,TN,1249,18185,19434,8,8,16,3264,3264,6528,6,0.318828,0.331214,5.060523,0.000611,0.000774,0,0.000206,0,14,0.75,0.00724
47043,Dickson County,,TN,3031,49852,52883,13,13,26,9552,8146,17698,6,0.327126,0.34226,189.81529,0.001489,0.00176,0,0.000235,0,14,0.692308,0.015875
47045,Dyer County,,TN,2271,41750,44021,12,13,25,4993,5066,10059,6,0.325955,0.340635,3306.239391,0.001389,0.001174,0,0.000232,0,14,0.433333,0.011543
47047,Fayette County,,TN,2724,36285,39009,7,8,15,13534,7708,21242,6,0.325496,0.339386,9.046588,0.000544,0.001046,0,0.000154,0,14,0.714286,0.005513
47049,Fentress County,,TN,590,16894,17484,4,4,8,955,981,1936,7,0.2575,0.265771,4.983632,0.000031,0.000111,0,0.00015,0,14,0.666667,0.001271
47051,Franklin County,,TN,2478,43084,45562,13,13,26,5043,5607,10650,6,0.3218,0.33593,1722.615877,0.001641,0.001511,0,0.00026,0,14,0.467033,0.016505
47053,Gibson County,,TN,2869,52731,55600,14,13,27,8772,7543,16315,6,0.325849,0.340468,68.547979,0.001086,0.001167,0,0.000275,0,14,0.543956,0.01099
47055,Giles County,,TN,1789,32162,33951,8,9,17,3987,4508,8495,6,0.320051,0.332934,9.938098,0.000839,0.001041,0,0.000179,0,14,0.694444,0.009338
47057,Grainger County,,TN,1337,21397,22734,7,7,14,4343,4102,8445,6,0.304326,0.316162,4.061324,0.000334,0.000427,0,0.000206,0,14,0.738095,0.004248
47059,Greene County,,TN,2667,71771,74438,16,11,27,6096,5736,11832,6,0.320324,0.333655,370.239243,0.00234,0.001036,0,0.000346,0,14,0.514706,0.023979
47061,Grundy County,,TN,625,14857,15482,5,5,10,1144,1413,2557,6,0.293732,0.304799,1.963564,0.000205,0.000227,0,0.000132,0,14,0.8,0.002406
47063,Hamblen County,,TN,3900,62073,65973,16,14,30,9754,10251,20005,6,0.321009,0.335098,4500.620216,0.00216,0.001313,0,0.000372,0,14,0.504167,0.021435
47065,Hamilton County,,TN,18537,349232,367769,130,107,237,50627,50534,101161,5,0.415146,0.446949,60498.498043,0.03415,0.029687,0,0.001507,0,14,0.419483,0.306388
47067,Hancock County,,TN,273,4662,4935,2,2,4,255,458,713,7,0.243101,0.24908,0,0.000014,0.000015,0,0.000095,0,14,1,0.000302
47069,Hardeman County,,TN,1479,27268,28747,9,9,18,3259,3444,6703,6,0.325566,0.339608,68.090566,0.000968,0.00094,0,0.000186,0,14,0.518182,0.009452
47071,Hardin County,,TN,1342,26298,27640,10,10,20,2734,2769,5503,6,0.325778,0.340052,777.072777,0.000512,0.000952,0,0.000232,0,14,0.481818,0.004969
47073,Hawkins County,,TN,3377,59579,62956,13,13,26,9628,9669,19297,6,0.320392,0.333988,2385.663065,0.00041,0.001048,0,0.000357,0,14,0.466667,0.005527
47075,Haywood County,,TN,1253,22025,23278,7,9,16,2662,3681,6343,6,0.325531,0.339553,7.67614,0.000496,0.000962,0,0.000162,0,14,0.680556,0.004712
47077,Henderson County,,TN,1540,29193,30733,9,9,18,3867,3391,7258,6,0.325566,0.339608,493.280346,0.00092,0.000948,0,0.00021,0,14,0.652778,0.00874
47079,Henry County,,TN,1844,33826,35670,13,10,23,3627,3383,7010,6,0.327126,0.3419,148.098154,0.001794,0.001381,0,0.000231,0,14,0.554945,0.016517
47081,Hickman County,,TN,1731,23210,24941,9,10,19,4629,4633,9262,6,0.321146,0.334393,1442.386398,0.000741,0.001168,0,0.000193,0,14,0.622222,0.008568
47083,Houston County,,TN,459,8080,8539,4,4,8,1129,1065,2194,6,0.30061,0.311474,1.333333,0.000245,0.000252,0,0.000106,0,14,0.666667,0.002403
47085,Humphreys County,,TN,1038,19823,20861,6,7,13,2128,2067,4195,6,0.321009,0.333838,65.440552,0.000667,0.000911,0,0.000141,0,14,0.571429,0.006498
47087,Jackson County,,TN,884,11512,12396,6,5,11,1819,1948,3767,7,0.257523,0.26591,215.161818,0.000456,0.000061,0,0.000179,0,14,0.595238,0.004981
47089,Jefferson County,,TN,3779,48373,52152,18,12,30,12425,11448,23873,6,0.304727,0.317355,149.790996,0.002667,0.000657,0,0.000365,0,14,0.470588,0.02656
47091,Johnson County,,TN,605,16071,16676,6,5,11,1148,1312,2460,6,0.271929,0.281375,31.359517,0.000123,0.000175,0,0.00017,0,14,0.4,0.002144
47093,Knox County,,TN,25729,421848,447577,198,163,361,88187,75077,163264,5,0.436755,0.472442,84556.296581,0.054704,0.050283,0,0.002098,0,14,0.395496,0.479268
47095,Lake County,,TN,391,5318,5709,2,2,4,668,943,1611,7,0.246189,0.252442,0,0.000014,0.000014,0,0.00008,0,14,1,0.00026
47097,Lauderdale County,,TN,1448,25870,27318,7,7,14,3484,3676,7160,6,0.325496,0.339275,20.728348,0.000912,0.000953,0,0.000151,0,14,0.809524,0.008616
47099,Lawrence County,,TN,1613,43091,44704,8,11,19,3372,3695,7067,6,0.319031,0.33188,590.440312,0.000739,0.000956,0,0.000182,0,14,0.490909,0.008468
47101,Lewis County,,TN,765,11729,12494,5,7,12,983,1401,2384,6,0.318659,0.330853,1215.760252,0.000452,0.00072,0,0.000134,0,14,0.595238,0.004824
47103,Lincoln County,,TN,1621,34994,36615,11,10,21,4619,3996,8615,6,0.320017,0.332989,644.109724,0.000864,0.001005,0,0.000237,0,14,0.554545,0.009722
47105,Loudon County,,TN,3201,48419,51620,12,10,22,9775,8862,18637,6,0.320495,0.333905,28.226571,0.002578,0.001234,0,0.000231,0,14,0.653846,0.022172
47107,McMinn County,,TN,2975,52626,55601,13,12,25,7671,7752,15423,6,0.320598,0.334265,192.578224,0.001438,0.001345,0,0.000301,0,14,0.620879,0.015624
47109,McNairy County,,TN,1441,26467,27908,8,8,16,3709,3459,7168,6,0.325566,0.339497,9.19376,0.000502,0.000942,0,0.000186,0,14,0.652778,0.00482
47111,Macon County,,TN,1130,21913,23043,10,11,21,3186,3101,6287,6,0.318998,0.331824,1035.9752,0.000651,0.000872,0,0.000259,0,14,0.439394,0.007852
47113,Madison County,,TN,6725,101824,108549,34,30,64,16504,17145,33649,6,0.353453,0.374889,4392.06627,0.004251,0.003838,0,0.000541,0,14,0.284535,0.037385
47115,Marion County,,TN,1541,30027,31568,8,9,17,3598,3759,7357,6,0.319473,0.332379,101.874677,0.000208,0.000699,0,0.000197,0,14,0.444444,0.002687
47117,Marshall County,,TN,1817,31720,33537,10,7,17,5516,4483,9999,6,0.318592,0.330742,3.083585,0.000805,0.000931,0,0.000205,0,14,0.711111,0.009693
47119,Maury County,,TN,4821,81646,86467,32,21,53,16797,12304,29101,6,0.341558,0.360913,873.016022,0.008578,0.003184,0,0.000399,0,14,0.504762,0.071982
47121,Meigs County,,TN,927,11083,12010,6,7,13,2859,2678,5537,6,0.305378,0.317715,0.544444,0.000218,0.000603,0,0.000164,0,14,0.904762,0.002941
47123,Monroe County,,TN,2251,42792,45043,14,9,23,6642,6175,12817,6,0.305533,0.318187,166.68434,0.002472,0.000677,0,0.000267,0,14,0.557143,0.022988
47125,Montgomery County,,TN,20682,149570,170252,135,134,269,57302,52652,109954,5,0.42945,0.462666,29740.420574,0.039867,0.038057,0,0.001208,0,14,0.444996,0.338931
47127,Moore County,,TN,480,6493,6973,4,4,8,1201,1013,2214,6,0.26495,0.272903,0,0.000038,0.000036,0,0.000121,0,14,1,0.000651
47129,Morgan County,,TN,1198,20067,21265,6,7,13,2826,2975,5801,6,0.304449,0.316328,200.913989,0.000327,0.000479,0,0.000183,0,14,0.571429,0.003946
47131,Obion County,,TN,2149,35989,38138,10,12,22,4623,4807,9430,6,0.326273,0.340912,6103.214169,0.000919,0.001166,0,0.00022,0,14,0.467949,0.008762
47133,Overton County,,TN,1123,21643,22766,6,8,14,2763,2679,5442,6,0.318964,0.331408,1245.919495,0.000026,0.000584,0,0.000242,0,14,0.464286,0.001415
47135,Perry County,,TN,487,7562,8049,4,4,8,465,507,972,7,0.243594,0.249901,348.846702,0.000432,0.000013,0,0.000125,0,14,0.45,0.00434
47137,Pickett County,,TN,275,4980,5255,3,3,6,283,416,699,7,0.257456,0.265483,2874.919355,0.00002,0.000048,0,0.000162,0,14,0.333333,0.000653
47139,Polk County,,TN,1167,16514,17681,7,5,12,3315,3493,6808,6,0.29379,0.304882,54.621938,0.000217,0.000305,0,0.000211,0,14,0.428571,0.003394
47141,Putnam County,,TN,4571,66999,71570,37,23,60,11856,10557,22413,6,0.346402,0.366495,23869.056392,0.008172,0.002837,0,0.000658,0,14,0.389339,0.074686
47143,Rhea County,,TN,1687,30583,32270,8,8,16,3534,3787,7321,6,0.305533,0.318104,31.287905,0.000519,0.000648,0,0.000201,0,14,0.660714,0.00624
47145,Roane County,,TN,3429,57130,60559,13,15,28,7968,8807,16775,6,0.320769,0.334876,144.102785,0.001096,0.001492,0,0.000305,0,14,0.590476,0.012816
47147,Robertson County,,TN,4704,67782,72486,15,15,30,16562,13004,29566,6,0.329278,0.345617,88.653177,0.001941,0.002272,0,0.000246,0,14,0.625,0.020189
47149,Rutherford County,,TN,16820,230511,247331,128,80,208,76317,49948,126265,5,0.41145,0.440374,24984.578741,0.033046,0.023054,0,0.001455,0,14,0.388235,0.284328
47151,Scott County,,TN,727,21704,22431,5,5,10,1025,1222,2247,6,0.304387,0.315968,856.074956,0.000313,0.000343,0,0.000145,0,14,0.5,0.003321
47153,Sequatchie County,,TN,739,12508,13247,3,3,6,2097,1688,3785,6,0.293474,0.304078,1.142857,0.000181,0.000204,0,0.000104,0,14,0.666667,0.00202
47155,Sevier County,,TN,5744,84870,90614,46,20,66,15970,13571,29541,6,0.348897,0.367144,1429.223131,0.011785,0.002532,0,0.000615,0,14,0.48767,0.107918
47157,Shelby County,,TN,50400,1022223,1072623,318,323,641,139691,172143,311834,5,0.475467,0.519996,264396.599003,0.073543,0.075694,0,0.003064,0,14,0.244462,0.626079
47159,Smith County,,TN,1132,19738,20870,9,9,18,3616,3288,6904,6,0.318862,0.33138,366.314931,0.000658,0.000875,0,0.000226,0,14,0.680556,0.008154
47161,Stewart County,,TN,1045,13355,14400,4,5,9,2081,1909,3990,6,0.321009,0.333589,46.466363,0.000766,0.000835,0,0.000098,0,14,0.6,0.007253
47163,Sullivan County,,TN,8647,168678,177325,39,32,71,24484,23359,47843,5,0.369678,0.3918,37044.558092,0.009248,0.00638,0,0.000703,0,14,0.405051,0.086826
47165,Sumner County,,TN,11227,156847,168074,57,38,95,38371,30158,68529,5,0.385474,0.409709,8092.322735,0.01834,0.008971,0,0.000628,0,14,0.520089,0.159024
47167,Tipton County,,TN,3770,62297,66067,13,10,23,14284,9325,23609,6,0.325602,0.339775,219.729724,0.002854,0.001237,0,0.000201,0,14,0.466667,0.025155
47169,Trousdale County,,TN,543,7867,8410,5,5,10,2088,1530,3618,6,0.318558,0.330465,0,0.000502,0.000626,0,0.000132,0,14,1,0.005722
47171,Unicoi County,,TN,1223,18254,19477,5,4,9,2636,2777,5413,6,0.270875,0.279605,2.854691,0.000284,0.000157,0,0.000151,0,14,0.85,0.004065
47173,Union County,,TN,1446,18550,19996,7,7,14,4148,4159,8307,6,0.304264,0.316051,4.089368,0.00035,0.000498,0,0.000208,0,14,0.714286,0.004885
47175,Van Buren County,,TN,355,5206,5561,3,3,6,595,715,1310,7,0.257434,0.265521,3.021825,0.000012,0.000061,0,0.00012,0,14,0.5,0.000356
47177,Warren County,,TN,1885,41761,43646,11,12,23,3596,4105,7701,6,0.319711,0.3331,1525.022515,0.000784,0.000991,0,0.000272,0,14,0.537879,0.008967
47179,Washington County,,TN,8142,116706,124848,52,34,86,24199,20794,44993,5,0.37059,0.393048,23642.533769,0.01466,0.008125,0,0.000786,0,14,0.504221,0.137205
47181,Wayne County,,TN,692,15712,16404,5,4,9,1049,1161,2210,6,0.318828,0.33077,682.141763,0.000031,0.000483,0,0.00014,0,14,0.533333,0.000601
47183,Weakley County,,TN,2044,33161,35205,12,13,25,4526,4669,9195,6,0.326948,0.341994,2457.864046,0.001071,0.001486,0,0.000237,0,14,0.510989,0.010731
47185,White County,,TN,1381,25600,26981,10,8,18,3453,3264,6717,6,0.31893,0.33138,2585.263881,0.001454,0.000778,0,0.000258,0,14,0.463636,0.014435
47187,Williamson County,,TN,13094,166461,179555,101,63,164,54200,38449,92649,5,0.408986,0.435952,7471.57494,0.034032,0.022933,0,0.000947,0,14,0.600419,0.292871
47189,Wilson County,,TN,7680,110633,118313,29,21,50,29538,21256,50794,5,0.358772,0.378873,1462.725491,0.007998,0.003017,0,0.000414,0,14,0.504301,0.07225
48001,Anderson County,,TX,3081,43642,46723,22,22,44,7468,7454,14922,6,0.345645,0.364536,24.434284,0.004066,0.005319,89,0.000261,0,14,0.738462,0.040902
48003,Andrews County,,TX,1176,14201,15377,6,5,11,1416,1815,3231,6,0.290129,0.302364,47.621131,0.000819,0.000315,89,0.000126,0,14,0.857143,0.007809
48005,Angelina County,,TX,5020,84604,89624,33,36,69,11401,12680,24081,6,0.346962,0.367554,225.550247,0.005318,0.006294,89,0.00038,0,14,0.5503,0.052947
48007,Aransas County,,TX,2112,21285,23397,15,9,24,5030,4224,9254,6,0.344022,0.360958,17.027203,0.003609,0.002742,89,0.000201,0,14,0.885714,0.036568
48009,Archer County,,TX,946,8925,9871,4,3,7,2065,2045,4110,6,0.331458,0.345467,0.25,0.000677,0.000692,89,0.000093,0,14,0.833333,0.006299
48011,Armstrong County,,TX,192,2054,2246,2,2,4,608,283,891,6,0.274138,0.283611,0,0.000123,0.00013,89,0.000079,0,14,1,0.001361
48013,Atascosa County,,TX,3372,43018,46390,12,11,23,9674,9503,19177,6,0.343471,0.360292,46.51829,0.002824,0.002559,89,0.000182,0,14,0.788462,0.027401
48015,Austin County,,TX,1971,28201,30172,12,10,22,5979,5419,11398,6,0.338326,0.354988,5.071468,0.002242,0.001929,89,0.00017,0,14,0.80303,0.0233
48017,Bailey County,,TX,601,7054,7655,4,4,8,664,939,1603,6,0.28615,0.29767,3.265472,0.000183,0.000158,4,0.000102,0,14,0.666667,0.001762
48019,Bandera County,,TX,1790,18007,19797,8,8,16,4290,3646,7936,6,0.342375,0.358655,0.570478,0.001818,0.002238,89,0.000146,0,14,0.916667,0.018478
48021,Bastrop County,,TX,5826,63691,69517,28,19,47,19742,15945,35687,5,0.361449,0.382102,122.862722,0.007647,0.006025,89,0.000315,0,14,0.807882,0.074473
48023,Baylor County,,TX,337,3746,4083,1,1,2,111,251,362,6,0.284766,0.295229,0,0.000122,0.000107,89,0.000057,0,14,0,0.001031
48025,Bee County,,TX,2047,24299,26346,11,11,22,3735,4081,7816,6,0.343668,0.360514,168.609879,0.00201,0.002239,89,0.00017,0,14,0.7,0.020091
48027,Bell County,,TX,37845,269149,306994,259,227,486,118770,111488,230258,5,0.453639,0.493253,31382.735987,0.066959,0.058408,89,0.00212,0,14,0.325312,0.567258
48029,Bexar County,,TX,83404,1608162,1691566,455,382,837,353807,289848,643655,5,0.489969,0.536324,167388.882277,0.095934,0.084745,89,0.003931,0,14,0.201828,0.809806
48031,Blanco County,,TX,817,9149,9966,7,6,13,1742,1473,3215,6,0.330801,0.344252,0.381046,0.001702,0.001326,89,0.000131,0,14,0.904762,0.017385
48033,Borden County,,TX,77,616,693,0,0,0,0,0,0,0,0,0,0,0,0,83,0.000049,70,126,0,0
48035,Bosque County,,TX,1565,17446,19011,12,11,23,3822,3725,7547,6,0.335418,0.35172,21.811853,0.002706,0.001905,89,0.000188,0,14,0.762821,0.026396
48037,Bowie County,,TX,6445,91491,97936,38,34,72,17021,16308,33329,6,0.352293,0.374318,10617.347802,0.006781,0.006224,89,0.000483,0,14,0.382114,0.06333
48039,Brazoria County,,TX,19094,281179,300273,80,80,160,83940,60213,144153,5,0.388314,0.417588,2866.682181,0.022221,0.01664,89,0.000708,0,14,0.410212,0.194035
48041,Brazos County,,TX,14943,132726,147669,82,76,158,36182,41616,77798,5,0.395055,0.424046,3865.809496,0.015416,0.019267,89,0.000878,0,14,0.396276,0.144174
48043,Brewster County,,TX,1111,8659,9770,8,8,16,1104,1668,2772,6,0.333038,0.347415,3079.587355,0.002009,0.001644,89,0.000174,0,14,0.633333,0.019365
48045,Briscoe County,,TX,172,1819,1991,0,0,0,0,0,0,0,0,0,0,0,0,84,0.000049,71,127,0,0
48047,Brooks County,,TX,515,8031,8546,4,4,8,935,1164,2099,6,0.303342,0.315002,0,0.000396,0.00043,89,0.000088,0,14,1,0.004055
48049,Brown County,,TX,2516,36328,38844,22,24,46,5075,5479,10554,6,0.348048,0.367693,11704.582828,0.004426,0.004781,89,0.000379,0,14,0.533333,0.043985
48051,Burleson County,,TX,1373,17525,18898,7,7,14,2869,3138,6007,6,0.338212,0.354488,1.67234,0.001295,0.001298,89,0.000123,0,14,0.767857,0.012797
48053,Burnet County,,TX,3309,38891,42200,24,21,45,9988,8595,18583,6,0.346522,0.365618,100.669481,0.006878,0.005611,89,0.000289,0,14,0.768473,0.064891
48055,Caldwell County,,TX,3246,34157,37403,11,13,24,9031,9495,18526,6,0.345486,0.363288,5.169593,0.002499,0.004106,89,0.000173,0,14,0.910256,0.026323
48057,Calhoun County,,TX,1593,21396,22989,9,9,18,2781,3207,5988,6,0.343628,0.360236,7.877045,0.001999,0.002308,89,0.000134,0,14,0.866667,0.019845
48059,Callahan County,,TX,1358,12944,14302,5,6,11,3235,3163,6398,6,0.33175,0.346521,3.612266,0.00069,0.000805,89,0.000109,0,14,0.8,0.006484
48061,Cameron County,,TX,15566,375477,391043,69,67,136,37826,41001,78827,5,0.396045,0.423702,1943.601858,0.02199,0.020117,89,0.00061,0,14,0.531173,0.196023
48063,Camp County,,TX,974,11959,12933,10,10,20,2780,2452,5232,6,0.334521,0.350361,2.936583,0.001626,0.001374,89,0.000165,0,14,0.818182,0.015729
48065,Carson County,,TX,614,6241,6855,4,4,8,1343,1518,2861,6,0.274188,0.283944,0,0.000143,0.000146,89,0.000123,0,14,1,0.001658
48067,Cass County,,TX,2084,31697,33781,14,13,27,5159,5199,10358,6,0.342883,0.360347,20.514617,0.00239,0.002161,89,0.000209,0,14,0.747253,0.02345
48069,Castro County,,TX,666,8020,8686,6,7,13,892,1560,2452,6,0.286095,0.297875,7.976849,0.00028,0.000262,89,0.000133,0,14,0.761905,0.002844
48071,Chambers County,,TX,2506,31724,34230,8,10,18,9508,8476,17984,6,0.342805,0.359903,0,0.001187,0.002987,89,0.00012,0,14,0.981818,0.012334
48073,Cherokee County,,TX,2872,46760,49632,12,16,28,7032,7969,15001,6,0.345129,0.363149,5.031309,0.002314,0.004343,89,0.000167,0,14,0.816176,0.022503
48075,Childress County,,TX,533,5924,6457,3,2,5,295,213,508,6,0.274138,0.283611,3013.071362,0.000061,0.00013,89,0.000124,0,14,0.166667,0.000793
48077,Clay County,,TX,1079,11664,12743,3,5,8,2323,2602,4925,6,0.336055,0.351115,0.333333,0.000669,0.001259,89,0.000081,0,14,0.8,0.006207
48079,Cochran County,,TX,295,3504,3799,2,2,4,385,664,1049,6,0.284739,0.295584,0,0.000133,0.000109,89,0.000077,0,14,1,0.001184
48081,Coke County,,TX,387,3376,3763,1,1,2,420,461,881,6,0.278664,0.288488,0,0.000104,0.000086,89,0.000059,0,14,0,0.000854
48083,Coleman County,,TX,716,8350,9066,4,3,7,985,776,1761,6,0.28708,0.297892,0,0.000775,0.0002,89,0.000091,0,14,1,0.007059
48085,Collin County,,TX,60886,648337,709223,306,247,553,318527,219809,538336,5,0.463867,0.502935,39982.383608,0.079977,0.068206,89,0.002509,0,14,0.312468,0.667295
48087,Collingsworth County,,TX,280,2996,3276,0,0,0,0,0,0,0,0,0,0,0,0,85,0.000049,72,128,0,0
48089,Colorado County,,TX,1403,21347,22750,9,10,19,3217,2981,6198,6,0.342375,0.358877,6.986426,0.0019,0.0024,89,0.000143,0,14,0.772727,0.019672
48091,Comal County,,TX,7795,96119,103914,57,35,92,37858,23396,61254,5,0.366968,0.39023,647.971249,0.014243,0.008852,89,0.000614,0,14,0.572898,0.131018
48093,Comanche County,,TX,1053,13467,14520,7,6,13,1743,1836,3579,6,0.331056,0.345467,15.191642,0.001257,0.00073,89,0.000137,0,14,0.785714,0.011697
48095,Concho County,,TX,273,2664,2937,1,2,3,298,239,537,6,0.27869,0.288654,0,0.000104,0.000087,89,0.000059,0,14,1,0.000854
48097,Cooke County,,TX,2875,39108,41983,10,10,20,6868,7359,14227,6,0.342609,0.359626,1366.039582,0.002547,0.002779,89,0.000161,0,14,0.727273,0.024775
48099,Coryell County,,TX,11803,55672,67475,69,74,143,30883,36739,67622,5,0.400694,0.4291,1995.122265,0.020119,0.020713,89,0.000598,0,14,0.545098,0.176257
48101,Cottle County,,TX,137,1733,1870,0,0,0,0,0,0,0,0,0,0,0,0,86,0.000049,73,129,0,0
48103,Crane County,,TX,425,4291,4716,2,2,4,477,484,961,6,0.274213,0.283761,0,0.000125,0.000125,89,0.000077,0,14,1,0.001381
48105,Crockett County,,TX,348,3974,4322,1,1,2,231,155,386,6,0.278664,0.288488,0,0.000104,0.000086,89,0.000059,0,14,0,0.000854
48107,Crosby County,,TX,638,6546,7184,1,1,2,1071,1459,2530,6,0.284712,0.295417,0,0.000125,0.000102,89,0.00006,0,14,0,0.00105
48109,Culberson County,,TX,298,2765,3063,0,2,2,0,200,200,6,0.313086,0.324681,0,0,0.000384,4,0.000049,0,130,1,0
48111,Dallam County,,TX,688,6837,7525,5,3,8,634,687,1321,6,0.274188,0.283833,3004,0.000137,0.000138,89,0.000158,0,14,0.55,0.001647
48113,Dallas County,,TX,175031,2265996,2441027,483,464,947,553725,657576,1211301,5,0.495219,0.549318,254009.903748,0.095181,0.092343,89,0.004347,0,14,0.16506,0.803474
48115,Dawson County,,TX,987,12958,13945,5,6,11,1183,1646,2829,6,0.28528,0.297026,11.925069,0.000219,0.000247,89,0.000138,0,14,0.633333,0.002226
48117,Deaf Smith County,,TX,1449,19634,21083,7,7,14,2046,2578,4624,6,0.336847,0.352336,144.949585,0.001441,0.001379,89,0.000136,0,14,0.736111,0.012115
48119,Delta County,,TX,582,5060,5642,4,5,9,1142,1359,2501,6,0.331458,0.345961,0,0.00062,0.001102,89,0.000089,0,14,1,0.005769
48121,Denton County,,TX,55568,542817,598385,286,216,502,273101,200112,473213,5,0.456882,0.494197,39247.384258,0.073401,0.057624,89,0.002448,0,14,0.313158,0.618311
48123,DeWitt County,,TX,1017,19457,20474,7,8,15,2334,2653,4987,6,0.34257,0.358905,3.28777,0.001759,0.002294,89,0.000124,0,14,0.821429,0.017366
48125,Dickens County,,TX,237,2097,2334,1,1,2,162,58,220,6,0.284712,0.295417,0,0.000125,0.000102,89,0.00006,0,14,0,0.00105
48127,Dimmit County,,TX,736,9950,10686,4,5,9,870,1233,2103,6,0.33091,0.344308,2.038991,0.000591,0.001166,89,0.000101,0,14,0.8,0.005765
48129,Donley County,,TX,371,3534,3905,2,3,5,362,498,860,6,0.274163,0.283777,0,0.000123,0.000138,89,0.000079,0,14,1,0.001361
48131,Duval County,,TX,855,12223,13078,4,4,8,1527,2055,3582,6,0.32935,0.341933,0,0.000711,0.000777,89,0.000088,0,14,1,0.006966
48133,Eastland County,,TX,1444,17472,18916,10,11,21,2394,2417,4811,6,0.335418,0.351409,32.375843,0.001314,0.001795,89,0.000178,0,14,0.627273,0.012559
48135,Ector County,,TX,7861,133493,141354,52,47,99,22375,20409,42784,5,0.373492,0.398668,15547.065564,0.009116,0.009768,89,0.000757,0,14,0.384278,0.088416
48137,Edwards County,,TX,176,2010,2186,0,0,0,0,0,0,0,0,0,0,0,0,87,0.000049,74,131,0,0
48139,Ellis County,,TX,9886,134730,144616,44,35,79,44005,29592,73597,5,0.365851,0.389009,223.563376,0.012239,0.007763,89,0.000445,0,14,0.671837,0.111861
48141,El Paso County,,TX,39142,799358,838500,213,223,436,106343,118881,225224,5,0.454669,0.493309,57547.289686,0.056075,0.059084,4,0.001894,0,14,0.352713,0.481817
48143,Erath County,,TX,2904,30285,33189,22,22,44,6543,6571,13114,6,0.346402,0.365224,219.278952,0.004443,0.004561,89,0.000324,0,14,0.621667,0.044865
48145,Falls County,,TX,1277,15125,16402,5,8,13,2331,3183,5514,6,0.342375,0.359127,1.897792,0.001588,0.002243,89,0.000098,0,14,0.785714,0.014992
48147,Fannin County,,TX,2209,30035,32244,9,8,17,6695,5927,12622,6,0.334633,0.350305,3.176825,0.002542,0.002161,89,0.000137,0,14,0.916667,0.024542
48149,Fayette County,,TX,1430,24765,26195,14,14,28,3492,3050,6542,6,0.342649,0.359709,16.255689,0.002415,0.002641,89,0.0002,0,14,0.645833,0.025495
48151,Fisher County,,TX,269,3916,4185,2,0,2,340,0,340,0,0,0,0,0.000116,0,89,0.00007,0,1,1,0.001028
48153,Floyd County,,TX,589,7659,8248,2,2,4,771,1238,2009,6,0.284739,0.295584,0,0.000148,0.000118,89,0.000072,0,14,1,0.001269
48155,Foard County,,TX,133,1488,1621,0,0,0,0,0,0,0,0,0,0,0,0,88,0.000049,75,132,0,0
48157,Fort Bend County,,TX,35441,463771,499212,180,115,295,212340,131948,344288,5,0.422088,0.4539,8940.589645,0.056601,0.036756,89,0.001383,0,14,0.478126,0.468101
48159,Franklin County,,TX,999,9861,10860,9,8,17,2617,2623,5240,6,0.334521,0.350139,2.38903,0.001896,0.001674,89,0.00015,0,14,0.791667,0.018526
48161,Freestone County,,TX,1369,17882,19251,10,10,20,3311,3070,6381,6,0.342375,0.359293,2.954086,0.002036,0.00205,89,0.000154,0,14,0.809091,0.019222
48163,Frio County,,TX,919,14196,15115,4,6,10,1376,1874,3250,6,0.341985,0.357878,19.170955,0.000534,0.001245,89,0.000111,0,14,0.666667,0.005417
48165,Gaines County,,TX,1025,15402,16427,7,8,15,1413,1647,3060,6,0.285361,0.297415,13.124772,0.000221,0.000273,89,0.000163,0,14,0.589286,0.002584
48167,Galveston County,,TX,20284,285382,305666,85,86,171,73013,62698,135711,5,0.398779,0.428723,2905.751546,0.023804,0.022666,89,0.000752,0,14,0.465446,0.211416
48169,Garza County,,TX,407,4520,4927,1,1,2,441,666,1107,6,0.284712,0.295417,0,0.000125,0.000102,89,0.00006,0,14,0,0.00105
48171,Gillespie County,,TX,1397,23671,25068,11,11,22,3185,2462,5647,6,0.343983,0.361152,21.287516,0.002968,0.002914,89,0.000189,0,14,0.810606,0.029924
48173,Glasscock County,,TX,117,1473,1590,1,0,1,51,0,51,0,0,0,0,0.000067,0,89,0.000063,0,11,0,0.000777
48175,Goliad County,,TX,484,7030,7514,3,1,4,927,695,1622,7,0.257788,0.265471,0,0.000803,0.000042,89,0.000079,0,14,1,0.007644
48177,Gonzales County,,TX,1155,19057,20212,11,11,22,2310,2794,5104,6,0.342453,0.359099,6.627661,0.001805,0.002119,89,0.000182,0,14,0.689394,0.018863
48179,Gray County,,TX,1581,21446,23027,10,8,18,2689,2418,5107,6,0.34355,0.360652,1041.143665,0.001409,0.002009,89,0.000219,0,14,0.590909,0.013511
48181,Grayson County,,TX,7617,119130,126747,35,31,66,20686,19122,39808,5,0.367507,0.390396,1127.299527,0.008653,0.007538,89,0.000408,0,14,0.585695,0.08132
48183,Gregg County,,TX,10058,121993,132051,54,47,101,29893,30761,60654,5,0.371506,0.396394,1219.339143,0.010261,0.009079,89,0.000578,0,14,0.468542,0.096181
48185,Grimes County,,TX,2056,22718,24774,9,8,17,5985,5395,11380,6,0.33825,0.354655,5.406664,0.001752,0.001595,89,0.000144,0,14,0.833333,0.017523
48187,Guadalupe County,,TX,9290,110407,119697,69,46,115,41649,27422,69071,5,0.379245,0.404389,1017.453249,0.019128,0.012998,89,0.00066,0,14,0.570393,0.17178
48189,Hale County,,TX,3267,36583,39850,13,17,30,5102,6897,11999,6,0.347283,0.366034,1821.889562,0.002705,0.00393,89,0.000224,0,14,0.555556,0.026004
48191,Hall County,,TX,348,3436,3784,0,1,1,0,158,158,7,0.215212,0.219785,0,0,0,89,0.000049,0,133,0,0
48193,Hamilton County,,TX,700,8330,9030,7,5,12,1190,910,2100,6,0.312559,0.324811,2.647268,0.001329,0.000637,89,0.000129,0,14,0.821429,0.012576
48195,Hansford County,,TX,462,5560,6022,2,4,6,228,393,621,6,0.274213,0.283999,0.5,0.000064,0.000139,89,0.000092,0,14,0.833333,0.000772
48197,Hardeman County,,TX,358,4374,4732,1,3,4,220,528,748,6,0.284901,0.295728,1.646465,0.000008,0.000115,89,0.000063,0,14,0.333333,0.000132
48199,Hardin County,,TX,4185,53821,58006,21,19,40,13657,11910,25567,6,0.343157,0.361401,54.248671,0.003875,0.003971,89,0.000241,0,14,0.67,0.036065
48201,Harris County,,TX,198375,3797481,3995856,627,576,1203,762967,766031,1528998,5,0.509671,0.571111,457541.741024,0.107491,0.101849,89,0.005619,0,14,0.123481,0.907273
48203,Harrison County,,TX,4735,63847,68582,18,18,36,12620,12931,25551,6,0.343668,0.361845,29.805025,0.003773,0.003956,89,0.000236,0,14,0.716374,0.035273
48205,Hartley County,,TX,463,3875,4338,2,4,6,197,447,644,6,0.274213,0.283999,0,0.000123,0.000139,89,0.000079,0,14,1,0.001361
48207,Haskell County,,TX,478,5719,6197,3,4,7,592,775,1367,6,0.288791,0.300405,3049.801523,0.000115,0.000197,89,0.000104,0,14,0.583333,0.001083
48209,Hays County,,TX,12139,109023,121162,67,44,111,57869,40841,98710,5,0.377245,0.401676,1079.071396,0.015697,0.011275,89,0.000701,0,14,0.513389,0.143285
48211,Hemphill County,,TX,302,3551,3853,0,2,2,0,176,176,6,0.274179,0.283683,0,0,0.00013,89,0.000049,0,134,1,0
48213,Henderson County,,TX,6100,72188,78288,25,26,51,18419,17486,35905,6,0.345804,0.365202,35.81164,0.00469,0.005359,89,0.000306,0,14,0.685961,0.047021
48215,Hidalgo County,,TX,22038,653173,675211,145,129,274,66899,56294,123193,5,0.422622,0.455853,27702.735403,0.037122,0.031345,89,0.001284,0,14,0.336484,0.323523
48217,Hill County,,TX,2761,33089,35850,14,15,29,7864,7290,15154,6,0.345327,0.363316,13.288768,0.003455,0.004477,89,0.000198,0,14,0.825,0.034303
48219,Hockley County,,TX,1972,23553,25525,7,8,15,3864,4978,8842,6,0.341209,0.358417,826.561906,0.001232,0.001438,89,0.000156,0,14,0.522222,0.011365
48221,Hood County,,TX,3811,45625,49436,31,16,47,13291,9658,22949,6,0.345804,0.364092,267.484569,0.007155,0.004436,89,0.000383,0,14,0.630108,0.067674
48223,Hopkins County,,TX,2406,33420,35826,16,17,33,5997,5618,11615,6,0.342649,0.360458,65.675321,0.002688,0.00306,89,0.000234,0,14,0.669935,0.026646
48225,Houston County,,TX,1462,20259,21721,8,11,19,2407,2727,5134,6,0.342414,0.35946,9.472083,0.001544,0.002277,89,0.00013,0,14,0.810606,0.015292
48227,Howard County,,TX,2356,30177,32533,15,17,32,3407,4068,7475,6,0.347203,0.365779,2035.452276,0.003093,0.004187,89,0.000243,0,14,0.647059,0.02953
48229,Hudspeth County,,TX,305,3365,3670,1,1,2,287,412,699,6,0.312591,0.323791,0,0.000348,0.000331,4,0.000056,0,14,0,0.002878
48231,Hunt County,,TX,7376,79512,86888,28,29,57,21024,20703,41727,6,0.348088,0.36867,375.388335,0.006561,0.005666,89,0.000341,0,14,0.631048,0.063577
48233,Hutchinson County,,TX,1861,24589,26450,9,8,17,2567,3286,5853,6,0.341441,0.358666,495.001059,0.001412,0.001457,89,0.000196,0,14,0.680556,0.013436
48235,Irion County,,TX,155,1659,1814,1,0,1,444,0,444,0,0,0,0,0.000104,0,89,0.000059,0,13,0,0.000854
48237,Jack County,,TX,670,7599,8269,6,7,13,1319,1650,2969,6,0.331604,0.346133,0.225,0.00075,0.000848,89,0.000119,0,14,0.928571,0.00728
48239,Jackson County,,TX,1057,15001,16058,5,7,12,1922,2100,4022,6,0.342297,0.358433,0.291667,0.000689,0.001805,89,0.000103,0,14,0.928571,0.006637
48241,Jasper County,,TX,2673,35734,38407,12,16,28,6198,6963,13161,6,0.343001,0.360847,33.16607,0.001765,0.003096,89,0.000165,0,14,0.683824,0.017244
48243,Jeff Davis County,,TX,212,2142,2354,0,1,1,0,73,73,7,0.249896,0.255733,0,0,0.000012,89,0.000049,0,135,0,0
48245,Jefferson County,,TX,13835,253969,267804,68,57,125,36190,46574,82764,5,0.383702,0.41017,5398.601196,0.016645,0.014217,89,0.000609,0,14,0.482116,0.145331
48247,Jim Hogg County,,TX,328,5320,5648,2,1,3,223,52,275,6,0.27547,0.284143,0,0.000233,0.000057,89,0.000066,0,14,1,0.00216
48249,Jim Wells County,,TX,2856,42599,45455,14,14,28,7104,7550,14654,6,0.345565,0.363316,223.383852,0.002721,0.003001,89,0.000202,0,14,0.661905,0.0265
48251,Johnson County,,TX,11458,143538,154996,47,34,81,41914,34646,76560,5,0.368137,0.391617,749.842803,0.010589,0.008823,89,0.000541,0,14,0.579082,0.099569
48253,Jones County,,TX,1628,15188,16816,6,7,13,2954,3345,6299,6,0.335868,0.351631,482.703028,0.001318,0.001338,89,0.000124,0,14,0.666667,0.011982
48255,Karnes County,,TX,850,12639,13489,6,7,13,1397,1591,2988,6,0.331238,0.344918,0.85,0.001162,0.001454,89,0.000118,0,14,0.857143,0.011925
48257,Kaufman County,,TX,7878,89013,96891,28,22,50,38876,24894,63770,5,0.357747,0.378529,147.777032,0.008127,0.005721,89,0.000315,0,14,0.731034,0.075405
48259,Kendall County,,TX,2415,30185,32600,16,13,29,9142,6054,15196,6,0.345049,0.362705,44.303951,0.005142,0.003577,89,0.000221,0,14,0.816993,0.05094
48261,Kenedy County,,TX,37,411,448,0,0,0,0,0,0,0,0,0,0,0,0,90,0.000049,76,136,0,0
48263,Kent County,,TX,76,818,894,0,0,0,0,0,0,0,0,0,0,0,0,91,0.000049,77,137,0,0
48265,Kerr County,,TX,3316,46869,50185,33,22,55,7950,7155,15105,6,0.346962,0.366339,5284.274825,0.008141,0.005346,89,0.000448,0,14,0.670232,0.080479
48267,Kimble County,,TX,355,4559,4914,2,1,3,139,167,306,7,0.257611,0.264994,0,0.000531,0.000048,89,0.000075,0,14,1,0.005417
48269,King County,,TX,-2,-2,-4,0,0,0,0,0,0,0,0,0,0,0,0,92,0.000049,78,138,0,0
48271,Kinney County,,TX,250,3175,3425,2,2,4,236,276,512,6,0.328989,0.341267,0,0.000549,0.000606,89,0.000066,0,14,1,0.005327
48273,Kleberg County,,TX,3166,30143,33309,16,18,34,5987,7775,13762,5,0.360711,0.381092,398.63347,0.004304,0.005059,89,0.000201,0,14,0.630952,0.039002
48275,Knox County,,TX,433,3889,4322,1,2,3,182,298,480,6,0.28196,0.291927,0,0.000001,0.000088,89,0.000071,0,14,1,0.000072
48277,Lamar County,,TX,3045,51202,54247,14,18,32,5760,5976,11736,6,0.345526,0.363926,224.818155,0.002632,0.004134,89,0.000224,0,14,0.578431,0.025974
48279,Lamb County,,TX,1218,14961,16179,5,7,12,1772,2580,4352,6,0.286095,0.297875,10.1864,0.000159,0.000257,89,0.000126,0,14,0.595238,0.001565
48281,Lampasas County,,TX,3622,18406,22028,9,10,19,4805,4731,9536,6,0.348088,0.365779,0.901116,0.003328,0.004268,89,0.000131,0,14,0.977778,0.032661
48283,La Salle County,,TX,343,5551,5894,3,3,6,577,653,1230,6,0.329061,0.341489,1.134524,0.000576,0.000626,89,0.000082,0,14,0.666667,0.005562
48285,Lavaca County,,TX,1115,21864,22979,9,10,19,2443,2606,5049,6,0.338364,0.355043,3.781205,0.001844,0.001765,89,0.00015,0,14,0.754545,0.018947
48287,Lee County,,TX,1185,16743,17928,9,10,19,2323,2764,5087,6,0.338441,0.355154,3.428975,0.00146,0.001745,89,0.000155,0,14,0.722222,0.015218
48289,Leon County,,TX,1319,16333,17652,12,12,24,3253,2626,5879,6,0.342453,0.359626,17.093935,0.001789,0.002452,89,0.000181,0,14,0.675824,0.017654
48291,Liberty County,,TX,6523,68588,75111,17,18,35,19218,18698,37916,6,0.345764,0.36392,23.665677,0.003294,0.004142,89,0.000202,0,14,0.792857,0.031864
48293,Limestone County,,TX,1608,21421,23029,10,8,18,3078,3593,6671,6,0.342297,0.35896,4.719194,0.002199,0.001924,89,0.000151,0,14,0.744444,0.020816
48295,Lipscomb County,,TX,381,3072,3453,1,1,2,146,200,346,7,0.222453,0.227684,0,0.000001,0.000001,89,0.000077,0,14,0,0.000076
48297,Live Oak County,,TX,744,9079,9823,4,5,9,1002,1194,2196,6,0.329386,0.342099,0,0.00073,0.000817,89,0.000089,0,14,1,0.007202
48299,Llano County,,TX,1465,15260,16725,8,6,14,3593,2767,6360,6,0.342297,0.358322,925.414195,0.002334,0.002119,89,0.000149,0,14,0.714286,0.023614
48301,Loving County,,TX,-2,-2,-4,0,0,0,0,0,0,0,0,0,0,0,0,93,0.000049,79,139,0,0
48303,Lubbock County,,TX,17695,249531,267226,102,107,209,50128,52373,102501,5,0.397986,0.430593,78002.047943,0.017256,0.021165,89,0.001413,0,14,0.294147,0.161377
48305,Lynn County,,TX,603,6486,7089,2,2,4,1070,1389,2459,6,0.284739,0.295584,0,0.000126,0.000103,89,0.00008,0,14,1,0.001131
48307,McCulloch County,,TX,716,8398,9114,3,3,6,315,530,845,6,0.321938,0.334454,0,0.000565,0.000639,89,0.000082,0,14,1,0.005671
48309,McLennan County,,TX,12725,220822,233547,75,68,143,34415,36377,70792,5,0.386069,0.413599,2672.796761,0.015285,0.014179,89,0.000807,0,14,0.450918,0.142831
48311,McMullen County,,TX,52,833,885,0,0,0,0,0,0,0,0,0,0,0,0,94,0.000049,80,140,0,0
48313,Madison County,,TX,1015,10752,11767,6,6,12,1965,2008,3973,6,0.337832,0.353823,0.366667,0.000965,0.001053,89,0.000116,0,14,0.933333,0.009665
48315,Marion County,,TX,894,8849,9743,8,6,14,1875,1937,3812,6,0.334372,0.349695,0.304803,0.001903,0.001248,89,0.000131,0,14,0.964286,0.01778
48317,Martin County,,TX,380,4463,4843,2,2,4,589,636,1225,6,0.273439,0.282828,0,0.000092,0.00009,89,0.000075,0,14,1,0.001019
48319,Mason County,,TX,251,3741,3992,0,0,0,0,0,0,0,0,0,0,0,0,95,0.000049,81,141,0,0
48321,Matagorda County,,TX,2723,38377,41100,13,15,28,4802,6089,10891,6,0.344693,0.362428,20.204043,0.002873,0.003591,89,0.000172,0,14,0.791667,0.027739
48323,Maverick County,,TX,3165,58183,61348,13,15,28,4956,6237,11193,6,0.360451,0.38047,65.506839,0.003862,0.004787,89,0.00016,0,14,0.691176,0.035621
48325,Medina County,,TX,3149,40981,44130,14,12,26,9982,8527,18509,6,0.344574,0.361929,60.19905,0.002517,0.00272,89,0.000217,0,14,0.666667,0.025361
48327,Menard County,,TX,219,2234,2453,0,0,0,0,0,0,0,0,0,0,0,0,96,0.000049,82,142,0,0
48329,Midland County,,TX,8860,128939,137799,69,58,127,28269,24182,52451,5,0.376205,0.402574,31428.556791,0.012161,0.011439,89,0.000957,0,14,0.365868,0.117043
48331,Milam County,,TX,1783,25150,26933,13,11,24,4199,4285,8484,6,0.34117,0.358666,20.59854,0.002667,0.00268,89,0.000187,0,14,0.697802,0.027369
48333,Mills County,,TX,279,4732,5011,1,1,2,195,150,345,7,0.258209,0.265649,0,0.000028,0.000026,89,0.000063,0,14,0,0.000327
48335,Mitchell County,,TX,584,6739,7323,5,7,12,750,953,1703,6,0.293474,0.306192,0.482738,0.000232,0.000384,89,0.000114,0,14,0.97619,0.002374
48337,Montague County,,TX,1394,19416,20810,9,8,17,3683,3276,6959,6,0.336206,0.35167,8.96021,0.002034,0.001773,89,0.000144,0,14,0.8,0.019684
48339,Montgomery County,,TX,28835,362566,391401,173,122,295,149833,94408,244241,5,0.416701,0.449589,14091.674376,0.047534,0.032619,89,0.001499,0,14,0.409265,0.410267
48341,Moore County,,TX,2030,21469,23499,14,12,26,2311,3614,5925,6,0.344772,0.36265,4573.620849,0.001409,0.002353,89,0.000284,0,14,0.452206,0.013277
48343,Morris County,,TX,1176,14162,15338,11,10,21,2896,2974,5870,6,0.341286,0.358139,20.94513,0.00191,0.001453,89,0.000176,0,14,0.8,0.018474
48345,Motley County,,TX,113,1203,1316,0,0,0,0,0,0,0,0,0,0,0,0,97,0.000049,83,143,0,0
48347,Nacogdoches County,,TX,4205,54631,58836,30,28,58,10090,11642,21732,6,0.346442,0.365973,117.205135,0.00546,0.006018,89,0.000335,0,14,0.587121,0.052105
48349,Navarro County,,TX,3265,46555,49820,16,17,33,8418,8805,17223,6,0.343511,0.361651,11.674388,0.003728,0.004057,89,0.000218,0,14,0.80719,0.037212
48351,Newton County,,TX,1000,10582,11582,6,6,12,2161,2426,4587,6,0.338136,0.354239,0.877684,0.00083,0.000871,89,0.000101,0,14,0.785714,0.007891
48353,Nolan County,,TX,1385,15449,16834,9,11,20,1907,2369,4276,6,0.336847,0.353518,342.475629,0.001457,0.001566,89,0.000153,0,14,0.674242,0.013278
48355,Nueces County,,TX,22254,331953,354207,121,117,238,60206,66431,126637,5,0.404743,0.438022,16258.260532,0.028817,0.027828,89,0.001162,0,14,0.353242,0.255344
48357,Ochiltree County,,TX,623,9707,10330,4,5,9,575,618,1193,6,0.286068,0.297598,6049.956146,0.000123,0.000232,89,0.000164,0,14,0.45,0.001495
48359,Oldham County,,TX,268,2052,2320,2,2,4,360,493,853,6,0.274138,0.283611,0,0.000123,0.00013,89,0.000079,0,14,1,0.001361
48361,Orange County,,TX,5391,91277,96668,20,25,45,14045,15589,29634,6,0.348613,0.368409,176.938422,0.004844,0.00522,89,0.000228,0,14,0.634921,0.044523
48363,Palo Pinto County,,TX,1963,26402,28365,13,13,26,5012,4937,9949,6,0.343511,0.360847,48.167128,0.00234,0.002542,89,0.000206,0,14,0.75,0.022933
48365,Panola County,,TX,1528,23825,25353,11,11,22,3267,3687,6954,6,0.342844,0.359903,5.886004,0.00209,0.002183,89,0.000158,0,14,0.845455,0.019763
48367,Parker County,,TX,8946,100122,109068,39,30,69,35101,25762,60863,5,0.367552,0.390424,678.950453,0.009724,0.007345,89,0.000453,0,14,0.620155,0.090284
48369,Parmer County,,TX,1174,10810,11984,8,7,15,1365,2047,3412,6,0.314819,0.328063,228.072025,0.000978,0.000621,4,0.000161,0,14,0.666667,0.009528
48371,Pecos County,,TX,1239,13570,14809,9,6,15,1622,1659,3281,6,0.314127,0.326814,150.543566,0.001139,0.000546,89,0.000181,0,14,0.666667,0.010792
48373,Polk County,,TX,5743,52202,57945,29,34,63,10849,11084,21933,5,0.368815,0.391894,801.287025,0.009077,0.008203,89,0.000314,0,14,0.587805,0.086722
48375,Potter County,,TX,12318,110063,122381,53,47,100,36006,38784,74790,5,0.374984,0.400361,38905.60946,0.010711,0.010185,89,0.00083,0,14,0.345704,0.099261
48377,Presidio County,,TX,980,10098,11078,4,4,8,1220,2021,3241,6,0.313276,0.325233,0,0.000483,0.000468,89,0.000103,0,14,1,0.004438
48379,Rains County,,TX,927,8852,9779,9,9,18,2847,2190,5037,6,0.334558,0.350305,0.174242,0.001687,0.001809,89,0.000142,0,14,0.977778,0.016434
48381,Randall County,,TX,11913,113835,125748,56,51,107,40193,35487,75680,5,0.375125,0.400866,43098.523487,0.011282,0.010628,89,0.000882,0,14,0.37252,0.104608
48383,Reagan County,,TX,292,3578,3870,2,2,4,232,284,516,6,0.280486,0.291228,0,0.000153,0.000158,89,0.000067,0,14,0.833333,0.001304
48385,Real County,,TX,345,3099,3444,1,2,3,147,243,390,7,0.258275,0.266082,0,0.000016,0.000059,89,0.000061,0,14,1,0.000177
48387,Red River County,,TX,978,13687,14665,6,4,10,1683,1804,3487,6,0.331604,0.346072,2.757043,0.001171,0.000625,89,0.000115,0,14,0.8,0.010902
48389,Reeves County,,TX,944,11376,12320,6,5,11,968,1757,2725,6,0.313308,0.325399,58.068495,0.000506,0.000463,89,0.000147,0,14,0.8,0.00481
48391,Refugio County,,TX,538,8413,8951,4,6,10,794,995,1789,6,0.329494,0.342377,0.125,0.000269,0.000864,89,0.000093,0,14,0.933333,0.002812
48393,Roberts County,,TX,103,827,930,0,0,0,0,0,0,0,0,0,0,0,0,98,0.000049,84,144,0,0
48395,Robertson County,,TX,1268,17084,18352,7,7,14,2824,3161,5985,6,0.341791,0.358211,5.609101,0.001487,0.001928,89,0.000125,0,14,0.733333,0.014375
48397,Rockwall County,,TX,5562,58558,64120,36,19,55,32223,17315,49538,5,0.362146,0.382562,179.389053,0.011281,0.006029,89,0.000366,0,14,0.718254,0.101791
48399,Runnels County,,TX,888,11682,12570,3,2,5,1073,1467,2540,6,0.28697,0.297559,9.502301,0.000211,0.000174,89,0.000094,0,14,0.666667,0.001805
48401,Rusk County,,TX,3353,46336,49689,14,12,26,9708,9285,18993,6,0.342453,0.359626,6.978554,0.002069,0.002483,89,0.000189,0,14,0.709524,0.019782
48403,Sabine County,,TX,850,10049,10899,6,8,14,1473,1528,3001,6,0.337946,0.354211,2.242157,0.000774,0.000861,89,0.000109,0,14,0.785714,0.007502
48405,San Augustine County,,TX,564,8420,8984,5,5,10,1112,1269,2381,6,0.337794,0.353656,0.783333,0.000687,0.00071,89,0.0001,0,14,0.85,0.006605
48407,San Jacinto County,,TX,2059,20828,22887,8,7,15,7147,6152,13299,6,0.339435,0.355082,0.410714,0.001348,0.00116,89,0.00012,0,14,0.888889,0.014478
48409,San Patricio County,,TX,7627,71448,79075,34,33,67,17854,19389,37243,5,0.364386,0.387045,950.138142,0.009118,0.008964,89,0.000372,0,14,0.650071,0.085825
48411,San Saba County,,TX,420,5615,6035,1,2,3,43,135,178,7,0.258298,0.265982,0.392157,0.000028,0.00004,89,0.000063,0,14,0,0.000327
48413,Schleicher County,,TX,253,3052,3305,1,1,2,350,238,588,6,0.278664,0.288488,0,0.000104,0.000086,89,0.000059,0,14,0,0.000854
48415,Scurry County,,TX,1309,15824,17133,10,9,19,1533,2163,3696,6,0.332595,0.34813,138.964063,0.001633,0.001004,89,0.000162,0,14,0.866667,0.015218
48417,Shackelford County,,TX,287,3448,3735,1,1,2,245,213,458,6,0.281907,0.291706,0,0.000107,0.000088,89,0.000058,0,14,0,0.000882
48419,Shelby County,,TX,1245,24351,25596,9,11,20,2513,2709,5222,6,0.341286,0.35825,20.41826,0.00135,0.00155,89,0.000146,0,14,0.621212,0.012911
48421,Sherman County,,TX,262,2625,2887,1,2,3,53,109,162,6,0.272942,0.282246,0,0.000014,0.000075,89,0.000069,0,14,1,0.000151
48423,Smith County,,TX,12271,196303,208574,81,67,148,43000,37678,80678,5,0.380109,0.408172,2868.175493,0.015881,0.01295,89,0.000829,0,14,0.402801,0.14614
48425,Somervell County,,TX,688,7323,8011,6,5,11,1548,1595,3143,6,0.329856,0.344213,0,0.001197,0.000721,89,0.000127,0,14,1,0.011554
48427,Starr County,,TX,2950,61537,64487,12,11,23,4904,7738,12642,6,0.349994,0.368425,22.556221,0.003444,0.003389,89,0.000148,0,14,0.772727,0.031121
48429,Stephens County,,TX,603,8676,9279,4,5,9,539,634,1173,6,0.33091,0.345134,0.309524,0.000665,0.000738,89,0.000094,0,14,0.9,0.006192
48431,Sterling County,,TX,133,1176,1309,1,0,1,47,0,47,0,0,0,0,0.000104,0,89,0.000059,0,12,0,0.000854
48433,Stonewall County,,TX,126,1527,1653,0,0,0,0,0,0,0,0,0,0,0,0,99,0.000049,85,145,0,0
48435,Sutton County,,TX,450,4810,5260,2,2,4,425,476,901,6,0.280721,0.29109,0,0.000153,0.000127,89,0.000067,0,14,1,0.001304
48437,Swisher County,,TX,684,7762,8446,4,4,8,1169,1526,2695,6,0.286014,0.297376,0,0.000271,0.000247,89,0.000101,0,14,1,0.00263
48439,Tarrant County,,TX,109652,1687872,1797524,502,445,947,474328,398521,872849,5,0.491814,0.545018,230585.97305,0.097448,0.090996,89,0.004524,0,14,0.166971,0.822132
48441,Taylor County,,TX,13023,129991,143014,72,82,154,26674,30685,57359,5,0.392526,0.421732,29444.759231,0.014885,0.018148,89,0.000891,0,14,0.379204,0.13611
48443,Terrell County,,TX,116,887,1003,0,0,0,0,0,0,0,0,0,0,0,0,100,0.000049,86,146,0,0
48445,Terry County,,TX,1155,11885,13040,3,4,7,1208,1993,3201,6,0.285226,0.296693,0.833333,0.000135,0.000182,89,0.000094,0,14,0.75,0.001269
48447,Throckmorton County,,TX,111,1670,1781,0,0,0,0,0,0,0,0,0,0,0,0,101,0.000049,87,147,0,0
48449,Titus County,,TX,2174,28606,30780,14,14,28,4329,4973,9302,6,0.342727,0.360236,33.478165,0.002293,0.002936,89,0.00021,0,14,0.675,0.0228
48451,Tom Green County,,TX,10696,108954,119650,63,76,139,19843,24138,43981,5,0.386267,0.415152,46492.778734,0.014613,0.017568,89,0.000901,0,14,0.367211,0.132858
48453,Travis County,,TX,76552,839499,916051,396,299,695,319675,281341,601016,5,0.471808,0.514558,92277.827609,0.089323,0.073464,89,0.003399,0,14,0.241228,0.748837
48455,Trinity County,,TX,1135,13143,14278,8,6,14,3083,2952,6035,6,0.339397,0.354916,0.958573,0.001067,0.001035,89,0.000127,0,14,0.839286,0.010948
48457,Tyler County,,TX,1502,18130,19632,9,8,17,3871,3430,7301,6,0.339512,0.355304,0.608596,0.001168,0.001159,89,0.000129,0,14,0.930556,0.012005
48459,Upshur County,,TX,3106,35707,38813,14,14,28,9205,8618,17823,6,0.342531,0.359959,21.820761,0.002648,0.002505,89,0.000211,0,14,0.709524,0.026119
48461,Upton County,,TX,382,3264,3646,2,2,4,228,279,507,6,0.274213,0.283761,0,0.000125,0.000125,89,0.000077,0,14,1,0.001381
48463,Uvalde County,,TX,1862,28053,29915,12,15,27,2845,3872,6717,6,0.344377,0.361956,4147.654893,0.001843,0.002764,89,0.000216,0,14,0.483333,0.018386
48465,Val Verde County,,TX,4439,50619,55058,23,31,54,5658,7845,13503,5,0.370635,0.39428,3766.849593,0.006916,0.008367,89,0.000297,0,14,0.540476,0.065981
48467,Van Zandt County,,TX,3793,48116,51909,14,16,30,11185,10350,21535,6,0.342962,0.360791,10.234505,0.002764,0.003649,89,0.000198,0,14,0.8875,0.027785
48469,Victoria County,,TX,5850,92619,98469,39,34,73,14587,16322,30909,6,0.347283,0.367921,3937.066914,0.007091,0.006629,89,0.000511,0,14,0.506707,0.069886
48471,Walker County,,TX,4676,44961,49637,24,26,50,11841,13490,25331,6,0.346362,0.36564,112.117091,0.004603,0.0059,89,0.000301,0,14,0.625661,0.046987
48473,Waller County,,TX,3481,32376,35857,11,12,23,10156,10018,20174,6,0.344377,0.361679,18.362811,0.002881,0.0033,89,0.000161,0,14,0.833333,0.02837
48475,Ward County,,TX,901,10880,11781,5,5,10,1321,1622,2943,6,0.274288,0.28426,1.333333,0.000132,0.000136,89,0.000157,0,14,0.8,0.001683
48477,Washington County,,TX,1948,32395,34343,15,17,32,5331,5096,10427,6,0.345208,0.363371,51.758194,0.002332,0.004092,89,0.00021,0,14,0.642857,0.022594
48479,Webb County,,TX,7605,237456,245061,34,42,76,15136,19655,34791,5,0.380157,0.404605,5200.939759,0.00967,0.011663,89,0.000419,0,14,0.523589,0.089299
48481,Wharton County,,TX,2674,45152,47826,9,12,21,5430,6795,12225,6,0.342688,0.359515,8.273794,0.001444,0.002538,89,0.000147,0,14,0.757576,0.015247
48483,Wheeler County,,TX,387,5245,5632,2,3,5,221,412,633,6,0.273141,0.282717,16.034937,0.000123,0.000079,89,0.000079,0,14,0.5,0.001361
48485,Wichita County,,TX,14177,126538,140715,81,96,177,22688,32401,55089,5,0.398092,0.429633,20853.500841,0.018186,0.020726,89,0.000875,0,14,0.374167,0.162024
48487,Wilbarger County,,TX,1241,13768,15009,6,7,13,1361,1614,2975,6,0.337187,0.352946,3337.226661,0.001251,0.001371,89,0.000114,0,14,0.5,0.01134
48489,Willacy County,,TX,1352,19669,21021,6,6,12,2337,3292,5629,6,0.343471,0.359682,0,0.002111,0.002244,89,0.000099,0,14,1,0.020076
48491,Williamson County,,TX,32133,329917,362050,208,126,334,173857,110687,284544,5,0.422741,0.45562,12330.558904,0.056932,0.036429,89,0.001786,0,14,0.394344,0.490111
48493,Wilson County,,TX,2775,38910,41685,15,11,26,10402,7517,17919,6,0.342609,0.359293,91.044853,0.004412,0.002234,89,0.00021,0,14,0.75,0.042035
48495,Winkler County,,TX,656,7013,7669,3,3,6,834,1006,1840,6,0.274238,0.283927,0,0.000126,0.000126,89,0.000104,0,14,1,0.001459
48497,Wise County,,TX,4631,53835,58466,18,16,34,14048,12628,26676,6,0.34501,0.363288,94.86681,0.00372,0.003669,89,0.000255,0,14,0.707602,0.035379
48499,Wood County,,TX,3036,38855,41891,19,18,37,9315,7864,17179,6,0.34304,0.361124,39.494143,0.002841,0.003613,89,0.00026,0,14,0.697368,0.028757
48501,Yoakum County,,TX,672,8173,8845,3,5,8,646,1020,1666,6,0.28528,0.296915,0,0.000149,0.000266,89,0.00009,0,14,0.95,0.00155
48503,Young County,,TX,1344,17918,19262,11,12,23,2153,2524,4677,6,0.336998,0.352913,55.83924,0.001846,0.001951,89,0.000186,0,14,0.647436,0.017636
48505,Zapata County,,TX,546,12358,12904,4,5,9,998,1059,2057,6,0.34304,0.358988,0,0.000874,0.001495,89,0.000086,0,14,1,0.008384
48507,Zavala County,,TX,719,10959,11678,5,4,9,1066,1279,2345,6,0.330764,0.343975,2.737951,0.000984,0.001106,89,0.000106,0,14,0.85,0.009915
49001,Beaver County,,UT,460,6570,7030,4,4,8,798,899,1697,6,0.340937,0.356147,0,0.000966,0.001169,4,0.000094,0,14,1,0.008898
49003,Box Elder County,,UT,3485,51734,55219,13,11,24,10656,9577,20233,5,0.352375,0.370062,841.63762,0.003038,0.002383,4,0.000204,0,14,0.762821,0.02774
49005,Cache County,,UT,9292,102028,111320,44,47,91,22852,25137,47989,5,0.37433,0.399062,15082.538027,0.007905,0.010864,4,0.000603,0,14,0.40487,0.072445
49007,Carbon County,,UT,1662,20807,22469,9,13,22,2688,3823,6511,6,0.342063,0.358616,35.576557,0.001591,0.001863,4,0.000146,0,14,0.782051,0.014589
49009,Daggett County,,UT,114,865,979,1,0,1,61,0,61,0,0,0,0,0.000388,0,4,0.000057,0,9,0,0.003415
49011,Davis County,,UT,25067,292298,317365,103,92,195,94953,80810,175763,5,0.39984,0.430276,6635.849477,0.025414,0.025896,4,0.000968,0,14,0.456203,0.225701
49013,Duchesne County,,UT,1045,16128,17173,10,6,16,3428,2455,5883,6,0.319099,0.331464,0.214286,0.001676,0.00091,4,0.000159,0,14,0.944444,0.015559
49015,Emery County,,UT,855,11500,12355,3,5,8,1303,1910,3213,6,0.318086,0.330226,0,0.000666,0.000747,4,0.000074,0,14,0.95,0.005588
49017,Garfield County,,UT,466,4584,5050,5,3,8,710,691,1401,6,0.316878,0.328723,0,0.001097,0.000515,4,0.000111,0,14,1,0.010466
49019,Grand County,,UT,805,8649,9454,3,5,8,756,907,1663,6,0.319439,0.331852,1.452624,0.000466,0.000865,4,0.000081,0,14,0.75,0.004492
49021,Iron County,,UT,3752,34905,38657,26,18,44,13950,10123,24073,5,0.359459,0.378695,487.343518,0.005862,0.00375,4,0.000336,0,14,0.495726,0.050725
49023,Juab County,,UT,744,9161,9905,4,4,8,2427,1754,4181,6,0.317951,0.329893,0,0.00072,0.000708,4,0.000092,0,14,1,0.006418
49025,Kane County,,UT,622,6059,6681,5,5,10,1154,1100,2254,6,0.341015,0.356369,0.125,0.001185,0.001261,4,0.000102,0,14,0.95,0.011179
49027,Millard County,,UT,1001,12801,13802,5,7,12,1413,2158,3571,6,0.319099,0.331575,0,0.001355,0.000942,4,0.000102,0,14,0.982143,0.012313
49029,Morgan County,,UT,571,8951,9522,6,3,9,2677,1766,4443,6,0.31785,0.329794,0,0.000992,0.000642,4,0.000104,0,14,1,0.008627
49031,Piute County,,UT,100,1346,1446,0,0,0,0,0,0,0,0,0,0,0,0,102,0.000049,88,148,0,0
49033,Rich County,,UT,218,2015,2233,1,1,2,70,160,230,6,0.272398,0.281158,0,0.000064,0.000047,4,0.00006,0,14,0,0.000506
49035,Salt Lake County,,UT,56901,1027840,1084741,271,265,536,196769,202559,399328,5,0.46358,0.504655,97768.822065,0.066999,0.065857,4,0.002444,0,14,0.296344,0.570963
49037,San Juan County,,UT,1202,9085,10287,7,11,18,2385,2737,5122,5,0.35114,0.368536,30.746101,0.000803,0.001673,4,0.00012,0,14,0.636364,0.007176
49039,Sanpete County,,UT,1777,22208,23985,9,10,19,4551,4886,9437,6,0.34148,0.357479,30.861546,0.001585,0.001697,4,0.000158,0,14,0.833333,0.014488
49041,Sevier County,,UT,1600,20033,21633,10,8,18,3327,3378,6705,6,0.341286,0.35698,10.00797,0.002074,0.001553,4,0.000152,0,14,0.790909,0.018388
49043,Summit County,,UT,3600,35152,38752,16,14,30,7828,8783,16611,5,0.359804,0.378695,155.690486,0.005818,0.004795,4,0.000178,0,14,0.761438,0.051142
49045,Tooele County,,UT,4737,52728,57465,16,14,30,16862,12187,29049,5,0.355209,0.373807,36.609373,0.004805,0.00311,4,0.0002,0,14,0.764706,0.041866
49047,Uintah County,,UT,1765,27138,28903,17,14,31,4820,4178,8998,6,0.342102,0.358783,500.019731,0.002534,0.001887,4,0.000252,0,14,0.630719,0.024431
49049,Utah County,,UT,31447,419214,450661,148,164,312,114501,104064,218565,5,0.436311,0.471588,24391.3985,0.037035,0.045329,4,0.001344,0,14,0.399177,0.333584
49051,Wasatch County,,UT,1937,18633,20570,11,8,19,6457,5311,11768,6,0.319167,0.331796,12.924881,0.003676,0.001037,4,0.000147,0,14,0.916667,0.032867
49053,Washington County,,UT,8181,106462,114643,68,42,110,41788,26342,68130,5,0.36368,0.386518,2106.094677,0.014555,0.009198,4,0.000714,0,14,0.426252,0.128339
49055,Wayne County,,UT,264,2498,2762,1,2,3,119,154,273,6,0.316844,0.328556,0,0.000388,0.000481,4,0.000057,0,14,1,0.003415
49057,Weber County,,UT,17262,229343,246605,63,55,118,55314,51839,107153,5,0.37734,0.40339,3578.868886,0.016468,0.015478,4,0.000621,0,14,0.5294,0.146706
50001,Addison County,,VT,2281,41917,44198,8,10,18,4604,4907,9511,6,0.321696,0.336634,57.64231,0.000773,0.001727,62,0.000115,0,14,0.627273,0.006479
50003,Bennington County,,VT,2470,42228,44698,15,13,28,3658,3858,7516,6,0.324511,0.340479,37.177028,0.003664,0.002737,65,0.00013,0,14,0.75,0.025838
50005,Caledonia County,,VT,1935,34516,36451,11,9,20,3960,4001,7961,6,0.318119,0.332163,235.829094,0.000853,0.000794,62,0.000169,0,14,0.572727,0.007083
50007,Chittenden County,,VT,11636,175009,186645,88,101,189,28365,30587,58952,5,0.398938,0.430249,20041.736758,0.027261,0.03215,62,0.000604,0,14,0.55207,0.211506
50009,Essex County,,VT,542,7331,7873,4,4,8,1319,1272,2591,6,0.273116,0.28224,2.593542,0.000101,0.000084,62,0.000097,0,14,0.583333,0.000917
50011,Franklin County,,VT,2752,54228,56980,8,10,18,6659,6152,12811,6,0.311942,0.325716,53.662869,0.000273,0.000687,62,0.000143,0,14,0.422222,0.002364
50013,Grand Isle County,,VT,817,8570,9387,2,3,5,2048,1833,3881,6,0.285524,0.296283,0,0.000194,0.000185,62,0.000066,0,14,1,0.001373
50015,Lamoille County,,VT,2088,27870,29958,9,6,15,3902,3963,7865,6,0.318018,0.331663,90.548556,0.001088,0.000692,62,0.000136,0,14,0.680556,0.008581
50017,Orange County,,VT,2337,33175,35512,8,10,18,5857,5967,11824,6,0.31822,0.33244,31.659568,0.000864,0.000833,62,0.000113,0,14,0.711111,0.006997
50019,Orleans County,,VT,1369,31148,32517,8,7,15,2451,2536,4987,6,0.285443,0.296643,23.721868,0.000262,0.000227,62,0.000147,0,14,0.625,0.002329
50021,Rutland County,,VT,3347,73950,77297,20,20,40,5692,5804,11496,6,0.322595,0.339131,242.125792,0.004395,0.003005,62,0.000182,0,14,0.566154,0.032744
50023,Washington County,,VT,3935,70586,74521,19,20,39,8531,8562,17093,5,0.350362,0.369108,631.184111,0.00336,0.003667,62,0.000206,0,14,0.603261,0.026207
50025,Windham County,,VT,3168,51067,54235,26,21,47,6312,6188,12500,6,0.324862,0.341894,62.71411,0.006981,0.004253,62,0.000185,0,14,0.723647,0.050916
50027,Windsor County,,VT,4690,67947,72637,26,28,54,10623,11151,21774,6,0.326167,0.344419,787.271747,0.005563,0.005492,62,0.000227,0,14,0.629032,0.042727
51001,Accomack County,,VA,1880,37382,39262,9,10,19,2332,3173,5505,6,0.321972,0.336585,29.828042,0.002011,0.00167,76,0.000126,0,14,0.568182,0.016533
51003,Albemarle County,,VA,10041,90806,100847,81,64,145,27269,26723,53992,5,0.399521,0.42667,22066.054173,0.025614,0.020138,104,0.000768,0,14,0.551436,0.214172
51005,Alleghany County,,VA,812,18775,19587,5,6,11,1135,1424,2559,7,0.261741,0.271375,6170.710585,0.00004,0.000071,104,0.000153,0,14,0.266667,0.000735
51007,Amelia County,,VA,962,14178,15140,6,7,13,3417,2437,5854,6,0.299711,0.312134,1.325275,0.000696,0.000804,104,0.000129,0,14,0.857143,0.006927
51009,Amherst County,,VA,2014,33998,36012,6,5,11,4871,4764,9635,7,0.250856,0.259338,31.734083,0.000178,0.000068,104,0.000145,0,14,0.6,0.002247
51011,Appomattox County,,VA,954,15889,16843,7,6,13,2175,1973,4148,7,0.25094,0.259671,26.335358,0.000068,0.000068,104,0.000166,0,14,0.452381,0.001123
51013,Arlington County,,VA,44566,201124,245690,227,167,394,127919,144604,272523,5,0.440082,0.475233,11073.636212,0.072719,0.056941,104,0.001512,0,14,0.471938,0.581361
51015,Augusta County,,VA,4365,78822,83187,18,14,32,12449,10467,22916,6,0.330546,0.347381,4245.624825,0.002285,0.001932,104,0.000311,0,14,0.460784,0.020222
51017,Bath County,,VA,405,5822,6227,1,4,5,108,354,462,6,0.322595,0.336335,213.349429,0,0.00053,104,0.000071,0,14,0.166667,0.000073
51019,Bedford County,,VA,4749,72410,77159,18,19,37,14624,13284,27908,6,0.332816,0.351209,3453.899124,0.002373,0.002708,104,0.000288,0,14,0.52619,0.02053
51021,Bland County,,VA,412,6559,6971,3,3,6,714,676,1390,7,0.245988,0.253427,8.357103,0.000012,0.000005,0,0.000106,0,14,0.666667,0.000275
51023,Botetourt County,,VA,2392,37220,39612,8,8,16,7153,6223,13376,6,0.282304,0.293109,162.371358,0.000188,0.000139,104,0.000183,0,14,0.625,0.001814
51025,Brunswick County,,VA,1019,16971,17990,8,10,18,1740,2291,4031,6,0.30019,0.313299,1864.603507,0.000287,0.000851,104,0.000183,0,14,0.381818,0.003313
51027,Buchanan County,,VA,1127,22509,23636,5,7,12,1266,2488,3754,6,0.273963,0.283805,502.057463,0.000007,0.000066,0,0.000152,0,14,0.404762,0.000412
51029,Buckingham County,,VA,664,14178,14842,7,7,14,1511,1441,2952,6,0.297279,0.309399,87.075005,0.000456,0.000522,104,0.000146,0,14,0.446429,0.004798
51031,Campbell County,,VA,3668,57784,61452,14,14,28,10876,10317,21193,6,0.332374,0.3501,2333.581517,0.0013,0.002324,104,0.000241,0,14,0.578431,0.011922
51033,Caroline County,,VA,2165,27165,29330,14,15,29,11581,6785,18366,6,0.327697,0.343869,44.764328,0.002409,0.002117,104,0.000179,0,14,0.704167,0.021259
51035,Carroll County,,VA,1283,30526,31809,9,9,18,2916,2841,5757,6,0.295524,0.308217,7192.344904,0.00035,0.000357,66,0.000245,0,14,0.263889,0.003674
51036,Charles City County,,VA,529,7920,8449,7,5,12,1395,1180,2575,6,0.299651,0.311801,0,0.00111,0.000868,104,0.000117,0,14,0.97619,0.01025
51037,Charlotte County,,VA,680,13579,14259,5,8,13,1016,1467,2483,6,0.29477,0.307135,59.706245,0.000026,0.000362,104,0.000132,0,14,0.535714,0.000584
51041,Chesterfield County,,VA,24386,329072,353458,174,143,317,94503,77516,172019,5,0.417048,0.45258,59522.053885,0.048999,0.041257,104,0.001518,0,14,0.414185,0.401646
51043,Clarke County,,VA,1388,14104,15492,9,7,16,4264,3138,7402,6,0.326664,0.341373,0.822273,0.001385,0.00103,104,0.000139,0,14,0.902778,0.012251
51045,Craig County,,VA,316,5507,5823,4,4,8,455,540,995,6,0.281801,0.291733,0,0.000171,0.000118,104,0.000102,0,14,1,0.001343
51047,Culpeper County,,VA,3397,42927,46324,19,16,35,14933,8467,23400,6,0.326948,0.342898,554.879552,0.003714,0.001842,104,0.000218,0,14,0.593074,0.033117
51049,Cumberland County,,VA,605,9541,10146,7,6,13,1845,1420,3265,6,0.299681,0.311967,6.198866,0.000699,0.000799,104,0.000145,0,14,0.761905,0.007022
51051,Dickenson County,,VA,614,14582,15196,5,5,10,1078,1304,2382,7,0.224363,0.230661,153.912814,0.000006,0.000007,0,0.000174,0,14,0.433333,0.000404
51053,Dinwiddie County,,VA,2062,28254,30316,10,11,21,7115,5822,12937,6,0.30058,0.313737,25.889708,0.000749,0.000876,104,0.00019,0,14,0.645455,0.007772
51057,Essex County,,VA,749,11572,12321,12,9,21,1781,1329,3110,6,0.299263,0.311745,458.217923,0.000774,0.000649,104,0.000195,0,14,0.515152,0.007709
51059,Fairfax County,,VA,129613,1141019,1270632,404,414,818,377625,445265,822890,5,0.483658,0.535836,154949.869223,0.095811,0.094853,104,0.002994,0,14,0.215935,0.783139
51061,Fauquier County,,VA,6055,67393,73448,22,27,49,19616,14860,34476,5,0.357747,0.377757,2303.111228,0.004548,0.005136,104,0.000236,0,14,0.544086,0.039578
51063,Floyd County,,VA,730,15591,16321,6,6,12,1713,1671,3384,6,0.28196,0.292288,10.074637,0.000178,0.000125,104,0.000149,0,14,0.8,0.001545
51065,Fluvanna County,,VA,2104,24677,26781,10,11,21,5332,4289,9621,6,0.30001,0.31316,53.746873,0.001762,0.000858,104,0.000157,0,14,0.570513,0.015018
51067,Franklin County,,VA,2828,55630,58458,13,11,24,6985,6329,13314,6,0.282304,0.293536,2019.75425,0.001104,0.000182,104,0.000216,0,14,0.505495,0.010044
51069,Frederick County,,VA,6609,77453,84062,29,23,52,24435,17248,41683,6,0.332927,0.351792,3968.931771,0.005157,0.003582,104,0.000366,0,14,0.457661,0.042502
51071,Giles County,,VA,828,19007,19835,4,5,9,1977,1790,3767,6,0.282543,0.292699,256.413217,0.000113,0.000057,104,0.000118,0,14,0.55,0.00077
51073,Gloucester County,,VA,2822,40776,43598,18,14,32,7620,5522,13142,6,0.322525,0.337777,189.173715,0.003097,0.002165,104,0.00025,0,14,0.535088,0.026153
51075,Goochland County,,VA,1493,19905,21398,8,6,14,6036,3560,9596,6,0.299651,0.311912,8.204166,0.001402,0.000832,104,0.000138,0,14,0.857143,0.013165
51077,Grayson County,,VA,834,16720,17554,5,6,11,1265,1647,2912,7,0.244387,0.251802,116.190051,0.000012,0.000015,66,0.000189,0,14,0.266667,0.000493
51079,Greene County,,VA,1619,18551,20170,8,8,16,3879,3504,7383,6,0.286041,0.296555,10.816793,0.001163,0.000283,104,0.000137,0,14,0.636364,0.010505
51081,Greensville County,,VA,561,8943,9504,4,6,10,811,779,1590,6,0.295786,0.308206,874.610494,0.000026,0.00052,104,0.00013,0,14,0.433333,0.000479
51083,Halifax County,,VA,1500,38791,40291,10,12,22,2205,2560,4765,6,0.308958,0.323546,839.832828,0.001241,0.001589,104,0.000156,0,14,0.544872,0.011157
51085,Hanover County,,VA,7743,109891,117634,23,21,44,22405,19863,42268,6,0.336168,0.355692,370.476377,0.00423,0.004204,104,0.000278,0,14,0.535714,0.035765
51087,Henrico County,,VA,28384,312767,341151,176,146,322,103859,98130,201989,5,0.42286,0.45784,66489.949268,0.049108,0.043541,104,0.001601,0,14,0.404198,0.404326
51089,Henry County,,VA,3038,62140,65178,9,12,21,6070,7061,13131,6,0.323777,0.338965,1475.323357,0.000432,0.001909,66,0.000165,0,14,0.583333,0.00469
51091,Highland County,,VA,124,2691,2815,0,0,0,0,0,0,0,0,0,0,0,0,103,0.000049,89,149,0,0
51093,Isle of Wight County,,VA,2727,36888,39615,13,13,26,10091,6721,16812,6,0.321524,0.336224,241.991551,0.002992,0.001719,104,0.000163,0,14,0.647619,0.024364
51095,James City County,,VA,5761,63385,69146,42,30,72,17849,12179,30028,6,0.35976,0.381014,1420.988448,0.012448,0.007949,104,0.000377,0,14,0.586957,0.102443
51097,King and Queen County,,VA,535,6901,7436,6,5,11,1320,1080,2400,6,0.297426,0.30896,2.074391,0.000352,0.000325,104,0.00013,0,14,0.666667,0.003817
51099,King George County,,VA,2364,21534,23898,20,18,38,9080,5480,14560,5,0.355882,0.374784,158.003406,0.006043,0.004767,104,0.000181,0,14,0.688406,0.050403
51101,King William County,,VA,1202,16874,18076,11,10,21,4788,3098,7886,6,0.306437,0.320045,21.613366,0.001069,0.001167,104,0.000188,0,14,0.672727,0.010369
51103,Lancaster County,,VA,698,13473,14171,6,5,11,980,769,1749,6,0.30544,0.317937,17.796066,0.000838,0.000573,104,0.000143,0,14,0.52381,0.007646
51105,Lee County,,VA,835,21175,22010,6,6,12,1440,1517,2957,6,0.272694,0.282107,62.71268,0.000049,0.000063,0,0.000169,0,14,0.404762,0.001017
51107,Loudoun County,,VA,29561,273607,303168,172,170,342,133931,89101,223032,5,0.427859,0.465108,12992.199513,0.058062,0.055665,104,0.001212,0,14,0.492891,0.47256
51109,Louisa County,,VA,2030,30706,32736,20,14,34,9085,5050,14135,6,0.327661,0.343703,208.782316,0.002518,0.002252,104,0.000256,0,14,0.564286,0.023324
51111,Lunenburg County,,VA,656,11778,12434,7,7,14,1246,1456,2702,6,0.295728,0.308206,240.161974,0.00045,0.000518,104,0.000146,0,14,0.642857,0.004726
51113,Madison County,,VA,889,13381,14270,7,5,12,2252,1814,4066,6,0.28585,0.295889,0.651923,0.00111,0.000213,104,0.000118,0,14,0.839286,0.010035
51115,Mathews County,,VA,580,9821,10401,3,4,7,909,891,1800,6,0.305347,0.31766,0.333279,0.000487,0.000563,104,0.000076,0,14,0.9,0.00387
51117,Mecklenburg County,,VA,1824,33288,35112,13,12,25,3198,3156,6354,6,0.320837,0.335758,1776.836684,0.00171,0.001392,104,0.000198,0,14,0.395604,0.016067
51119,Middlesex County,,VA,796,11100,11896,9,5,14,1656,997,2653,6,0.306,0.318797,11.801698,0.001006,0.000851,104,0.000173,0,14,0.583333,0.009473
51121,Montgomery County,,VA,7905,71821,79726,44,63,107,14186,17416,31602,5,0.390891,0.418043,42167.344846,0.008127,0.017254,104,0.000606,0,14,0.438037,0.073279
51125,Nelson County,,VA,1091,16192,17283,7,7,14,2311,2195,4506,6,0.286068,0.296444,100.770693,0.000774,0.000276,104,0.00016,0,14,0.555556,0.00713
51127,New Kent County,,VA,1216,17624,18840,10,8,18,5409,3148,8557,6,0.306312,0.319602,3.513559,0.001157,0.001148,104,0.000155,0,14,0.766667,0.010793
51131,Northampton County,,VA,828,13670,14498,3,3,6,1271,1162,2433,6,0.319676,0.332684,0,0.000829,0.000779,76,0.000071,0,14,1,0.006434
51133,Northumberland County,,VA,812,13225,14037,7,6,13,1472,1268,2740,6,0.298193,0.309981,1334.09832,0.001649,0.000519,104,0.000127,0,14,0.583333,0.013855
51135,Nottoway County,,VA,944,15799,16743,7,7,14,2150,2008,4158,6,0.299711,0.312134,5.065508,0.000699,0.000803,104,0.000142,0,14,0.761905,0.007028
51137,Orange County,,VA,2691,32711,35402,22,16,38,11076,6389,17465,6,0.327554,0.343814,191.665234,0.003195,0.002161,104,0.000251,0,14,0.588745,0.029028
51139,Page County,,VA,1268,26481,27749,8,6,14,2686,2152,4838,7,0.251087,0.259932,13.546076,0.001015,0.000108,104,0.000151,0,14,0.708333,0.009088
51141,Patrick County,,VA,916,19567,20483,5,5,10,1696,1752,3448,7,0.245565,0.253233,19.855753,0.000036,0.000022,66,0.00013,0,14,0.4,0.000581
51143,Pittsylvania County,,VA,3368,70764,74132,13,19,32,8776,9263,18039,6,0.328881,0.34631,477.598289,0.000716,0.002683,66,0.000208,0,14,0.473684,0.007712
51145,Powhatan County,,VA,1757,26894,28651,7,7,14,6607,4252,10859,6,0.299651,0.312023,2.2,0.00072,0.000829,104,0.000144,0,14,0.785714,0.00723
51147,Prince Edward County,,VA,1224,16045,17269,11,11,22,2689,2557,5246,6,0.29989,0.312911,706.377663,0.000712,0.000847,104,0.000218,0,14,0.469697,0.007422
51149,Prince George County,,VA,4982,32480,37462,24,19,43,10961,10500,21461,6,0.351386,0.369968,1172.379655,0.004881,0.004866,104,0.000277,0,14,0.564615,0.042869
51153,Prince William County,,VA,51245,373698,424943,210,229,439,184575,169921,354496,5,0.44248,0.484099,29673.427164,0.065018,0.063989,104,0.001518,0,14,0.370231,0.533812
51155,Pulaski County,,VA,2182,36594,38776,10,9,19,4986,4689,9675,6,0.282384,0.293359,71.919105,0.000191,0.000127,104,0.000226,0,14,0.511111,0.001885
51157,Rappahannock County,,VA,607,8310,8917,5,4,9,1444,1140,2584,6,0.263995,0.272071,0.438095,0.000986,0.000071,104,0.000092,0,14,0.8,0.008577
51159,Richmond County,,VA,538,8309,8847,3,5,8,1199,1215,2414,6,0.297455,0.309016,1.083333,0.000019,0.000319,104,0.000096,0,14,0.7,0.000418
51161,Roanoke County,,VA,8590,103718,112308,30,27,57,24858,23817,48675,6,0.334819,0.354955,6946.553173,0.004563,0.005205,104,0.000439,0,14,0.376114,0.041513
51163,Rockbridge County,,VA,1197,23068,24265,6,7,13,2204,2239,4443,7,0.258966,0.268312,12091.687899,0.000049,0.000069,104,0.000245,0,14,0.238095,0.000978
51165,Rockingham County,,VA,4412,83769,88181,18,14,32,12737,10403,23140,6,0.3304,0.347159,5658.236048,0.002458,0.001611,104,0.000326,0,14,0.461988,0.022268
51167,Russell County,,VA,1128,26419,27547,8,8,16,3060,2921,5981,6,0.271585,0.281036,691.756033,0.000043,0.000063,0,0.000249,0,14,0.517857,0.001177
51169,Scott County,,VA,944,23448,24392,7,8,15,2505,2748,5253,6,0.271904,0.281547,30.987468,0.000094,0.000151,0,0.000214,0,14,0.642857,0.001918
51171,Shenandoah County,,VA,2536,44315,46851,16,15,31,8271,5827,14098,6,0.327948,0.344147,753.688894,0.002293,0.001769,104,0.000231,0,14,0.532164,0.020632
51173,Smyth County,,VA,1325,34762,36087,5,5,10,2146,2400,4546,6,0.271168,0.280176,120.996342,0.000041,0.000063,0,0.000168,0,14,0.466667,0.000944
51175,Southampton County,,VA,976,17830,18806,10,10,20,3593,2062,5655,6,0.320906,0.335403,708.850082,0.001403,0.001128,104,0.00015,0,14,0.522727,0.011334
51177,Spotsylvania County,,VA,12786,122196,134982,52,56,108,44032,34957,78989,5,0.381025,0.407634,1938.829305,0.015622,0.018714,104,0.000441,0,14,0.612587,0.13171
51179,Stafford County,,VA,17047,122684,139731,73,70,143,52368,46425,98793,5,0.386615,0.414836,3026.248522,0.024468,0.022814,104,0.000578,0,14,0.568574,0.209961
51181,Surry County,,VA,480,7323,7803,5,5,10,869,858,1727,6,0.29992,0.311745,11.363762,0.000533,0.000371,104,0.0001,0,14,0.533333,0.004606
51183,Sussex County,,VA,946,10820,11766,10,10,20,1987,1837,3824,6,0.29535,0.308017,944.958015,0.000322,0.000376,104,0.00021,0,14,0.363636,0.003835
51185,Tazewell County,,VA,2119,43761,45880,9,13,22,4508,4172,8680,6,0.287272,0.299462,915.389187,0.000116,0.000228,0,0.000243,0,14,0.301282,0.001204
51187,Warren County,,VA,3063,38848,41911,17,16,33,10205,7644,17849,6,0.327126,0.343093,721.585186,0.002813,0.00153,104,0.000223,0,14,0.540476,0.024592
51191,Washington County,,VA,3188,55345,58533,15,11,26,7924,7236,15160,6,0.285823,0.297559,3673.89445,0.001049,0.000193,0,0.000377,0,14,0.314286,0.010238
51193,Westmoreland County,,VA,1298,17777,19075,12,13,25,3820,2977,6797,6,0.327983,0.344063,1386.174173,0.001829,0.002078,104,0.000164,0,14,0.653846,0.015281
51195,Wise County,,VA,1804,39072,40876,9,10,19,3530,3983,7513,6,0.273414,0.283594,7059.741499,0.00009,0.000152,0,0.000282,0,14,0.377778,0.002028
51197,Wythe County,,VA,1428,31387,32815,10,8,18,2898,2648,5546,6,0.281775,0.292504,581.063292,0.000125,0.000062,104,0.000265,0,14,0.377778,0.001326
51199,York County,,VA,9938,68949,78887,49,52,101,24342,23456,47798,5,0.383066,0.408677,1983.178833,0.014123,0.016358,104,0.000424,0,14,0.58091,0.122425
51510,Alexandria city,,VA,34606,133628,168234,167,125,292,94854,106681,201535,5,0.423636,0.456464,4123.076997,0.05956,0.046103,104,0.001115,0,14,0.597013,0.480603
51515,Bedford city,,VA,610,6658,7268,5,5,10,1154,1390,2544,7,0.259122,0.268201,0.46309,0.000124,0.000132,104,0.00012,0,14,0.95,0.001519
51520,Bristol city,,VA,1944,16609,18553,6,4,10,5202,5129,10331,6,0.271389,0.280249,9.223277,0.000088,0.000147,0,0.000194,0,14,0.733333,0.001807
51530,Buena Vista city,,VA,582,6775,7357,2,2,4,1041,1087,2128,8,0.205725,0.210319,0,0,0,104,0.000137,0,14,1,0.000141
51540,Charlottesville city,,VA,6232,34394,40626,36,40,76,13199,16866,30065,5,0.376677,0.400289,4814.743919,0.010626,0.01318,104,0.000412,0,14,0.601883,0.095418
51550,Chesapeake city,,VA,25404,229563,254967,102,114,216,83121,77605,160726,5,0.410775,0.443758,7921.668407,0.03367,0.03686,104,0.000757,0,14,0.533647,0.27627
51570,Colonial Heights city,,VA,2524,19432,21956,9,7,16,6656,6911,13567,6,0.30019,0.312572,11.061898,0.001262,0.000856,104,0.000158,0,14,0.805556,0.011955
51580,Covington city,,VA,471,7094,7565,2,2,4,637,538,1175,7,0.258809,0.26723,2.974538,0.000004,0.000042,104,0.000086,0,14,0.666667,0.000137
51590,Danville city,,VA,3375,47510,50885,9,16,25,6581,8249,14830,6,0.330074,0.34727,803.859549,0.001271,0.003162,66,0.000142,0,14,0.616667,0.012795
51595,Emporia city,,VA,506,6136,6642,5,3,8,678,485,1163,7,0.231397,0.23762,4.564644,0.000036,0.000004,104,0.000125,0,14,0.45,0.000611
51600,Fairfax city,,VA,4807,24000,28807,9,13,22,12085,12658,24743,6,0.354078,0.371832,3.417501,0.003249,0.004278,104,0.000106,0,14,0.923077,0.02822
51610,Falls Church city,,VA,1896,11476,13372,7,7,14,4231,4230,8461,6,0.327269,0.342233,0,0.002774,0.00305,104,0.000095,0,14,1,0.024652
51620,Franklin city,,VA,892,8979,9871,7,4,11,2165,1500,3665,6,0.29986,0.311524,0.423021,0.001201,0.00033,104,0.000103,0,14,0.946429,0.009566
51630,Fredericksburg city,,VA,4963,17657,22620,20,21,41,13684,14548,28232,6,0.330473,0.348297,68.804705,0.005036,0.004618,104,0.00021,0,14,0.701581,0.044318
51640,Galax city,,VA,567,7528,8095,2,2,4,970,806,1776,7,0.228267,0.234134,0,0.000002,0.000002,66,0.000099,0,14,1,0.000164
51650,Hampton city,,VA,20388,140037,160425,88,95,183,53968,58615,112583,5,0.410551,0.441151,5709.816351,0.030832,0.03318,104,0.000674,0,14,0.595496,0.260295
51660,Harrisonburg city,,VA,4852,30698,35550,19,21,40,8384,10473,18857,6,0.333259,0.352125,4538.669226,0.003334,0.004825,104,0.000305,0,14,0.525,0.029302
51670,Hopewell city,,VA,2823,22909,25732,9,8,17,7856,7676,15532,6,0.30034,0.31296,35.661721,0.001084,0.000858,104,0.000162,0,14,0.791667,0.01094
51678,Lexington city,,VA,703,5506,6209,2,2,4,522,565,1087,8,0.205725,0.210319,0,0,0,104,0.000137,0,14,1,0.000141
51680,Lynchburg city,,VA,5955,62594,68549,32,22,54,14530,15206,29736,6,0.334261,0.353595,7426.971605,0.006976,0.004719,104,0.000403,0,14,0.493761,0.060881
51683,Manassas city,,VA,8018,38523,46541,16,24,40,20148,24629,44777,6,0.350117,0.370939,119.440125,0.004226,0.00616,104,0.000165,0,14,0.666667,0.036947
51685,Manassas Park city,,VA,2968,12300,15268,10,14,24,8627,9205,17832,6,0.346003,0.364392,10.618569,0.002536,0.003537,104,0.000115,0,14,0.779167,0.022161
51690,Martinsville city,,VA,1225,14947,16172,6,8,14,2967,3099,6066,6,0.321249,0.33537,576.817529,0.000064,0.00102,66,0.000126,0,14,0.652778,0.000733
51700,Newport News city,,VA,30448,184905,215353,133,153,286,71670,84499,156169,5,0.427433,0.463066,24696.622167,0.042327,0.047245,104,0.001072,0,14,0.477376,0.351618
51710,Norfolk city,,VA,37049,213485,250534,159,177,336,95214,112112,207326,5,0.43822,0.474911,16769.02272,0.051725,0.056163,104,0.001155,0,14,0.491068,0.423127
51720,Norton city,,VA,534,4003,4537,2,2,4,914,1006,1920,7,0.214802,0.219642,0,0.000001,0.000001,0,0.000103,0,14,1,0.000155
51730,Petersburg city,,VA,4088,33020,37108,18,15,33,9548,10784,20332,6,0.332117,0.350244,517.192203,0.004796,0.002993,104,0.000228,0,14,0.599415,0.040689
51735,Poquoson city,,VA,1137,13798,14935,4,6,10,2726,2285,5011,6,0.321043,0.33467,0,0.001059,0.001069,104,0.000074,0,14,1,0.008204
51740,Portsmouth city,,VA,12403,99752,112155,43,48,91,36840,38089,74929,5,0.384192,0.409526,1420.661842,0.015245,0.01682,104,0.000352,0,14,0.675751,0.126376
51750,Radford city,,VA,1696,10281,11977,8,8,16,3004,3570,6574,6,0.330074,0.34631,770.45863,0.000729,0.001256,104,0.000182,0,14,0.583333,0.00625
51760,Richmond city,,VA,23192,177397,200589,127,102,229,73170,79924,153094,5,0.404743,0.436241,30832.341157,0.035525,0.030752,104,0.001186,0,14,0.428059,0.295653
51770,Roanoke city,,VA,10029,96430,106459,38,32,70,26437,28659,55096,6,0.348654,0.370428,36158.253675,0.007166,0.006048,104,0.000534,0,14,0.376307,0.062833
51775,Salem city,,VA,2647,26231,28878,7,8,15,7633,7143,14776,6,0.298846,0.311241,27.983438,0.000187,0.000429,104,0.000156,0,14,0.785714,0.001743
51790,Staunton city,,VA,2142,24500,26642,9,6,15,5671,5211,10882,6,0.285986,0.296166,1097.958086,0.001295,0.000203,104,0.00019,0,14,0.75,0.011188
51800,Suffolk city,,VA,8256,80386,88642,32,32,64,28019,20618,48637,5,0.359933,0.381552,700.638007,0.009274,0.008253,104,0.000294,0,14,0.5722,0.077795
51810,Virginia Beach city,,VA,59387,477753,537140,290,323,613,160671,185519,346190,5,0.469375,0.515446,80873.513687,0.078455,0.082872,104,0.002128,0,14,0.294597,0.638273
51820,Waynesboro city,,VA,2281,22453,24734,12,7,19,6277,5236,11513,6,0.285959,0.296222,135.012427,0.000757,0.000273,104,0.000243,0,14,0.515152,0.007133
51830,Williamsburg city,,VA,1581,8359,9940,6,12,18,2879,3680,6559,6,0.329748,0.34605,6.115693,0.001665,0.002872,104,0.00009,0,14,0.840909,0.013531
51840,Winchester city,,VA,4405,25453,29858,13,12,25,10290,11961,22251,6,0.326984,0.342427,754.751057,0.00189,0.001447,104,0.000211,0,14,0.642857,0.016708
53001,Adams County,,WA,1325,17425,18750,7,6,13,2443,2991,5434,6,0.328486,0.341711,0,0.001248,0.001001,4,0.000112,0,14,1,0.012013
53003,Asotin County,,WA,2063,20888,22951,12,9,21,5698,4872,10570,6,0.33197,0.346477,3072.443703,0.001183,0.001644,4,0.000219,0,14,0.647436,0.011927
53005,Benton County,,WA,12747,170053,182800,67,65,132,41001,38247,79248,5,0.382091,0.409498,4674.277526,0.014084,0.015301,4,0.000663,0,14,0.484515,0.127887
53007,Chelan County,,WA,5536,73471,79007,26,24,50,17207,16900,34107,5,0.360321,0.380443,47.787879,0.005685,0.005546,4,0.000262,0,14,0.789655,0.051527
53009,Clallam County,,WA,3972,72484,76456,38,27,65,11313,8363,19676,5,0.360711,0.381247,42.762044,0.010507,0.007156,4,0.000333,0,14,0.767683,0.092972
53011,Clark County,,WA,24099,420968,445067,139,126,265,100487,79393,179880,5,0.401068,0.435081,9977.610253,0.032656,0.030347,4,0.00123,0,14,0.417398,0.292437
53013,Columbia County,,WA,382,4208,4590,1,1,2,422,476,898,6,0.264204,0.271588,0,0.000031,0.000039,4,0.000061,0,14,0,0.000429
53015,Cowlitz County,,WA,6263,101039,107302,34,30,64,20771,16036,36807,5,0.360884,0.38183,3027.109491,0.008425,0.006966,4,0.00035,0,14,0.739683,0.076782
53017,Douglas County,,WA,3303,33800,37103,16,12,28,12213,10855,23068,5,0.352128,0.36984,27.727569,0.004595,0.002581,4,0.000183,0,14,0.9375,0.042361
53019,Ferry County,,WA,635,6353,6988,5,5,10,974,1124,2098,6,0.328306,0.341472,0.125,0.001027,0.001136,4,0.000099,0,14,0.95,0.0101
53021,Franklin County,,WA,5072,60148,65220,29,20,49,23860,17214,41074,5,0.365984,0.387101,137.193639,0.008026,0.005786,4,0.000285,0,14,0.774621,0.071938
53023,Garfield County,,WA,159,2389,2548,0,1,1,0,132,132,7,0.249295,0.255178,0,0,0.000007,4,0.000049,0,150,0,0
53025,Grant County,,WA,4978,80243,85221,36,35,71,14210,13232,27442,5,0.363109,0.385048,347.910806,0.007679,0.007086,4,0.000384,0,14,0.649502,0.070265
53027,Grays Harbor County,,WA,4142,68645,72787,25,25,50,12090,11427,23517,5,0.359158,0.37925,51.919835,0.006606,0.005507,4,0.000258,0,14,0.846059,0.060821
53029,Island County,,WA,11211,81599,92810,48,55,103,25569,25101,50670,5,0.390485,0.416767,598.116797,0.016244,0.017611,4,0.000415,0,14,0.646748,0.143661
53031,Jefferson County,,WA,2203,30348,32551,13,13,26,5359,4784,10143,5,0.355209,0.373668,0.097619,0.004033,0.003999,4,0.000151,0,14,0.979167,0.036766
53033,King County,,WA,124024,1992316,2116340,449,383,832,459374,453578,912952,5,0.486478,0.534021,154363.701219,0.096595,0.08823,4,0.003762,0,14,0.211149,0.803747
53035,Kitsap County,,WA,26466,262513,288979,101,117,218,62027,66301,128328,5,0.403655,0.436701,2285.261156,0.027744,0.033274,4,0.000801,0,14,0.490314,0.24325
53037,Kittitas County,,WA,2924,32407,35331,21,19,40,9747,8449,18196,5,0.356177,0.37561,19.087352,0.002625,0.004546,4,0.000235,0,14,0.835,0.026046
53039,Klickitat County,,WA,1661,19567,21228,13,9,22,3954,3026,6980,6,0.329061,0.342904,44.269611,0.002519,0.001539,4,0.000178,0,14,0.75641,0.024571
53041,Lewis County,,WA,4688,74343,79031,27,24,51,15682,13005,28687,5,0.356643,0.376775,47.220546,0.007734,0.0057,4,0.000266,0,14,0.836694,0.070096
53043,Lincoln County,,WA,883,11093,11976,6,4,10,2006,1842,3848,6,0.328163,0.34114,0.055556,0.001069,0.000835,4,0.000108,0,14,0.933333,0.010586
53045,Mason County,,WA,4281,54930,59211,21,19,40,17159,12398,29557,5,0.355461,0.374667,19.857912,0.005384,0.004259,4,0.000222,0,14,0.898551,0.050384
53047,Okanogan County,,WA,2455,39339,41794,16,19,35,5889,5441,11330,6,0.33197,0.347587,24.175939,0.002853,0.002634,4,0.000197,0,14,0.773684,0.026789
53049,Pacific County,,WA,1355,20756,22111,14,13,27,3747,3151,6898,6,0.331604,0.346394,608.55947,0.002597,0.002559,4,0.000197,0,14,0.828571,0.025953
53051,Pend Oreille County,,WA,1139,11996,13135,7,5,12,2688,2470,5158,6,0.328306,0.341472,0.142857,0.001492,0.000921,4,0.000132,0,14,0.97619,0.014916
53053,Pierce County,,WA,59402,795734,855136,300,274,574,222355,199878,422233,5,0.465087,0.50678,50243.167546,0.07251,0.068232,4,0.002484,0,14,0.289677,0.624408
53055,San Juan County,,WA,1179,16066,17245,7,5,12,1853,1737,3590,6,0.327661,0.340807,0,0.002357,0.00118,4,0.000106,0,14,1,0.022465
53057,Skagit County,,WA,7467,117099,124566,43,39,82,25168,20133,45301,5,0.364652,0.387139,274.679538,0.012546,0.010186,4,0.000382,0,14,0.668235,0.112125
53059,Skamania County,,WA,781,9807,10588,5,5,10,1931,1537,3468,6,0.310299,0.322365,0.111111,0.000678,0.000779,4,0.000105,0,14,0.95,0.007065
53061,Snohomish County,,WA,47218,710090,757308,201,174,375,195500,164052,359552,5,0.431982,0.469052,17508.300193,0.05581,0.046481,4,0.001678,0,14,0.393315,0.482849
53063,Spokane County,,WA,24792,471859,496651,160,147,307,91045,76207,167252,5,0.409655,0.445966,31839.826466,0.031104,0.034149,4,0.00162,0,14,0.336704,0.282488
53065,Stevens County,,WA,3338,42424,45762,23,15,38,9294,8349,17643,5,0.352582,0.370756,191.8654,0.006335,0.00282,4,0.000268,0,14,0.728333,0.056901
53067,Thurston County,,WA,18178,249805,267983,110,86,196,73661,55320,128981,5,0.391656,0.421566,2070.206422,0.027981,0.023199,4,0.000904,0,14,0.501032,0.24829
53069,Wahkiakum County,,WA,270,3862,4132,3,2,5,507,430,937,6,0.26523,0.273064,0,0.000235,0.000065,4,0.00008,0,14,1,0.002528
53071,Walla Walla County,,WA,3848,56380,60228,27,23,50,8995,9692,18687,5,0.35903,0.378862,6085.727017,0.006586,0.0053,4,0.00032,0,14,0.76601,0.061307
53073,Whatcom County,,WA,10882,194076,204958,80,63,143,36920,31671,68591,5,0.380301,0.407185,1127.332161,0.018928,0.016212,4,0.000725,0,14,0.564295,0.171799
53075,Whitman County,,WA,4749,33564,38313,27,31,58,9688,11810,21498,5,0.362015,0.383383,193.306991,0.005572,0.007191,4,0.000306,0,14,0.729947,0.052536
53077,Yakima County,,WA,10709,241818,252527,57,62,119,24894,30797,55691,5,0.374004,0.400932,740.251736,0.012406,0.014636,4,0.000534,0,14,0.59905,0.112767
54001,Barbour County,,WV,702,15899,16601,6,6,12,1769,1626,3395,7,0.277352,0.287009,1.65,0.000059,0.000034,76,0.000168,0,14,0.866667,0.00074
54003,Berkeley County,,WV,5692,100172,105864,37,29,66,28064,13872,41936,6,0.334447,0.354289,5743.628073,0.006609,0.005361,104,0.000438,0,14,0.44808,0.054567
54005,Boone County,,WV,1181,24736,25917,7,6,13,2446,2931,5377,6,0.286805,0.296821,3.152866,0.000131,0.000058,71,0.000173,0,14,0.738095,0.001067
54007,Braxton County,,WV,606,13385,13991,5,6,11,839,912,1751,6,0.288015,0.298513,5220.033876,0.000096,0.000069,71,0.000169,0,14,0.4,0.000741
54009,Brooke County,,WV,1412,28023,29435,6,5,11,2635,2898,5533,6,0.316011,0.329999,0.393223,0.000632,0.00055,76,0.000106,0,14,0.933333,0.004844
54011,Cabell County,,WV,6450,95402,101852,23,27,50,13713,14520,28233,6,0.343236,0.36508,5102.413661,0.000964,0.003633,71,0.000444,0,14,0.279557,0.008839
54013,Calhoun County,,WV,340,6937,7277,2,3,5,294,420,714,7,0.250563,0.258173,100.749758,0,0.000005,71,0.000111,0,14,0.333333,0.00014
54015,Clay County,,WV,610,9474,10084,4,4,8,722,1100,1822,6,0.286669,0.296349,4.366667,0.000096,0.000045,71,0.000134,0,14,0.666667,0.000679
54017,Doddridge County,,WV,293,5152,5445,2,2,4,478,595,1073,7,0.247712,0.254639,0,0.000007,0.000004,76,0.000106,0,14,1,0.00018
54019,Fayette County,,WV,2274,44519,46793,8,8,16,4168,4826,8994,6,0.288902,0.300072,145.985177,0.000121,0.000084,71,0.000192,0,14,0.611111,0.001067
54021,Gilmer County,,WV,427,6137,6564,3,3,6,492,559,1051,7,0.223962,0.229379,7.185714,0.000001,0.000001,71,0.000126,0,14,0.333333,0.000208
54023,Grant County,,WV,643,13107,13750,4,3,7,1208,965,2173,8,0.218616,0.224048,24.575335,0.000005,0.000001,104,0.000152,0,14,0.333333,0.000403
54025,Greenbrier County,,WV,1478,36838,38316,10,11,21,2171,2183,4354,6,0.289069,0.300738,3533.345541,0.000175,0.00008,71,0.000244,0,14,0.4,0.001413
54027,Hampshire County,,WV,1255,23594,24849,14,7,21,3745,2509,6254,7,0.252905,0.262379,579.411571,0.001899,0.00011,104,0.000237,0,14,0.538462,0.016358
54029,Hancock County,,WV,1921,37470,39391,8,8,16,4687,4211,8898,6,0.317112,0.331697,21.225946,0.000782,0.00063,76,0.000125,0,14,0.660714,0.005561
54031,Hardy County,,WV,872,14771,15643,8,6,14,1562,1433,2995,7,0.252564,0.261857,596.860294,0.000079,0.000096,104,0.000219,0,14,0.486111,0.00143
54033,Harrison County,,WV,3469,76491,79960,15,15,30,6447,6307,12754,6,0.329169,0.346055,13685.953106,0.000681,0.001097,76,0.000353,0,14,0.319853,0.005777
54035,Jackson County,,WV,1377,30937,32314,6,7,13,2781,2761,5542,6,0.28843,0.299345,13.433134,0.000137,0.000086,71,0.000157,0,14,0.714286,0.000995
54037,Jefferson County,,WV,4239,52404,56643,19,17,36,14497,10071,24568,6,0.329603,0.346505,320.51119,0.004469,0.003493,104,0.000219,0,14,0.619048,0.037709
54039,Kanawha County,,WV,10542,217417,227959,41,59,100,21386,23779,45165,5,0.401443,0.428223,78573.743027,0.007306,0.016123,71,0.000674,0,14,0.352535,0.064556
54041,Lewis County,,WV,864,18880,19744,4,6,10,1618,1668,3286,7,0.27748,0.287231,890.224114,0.000007,0.000034,76,0.000149,0,14,0.5,0.000325
54043,Lincoln County,,WV,1090,21224,22314,6,6,12,2832,3105,5937,6,0.286805,0.296821,1.508766,0.000127,0.000061,71,0.00016,0,14,0.833333,0.000984
54045,Logan County,,WV,1340,35486,36826,7,7,14,2274,2694,4968,6,0.28697,0.29717,1291.051714,0.00063,0.000058,71,0.000163,0,14,0.625,0.005145
54047,McDowell County,,WV,1014,17833,18847,5,6,11,1155,2129,3284,6,0.27656,0.286951,646.868458,0.000075,0.000176,0,0.000129,0,14,0.366667,0.001796
54049,Marion County,,WV,2643,60559,63202,13,12,25,5762,5501,11263,6,0.318355,0.334082,1878.504346,0.000684,0.000583,76,0.000272,0,14,0.416667,0.005644
54051,Marshall County,,WV,1678,37030,38708,5,8,13,2896,3605,6501,6,0.327983,0.343531,164.909584,0.000164,0.001089,76,0.000107,0,14,0.732143,0.00119
54053,Mason County,,WV,1102,26653,27755,8,7,15,2617,2316,4933,6,0.325214,0.339397,182.979944,0.000652,0.000569,71,0.000168,0,14,0.642857,0.00532
54055,Mercer County,,WV,3189,61491,64680,16,21,37,5410,5507,10917,6,0.324932,0.34185,16890.783737,0.00057,0.001779,0,0.000327,0,14,0.252964,0.006146
54057,Mineral County,,WV,1419,31056,32475,7,7,14,3548,3096,6644,7,0.278509,0.288968,2250.922258,0.000105,0.000106,104,0.000203,0,14,0.47619,0.001387
54059,Mingo County,,WV,1156,24657,25813,8,8,16,1967,2493,4460,6,0.287492,0.298141,2391.254072,0.000637,0.000061,28,0.000184,0,14,0.388889,0.005272
54061,Monongalia County,,WV,5767,78271,84038,40,41,81,11943,11864,23807,6,0.383212,0.408012,54723.511939,0.00417,0.008111,76,0.000653,0,14,0.221188,0.035565
54063,Monroe County,,WV,641,12984,13625,4,4,8,1280,1101,2381,7,0.245505,0.252872,8.977103,0.000011,0.000005,71,0.000123,0,14,0.583333,0.000337
54065,Morgan County,,WV,963,17524,18487,13,7,20,3061,1881,4942,6,0.271487,0.281197,218.388375,0.001978,0.000167,104,0.000189,0,14,0.615385,0.016375
54067,Nicholas County,,WV,1172,26794,27966,7,8,15,1933,1914,3847,6,0.288264,0.299151,6066.359471,0.000104,0.000072,71,0.000232,0,14,0.464286,0.000913
54069,Ohio County,,WV,2671,51381,54052,11,9,20,5598,5922,11520,6,0.327983,0.343642,339.575387,0.00129,0.00109,76,0.000164,0,14,0.563636,0.009943
54071,Pendleton County,,WV,529,8929,9458,2,3,5,168,496,664,7,0.250438,0.258301,360.985015,0.00001,0.000034,104,0.000112,0,14,0.333333,0.000271
54073,Pleasants County,,WV,514,8155,8669,4,3,7,949,1020,1969,7,0.251718,0.259582,10.445425,0.000021,0.000012,71,0.000139,0,14,0.5,0.000384
54075,Pocahontas County,,WV,483,9421,9904,2,3,5,222,422,644,6,0.314489,0.327347,51.44595,0.000001,0.000409,71,0.000089,0,14,0,0.000157
54077,Preston County,,WV,1223,33033,34256,5,6,11,2864,2711,5575,7,0.277711,0.287592,15.253833,0.000071,0.000063,76,0.000131,0,14,0.533333,0.000846
54079,Putnam County,,WV,4095,60128,64223,13,12,25,11491,9538,21029,6,0.330983,0.347631,1134.820239,0.000702,0.001165,71,0.000279,0,14,0.478022,0.005935
54081,Raleigh County,,WV,3830,77430,81260,13,13,26,6152,5940,12092,6,0.331494,0.348435,2691.689248,0.000195,0.001164,71,0.000282,0,14,0.414286,0.001766
54083,Randolph County,,WV,1211,30947,32158,7,8,15,1858,2165,4023,6,0.288098,0.298901,3891.140058,0.000061,0.000076,76,0.000202,0,14,0.5,0.000797
54085,Ritchie County,,WV,659,11816,12475,4,4,8,1010,1069,2079,7,0.251781,0.259949,36.400339,0.000017,0.000008,71,0.000171,0,14,0.5,0.000363
54087,Roane County,,WV,683,15173,15856,5,5,10,1365,1499,2864,6,0.286942,0.296932,3157.592605,0.000106,0.000049,71,0.000156,0,14,0.45,0.000787
54089,Summers County,,WV,621,11278,11899,4,5,9,1046,1372,2418,7,0.250333,0.258451,8.437137,0.000018,0.000006,71,0.000126,0,14,0.75,0.000352
54091,Taylor County,,WV,864,16724,17588,5,5,10,2157,2022,4179,7,0.277275,0.286732,1.45,0.000058,0.000033,76,0.000144,0,14,0.85,0.000666
54093,Tucker County,,WV,424,7833,8257,1,2,3,336,441,777,7,0.277147,0.286149,0,0,0.000025,76,0.000071,0,14,1,0.000075
54095,Tyler County,,WV,560,9879,10439,2,3,5,833,945,1778,7,0.250542,0.258118,2.62619,0.00001,0.000005,76,0.000081,0,14,0.5,0.000189
54097,Upshur County,,WV,1164,23935,25099,6,7,13,1574,1973,3547,6,0.288098,0.298791,100.550527,0.000059,0.000076,76,0.000168,0,14,0.738095,0.000737
54099,Wayne County,,WV,2308,40797,43105,10,9,19,5265,5698,10963,6,0.325672,0.340202,3214.47538,0.000646,0.000582,71,0.000243,0,14,0.466667,0.005529
54101,Webster County,,WV,387,8811,9198,1,1,2,299,440,739,7,0.223778,0.228686,0,0,0.000001,71,0.000074,0,14,0,0.000076
54103,Wetzel County,,WV,904,19249,20153,5,8,13,1348,1818,3166,7,0.277865,0.28823,176.949117,0.000061,0.000049,76,0.000132,0,14,0.357143,0.000643
54105,Wirt County,,WV,391,5459,5850,1,1,2,609,731,1340,7,0.250396,0.257535,0,0.00001,0.000004,71,0.000067,0,14,0,0.000117
54107,Wood County,,WV,4421,97519,101940,17,20,37,8192,7763,15955,6,0.334,0.352236,22571.404694,0.000731,0.001725,71,0.00042,0,14,0.225296,0.006372
54109,Wyoming County,,WV,876,21909,22785,5,7,12,1395,1935,3330,6,0.287464,0.29787,45.263889,0.000019,0.000056,71,0.000138,0,14,0.5,0.000479
55001,Adams County,,WI,1453,20807,22260,15,12,27,4389,3575,7964,6,0.343511,0.360392,59.443784,0.002162,0.001554,105,0.000171,0,14,0.738095,0.017705
55003,Ashland County,,WI,1233,18544,19777,3,9,12,1122,1691,2813,5,0.327948,0.341872,17.207514,0.000319,0.000869,18,0.000085,0,14,0.666667,0.002868
55005,Barron County,,WI,2868,54606,57474,18,18,36,6208,6899,13107,5,0.349506,0.367543,957.643646,0.00192,0.002,18,0.000246,0,14,0.639474,0.016178
55007,Bayfield County,,WI,971,17602,18573,6,6,12,1444,1607,3051,5,0.324827,0.338149,31.401318,0.000818,0.000518,18,0.000115,0,14,0.809524,0.007129
55009,Brown County,,WI,13386,288634,302020,64,68,132,37500,38042,75542,5,0.384832,0.412006,26317.053091,0.00884,0.013528,105,0.000679,0,14,0.322162,0.076076
55011,Buffalo County,,WI,872,17064,17936,7,8,15,1883,2194,4077,6,0.271511,0.281436,14.174886,0.000109,0.000109,18,0.000135,0,14,0.535714,0.001414
55013,Burnett County,,WI,1117,18041,19158,12,10,22,2629,2046,4675,5,0.324616,0.338232,4.236403,0.001186,0.000967,18,0.000171,0,14,0.772727,0.010007
55015,Calumet County,,WI,3922,53050,56972,11,11,22,11514,11534,23048,6,0.343628,0.360447,6.00109,0.001177,0.001632,105,0.000137,0,14,0.939394,0.009443
55017,Chippewa County,,WI,3786,70092,73878,21,19,40,11357,10582,21939,5,0.356135,0.375583,1641.426663,0.001813,0.002433,18,0.000269,0,14,0.518116,0.015764
55019,Clark County,,WI,2211,39587,41798,7,13,20,3895,5504,9399,5,0.330364,0.345062,62.253792,0.000409,0.001271,105,0.00012,0,14,0.769231,0.00388
55021,Columbia County,,WI,4731,67728,72459,19,21,40,14675,13752,28427,5,0.362671,0.382712,190.185184,0.001799,0.002902,105,0.000222,0,14,0.679348,0.015744
55023,Crawford County,,WI,1140,19346,20486,7,7,14,2104,2453,4557,6,0.310973,0.32298,92.093334,0.00037,0.000368,105,0.000133,0,14,0.595238,0.003594
55025,Dane County,,WI,30830,533588,564418,217,207,424,104427,101661,206088,5,0.449835,0.487372,86719.86701,0.053389,0.052851,105,0.001826,0,14,0.329289,0.43808
55027,Dodge County,,WI,6366,100782,107148,23,26,49,19681,18848,38529,5,0.364077,0.384931,192.726805,0.002782,0.003703,105,0.000233,0,14,0.723545,0.02407
55029,Door County,,WI,1670,35246,36916,12,9,21,3234,3067,6301,5,0.358644,0.37672,324.568981,0.002599,0.002252,105,0.000138,0,14,0.852564,0.020456
55031,Douglas County,,WI,2561,49420,51981,14,16,30,5309,5594,10903,5,0.355545,0.374556,161.689176,0.001383,0.002373,18,0.000212,0,14,0.610294,0.012078
55033,Dunn County,,WI,3155,42456,45611,21,19,40,8019,7898,15917,5,0.330691,0.3462,1635.93571,0.002216,0.001806,18,0.000265,0,14,0.561265,0.018461
55035,Eau Claire County,,WI,7555,102409,109964,44,44,88,21371,21299,42670,5,0.371185,0.394463,12370.051375,0.004387,0.005627,18,0.000501,0,14,0.37633,0.038211
55037,Florence County,,WI,381,5510,5891,3,4,7,536,714,1250,6,0.278045,0.287783,0.487179,0.000089,0.00006,105,0.000083,0,14,0.833333,0.00076
55039,Fond du Lac County,,WI,5338,120766,126104,30,29,59,15779,15259,31038,5,0.364386,0.385652,423.823484,0.003772,0.004056,105,0.000298,0,14,0.610795,0.032659
55041,Forest County,,WI,598,10491,11089,6,6,12,771,896,1667,6,0.314522,0.326692,0.591782,0.000504,0.000449,105,0.00011,0,14,0.880952,0.004103
55043,Grant County,,WI,3079,57626,60705,15,20,35,6423,7524,13947,5,0.349709,0.36807,549.322954,0.001667,0.002077,105,0.000205,0,14,0.471053,0.014408
55045,Green County,,WI,2316,42760,45076,11,14,25,7055,5938,12993,5,0.358687,0.37733,200.432786,0.001593,0.002226,105,0.000145,0,14,0.631868,0.013374
55047,Green Lake County,,WI,1487,23506,24993,11,10,21,3569,3937,7506,6,0.320222,0.33269,2.942205,0.001145,0.000838,105,0.000144,0,14,0.863636,0.009165
55049,Iowa County,,WI,1896,27942,29838,8,8,16,5322,4903,10225,6,0.319915,0.332052,13.445816,0.00077,0.000726,105,0.000125,0,14,0.75,0.006578
55051,Iron County,,WI,425,7319,7744,1,1,2,398,381,779,7,0.211893,0.215877,0,0,0,105,0.000114,0,14,0,0.000072
55053,Jackson County,,WI,1224,21432,22656,8,8,16,2838,2717,5555,6,0.310844,0.323008,2.887132,0.000801,0.000415,18,0.000118,0,14,0.875,0.006719
55055,Jefferson County,,WI,6468,91429,97897,23,22,45,20167,18093,38260,5,0.362627,0.382767,48.910455,0.002798,0.003112,105,0.000225,0,14,0.727832,0.024178
55057,Juneau County,,WI,2019,29311,31330,15,10,25,5374,4768,10142,6,0.320085,0.332551,21.075473,0.001797,0.000788,105,0.000174,0,14,0.733333,0.015099
55059,Kenosha County,,WI,10927,180314,191241,26,42,68,34200,29474,63674,5,0.385672,0.409831,358.3957,0.008028,0.011139,105,0.000225,0,14,0.605759,0.066458
55061,Kewaunee County,,WI,1257,25072,26329,4,5,9,2860,3328,6188,6,0.314489,0.326526,0.111111,0.000164,0.000453,105,0.000086,0,14,0.95,0.001389
55063,La Crosse County,,WI,6978,122118,129096,49,45,94,18602,18099,36701,5,0.371369,0.394796,7127.429929,0.005976,0.005668,105,0.000516,0,14,0.372642,0.052445
55065,Lafayette County,,WI,1131,20131,21262,5,6,11,2557,3012,5569,6,0.310909,0.322759,2.7864,0.000351,0.000377,105,0.0001,0,14,0.733333,0.003235
55067,Langlade County,,WI,1106,24163,25269,11,10,21,2261,2469,4730,6,0.32029,0.332801,5.512791,0.000816,0.000834,105,0.00016,0,14,0.80303,0.006562
55069,Lincoln County,,WI,1640,36153,37793,10,10,20,3314,3683,6997,6,0.320427,0.332995,108.309884,0.001109,0.000955,105,0.000137,0,14,0.833333,0.008898
55071,Manitowoc County,,WI,3678,100937,104615,16,22,38,8183,9763,17946,5,0.362714,0.382878,722.815388,0.0025,0.002909,105,0.000188,0,14,0.69697,0.021543
55073,Marathon County,,WI,6254,156368,162622,41,36,77,18854,17208,36062,5,0.363636,0.385542,2517.879403,0.004963,0.003578,105,0.000407,0,14,0.44697,0.042707
55075,Marinette County,,WI,2730,49836,52566,13,15,28,6494,6489,12983,5,0.330291,0.345173,619.758299,0.001124,0.001454,105,0.000182,0,14,0.625,0.009184
55077,Marquette County,,WI,1257,18009,19266,11,10,21,3746,3337,7083,6,0.319881,0.332218,1.674383,0.001054,0.000775,105,0.000144,0,14,0.833333,0.008619
55078,Menominee County,,WI,313,4501,4814,2,2,4,530,840,1370,6,0.277942,0.287367,0,0.000085,0.000059,105,0.000071,0,14,1,0.000681
55079,Milwaukee County,,WI,54752,1025120,1079872,212,237,449,135258,183013,318271,5,0.457718,0.497276,72938.259106,0.05587,0.063779,105,0.001699,0,14,0.339404,0.461383
55081,Monroe County,,WI,2846,48932,51778,14,17,31,6050,6247,12297,5,0.355503,0.374639,155.754431,0.001596,0.002149,105,0.000175,0,14,0.7,0.013832
55083,Oconto County,,WI,2635,44952,47587,11,11,22,7539,6929,14468,6,0.320358,0.332995,43.886096,0.000825,0.000966,105,0.000154,0,14,0.692308,0.006493
55085,Oneida County,,WI,2859,46151,49010,21,18,39,6244,5629,11873,5,0.362671,0.382351,320.363697,0.002748,0.002823,105,0.000232,0,14,0.660079,0.022389
55087,Outagamie County,,WI,13320,209995,223315,51,52,103,42702,41001,83703,5,0.382042,0.407374,5817.833424,0.007003,0.009103,105,0.000512,0,14,0.374343,0.059428
55089,Ozaukee County,,WI,6671,104628,111299,20,23,43,18975,17604,36579,5,0.371093,0.391939,32.920973,0.004543,0.005652,105,0.000191,0,14,0.790769,0.037968
55091,Pepin County,,WI,610,9087,9697,4,4,8,1070,1073,2143,6,0.270899,0.279716,0.555556,0.000053,0.000047,18,0.000095,0,14,0.833333,0.000729
55093,Pierce County,,WI,2969,43730,46699,14,16,30,8028,7652,15680,5,0.32827,0.34312,654.251853,0.001263,0.001447,18,0.000192,0,14,0.647059,0.010885
55095,Polk County,,WI,2754,51586,54340,12,15,27,8220,7284,15504,5,0.328198,0.342898,7.94653,0.00121,0.001449,18,0.00017,0,14,0.8,0.010258
55097,Portage County,,WI,4186,76953,81139,32,28,60,10468,10362,20830,5,0.363197,0.384127,355.81869,0.002605,0.003293,105,0.000334,0,14,0.578431,0.022914
55099,Price County,,WI,942,18276,19218,6,7,13,837,1292,2129,6,0.320017,0.332107,90.883026,0.00074,0.000718,105,0.000099,0,14,0.75,0.006132
55101,Racine County,,WI,10952,228690,239642,31,49,80,32475,30401,62876,5,0.379628,0.404377,542.414929,0.007516,0.01003,105,0.000268,0,14,0.513726,0.061457
55103,Richland County,,WI,1190,20098,21288,7,8,15,2655,3080,5735,6,0.310716,0.322786,3.083281,0.000388,0.0004,105,0.000127,0,14,0.75,0.003769
55105,Rock County,,WI,7980,184717,192697,40,41,81,24105,20904,45009,5,0.368318,0.391534,933.500863,0.006958,0.006019,105,0.000366,0,14,0.522067,0.058111
55107,Rusk County,,WI,1021,17308,18329,5,6,11,1423,1627,3050,6,0.270924,0.279993,2.157268,0.000069,0.000071,18,0.000114,0,14,0.666667,0.000904
55109,St. Croix County,,WI,5345,89568,94913,26,21,47,21938,14906,36844,5,0.355798,0.375444,261.536321,0.002912,0.00254,18,0.000305,0,14,0.590769,0.025519
55111,Sauk County,,WI,4174,71323,75497,30,28,58,12997,11593,24590,5,0.363109,0.384043,469.00185,0.003026,0.002982,105,0.000309,0,14,0.559659,0.024996
55113,Sawyer County,,WI,1185,19531,20716,11,7,18,1722,1514,3236,5,0.324827,0.33826,717.291548,0.001679,0.000492,18,0.000167,0,14,0.609091,0.014535
55115,Shawano County,,WI,2701,47745,50446,13,12,25,7181,7239,14420,6,0.320358,0.333134,250.206411,0.00115,0.000845,105,0.000189,0,14,0.71978,0.009438
55117,Sheboygan County,,WI,5441,141509,146950,24,25,49,13303,13796,27099,5,0.365851,0.386679,181.954721,0.004478,0.003913,105,0.00023,0,14,0.728836,0.036551
55119,Taylor County,,WI,1128,22906,24034,8,10,18,1942,2393,4335,5,0.329856,0.344036,197.65852,0.000106,0.001165,105,0.000136,0,14,0.654545,0.001427
55121,Trempealeau County,,WI,1877,35249,37126,11,11,22,5279,5076,10355,5,0.329929,0.344258,207.583058,0.000821,0.001192,18,0.000159,0,14,0.666667,0.007145
55123,Vernon County,,WI,1686,33761,35447,10,10,20,4072,4473,8545,5,0.329856,0.344036,61.300784,0.000808,0.001167,105,0.000151,0,14,0.727273,0.007161
55125,Vilas County,,WI,1541,25266,26807,11,10,21,3164,2669,5833,6,0.343825,0.360586,1738.631164,0.002174,0.001604,105,0.000129,0,14,0.807692,0.017404
55127,Walworth County,,WI,6706,110424,117130,27,28,55,22316,19257,41573,5,0.371277,0.392771,92.663164,0.004414,0.006842,105,0.00024,0,14,0.685484,0.035553
55129,Washburn County,,WI,1190,19036,20226,9,9,18,2435,2313,4748,5,0.327876,0.341761,6.259594,0.001017,0.00084,18,0.000154,0,14,0.836364,0.008688
55131,Washington County,,WI,8787,156582,165369,26,31,57,32073,25868,57941,5,0.370544,0.392216,258.903415,0.004359,0.005308,105,0.000249,0,14,0.65625,0.037137
55133,Waukesha County,,WI,28042,473922,501964,96,121,217,92014,88509,180523,5,0.418734,0.451376,12055.842485,0.026776,0.035036,105,0.000782,0,14,0.440523,0.223983
55135,Waupaca County,,WI,3143,61366,64509,15,13,28,8493,8186,16679,5,0.352375,0.370451,59.831521,0.001859,0.001705,105,0.000177,0,14,0.8375,0.015526
55137,Waushara County,,WI,1671,26040,27711,15,13,28,4858,4197,9055,6,0.320461,0.333383,26.541278,0.001797,0.001017,105,0.000178,0,14,0.783333,0.015097
55139,Winnebago County,,WI,11799,186291,198090,48,44,92,37781,35234,73015,5,0.372566,0.396072,1743.563716,0.005936,0.007425,105,0.000476,0,14,0.42598,0.050472
55141,Wood County,,WI,4645,92821,97466,26,33,59,10084,12265,22349,5,0.363416,0.384959,729.417759,0.002092,0.003278,105,0.000288,0,14,0.544538,0.018197
56001,Albany County,,WY,4631,29773,34404,30,37,67,6550,8770,15320,5,0.371323,0.39469,8207.889552,0.006077,0.008434,6,0.000388,0,14,0.496246,0.05763
56003,Big Horn County,,WY,976,11657,12633,5,6,11,1105,1289,2394,6,0.275799,0.286618,22.958192,0.000139,0.000197,6,0.000118,0,14,0.857143,0.001629
56005,Campbell County,,WY,3007,42630,45637,32,25,57,7057,6020,13077,5,0.356262,0.376099,8492.565812,0.004258,0.003117,6,0.000567,0,14,0.364528,0.03973
56007,Carbon County,,WY,1603,16239,17842,9,9,18,1793,2246,4039,5,0.350894,0.368037,2.109978,0.0012,0.001207,6,0.000157,0,14,0.877778,0.012261
56009,Converse County,,WY,1071,14188,15259,7,8,15,2128,1928,4056,6,0.277045,0.287672,3.861366,0.000222,0.000239,6,0.000143,0,14,0.875,0.002692
56011,Crook County,,WY,492,6994,7486,4,3,7,1006,820,1826,6,0.263509,0.271316,0.333333,0.000091,0.000031,6,0.000153,0,14,0.916667,0.00114
56013,Fremont County,,WY,2457,40045,42502,19,18,37,3438,3471,6909,5,0.35337,0.372243,2048.499163,0.002043,0.002233,6,0.000303,0,14,0.510823,0.020211
56015,Goshen County,,WY,1029,12951,13980,6,6,12,1101,1371,2472,6,0.277506,0.287883,18.954076,0.000401,0.000195,6,0.000122,0,14,0.833333,0.004308
56017,Hot Springs County,,WY,481,4912,5393,2,4,6,310,440,750,6,0.269103,0.278201,4.557611,0.000053,0.000073,6,0.000075,0,14,0.833333,0.000711
56019,Johnson County,,WY,639,8003,8642,3,3,6,853,793,1646,6,0.269103,0.27809,0,0.000069,0.000079,6,0.000095,0,14,1,0.000978
56021,Laramie County,,WY,8487,97344,105831,55,50,105,14722,14448,29170,5,0.381122,0.406558,14036.762476,0.012409,0.012689,6,0.000651,0,14,0.454685,0.113194
56023,Lincoln County,,WY,1570,17584,19154,13,17,30,2974,2621,5595,5,0.352045,0.370395,321.814221,0.001666,0.001992,4,0.000203,0,14,0.599265,0.015905
56025,Natrona County,,WY,5099,77409,82508,40,37,77,10743,10318,21061,5,0.367777,0.391273,14540.377727,0.008009,0.00669,6,0.000517,0,14,0.406763,0.07426
56027,Niobrara County,,WY,179,2635,2814,0,0,0,0,0,0,0,0,0,0,0,0,106,0.000049,90,151,0,0
56029,Park County,,WY,2300,30466,32766,15,15,30,2615,3131,5746,5,0.352541,0.370883,2843.137761,0.002235,0.001462,6,0.000258,0,14,0.45614,0.021438
56031,Platte County,,WY,872,9587,10459,5,6,11,999,1438,2437,6,0.276586,0.286707,0.45,0.000166,0.000185,6,0.000114,0,14,0.9,0.001845
56033,Sheridan County,,WY,2152,30614,32766,15,16,31,3516,3612,7128,5,0.353703,0.372076,1751.446046,0.001102,0.001851,6,0.000282,0,14,0.519608,0.011781
56035,Sublette County,,WY,676,7548,8224,8,4,12,1191,562,1753,6,0.272299,0.28234,1.536006,0.000532,0.000157,6,0.000141,0,14,0.652778,0.005536
56037,Sweetwater County,,WY,3688,44429,48117,33,29,62,6878,6787,13665,5,0.361362,0.383156,2009.683142,0.006542,0.004397,6,0.000419,0,14,0.494118,0.060566
56039,Teton County,,WY,2694,21606,24300,20,17,37,2443,3718,6161,5,0.361492,0.381097,609.210788,0.005961,0.004996,4,0.000247,0,14,0.600791,0.053988
56041,Uinta County,,WY,1890,22068,23958,12,17,29,2938,3084,6022,5,0.352914,0.371477,78.015883,0.003053,0.002671,4,0.000159,0,14,0.673203,0.027504
56043,Washakie County,,WY,709,9200,9909,4,7,11,446,760,1206,6,0.275723,0.286562,12.197004,0.00006,0.000191,6,0.000105,0,14,0.75,0.000759
56045,Weston County,,WY,513,7368,7881,5,4,9,684,551,1235,6,0.280145,0.289692,38.986309,0.000124,0.000088,6,0.000165,0,14,0.566667,0.0016
2230,Skagway Hoonah Ango,,AK,342,3450,3792,1,2,3,177,234,411,6,0.312299,0.323075,0,0.000031,0.000324,4,0.000062,0,14,1,0.000261
2198,Prince Of Wales Oute,,AK,491,4790,5281,2,3,5,328,512,840,6,0.312331,0.323241,0,0.000041,0.000329,4,0.000078,0,14,1,0.000374
2275,Wrangell Peters,,AK,2320,4961,7281,1,4,5,80,539,619,6,0.312364,0.323408,0,0.000031,0.000334,4,0.000062,0,14,0.916667,0.000261
