id,label,timeset,state,totalMig,totalNonMig,population
1001,Autauga County,,AL,5500,50963,56463
1003,Baldwin County,,AL,9469,164112,173581
1005,Barbour County,,AL,1793,26722,28515
1007,Bibb County,,AL,1292,21074,22366
1009,Blount County,,AL,3244,52978,56222
1011,Bullock County,,AL,535,8482,9017
1013,Butler County,,AL,1032,21695,22727
1015,Calhoun County,,AL,6303,122844,129147
1017,Chambers County,,AL,2189,38853,41042
1019,Cherokee County,,AL,1263,24613,25876
1021,Chilton County,,AL,2099,41436,43535
1023,Choctaw County,,AL,862,15327,16189
1025,Clarke County,,AL,1424,29524,30948
1027,Clay County,,AL,810,15637,16447
1029,Cleburne County,,AL,962,14117,15079
1031,Coffee County,,AL,4846,44757,49603
1033,Colbert County,,AL,3165,58520,61685
1035,Conecuh County,,AL,838,14027,14865
1037,Coosa County,,AL,1065,11486,12551
1039,Covington County,,AL,1598,33537,35135
1041,Crenshaw County,,AL,863,14396,15259
1043,Cullman County,,AL,3783,81550,85333
1045,Dale County,,AL,7998,47748,55746
1047,Dallas County,,AL,2348,46412,48760
1049,DeKalb County,,AL,3362,68337,71699
1051,Elmore County,,AL,5790,74223,80013
1053,Escambia County,,AL,2123,37035,39158
1055,Etowah County,,AL,5156,108127,113283
1057,Fayette County,,AL,816,18325,19141
1059,Franklin County,,AL,1639,31047,32686
1061,Geneva County,,AL,1666,25209,26875
1063,Greene County,,AL,543,9364,9907
1065,Hale County,,AL,940,17640,18580
1067,Henry County,,AL,1256,17472,18728
1069,Houston County,,AL,6343,99907,106250
1071,Jackson County,,AL,2668,56944,59612
1073,Jefferson County,,AL,37782,704651,742433
1075,Lamar County,,AL,876,15853,16729
1077,Lauderdale County,,AL,4673,93163,97836
1079,Lawrence County,,AL,1889,36719,38608
1081,Lee County,,AL,9606,114096,123702
1083,Limestone County,,AL,3810,73410,77220
1085,Lowndes County,,AL,947,13925,14872
1087,Macon County,,AL,1523,21524,23047
1089,Madison County,,AL,16834,333999,350833
1091,Marengo County,,AL,1229,23128,24357
1093,Marion County,,AL,1509,28540,30049
1095,Marshall County,,AL,5037,89885,94922
1097,Mobile County,,AL,16364,418585,434949
1099,Monroe County,,AL,1175,25312,26487
1101,Montgomery County,,AL,17852,239686,257538
1103,Morgan County,,AL,6746,124912,131658
1105,Perry County,,AL,685,11306,11991
1107,Pickens County,,AL,1053,20984,22037
1109,Pike County,,AL,1937,28350,30287
1111,Randolph County,,AL,1168,22655,23823
1113,Russell County,,AL,5482,50048,55530
1115,St. Clair County,,AL,4611,72121,76732
1117,Shelby County,,AL,14694,179119,193813
1119,Sumter County,,AL,906,13684,14590
1121,Talladega County,,AL,4666,83717,88383
1123,Tallapoosa County,,AL,2543,43194,45737
1125,Tuscaloosa County,,AL,9281,173292,182573
1127,Walker County,,AL,2903,68673,71576
1129,Washington County,,AL,965,18329,19294
1131,Wilcox County,,AL,657,12716,13373
1133,Winston County,,AL,1331,25192,26523
2013,Aleutians East Borough,,AK,281,1615,1896
2016,Aleutians West Census Area,,AK,732,4391,5123
2020,Anchorage Municipality,,AK,27711,294184,321895
2050,Bethel Census Area,,AK,992,16877,17869
2060,Bristol Bay Borough,,AK,140,1298,1438
2068,Denali Borough,,AK,468,2167,2635
2070,Dillingham Census Area,,AK,406,4645,5051
2090,Fairbanks North Star Borough,,AK,11599,97189,108788
2100,Haines Borough,,AK,206,2582,2788
2105,Hoonah-Angoon Census Area,,AK,0,0,0
2110,Juneau City and Borough,,AK,2933,34902,37835
2122,Kenai Peninsula Borough,,AK,4036,54688,58724
2130,Ketchikan Gateway Borough,,AK,1310,14620,15930
2150,Kodiak Island Borough,,AK,1954,14952,16906
2164,Lake and Peninsula Borough,,AK,152,1501,1653
2170,Matanuska-Susitna Borough,,AK,5266,72221,77487
2180,Nome Census Area,,AK,692,8980,9672
2185,North Slope Borough,,AK,604,6824,7428
2188,Northwest Arctic Borough,,AK,525,6313,6838
2195,Petersburg Census Area,,AK,0,0,0
2220,Sitka City and Borough,,AK,956,9845,10801
2240,Southeast Fairbanks Census Area,,AK,599,6814,7413
2261,Valdez-Cordova Census Area,,AK,1185,10925,12110
2270,Wade Hampton Census Area,,AK,408,7060,7468
2282,Yakutat City and Borough,,AK,45,563,608
2290,Yukon-Koyukuk Census Area,,AK,669,5971,6640
4001,Apache County,,AZ,7322,56445,63767
4003,Cochise County,,AZ,12715,117649,130364
4005,Coconino County,,AZ,13091,121341,134432
4007,Gila County,,AZ,4133,50210,54343
4009,Graham County,,AZ,1773,25567,27340
4011,Greenlee County,,AZ,662,7244,7906
4012,La Paz County,,AZ,1401,14209,15610
4013,Maricopa County,,AZ,157013,3492040,3649053
4015,Mohave County,,AZ,12889,166946,179835
4017,Navajo County,,AZ,7923,91946,99869
4019,Pima County,,AZ,46259,911995,958254
4021,Pinal County,,AZ,17395,179692,197087
4023,Santa Cruz County,,AZ,2318,47330,49648
4025,Yavapai County,,AZ,13171,185736,198907
4027,Yuma County,,AZ,10868,182377,193245
5001,Arkansas County,,AR,1183,21596,22779
5003,Ashley County,,AR,1359,23834,25193
5005,Baxter County,,AR,2659,40036,42695
5007,Benton County,,AR,13997,187219,201216
5009,Boone County,,AR,2318,36126,38444
5011,Bradley County,,AR,713,11588,12301
5013,Calhoun County,,AR,367,5220,5587
5015,Carroll County,,AR,1937,26030,27967
5017,Chicot County,,AR,927,11988,12915
5019,Clark County,,AR,1769,20947,22716
5021,Clay County,,AR,1112,17121,18233
5023,Cleburne County,,AR,1470,24610,26080
5025,Cleveland County,,AR,597,8934,9531
5027,Columbia County,,AR,1450,24677,26127
5029,Conway County,,AR,1302,21018,22320
5031,Craighead County,,AR,6086,85084,91170
5033,Crawford County,,AR,4390,57728,62118
5035,Crittenden County,,AR,3441,52644,56085
5037,Cross County,,AR,1411,19604,21015
5039,Dallas County,,AR,677,8594,9271
5041,Desha County,,AR,1046,14737,15783
5043,Drew County,,AR,1314,17894,19208
5045,Faulkner County,,AR,6873,95622,102495
5047,Franklin County,,AR,1179,17478,18657
5049,Fulton County,,AR,781,10501,11282
5051,Garland County,,AR,5610,92372,97982
5053,Grant County,,AR,1260,17970,19230
5055,Greene County,,AR,2067,40360,42427
5057,Hempstead County,,AR,1578,22706,24284
5059,Hot Spring County,,AR,2023,30532,32555
5061,Howard County,,AR,974,15086,16060
5063,Independence County,,AR,2302,36354,38656
5065,Izard County,,AR,860,11964,12824
5067,Jackson County,,AR,1085,15980,17065
5069,Jefferson County,,AR,4947,83049,87996
5071,Johnson County,,AR,1368,23049,24417
5073,Lafayette County,,AR,567,7427,7994
5075,Lawrence County,,AR,1292,16791,18083
5077,Lee County,,AR,620,8711,9331
5079,Lincoln County,,AR,845,11305,12150
5081,Little River County,,AR,884,13465,14349
5083,Logan County,,AR,1472,22399,23871
5085,Lonoke County,,AR,5215,61522,66737
5087,Madison County,,AR,1104,14776,15880
5089,Marion County,,AR,1264,14936,16200
5091,Miller County,,AR,3725,40442,44167
5093,Mississippi County,,AR,3059,48305,51364
5095,Monroe County,,AR,713,9183,9896
5097,Montgomery County,,AR,638,8109,8747
5099,Nevada County,,AR,775,9625,10400
5101,Newton County,,AR,627,8057,8684
5103,Ouachita County,,AR,1803,27750,29553
5105,Perry County,,AR,798,10057,10855
5107,Phillips County,,AR,1490,23743,25233
5109,Pike County,,AR,778,10876,11654
5111,Poinsett County,,AR,1599,24476,26075
5113,Polk County,,AR,1173,19411,20584
5115,Pope County,,AR,3811,55616,59427
5117,Prairie County,,AR,591,8654,9245
5119,Pulaski County,,AR,27680,397731,425411
5121,Randolph County,,AR,1163,17914,19077
5123,St. Francis County,,AR,2066,25742,27808
5125,Saline County,,AR,6346,96286,102632
5127,Scott County,,AR,708,10461,11169
5129,Searcy County,,AR,484,7166,7650
5131,Sebastian County,,AR,9119,121950,131069
5133,Sevier County,,AR,881,15267,16148
5135,Sharp County,,AR,1477,16916,18393
5137,Stone County,,AR,580,11126,11706
5139,Union County,,AR,2616,47374,49990
5141,Van Buren County,,AR,1082,15523,16605
5143,Washington County,,AR,14006,174754,188760
5145,White County,,AR,4498,70862,75360
5147,Woodruff County,,AR,533,7941,8474
5149,Yell County,,AR,1615,19935,21550
6001,Alameda County,,CA,124906,1520776,1645682
6003,Alpine County,,CA,188,1012,1200
6005,Amador County,,CA,2333,36453,38786
6007,Butte County,,CA,12157,198689,210846
6009,Calaveras County,,CA,3324,43992,47316
6011,Colusa County,,CA,1414,22130,23544
6013,Contra Costa County,,CA,71886,1075933,1147819
6015,Del Norte County,,CA,1638,21975,23613
6017,El Dorado County,,CA,13738,181589,195327
6019,Fresno County,,CA,33225,847163,880388
6021,Glenn County,,CA,1925,27658,29583
6023,Humboldt County,,CA,7294,125247,132541
6025,Imperial County,,CA,8284,177571,185855
6027,Inyo County,,CA,1449,19366,20815
6029,Kern County,,CA,31486,706830,738316
6031,Kings County,,CA,10661,122770,133431
6033,Lake County,,CA,4045,55117,59162
6035,Lassen County,,CA,2135,25332,27467
6037,Los Angeles County,,CA,421162,10005039,10426201
6039,Madera County,,CA,7850,121843,129693
6041,Marin County,,CA,18740,244791,263531
6043,Mariposa County,,CA,1536,17275,18811
6045,Mendocino County,,CA,5257,88839,94096
6047,Merced County,,CA,14434,230707,245141
6049,Modoc County,,CA,724,8478,9202
6051,Mono County,,CA,1655,12013,13668
6053,Monterey County,,CA,35026,416693,451719
6055,Napa County,,CA,9780,138959,148739
6057,Nevada County,,CA,7617,102913,110530
6059,Orange County,,CA,193645,3161099,3354744
6061,Placer County,,CA,27439,327061,354500
6063,Plumas County,,CA,1739,21978,23717
6065,Riverside County,,CA,115449,1836330,1951779
6067,Sacramento County,,CA,89193,1402578,1491771
6069,San Benito County,,CA,5721,59147,64868
6071,San Bernardino County,,CA,130755,1901962,2032717
6073,San Diego County,,CA,214824,3168550,3383374
6075,San Francisco County,,CA,79455,789966,869421
6077,San Joaquin County,,CA,38796,648466,687262
6079,San Luis Obispo County,,CA,16370,252882,269252
6081,San Mateo County,,CA,63945,761738,825683
6083,Santa Barbara County,,CA,29539,410436,439975
6085,Santa Clara County,,CA,116211,1862894,1979105
6087,Santa Cruz County,,CA,18783,265425,284208
6089,Shasta County,,CA,10192,174293,184485
6091,Sierra County,,CA,355,3093,3448
6093,Siskiyou County,,CA,2818,43811,46629
6095,Solano County,,CA,36997,433283,470280
6097,Sonoma County,,CA,27870,505160,533030
6099,Stanislaus County,,CA,28713,505507,534220
6101,Sutter County,,CA,7197,87250,94447
6103,Tehama County,,CA,3593,55922,59515
6105,Trinity County,,CA,818,11142,11960
6107,Tulare County,,CA,16157,388341,404498
6109,Tuolumne County,,CA,3522,55464,58986
6111,Ventura County,,CA,54054,867555,921609
6113,Yolo County,,CA,18209,175655,193864
6115,Yuba County,,CA,8273,57864,66137
8001,Adams County,,CO,43457,399067,442524
8003,Alamosa County,,CO,1499,14259,15758
8005,Arapahoe County,,CO,65340,551261,616601
8007,Archuleta County,,CO,1111,10854,11965
8009,Baca County,,CO,274,4315,4589
8011,Bent County,,CO,433,4526,4959
8013,Boulder County,,CO,29518,289167,318685
8014,Broomfield County,,CO,7675,46481,54156
8015,Chaffee County,,CO,1531,16893,18424
8017,Cheyenne County,,CO,180,2187,2367
8019,Clear Creek County,,CO,1124,9288,10412
8021,Conejos County,,CO,456,8182,8638
8023,Costilla County,,CO,311,3103,3414
8025,Crowley County,,CO,364,2983,3347
8027,Custer County,,CO,406,3858,4264
8029,Delta County,,CO,2089,29037,31126
8031,Denver County,,CO,77333,523920,601253
8033,Dolores County,,CO,186,1874,2060
8035,Douglas County,,CO,26930,254908,281838
8037,Eagle County,,CO,4956,43687,48643
8039,Elbert County,,CO,2313,22349,24662
8041,El Paso County,,CO,55710,600759,656469
8043,Fremont County,,CO,2993,39511,42504
8045,Garfield County,,CO,4244,47066,51310
8047,Gilpin County,,CO,614,4848,5462
8049,Grand County,,CO,1603,13376,14979
8051,Gunnison County,,CO,1635,13446,15081
8053,Hinsdale County,,CO,104,794,898
8055,Huerfano County,,CO,557,6373,6930
8057,Jackson County,,CO,227,1548,1775
8059,Jefferson County,,CO,56450,577050,633500
8061,Kiowa County,,CO,144,1554,1698
8063,Kit Carson County,,CO,673,8245,8918
8065,Lake County,,CO,896,6551,7447
8067,La Plata County,,CO,4195,45893,50088
8069,Larimer County,,CO,24036,288097,312133
8071,Las Animas County,,CO,1132,14765,15897
8073,Lincoln County,,CO,499,5059,5558
8075,Logan County,,CO,1545,20494,22039
8077,Mesa County,,CO,7853,136016,143869
8079,Mineral County,,CO,78,884,962
8081,Moffat County,,CO,1346,13842,15188
8083,Montezuma County,,CO,2037,24075,26112
8085,Montrose County,,CO,2672,37801,40473
8087,Morgan County,,CO,2153,29269,31422
8089,Otero County,,CO,1370,20142,21512
8091,Ouray County,,CO,372,3921,4293
8093,Park County,,CO,1872,14485,16357
8095,Phillips County,,CO,348,4871,5219
8097,Pitkin County,,CO,1951,13857,15808
8099,Prowers County,,CO,1054,13690,14744
8101,Pueblo County,,CO,7435,154702,162137
8103,Rio Blanco County,,CO,758,6075,6833
8105,Rio Grande County,,CO,1385,15471,16856
8107,Routt County,,CO,2347,20829,23176
8109,Saguache County,,CO,387,3077,3464
8111,San Juan County,,CO,93,631,724
8113,San Miguel County,,CO,864,6380,7244
8115,Sedgwick County,,CO,173,2693,2866
8117,Summit County,,CO,4156,25656,29812
8119,Teller County,,CO,2970,23390,26360
8121,Washington County,,CO,344,4825,5169
8123,Weld County,,CO,17286,223032,240318
8125,Yuma County,,CO,804,9887,10691
9001,Fairfield County,,CT,54033,979240,1033273
9003,Hartford County,,CT,43461,1017688,1061149
9005,Litchfield County,,CT,11912,223444,235356
9007,Middlesex County,,CT,11910,189162,201072
9009,New Haven County,,CT,44487,945672,990159
9011,New London County,,CT,19466,312095,331561
9013,Tolland County,,CT,11252,158176,169428
9015,Windham County,,CT,7380,129391,136771
10001,Kent County,,DE,9559,156817,166376
10003,New Castle County,,DE,28501,593222,621723
10005,Sussex County,,DE,8420,189954,198374
11001,District of Columbia,,DC,63668,542111,605779
12001,Alachua County,,FL,21447,211620,233067
12003,Baker County,,FL,1419,24013,25432
12005,Bay County,,FL,13531,170614,184145
12007,Bradford County,,FL,1661,22487,24148
12009,Brevard County,,FL,30904,572446,603350
12011,Broward County,,FL,128004,1823174,1951178
12013,Calhoun County,,FL,654,11037,11691
12015,Charlotte County,,FL,16822,152099,168921
12017,Citrus County,,FL,8401,130999,139400
12019,Clay County,,FL,18826,182562,201388
12021,Collier County,,FL,22098,304357,326455
12023,Columbia County,,FL,3931,52004,55935
12027,DeSoto County,,FL,2665,26172,28837
12029,Dixie County,,FL,965,11676,12641
12031,Duval County,,FL,68994,902615,971609
12033,Escambia County,,FL,31902,303902,335804
12035,Flagler County,,FL,5271,75226,80497
12037,Franklin County,,FL,745,9582,10327
12039,Gadsden County,,FL,3134,47584,50718
12041,Gilchrist County,,FL,1263,13477,14740
12043,Glades County,,FL,980,8272,9252
12045,Gulf County,,FL,1001,12110,13111
12047,Hamilton County,,FL,993,11336,12329
12049,Hardee County,,FL,1812,22346,24158
12051,Hendry County,,FL,3107,35220,38327
12053,Hernando County,,FL,10763,152129,162892
12055,Highlands County,,FL,5899,86703,92602
12057,Hillsborough County,,FL,83340,1173369,1256709
12059,Holmes County,,FL,1195,16737,17932
12061,Indian River County,,FL,9496,132610,142106
12063,Jackson County,,FL,2610,44260,46870
12065,Jefferson County,,FL,1083,13673,14756
12067,Lafayette County,,FL,388,4689,5077
12069,Lake County,,FL,21943,267493,289436
12071,Lee County,,FL,31968,545423,577391
12073,Leon County,,FL,22090,241735,263825
12075,Levy County,,FL,3101,35708,38809
12077,Liberty County,,FL,431,5855,6286
12079,Madison County,,FL,1031,17623,18654
12081,Manatee County,,FL,22708,306353,329061
12083,Marion County,,FL,18310,301723,320033
12085,Martin County,,FL,12647,142545,155192
12086,Miami-Dade County,,FL,122367,2471315,2593682
12087,Monroe County,,FL,11430,79132,90562
12089,Nassau County,,FL,5606,71336,76942
12091,Okaloosa County,,FL,22978,201406,224384
12093,Okeechobee County,,FL,2772,34343,37115
12095,Orange County,,FL,98980,1066801,1165781
12097,Osceola County,,FL,27590,221538,249128
12099,Palm Beach County,,FL,79600,1310585,1390185
12101,Pasco County,,FL,32363,405147,437510
12103,Pinellas County,,FL,66068,976486,1042554
12105,Polk County,,FL,31792,548004,579796
12107,Putnam County,,FL,4513,69662,74175
12109,St. Johns County,,FL,14590,161672,176262
12111,St. Lucie County,,FL,18963,236519,255482
12113,Santa Rosa County,,FL,15073,138243,153316
12115,Sarasota County,,FL,28032,380583,408615
12117,Seminole County,,FL,46014,419176,465190
12119,Sumter County,,FL,4202,58180,62382
12121,Suwannee County,,FL,2719,36619,39338
12123,Taylor County,,FL,915,19591,20506
12125,Union County,,FL,1003,10236,11239
12127,Volusia County,,FL,31844,492817,524661
12129,Wakulla County,,FL,1923,24745,26668
12131,Walton County,,FL,4506,42803,47309
12133,Washington County,,FL,1680,20371,22051
13001,Appling County,,GA,1082,17908,18990
13003,Atkinson County,,GA,511,7894,8405
13005,Bacon County,,GA,542,9774,10316
13007,Baker County,,GA,268,3340,3608
13009,Baldwin County,,GA,2608,41868,44476
13011,Banks County,,GA,1651,16210,17861
13013,Barrow County,,GA,4912,56015,60927
13015,Bartow County,,GA,6951,94147,101098
13017,Ben Hill County,,GA,1230,17464,18694
13019,Berrien County,,GA,1368,16516,17884
13021,Bibb County,,GA,11329,159034,170363
13023,Bleckley County,,GA,739,12921,13660
13025,Brantley County,,GA,1250,15431,16681
13027,Brooks County,,GA,1356,14432,15788
13029,Bryan County,,GA,3590,28013,31603
13031,Bulloch County,,GA,4192,49277,53469
13033,Burke County,,GA,1523,24344,25867
13035,Butts County,,GA,1826,20857,22683
13037,Calhoun County,,GA,438,5681,6119
13039,Camden County,,GA,7110,46632,53742
13043,Candler County,,GA,681,9339,10020
13045,Carroll County,,GA,7230,99627,106857
13047,Catoosa County,,GA,5251,58916,64167
13049,Charlton County,,GA,718,9043,9761
13051,Chatham County,,GA,21847,237825,259672
13053,Chattahoochee County,,GA,4424,7578,12002
13055,Chattooga County,,GA,1272,25414,26686
13057,Cherokee County,,GA,15411,181468,196879
13059,Clarke County,,GA,11590,85516,97106
13061,Clay County,,GA,216,2769,2985
13063,Clayton County,,GA,35502,246602,282104
13065,Clinch County,,GA,328,6522,6850
13067,Cobb County,,GA,73665,692032,765697
13069,Coffee County,,GA,1937,37254,39191
13071,Colquitt County,,GA,2101,40246,42347
13073,Columbia County,,GA,10281,113304,123585
13075,Cook County,,GA,1051,16005,17056
13077,Coweta County,,GA,7901,111500,119401
13079,Crawford County,,GA,1121,12637,13758
13081,Crisp County,,GA,1379,21917,23296
13083,Dade County,,GA,1125,15475,16600
13085,Dawson County,,GA,1746,18263,20009
13087,Decatur County,,GA,1675,27815,29490
13089,DeKalb County,,GA,87793,641076,728869
13091,Dodge County,,GA,976,17750,18726
13093,Dooly County,,GA,903,13006,13909
13095,Dougherty County,,GA,7838,94778,102616
13097,Douglas County,,GA,12352,108566,120918
13099,Early County,,GA,714,12106,12820
13101,Echols County,,GA,245,2686,2931
13103,Effingham County,,GA,3320,46451,49771
13105,Elbert County,,GA,1064,22075,23139
13107,Emanuel County,,GA,1297,22480,23777
13109,Evans County,,GA,681,10447,11128
13111,Fannin County,,GA,1368,21437,22805
13113,Fayette County,,GA,9814,111214,121028
13115,Floyd County,,GA,6625,95547,102172
13117,Forsyth County,,GA,10998,134031,145029
13119,Franklin County,,GA,1539,22087,23626
13121,Fulton County,,GA,103901,748429,852330
13123,Gilmer County,,GA,1599,23041,24640
13125,Glascock County,,GA,188,2706,2894
13127,Glynn County,,GA,5288,72746,78034
13129,Gordon County,,GA,3222,52403,55625
13131,Grady County,,GA,1428,22912,24340
13133,Greene County,,GA,976,15625,16601
13135,Gwinnett County,,GA,67181,723584,790765
13137,Habersham County,,GA,2243,38748,40991
13139,Hall County,,GA,11095,163338,174433
13141,Hancock County,,GA,584,9188,9772
13143,Haralson County,,GA,2099,26771,28870
13145,Harris County,,GA,2487,29051,31538
13147,Hart County,,GA,1384,24232,25616
13149,Heard County,,GA,979,10351,11330
13151,Henry County,,GA,16070,175076,191146
13153,Houston County,,GA,12224,136527,148751
13155,Irwin County,,GA,808,9155,9963
13157,Jackson County,,GA,4300,49475,53775
13159,Jasper County,,GA,1097,13034,14131
13161,Jeff Davis County,,GA,801,13750,14551
13163,Jefferson County,,GA,988,19673,20661
13165,Jenkins County,,GA,393,8275,8668
13167,Johnson County,,GA,515,8438,8953
13169,Jones County,,GA,2128,28640,30768
13171,Lamar County,,GA,1483,15787,17270
13173,Lanier County,,GA,776,6698,7474
13175,Laurens County,,GA,2386,50057,52443
13177,Lee County,,GA,2716,27630,30346
13179,Liberty County,,GA,17513,57366,74879
13181,Lincoln County,,GA,539,8700,9239
13183,Long County,,GA,1689,7662,9351
13185,Lowndes County,,GA,9502,93693,103195
13187,Lumpkin County,,GA,2224,22603,24827
13189,McDuffie County,,GA,1497,23497,24994
13191,McIntosh County,,GA,958,10674,11632
13193,Macon County,,GA,853,10672,11525
13195,Madison County,,GA,2099,27924,30023
13197,Marion County,,GA,523,6582,7105
13199,Meriwether County,,GA,1798,23196,24994
13201,Miller County,,GA,394,5603,5997
13205,Mitchell County,,GA,1596,22237,23833
13207,Monroe County,,GA,1837,24524,26361
13209,Montgomery County,,GA,635,7860,8495
13211,Morgan County,,GA,1038,17471,18509
13213,Murray County,,GA,3172,39954,43126
13215,Muscogee County,,GA,21503,193647,215150
13217,Newton County,,GA,7480,84009,91489
13219,Oconee County,,GA,2677,30758,33435
13221,Oglethorpe County,,GA,1156,13188,14344
13223,Paulding County,,GA,10105,111385,121490
13225,Peach County,,GA,2543,24768,27311
13227,Pickens County,,GA,2100,28100,30200
13229,Pierce County,,GA,1262,17044,18306
13231,Pike County,,GA,1324,16462,17786
13233,Polk County,,GA,2113,39760,41873
13235,Pulaski County,,GA,598,9477,10075
13237,Putnam County,,GA,1656,20066,21722
13239,Quitman County,,GA,197,2147,2344
13241,Rabun County,,GA,947,16023,16970
13243,Randolph County,,GA,500,7746,8246
13245,Richmond County,,GA,21390,199722,221112
13247,Rockdale County,,GA,10046,75349,85395
13249,Schley County,,GA,312,4121,4433
13251,Screven County,,GA,986,15267,16253
13253,Seminole County,,GA,766,9386,10152
13255,Spalding County,,GA,5148,62435,67583
13257,Stephens County,,GA,1879,26554,28433
13259,Stewart County,,GA,383,4766,5149
13261,Sumter County,,GA,2075,32638,34713
13263,Talbot County,,GA,476,7340,7816
13265,Taliaferro County,,GA,165,1688,1853
13267,Tattnall County,,GA,1180,18665,19845
13269,Taylor County,,GA,548,9062,9610
13271,Telfair County,,GA,650,11232,11882
13273,Terrell County,,GA,770,11175,11945
13275,Thomas County,,GA,2533,44619,47152
13277,Tift County,,GA,2654,40127,42781
13279,Toombs County,,GA,1602,26158,27760
13281,Towns County,,GA,650,9893,10543
13283,Treutlen County,,GA,395,6248,6643
13285,Troup County,,GA,3678,65103,68781
13287,Turner County,,GA,645,9601,10246
13289,Twiggs County,,GA,1060,10874,11934
13291,Union County,,GA,1121,18869,19990
13293,Upson County,,GA,1435,28069,29504
13295,Walker County,,GA,4455,64289,68744
13297,Walton County,,GA,4971,72831,77802
13299,Ware County,,GA,2310,34187,36497
13301,Warren County,,GA,486,6610,7096
13303,Washington County,,GA,895,21619,22514
13305,Wayne County,,GA,1542,26492,28034
13307,Webster County,,GA,186,2513,2699
13309,Wheeler County,,GA,301,4605,4906
13311,White County,,GA,1819,23431,25250
13313,Whitfield County,,GA,6548,103818,110366
13315,Wilcox County,,GA,461,7058,7519
13317,Wilkes County,,GA,660,11092,11752
13319,Wilkinson County,,GA,754,11254,12008
13321,Worth County,,GA,1682,22474,24156
15001,Hawaii County,,HI,6860,164377,171237
15003,Honolulu County,,HI,59069,1015723,1074792
15005,Kalawao County,,HI,-2,-2,-4
15007,Kauai County,,HI,3093,67942,71035
15009,Maui County,,HI,7730,151705,159435
16001,Ada County,,ID,23604,364837,388441
16003,Adams County,,ID,356,3763,4119
16005,Bannock County,,ID,6875,79162,86037
16007,Bear Lake County,,ID,459,6811,7270
16009,Benewah County,,ID,619,9324,9943
16011,Bingham County,,ID,3461,46232,49693
16013,Blaine County,,ID,1966,22448,24414
16015,Boise County,,ID,863,6495,7358
16017,Bonner County,,ID,2936,38274,41210
16019,Bonneville County,,ID,7439,98445,105884
16021,Boundary County,,ID,790,10607,11397
16023,Butte County,,ID,277,2909,3186
16025,Camas County,,ID,123,911,1034
16027,Canyon County,,ID,12094,159848,171942
16029,Caribou County,,ID,600,7898,8498
16031,Cassia County,,ID,1932,21836,23768
16033,Clark County,,ID,96,952,1048
16035,Clearwater County,,ID,705,8543,9248
16037,Custer County,,ID,405,4262,4667
16039,Elmore County,,ID,4959,26994,31953
16041,Franklin County,,ID,931,13214,14145
16043,Fremont County,,ID,1258,13282,14540
16045,Gem County,,ID,1413,16490,17903
16047,Gooding County,,ID,1351,14430,15781
16049,Idaho County,,ID,992,14684,15676
16051,Jefferson County,,ID,2086,23323,25409
16053,Jerome County,,ID,1937,19439,21376
16055,Kootenai County,,ID,8051,130010,138061
16057,Latah County,,ID,4323,33266,37589
16059,Lemhi County,,ID,578,7893,8471
16061,Lewis County,,ID,388,4073,4461
16063,Lincoln County,,ID,442,4511,4953
16065,Madison County,,ID,3511,23891,27402
16067,Minidoka County,,ID,1837,21250,23087
16069,Nez Perce County,,ID,3072,40385,43457
16071,Oneida County,,ID,266,4409,4675
16073,Owyhee County,,ID,1304,10338,11642
16075,Payette County,,ID,1890,21825,23715
16077,Power County,,ID,671,8152,8823
16079,Shoshone County,,ID,847,12325,13172
16081,Teton County,,ID,750,7687,8437
16083,Twin Falls County,,ID,5348,72072,77420
16085,Valley County,,ID,1016,8847,9863
16087,Washington County,,ID,806,9947,10753
17001,Adams County,,IL,2846,78783,81629
17003,Alexander County,,IL,829,8208,9037
17005,Bond County,,IL,1204,18237,19441
17007,Boone County,,IL,4344,56899,61243
17009,Brown County,,IL,354,5835,6189
17011,Bureau County,,IL,2216,42481,44697
17013,Calhoun County,,IL,174,6004,6178
17015,Carroll County,,IL,1123,19662,20785
17017,Cass County,,IL,1039,15488,16527
17019,Champaign County,,IL,14078,188013,202091
17021,Christian County,,IL,2002,41017,43019
17023,Clark County,,IL,1012,19689,20701
17025,Clay County,,IL,893,16547,17440
17027,Clinton County,,IL,2082,42649,44731
17029,Coles County,,IL,3805,51046,54851
17031,Cook County,,IL,277837,5767919,6045756
17033,Crawford County,,IL,949,22915,23864
17035,Cumberland County,,IL,848,12287,13135
17037,DeKalb County,,IL,8196,97056,105252
17039,De Witt County,,IL,1097,19536,20633
17041,Douglas County,,IL,1545,25499,27044
17043,DuPage County,,IL,88283,1074759,1163042
17045,Edgar County,,IL,1033,21822,22855
17047,Edwards County,,IL,430,8027,8457
17049,Effingham County,,IL,2308,43296,45604
17051,Fayette County,,IL,1137,24352,25489
17053,Ford County,,IL,1212,16863,18075
17055,Franklin County,,IL,2062,43465,45527
17057,Fulton County,,IL,1886,42259,44145
17059,Gallatin County,,IL,357,6663,7020
17061,Greene County,,IL,837,16464,17301
17063,Grundy County,,IL,3403,51617,55020
17065,Hamilton County,,IL,461,9400,9861
17067,Hancock County,,IL,1311,23826,25137
17069,Hardin County,,IL,203,4579,4782
17071,Henderson County,,IL,542,8945,9487
17073,Henry County,,IL,3370,61950,65320
17075,Iroquois County,,IL,2040,37112,39152
17077,Jackson County,,IL,5790,52186,57976
17079,Jasper County,,IL,595,12624,13219
17081,Jefferson County,,IL,2115,42375,44490
17083,Jersey County,,IL,1420,26007,27427
17085,Jo Daviess County,,IL,1415,27560,28975
17087,Johnson County,,IL,734,12238,12972
17089,Kane County,,IL,38766,511729,550495
17091,Kankakee County,,IL,6188,120741,126929
17093,Kendall County,,IL,7092,90623,97715
17095,Knox County,,IL,3040,59209,62249
17097,Lake County,,IL,49275,771885,821160
17099,LaSalle County,,IL,6335,136165,142500
17101,Lawrence County,,IL,852,16699,17551
17103,Lee County,,IL,2546,41129,43675
17105,Livingston County,,IL,2395,45020,47415
17107,Logan County,,IL,1847,32628,34475
17109,McDonough County,,IL,2164,30041,32205
17111,McHenry County,,IL,20497,351904,372401
17113,McLean County,,IL,10762,174905,185667
17115,Macon County,,IL,5829,128415,134244
17117,Macoupin County,,IL,3210,55984,59194
17119,Madison County,,IL,15398,309877,325275
17121,Marion County,,IL,2382,46098,48480
17123,Marshall County,,IL,979,16087,17066
17125,Mason County,,IL,1172,18285,19457
17127,Massac County,,IL,914,17594,18508
17129,Menard County,,IL,1047,15223,16270
17131,Mercer County,,IL,1314,21368,22682
17133,Monroe County,,IL,1930,38473,40403
17135,Montgomery County,,IL,1634,33991,35625
17137,Morgan County,,IL,2289,40230,42519
17139,Moultrie County,,IL,1103,17223,18326
17141,Ogle County,,IL,3788,63513,67301
17143,Peoria County,,IL,12283,211102,223385
17145,Perry County,,IL,1175,23042,24217
17147,Piatt County,,IL,1261,19832,21093
17149,Pike County,,IL,911,19080,19991
17151,Pope County,,IL,278,4353,4631
17153,Pulaski County,,IL,509,7086,7595
17155,Putnam County,,IL,479,7491,7970
17157,Randolph County,,IL,1851,36331,38182
17159,Richland County,,IL,957,19045,20002
17161,Rock Island County,,IL,9146,173416,182562
17163,St. Clair County,,IL,18400,294748,313148
17165,Saline County,,IL,1369,26665,28034
17167,Sangamon County,,IL,10452,233477,243929
17169,Schuyler County,,IL,484,8271,8755
17171,Scott County,,IL,357,6450,6807
17173,Shelby County,,IL,1461,25941,27402
17175,Stark County,,IL,431,7440,7871
17177,Stephenson County,,IL,2869,57563,60432
17179,Tazewell County,,IL,8366,157724,166090
17181,Union County,,IL,936,19929,20865
17183,Vermilion County,,IL,4113,92312,96425
17185,Wabash County,,IL,672,14519,15191
17187,Warren County,,IL,1255,19580,20835
17189,Washington County,,IL,1152,18511,19663
17191,Wayne County,,IL,815,19058,19873
17193,White County,,IL,732,17447,18179
17195,Whiteside County,,IL,3271,72462,75733
17197,Will County,,IL,44765,717282,762047
17199,Williamson County,,IL,4115,68348,72463
17201,Winnebago County,,IL,14957,335152,350109
17203,Woodford County,,IL,2535,43778,46313
18001,Adams County,,IN,1817,41394,43211
18003,Allen County,,IN,17870,406454,424324
18005,Bartholomew County,,IN,4935,84961,89896
18007,Benton County,,IN,915,10559,11474
18009,Blackford County,,IN,950,16117,17067
18011,Boone County,,IN,3954,59255,63209
18013,Brown County,,IN,1517,18186,19703
18015,Carroll County,,IN,1569,23945,25514
18017,Cass County,,IN,2555,46194,48749
18019,Clark County,,IN,8219,114260,122479
18021,Clay County,,IN,1822,31694,33516
18023,Clinton County,,IN,2158,38378,40536
18025,Crawford County,,IN,806,11889,12695
18027,Daviess County,,IN,1374,34153,35527
18029,Dearborn County,,IN,3611,58039,61650
18031,Decatur County,,IN,1731,31151,32882
18033,DeKalb County,,IN,3120,49924,53044
18035,Delaware County,,IN,7450,120475,127925
18037,Dubois County,,IN,2290,51870,54160
18039,Elkhart County,,IN,10152,219244,229396
18041,Fayette County,,IN,1590,27955,29545
18043,Floyd County,,IN,6581,81650,88231
18045,Fountain County,,IN,1491,20790,22281
18047,Franklin County,,IN,1485,28352,29837
18049,Fulton County,,IN,1640,24512,26152
18051,Gibson County,,IN,2020,39040,41060
18053,Grant County,,IN,3943,77716,81659
18055,Greene County,,IN,2105,36916,39021
18057,Hamilton County,,IN,19386,260332,279718
18059,Hancock County,,IN,4997,74733,79730
18061,Harrison County,,IN,2484,44112,46596
18063,Hendricks County,,IN,10460,138768,149228
18065,Henry County,,IN,3072,57257,60329
18067,Howard County,,IN,4974,102919,107893
18069,Huntington County,,IN,2386,46001,48387
18071,Jackson County,,IN,2529,49055,51584
18073,Jasper County,,IN,2234,36697,38931
18075,Jay County,,IN,1399,25523,26922
18077,Jefferson County,,IN,1837,36646,38483
18079,Jennings County,,IN,2236,32217,34453
18081,Johnson County,,IN,12071,144337,156408
18083,Knox County,,IN,1990,41157,43147
18085,Kosciusko County,,IN,5014,91215,96229
18087,LaGrange County,,IN,2365,43696,46061
18089,Lake County,,IN,27350,546441,573791
18091,LaPorte County,,IN,5151,122099,127250
18093,Lawrence County,,IN,2347,52968,55315
18095,Madison County,,IN,7390,148698,156088
18097,Marion County,,IN,66020,967648,1033668
18099,Marshall County,,IN,3127,54362,57489
18101,Martin County,,IN,684,12066,12750
18103,Miami County,,IN,2748,40219,42967
18105,Monroe County,,IN,10604,112066,122670
18107,Montgomery County,,IN,2186,43006,45192
18109,Morgan County,,IN,5604,80063,85667
18111,Newton County,,IN,1212,16746,17958
18113,Noble County,,IN,3249,53613,56862
18115,Ohio County,,IN,552,6847,7399
18117,Orange County,,IN,1130,21482,22612
18119,Owen County,,IN,2005,23087,25092
18121,Parke County,,IN,1161,16873,18034
18123,Perry County,,IN,1014,20782,21796
18125,Pike County,,IN,954,14476,15430
18127,Porter County,,IN,11172,179600,190772
18129,Posey County,,IN,1903,31236,33139
18131,Pulaski County,,IN,997,15421,16418
18133,Putnam County,,IN,2665,38928,41593
18135,Randolph County,,IN,1928,30820,32748
18137,Ripley County,,IN,2004,31883,33887
18139,Rush County,,IN,1330,20914,22244
18141,St. Joseph County,,IN,15564,298497,314061
18143,Scott County,,IN,1530,25693,27223
18145,Shelby County,,IN,3308,50743,54051
18147,Spencer County,,IN,1387,24653,26040
18149,Starke County,,IN,1611,26162,27773
18151,Steuben County,,IN,2685,38037,40722
18153,Sullivan County,,IN,1316,22963,24279
18155,Switzerland County,,IN,680,9931,10611
18157,Tippecanoe County,,IN,12380,149817,162197
18159,Tipton County,,IN,1296,20155,21451
18161,Union County,,IN,694,8545,9239
18163,Vanderburgh County,,IN,10947,195577,206524
18165,Vermillion County,,IN,1236,19041,20277
18167,Vigo County,,IN,6934,110359,117293
18169,Wabash County,,IN,2082,40294,42376
18171,Warren County,,IN,663,10128,10791
18173,Warrick County,,IN,4461,65259,69720
18175,Washington County,,IN,1853,31221,33074
18177,Wayne County,,IN,4034,80163,84197
18179,Wells County,,IN,1877,32130,34007
18181,White County,,IN,2126,29613,31739
18183,Whitley County,,IN,2205,38815,41020
19001,Adair County,,IA,581,9313,9894
19003,Adams County,,IA,336,4961,5297
19005,Allamakee County,,IA,835,16896,17731
19007,Appanoose County,,IA,749,14436,15185
19009,Audubon County,,IA,367,7614,7981
19011,Benton County,,IA,1844,30511,32355
19013,Black Hawk County,,IA,7462,135955,143417
19015,Boone County,,IA,1840,30543,32383
19017,Bremer County,,IA,1545,26801,28346
19019,Buchanan County,,IA,1321,24363,25684
19021,Buena Vista County,,IA,1655,22732,24387
19023,Butler County,,IA,893,18096,18989
19025,Calhoun County,,IA,731,12136,12867
19027,Carroll County,,IA,1225,26186,27411
19029,Cass County,,IA,895,16184,17079
19031,Cedar County,,IA,1484,21814,23298
19033,Cerro Gordo County,,IA,2709,51551,54260
19035,Cherokee County,,IA,827,14963,15790
19037,Chickasaw County,,IA,797,15301,16098
19039,Clarke County,,IA,971,10315,11286
19041,Clay County,,IA,1291,20314,21605
19043,Clayton County,,IA,1147,22084,23231
19045,Clinton County,,IA,2748,57621,60369
19047,Crawford County,,IA,1046,19345,20391
19049,Dallas County,,IA,5093,57371,62464
19051,Davis County,,IA,533,9457,9990
19053,Decatur County,,IA,644,8028,8672
19055,Delaware County,,IA,1049,21757,22806
19057,Des Moines County,,IA,2364,47252,49616
19059,Dickinson County,,IA,1220,19961,21181
19061,Dubuque County,,IA,4187,106821,111008
19063,Emmet County,,IA,691,11848,12539
19065,Fayette County,,IA,1235,23420,24655
19067,Floyd County,,IA,1074,19047,20121
19069,Franklin County,,IA,644,12302,12946
19071,Fremont County,,IA,521,8710,9231
19073,Greene County,,IA,688,11532,12220
19075,Grundy County,,IA,918,15050,15968
19077,Guthrie County,,IA,929,13225,14154
19079,Hamilton County,,IA,1119,18999,20118
19081,Hancock County,,IA,905,13994,14899
19083,Hardin County,,IA,1290,20407,21697
19085,Harrison County,,IA,983,17746,18729
19087,Henry County,,IA,1389,22250,23639
19089,Howard County,,IA,641,12049,12690
19091,Humboldt County,,IA,684,12095,12779
19093,Ida County,,IA,487,8829,9316
19095,Iowa County,,IA,1032,20079,21111
19097,Jackson County,,IA,1179,24386,25565
19099,Jasper County,,IA,2425,43450,45875
19101,Jefferson County,,IA,1087,16689,17776
19103,Johnson County,,IA,11754,119278,131032
19105,Jones County,,IA,1275,22534,23809
19107,Keokuk County,,IA,781,12635,13416
19109,Kossuth County,,IA,899,20198,21097
19111,Lee County,,IA,2041,40854,42895
19113,Linn County,,IA,11153,232904,244057
19115,Louisa County,,IA,994,13257,14251
19117,Lucas County,,IA,602,9943,10545
19119,Lyon County,,IA,721,14143,14864
19121,Madison County,,IA,1220,16845,18065
19123,Mahaska County,,IA,1374,24757,26131
19125,Marion County,,IA,2082,37422,39504
19127,Marshall County,,IA,2679,45547,48226
19129,Mills County,,IA,1150,16044,17194
19131,Mitchell County,,IA,565,12655,13220
19133,Monona County,,IA,601,10910,11511
19135,Monroe County,,IA,528,8871,9399
19137,Montgomery County,,IA,784,12599,13383
19139,Muscatine County,,IA,2429,49737,52166
19141,O'Brien County,,IA,1006,17276,18282
19143,Osceola County,,IA,456,8127,8583
19145,Page County,,IA,917,17375,18292
19147,Palo Alto County,,IA,641,11154,11795
19149,Plymouth County,,IA,1619,30768,32387
19151,Pocahontas County,,IA,507,9333,9840
19153,Polk County,,IA,23501,452254,475755
19155,Pottawattamie County,,IA,5917,100089,106006
19157,Poweshiek County,,IA,1374,20923,22297
19159,Ringgold County,,IA,422,5710,6132
19161,Sac County,,IA,697,12743,13440
19163,Scott County,,IA,10363,183343,193706
19165,Shelby County,,IA,838,14971,15809
19167,Sioux County,,IA,1611,37199,38810
19169,Story County,,IA,8201,77829,86030
19171,Tama County,,IA,1260,21473,22733
19173,Taylor County,,IA,507,7317,7824
19175,Union County,,IA,857,13706,14563
19177,Van Buren County,,IA,522,8525,9047
19179,Wapello County,,IA,2396,38740,41136
19181,Warren County,,IA,3482,49329,52811
19183,Washington County,,IA,1490,25312,26802
19185,Wayne County,,IA,439,7346,7785
19187,Webster County,,IA,2291,42373,44664
19189,Winnebago County,,IA,788,13628,14416
19191,Winneshiek County,,IA,1045,22899,23944
19193,Woodbury County,,IA,7585,113081,120666
19195,Worth County,,IA,546,8985,9531
19197,Wright County,,IA,915,15917,16832
20001,Allen County,,KS,985,14962,15947
20003,Anderson County,,KS,580,9249,9829
20005,Atchison County,,KS,1161,17976,19137
20007,Barber County,,KS,345,5671,6016
20009,Barton County,,KS,1669,30445,32114
20011,Bourbon County,,KS,1042,16474,17516
20013,Brown County,,KS,830,11602,12432
20015,Butler County,,KS,4745,66801,71546
20017,Chase County,,KS,224,3168,3392
20019,Chautauqua County,,KS,367,4137,4504
20021,Cherokee County,,KS,1587,22890,24477
20023,Cheyenne County,,KS,145,3463,3608
20025,Clark County,,KS,255,2408,2663
20027,Clay County,,KS,625,10033,10658
20029,Cloud County,,KS,653,10573,11226
20031,Coffey County,,KS,662,10232,10894
20033,Comanche County,,KS,118,2206,2324
20035,Cowley County,,KS,2634,38117,40751
20037,Crawford County,,KS,2955,37799,40754
20039,Decatur County,,KS,243,3743,3986
20041,Dickinson County,,KS,1655,21851,23506
20043,Doniphan County,,KS,703,8525,9228
20045,Douglas County,,KS,10418,97399,107817
20047,Edwards County,,KS,277,3607,3884
20049,Elk County,,KS,227,3288,3515
20051,Ellis County,,KS,2395,29261,31656
20053,Ellsworth County,,KS,455,6731,7186
20055,Finney County,,KS,3578,41767,45345
20057,Ford County,,KS,2702,34093,36795
20059,Franklin County,,KS,2050,28160,30210
20061,Geary County,,KS,8445,31917,40362
20063,Gove County,,KS,209,3572,3781
20065,Graham County,,KS,188,3201,3389
20067,Grant County,,KS,716,8777,9493
20069,Gray County,,KS,665,7190,7855
20071,Greeley County,,KS,164,1653,1817
20073,Greenwood County,,KS,585,7529,8114
20075,Hamilton County,,KS,258,2699,2957
20077,Harper County,,KS,516,6885,7401
20079,Harvey County,,KS,2364,38029,40393
20081,Haskell County,,KS,480,4761,5241
20083,Hodgeman County,,KS,176,2312,2488
20085,Jackson County,,KS,1017,15515,16532
20087,Jefferson County,,KS,1674,21410,23084
20089,Jewell County,,KS,249,4037,4286
20091,Johnson County,,KS,40432,576402,616834
20093,Kearny County,,KS,445,4711,5156
20095,Kingman County,,KS,742,9486,10228
20097,Kiowa County,,KS,310,3478,3788
20099,Labette County,,KS,1266,24138,25404
20101,Lane County,,KS,155,2212,2367
20103,Leavenworth County,,KS,9804,70994,80798
20105,Lincoln County,,KS,280,3915,4195
20107,Linn County,,KS,711,10404,11115
20109,Logan County,,KS,247,3379,3626
20111,Lyon County,,KS,3127,38258,41385
20113,McPherson County,,KS,1969,34571,36540
20115,Marion County,,KS,886,14374,15260
20117,Marshall County,,KS,639,12880,13519
20119,Meade County,,KS,341,5260,5601
20121,Miami County,,KS,2364,33485,35849
20123,Mitchell County,,KS,501,7580,8081
20125,Montgomery County,,KS,2654,36844,39498
20127,Morris County,,KS,380,6740,7120
20129,Morton County,,KS,361,3926,4287
20131,Nemaha County,,KS,606,12964,13570
20133,Neosho County,,KS,1183,17957,19140
20135,Ness County,,KS,220,3820,4040
20137,Norton County,,KS,416,5959,6375
20139,Osage County,,KS,1317,18878,20195
20141,Osborne County,,KS,287,4874,5161
20143,Ottawa County,,KS,542,7237,7779
20145,Pawnee County,,KS,502,7136,7638
20147,Phillips County,,KS,448,6847,7295
20149,Pottawatomie County,,KS,1793,21772,23565
20151,Pratt County,,KS,678,10582,11260
20153,Rawlins County,,KS,221,3102,3323
20155,Reno County,,KS,3713,69929,73642
20157,Republic County,,KS,352,6237,6589
20159,Rice County,,KS,761,11072,11833
20161,Riley County,,KS,8442,47464,55906
20163,Rooks County,,KS,351,6100,6451
20165,Rush County,,KS,288,3984,4272
20167,Russell County,,KS,630,7691,8321
20169,Saline County,,KS,3996,62628,66624
20171,Scott County,,KS,411,5809,6220
20173,Sedgwick County,,KS,25763,518455,544218
20175,Seward County,,KS,2410,23680,26090
20177,Shawnee County,,KS,10231,195034,205265
20179,Sheridan County,,KS,181,3222,3403
20181,Sherman County,,KS,547,6557,7104
20183,Smith County,,KS,239,5078,5317
20185,Stafford County,,KS,325,5106,5431
20187,Stanton County,,KS,243,2466,2709
20189,Stevens County,,KS,544,6387,6931
20191,Sumner County,,KS,2074,27933,30007
20193,Thomas County,,KS,854,8647,9501
20195,Trego County,,KS,272,3737,4009
20197,Wabaunsee County,,KS,549,7815,8364
20199,Wallace County,,KS,131,1862,1993
20201,Washington County,,KS,385,7512,7897
20203,Wichita County,,KS,234,2962,3196
20205,Wilson County,,KS,746,10590,11336
20207,Woodson County,,KS,227,3692,3919
20209,Wyandotte County,,KS,13502,151335,164837
21001,Adair County,,KY,853,16554,17407
21003,Allen County,,KY,1082,18704,19786
21005,Anderson County,,KY,1468,23216,24684
21007,Ballard County,,KY,498,9155,9653
21009,Barren County,,KY,2236,42881,45117
21011,Bath County,,KY,674,11555,12229
21013,Bell County,,KY,1563,24799,26362
21015,Boone County,,KY,10443,116137,126580
21017,Bourbon County,,KY,1456,21218,22674
21019,Boyd County,,KY,3044,51133,54177
21021,Boyle County,,KY,2174,28681,30855
21023,Bracken County,,KY,714,10194,10908
21025,Breathitt County,,KY,564,12554,13118
21027,Breckinridge County,,KY,1184,19786,20970
21029,Bullitt County,,KY,5377,77724,83101
21031,Butler County,,KY,719,13480,14199
21033,Caldwell County,,KY,685,13956,14641
21035,Calloway County,,KY,2250,33598,35848
21037,Campbell County,,KY,7200,96995,104195
21039,Carlisle County,,KY,398,5839,6237
21041,Carroll County,,KY,976,12523,13499
21043,Carter County,,KY,1086,28214,29300
21045,Casey County,,KY,649,15333,15982
21047,Christian County,,KY,16151,70022,86173
21049,Clark County,,KY,2487,37079,39566
21051,Clay County,,KY,858,17813,18671
21053,Clinton County,,KY,447,9582,10029
21055,Crittenden County,,KY,502,9315,9817
21057,Cumberland County,,KY,387,6620,7007
21059,Daviess County,,KY,4443,105785,110228
21061,Edmonson County,,KY,660,12103,12763
21063,Elliott County,,KY,269,5986,6255
21065,Estill County,,KY,766,14676,15442
21067,Fayette County,,KY,22041,275127,297168
21069,Fleming County,,KY,719,15461,16180
21071,Floyd County,,KY,1616,37235,38851
21073,Franklin County,,KY,3324,55336,58660
21075,Fulton County,,KY,702,6707,7409
21077,Gallatin County,,KY,758,5926,6684
21079,Garrard County,,KY,1378,16375,17753
21081,Grant County,,KY,2721,26672,29393
21083,Graves County,,KY,1926,38953,40879
21085,Grayson County,,KY,1164,26754,27918
21087,Green County,,KY,601,11439,12040
21089,Greenup County,,KY,2259,39257,41516
21091,Hancock County,,KY,581,9652,10233
21093,Hardin County,,KY,11305,104051,115356
21095,Harlan County,,KY,1074,26876,27950
21097,Harrison County,,KY,1021,19941,20962
21099,Hart County,,KY,955,18387,19342
21101,Henderson County,,KY,2610,51052,53662
21103,Henry County,,KY,1293,16700,17993
21105,Hickman County,,KY,331,5091,5422
21107,Hopkins County,,KY,2483,50794,53277
21109,Jackson County,,KY,502,12683,13185
21111,Jefferson County,,KY,37592,790662,828254
21113,Jessamine County,,KY,4169,42962,47131
21115,Johnson County,,KY,1115,21603,22718
21117,Kenton County,,KY,15253,170548,185801
21119,Knott County,,KY,641,13889,14530
21121,Knox County,,KY,1592,28317,29909
21123,Larue County,,KY,1015,14635,15650
21125,Laurel County,,KY,2974,56763,59737
21127,Lawrence County,,KY,807,14618,15425
21129,Lee County,,KY,390,6078,6468
21131,Leslie County,,KY,403,10470,10873
21133,Letcher County,,KY,867,22783,23650
21135,Lewis County,,KY,627,13404,14031
21137,Lincoln County,,KY,1517,25485,27002
21139,Livingston County,,KY,782,10247,11029
21141,Logan County,,KY,1568,28406,29974
21143,Lyon County,,KY,575,7391,7966
21145,McCracken County,,KY,4471,71341,75812
21147,McCreary County,,KY,648,14063,14711
21149,McLean County,,KY,652,10789,11441
21151,Madison County,,KY,5098,74071,79169
21153,Magoffin County,,KY,416,11326,11742
21155,Marion County,,KY,783,19207,19990
21157,Marshall County,,KY,1929,33601,35530
21159,Martin County,,KY,553,9862,10415
21161,Mason County,,KY,1128,18199,19327
21163,Meade County,,KY,4072,29501,33573
21165,Menifee County,,KY,502,6035,6537
21167,Mercer County,,KY,1384,24152,25536
21169,Metcalfe County,,KY,630,10181,10811
21171,Monroe County,,KY,482,11735,12217
21173,Montgomery County,,KY,1630,25865,27495
21175,Morgan County,,KY,643,11902,12545
21177,Muhlenberg County,,KY,1331,33398,34729
21179,Nelson County,,KY,2368,47303,49671
21181,Nicholas County,,KY,498,7739,8237
21183,Ohio County,,KY,1285,24522,25807
21185,Oldham County,,KY,4476,56391,60867
21187,Owen County,,KY,842,10453,11295
21189,Owsley County,,KY,187,3820,4007
21191,Pendleton County,,KY,1089,15079,16168
21193,Perry County,,KY,1252,28612,29864
21195,Pike County,,KY,2477,58497,60974
21197,Powell County,,KY,896,13394,14290
21199,Pulaski County,,KY,2610,61004,63614
21201,Robertson County,,KY,141,1916,2057
21203,Rockcastle County,,KY,784,16311,17095
21205,Rowan County,,KY,1456,19538,20994
21207,Russell County,,KY,686,16931,17617
21209,Scott County,,KY,3062,41606,44668
21211,Shelby County,,KY,2738,39021,41759
21213,Simpson County,,KY,1193,18672,19865
21215,Spencer County,,KY,1211,15427,16638
21217,Taylor County,,KY,1267,24397,25664
21219,Todd County,,KY,857,12620,13477
21221,Trigg County,,KY,1054,14492,15546
21223,Trimble County,,KY,737,9346,10083
21225,Union County,,KY,930,16499,17429
21227,Warren County,,KY,6422,102545,108967
21229,Washington County,,KY,605,12317,12922
21231,Wayne County,,KY,843,19383,20226
21233,Webster County,,KY,1053,14918,15971
21235,Whitley County,,KY,1788,33344,35132
21237,Wolfe County,,KY,371,6667,7038
21239,Woodford County,,KY,1978,26677,28655
22001,Acadia Parish,,LA,3100,62099,65199
22003,Allen Parish,,LA,1444,22381,23825
22005,Ascension Parish,,LA,5391,95779,101170
22007,Assumption Parish,,LA,1306,24935,26241
22009,Avoyelles Parish,,LA,1681,41951,43632
22011,Beauregard Parish,,LA,2458,32476,34934
22013,Bienville Parish,,LA,1135,14882,16017
22015,Bossier Parish,,LA,12206,109322,121528
22017,Caddo Parish,,LA,16648,264026,280674
22019,Calcasieu Parish,,LA,9407,201339,210746
22021,Caldwell Parish,,LA,748,9872,10620
22023,Cameron Parish,,LA,716,10364,11080
22025,Catahoula Parish,,LA,639,9975,10614
22027,Claiborne Parish,,LA,917,15368,16285
22029,Concordia Parish,,LA,1211,19657,20868
22031,De Soto Parish,,LA,1784,28382,30166
22033,East Baton Rouge Parish,,LA,27055,422552,449607
22035,East Carroll Parish,,LA,478,7428,7906
22037,East Feliciana Parish,,LA,1522,20121,21643
22039,Evangeline Parish,,LA,1484,33295,34779
22041,Franklin Parish,,LA,1189,21206,22395
22043,Grant Parish,,LA,1306,18968,20274
22045,Iberia Parish,,LA,4004,80978,84982
22047,Iberville Parish,,LA,2024,32583,34607
22049,Jackson Parish,,LA,1034,15867,16901
22051,Jefferson Parish,,LA,34656,484590,519246
22053,Jefferson Davis Parish,,LA,1958,32993,34951
22055,Lafayette Parish,,LA,13958,210675,224633
22057,Lafourche Parish,,LA,4576,99164,103740
22059,La Salle Parish,,LA,791,13654,14445
22061,Lincoln Parish,,LA,3289,38327,41616
22063,Livingston Parish,,LA,6657,111490,118147
22065,Madison Parish,,LA,845,11944,12789
22067,Morehouse Parish,,LA,1941,31769,33710
22069,Natchitoches Parish,,LA,2435,37023,39458
22071,Orleans Parish,,LA,34426,435795,470221
22073,Ouachita Parish,,LA,9552,157385,166937
22075,Plaquemines Parish,,LA,3281,30326,33607
22077,Pointe Coupee Parish,,LA,1228,23740,24968
22079,Rapides Parish,,LA,6738,136788,143526
22081,Red River Parish,,LA,647,9276,9923
22083,Richland Parish,,LA,1402,20745,22147
22085,Sabine Parish,,LA,1115,23343,24458
22087,St. Bernard Parish,,LA,3920,71091,75011
22089,St. Charles Parish,,LA,3997,56255,60252
22091,St. Helena Parish,,LA,1057,13183,14240
22093,St. James Parish,,LA,1118,25113,26231
22095,St. John the Baptist Parish,,LA,3501,48943,52444
22097,St. Landry Parish,,LA,4036,86742,90778
22099,St. Martin Parish,,LA,3325,54183,57508
22101,St. Mary Parish,,LA,3551,60119,63670
22103,St. Tammany Parish,,LA,13609,224610,238219
22105,Tangipahoa Parish,,LA,5719,102288,108007
22107,Tensas Parish,,LA,392,5467,5859
22109,Terrebonne Parish,,LA,5333,119259,124592
22111,Union Parish,,LA,1410,23083,24493
22113,Vermilion Parish,,LA,2792,59258,62050
22115,Vernon Parish,,LA,12026,47695,59721
22117,Washington Parish,,LA,1881,42645,44526
22119,Webster Parish,,LA,2444,42341,44785
22121,West Baton Rouge Parish,,LA,2198,24195,26393
22123,West Carroll Parish,,LA,721,12133,12854
22125,West Feliciana Parish,,LA,629,10977,11606
22127,Winn Parish,,LA,778,14491,15269
23001,Androscoggin County,,ME,6866,116091,122957
23003,Aroostook County,,ME,2917,80853,83770
23005,Cumberland County,,ME,20638,315407,336045
23007,Franklin County,,ME,1972,31426,33398
23009,Hancock County,,ME,3164,59483,62647
23011,Kennebec County,,ME,6971,136641,143612
23013,Knox County,,ME,2412,45287,47699
23015,Lincoln County,,ME,2445,41103,43548
23017,Oxford County,,ME,3310,61536,64846
23019,Penobscot County,,ME,8530,162915,171445
23021,Piscataquis County,,ME,1188,18524,19712
23023,Sagadahoc County,,ME,4262,41117,45379
23025,Somerset County,,ME,3192,53421,56613
23027,Waldo County,,ME,2603,42028,44631
23029,Washington County,,ME,1753,35998,37751
23031,York County,,ME,13311,227542,240853
24001,Allegany County,,MD,3048,75444,78492
24003,Anne Arundel County,,MD,48919,586656,635575
24005,Baltimore County,,MD,64430,890577,955007
24009,Calvert County,,MD,6366,100785,107151
24011,Caroline County,,MD,2281,34134,36415
24013,Carroll County,,MD,10867,197340,208207
24015,Cecil County,,MD,6220,106280,112500
24017,Charles County,,MD,13340,157498,170838
24019,Dorchester County,,MD,1832,34723,36555
24021,Frederick County,,MD,19878,256608,276486
24023,Garrett County,,MD,1514,33401,34915
24025,Harford County,,MD,17283,281978,299261
24027,Howard County,,MD,30298,301176,331474
24029,Kent County,,MD,1220,21238,22458
24031,Montgomery County,,MD,84088,1047437,1131525
24033,Prince George's County,,MD,80563,925842,1006405
24035,Queen Anne's County,,MD,3811,49817,53628
24037,St. Mary's County,,MD,8353,109040,117393
24039,Somerset County,,MD,1538,21226,22764
24041,Talbot County,,MD,2656,40499,43155
24043,Washington County,,MD,8942,156692,165634
24045,Wicomico County,,MD,5980,96126,102106
24047,Worcester County,,MD,4781,57319,62100
24510,Baltimore city,,MD,48670,577649,626319
25001,Barnstable County,,MA,14693,266947,281640
25003,Berkshire County,,MA,5873,150411,156284
25005,Bristol County,,MA,28392,617686,646078
25007,Dukes County,,MA,1086,18794,19880
25009,Essex County,,MA,45785,825739,871524
25011,Franklin County,,MA,4852,81975,86827
25013,Hampden County,,MA,19431,512335,531766
25015,Hampshire County,,MA,12312,159965,172277
25017,Middlesex County,,MA,120739,1645180,1765919
25019,Nantucket County,,MA,1067,11317,12384
25021,Norfolk County,,MA,58376,739029,797405
25023,Plymouth County,,MA,30394,561372,591766
25025,Suffolk County,,MA,85483,654347,739830
25027,Worcester County,,MA,40094,895178,935272
26001,Alcona County,,MI,712,12438,13150
26003,Alger County,,MI,566,10039,10605
26005,Allegan County,,MI,8176,129860,138036
26007,Alpena County,,MI,1673,35613,37286
26009,Antrim County,,MI,1904,26961,28865
26011,Arenac County,,MI,1125,18898,20023
26013,Baraga County,,MI,429,8926,9355
26015,Barry County,,MI,3776,69633,73409
26017,Bay County,,MI,5094,132936,138030
26019,Benzie County,,MI,1443,20170,21613
26021,Berrien County,,MI,9247,177808,187055
26023,Branch County,,MI,3056,49731,52787
26025,Calhoun County,,MI,8196,154738,162934
26027,Cass County,,MI,3732,57172,60904
26029,Charlevoix County,,MI,1945,31182,33127
26031,Cheboygan County,,MI,1764,31079,32843
26033,Chippewa County,,MI,2020,38417,40437
26035,Clare County,,MI,2244,32335,34579
26037,Clinton County,,MI,5781,82679,88460
26039,Crawford County,,MI,901,14904,15805
26041,Delta County,,MI,1706,45247,46953
26043,Dickinson County,,MI,1506,32395,33901
26045,Eaton County,,MI,10192,125425,135617
26047,Emmet County,,MI,2350,37869,40219
26049,Genesee County,,MI,20733,502389,523122
26051,Gladwin County,,MI,1751,28926,30677
26053,Gogebic County,,MI,865,16959,17824
26055,Grand Traverse County,,MI,6124,97710,103834
26057,Gratiot County,,MI,2355,44377,46732
26059,Hillsdale County,,MI,3033,53207,56240
26061,Houghton County,,MI,2057,35531,37588
26063,Huron County,,MI,1735,43460,45195
26065,Ingham County,,MI,25319,285035,310354
26067,Ionia County,,MI,4149,68300,72449
26069,Iosco County,,MI,1794,29408,31202
26071,Iron County,,MI,624,13623,14247
26073,Isabella County,,MI,4714,58933,63647
26075,Jackson County,,MI,7643,177909,185552
26077,Kalamazoo County,,MI,16886,261483,278369
26079,Kalkaska County,,MI,1370,18592,19962
26081,Kent County,,MI,34352,679387,713739
26083,Keweenaw County,,MI,172,2239,2411
26085,Lake County,,MI,899,10648,11547
26087,Lapeer County,,MI,5919,107286,113205
26089,Leelanau County,,MI,1661,25491,27152
26091,Lenawee County,,MI,5468,116833,122301
26093,Livingston County,,MI,11681,208728,220409
26095,Luce County,,MI,393,6579,6972
26097,Mackinac County,,MI,947,13685,14632
26099,Macomb County,,MI,44390,999018,1043408
26101,Manistee County,,MI,1650,27905,29555
26103,Marquette County,,MI,3481,71078,74559
26105,Mason County,,MI,1796,33196,34992
26107,Mecosta County,,MI,3230,40178,43408
26109,Menominee County,,MI,1530,28183,29713
26111,Midland County,,MI,5742,99957,105699
26113,Missaukee County,,MI,1077,16175,17252
26115,Monroe County,,MI,8981,182081,191062
26117,Montcalm County,,MI,4473,69350,73823
26119,Montmorency County,,MI,710,11177,11887
26121,Muskegon County,,MI,7126,189882,197008
26123,Newaygo County,,MI,3486,54242,57728
26125,Oakland County,,MI,85374,1405914,1491288
26127,Oceana County,,MI,1944,29713,31657
26129,Ogemaw County,,MI,1463,23730,25193
26131,Ontonagon County,,MI,480,8107,8587
26133,Osceola County,,MI,1910,26045,27955
26135,Oscoda County,,MI,637,9484,10121
26137,Otsego County,,MI,1899,28447,30346
26139,Ottawa County,,MI,16792,290849,307641
26141,Presque Isle County,,MI,759,16537,17296
26143,Roscommon County,,MI,1820,27454,29274
26145,Saginaw County,,MI,10035,238403,248438
26147,St. Clair County,,MI,9347,199614,208961
26149,St. Joseph County,,MI,3597,71345,74942
26151,Sanilac County,,MI,2775,51943,54718
26153,Schoolcraft County,,MI,433,9447,9880
26155,Shiawassee County,,MI,4978,86238,91216
26157,Tuscola County,,MI,3445,69454,72899
26159,Van Buren County,,MI,5478,85104,90582
26161,Washtenaw County,,MI,29652,347085,376737
26163,Wayne County,,MI,95423,2063138,2158561
26165,Wexford County,,MI,2416,35946,38362
27001,Aitkin County,,MN,908,14677,15585
27003,Anoka County,,MN,26889,368821,395710
27005,Becker County,,MN,2096,36520,38616
27007,Beltrami County,,MN,2614,42063,44677
27009,Benton County,,MN,4431,40632,45063
27011,Big Stone County,,MN,312,6215,6527
27013,Blue Earth County,,MN,5263,60418,65681
27015,Brown County,,MN,1537,32270,33807
27017,Carlton County,,MN,1983,37212,39195
27019,Carver County,,MN,6858,94360,101218
27021,Cass County,,MN,2221,31881,34102
27023,Chippewa County,,MN,772,15222,15994
27025,Chisago County,,MN,4236,59893,64129
27027,Clay County,,MN,4008,55497,59505
27029,Clearwater County,,MN,593,9147,9740
27031,Cook County,,MN,425,5971,6396
27033,Cottonwood County,,MN,885,14665,15550
27035,Crow Wing County,,MN,3954,68043,71997
27037,Dakota County,,MN,35213,451173,486386
27039,Dodge County,,MN,1403,22458,23861
27041,Douglas County,,MN,2110,41496,43606
27043,Faribault County,,MN,1118,18695,19813
27045,Fillmore County,,MN,1370,25584,26954
27047,Freeborn County,,MN,1750,37695,39445
27049,Goodhue County,,MN,3230,54012,57242
27051,Grant County,,MN,482,7447,7929
27053,Hennepin County,,MN,96896,1253417,1350313
27055,Houston County,,MN,1086,24346,25432
27057,Hubbard County,,MN,1405,21617,23022
27059,Isanti County,,MN,3023,39878,42901
27061,Itasca County,,MN,2119,50385,52504
27063,Jackson County,,MN,672,12838,13510
27065,Kanabec County,,MN,1191,18056,19247
27067,Kandiyohi County,,MN,2620,48860,51480
27069,Kittson County,,MN,253,5826,6079
27071,Koochiching County,,MN,701,15412,16113
27073,Lac qui Parle County,,MN,476,9239,9715
27075,Lake County,,MN,631,12569,13200
27077,Lake of the Woods County,,MN,268,5105,5373
27079,Le Sueur County,,MN,2146,30015,32161
27081,Lincoln County,,MN,358,6851,7209
27083,Lyon County,,MN,1915,28984,30899
27085,McLeod County,,MN,2688,44111,46799
27087,Mahnomen County,,MN,343,4928,5271
27089,Marshall County,,MN,619,12097,12716
27091,Martin County,,MN,1291,26266,27557
27093,Meeker County,,MN,1695,27016,28711
27095,Mille Lacs County,,MN,1854,27996,29850
27097,Morrison County,,MN,2031,38857,40888
27099,Mower County,,MN,2592,44454,47046
27101,Murray County,,MN,493,10894,11387
27103,Nicollet County,,MN,3575,33987,37562
27105,Nobles County,,MN,1292,24633,25925
27107,Norman County,,MN,502,8425,8927
27109,Olmsted County,,MN,9418,163497,172915
27111,Otter Tail County,,MN,3419,65516,68935
27113,Pennington County,,MN,965,15571,16536
27115,Pine County,,MN,1883,28456,30339
27117,Pipestone County,,MN,726,11405,12131
27119,Polk County,,MN,2101,35125,37226
27121,Pope County,,MN,754,13328,14082
27123,Ramsey County,,MN,54433,532208,586641
27125,Red Lake County,,MN,365,4926,5291
27127,Redwood County,,MN,1098,19386,20484
27129,Renville County,,MN,1147,20473,21620
27131,Rice County,,MN,4338,64230,68568
27133,Rock County,,MN,567,11052,11619
27135,Roseau County,,MN,859,20117,20976
27137,St. Louis County,,MN,10144,216397,226541
27139,Scott County,,MN,10063,132412,142475
27141,Sherburne County,,MN,7784,88956,96740
27143,Sibley County,,MN,1133,18283,19416
27145,Stearns County,,MN,10396,156222,166618
27147,Steele County,,MN,2512,43330,45842
27149,Stevens County,,MN,712,10231,10943
27151,Swift County,,MN,773,12032,12805
27153,Todd County,,MN,1604,26342,27946
27155,Traverse County,,MN,258,4400,4658
27157,Wabasha County,,MN,1564,26487,28051
27159,Wadena County,,MN,1085,15799,16884
27161,Waseca County,,MN,1386,22690,24076
27163,Washington County,,MN,19813,257395,277208
27165,Watonwan County,,MN,811,12565,13376
27167,Wilkin County,,MN,593,8488,9081
27169,Winona County,,MN,2908,52014,54922
27171,Wright County,,MN,8576,126758,135334
27173,Yellow Medicine County,,MN,781,12556,13337
28001,Adams County,,MS,1941,31663,33604
28003,Alcorn County,,MS,1858,34760,36618
28005,Amite County,,MS,764,12684,13448
28007,Attala County,,MS,1002,18593,19595
28009,Benton County,,MS,616,7998,8614
28011,Bolivar County,,MS,2491,36276,38767
28013,Calhoun County,,MS,829,15831,16660
28015,Carroll County,,MS,882,9881,10763
28017,Chickasaw County,,MS,1249,19712,20961
28019,Choctaw County,,MS,574,7732,8306
28021,Claiborne County,,MS,622,9819,10441
28023,Clarke County,,MS,1083,18134,19217
28025,Clay County,,MS,1385,21707,23092
28027,Coahoma County,,MS,1696,29151,30847
28029,Copiah County,,MS,1697,30260,31957
28031,Covington County,,MS,1362,19582,20944
28033,DeSoto County,,MS,11044,144827,155871
28035,Forrest County,,MS,6855,66654,73509
28037,Franklin County,,MS,491,8255,8746
28039,George County,,MS,996,20660,21656
28041,Greene County,,MS,565,10974,11539
28043,Grenada County,,MS,1510,24375,25885
28045,Hancock County,,MS,3469,43593,47062
28047,Harrison County,,MS,19463,196874,216337
28049,Hinds County,,MS,18187,258342,276529
28051,Holmes County,,MS,1289,20735,22024
28053,Humphreys County,,MS,697,10287,10984
28055,Issaquena County,,MS,84,928,1012
28057,Itawamba County,,MS,1687,26069,27756
28059,Jackson County,,MS,11007,143697,154704
28061,Jasper County,,MS,1280,18960,20240
28063,Jefferson County,,MS,459,7997,8456
28065,Jefferson Davis County,,MS,817,12113,12930
28067,Jones County,,MS,3193,65609,68802
28069,Kemper County,,MS,588,8965,9553
28071,Lafayette County,,MS,3208,34906,38114
28073,Lamar County,,MS,4465,44694,49159
28075,Lauderdale County,,MS,5159,81224,86383
28077,Lawrence County,,MS,904,14651,15555
28079,Leake County,,MS,1306,21863,23169
28081,Lee County,,MS,5387,84218,89605
28083,Leflore County,,MS,2175,33521,35696
28085,Lincoln County,,MS,1737,35263,37000
28087,Lowndes County,,MS,5293,61487,66780
28089,Madison County,,MS,7992,85863,93855
28091,Marion County,,MS,1313,26897,28210
28093,Marshall County,,MS,2657,37132,39789
28095,Monroe County,,MS,2145,40153,42298
28097,Montgomery County,,MS,742,12079,12821
28099,Neshoba County,,MS,1536,30342,31878
28101,Newton County,,MS,1235,23353,24588
28103,Noxubee County,,MS,618,13065,13683
28105,Oktibbeha County,,MS,3690,36145,39835
28107,Panola County,,MS,2210,36623,38833
28109,Pearl River County,,MS,2715,48698,51413
28111,Perry County,,MS,865,12795,13660
28113,Pike County,,MS,2364,39790,42154
28115,Pontotoc County,,MS,1800,29564,31364
28117,Prentiss County,,MS,1405,25430,26835
28119,Quitman County,,MS,627,8547,9174
28121,Rankin County,,MS,10406,131498,141904
28123,Scott County,,MS,1694,29601,31295
28125,Sharkey County,,MS,417,6208,6625
28127,Simpson County,,MS,1522,26935,28457
28129,Smith County,,MS,818,14816,15634
28131,Stone County,,MS,950,14528,15478
28133,Sunflower County,,MS,1868,27414,29282
28135,Tallahatchie County,,MS,946,14716,15662
28137,Tate County,,MS,2163,27944,30107
28139,Tippah County,,MS,1037,23097,24134
28141,Tishomingo County,,MS,936,18973,19909
28143,Tunica County,,MS,1279,12041,13320
28145,Union County,,MS,1457,27780,29237
28147,Walthall County,,MS,877,14562,15439
28149,Warren County,,MS,3249,55950,59199
28151,Washington County,,MS,3676,59164,62840
28153,Wayne County,,MS,964,21287,22251
28155,Webster County,,MS,778,11923,12701
28157,Wilkinson County,,MS,484,9159,9643
28159,Winston County,,MS,1009,20664,21673
28161,Yalobusha County,,MS,871,13601,14472
28163,Yazoo County,,MS,1519,26204,27723
29001,Adair County,,MO,1917,21372,23289
29003,Andrew County,,MO,1770,19107,20877
29005,Atchison County,,MO,442,6788,7230
29007,Audrain County,,MO,1562,27201,28763
29009,Barry County,,MO,2781,35328,38109
29011,Barton County,,MO,968,14131,15099
29013,Bates County,,MO,1265,18353,19618
29015,Benton County,,MO,1240,17836,19076
29017,Bollinger County,,MO,765,12580,13345
29019,Boone County,,MO,11839,145255,157094
29021,Buchanan County,,MO,5579,90198,95777
29023,Butler County,,MO,2621,42149,44770
29025,Caldwell County,,MO,805,9895,10700
29027,Callaway County,,MO,3285,43812,47097
29029,Camden County,,MO,3481,39348,42829
29031,Cape Girardeau County,,MO,4870,77423,82293
29033,Carroll County,,MO,538,11079,11617
29035,Carter County,,MO,515,6383,6898
29037,Cass County,,MO,7753,100890,108643
29039,Cedar County,,MO,927,13324,14251
29041,Chariton County,,MO,504,9179,9683
29043,Christian County,,MO,6591,67687,74278
29045,Clark County,,MO,400,8179,8579
29047,Clay County,,MO,18600,227959,246559
29049,Clinton County,,MO,2052,22816,24868
29051,Cole County,,MO,5224,82135,87359
29053,Cooper County,,MO,1115,17772,18887
29055,Crawford County,,MO,1658,24323,25981
29057,Dade County,,MO,630,8381,9011
29059,Dallas County,,MO,1285,15972,17257
29061,Daviess County,,MO,722,9094,9816
29063,DeKalb County,,MO,858,10281,11139
29065,Dent County,,MO,952,14453,15405
29067,Douglas County,,MO,891,12510,13401
29069,Dunklin County,,MO,2009,31226,33235
29071,Franklin County,,MO,5750,115577,121327
29073,Gasconade County,,MO,1098,17662,18760
29075,Gentry County,,MO,458,7624,8082
29077,Greene County,,MO,19984,267569,287553
29079,Grundy County,,MO,650,10956,11606
29081,Harrison County,,MO,524,9327,9851
29083,Henry County,,MO,1775,24050,25825
29085,Hickory County,,MO,603,8702,9305
29087,Holt County,,MO,397,5910,6307
29089,Howard County,,MO,734,10674,11408
29091,Howell County,,MO,2216,39728,41944
29093,Iron County,,MO,854,10641,11495
29095,Jackson County,,MO,45935,710788,756723
29097,Jasper County,,MO,7659,112781,120440
29099,Jefferson County,,MO,14190,244815,259005
29101,Johnson County,,MO,6266,49927,56193
29103,Knox County,,MO,319,4772,5091
29105,Laclede County,,MO,2072,36701,38773
29107,Lafayette County,,MO,2623,36963,39586
29109,Lawrence County,,MO,2708,38588,41296
29111,Lewis County,,MO,645,10909,11554
29113,Lincoln County,,MO,3302,50985,54287
29115,Linn County,,MO,1012,15107,16119
29117,Livingston County,,MO,1004,15409,16413
29119,McDonald County,,MO,1867,19133,21000
29121,Macon County,,MO,1057,18235,19292
29123,Madison County,,MO,719,12340,13059
29125,Maries County,,MO,599,8849,9448
29127,Marion County,,MO,1885,31408,33293
29129,Mercer County,,MO,326,3958,4284
29131,Miller County,,MO,1967,24652,26619
29133,Mississippi County,,MO,750,13037,13787
29135,Moniteau County,,MO,996,16597,17593
29137,Monroe County,,MO,723,10300,11023
29139,Montgomery County,,MO,912,13804,14716
29141,Morgan County,,MO,1503,20156,21659
29143,New Madrid County,,MO,1479,19049,20528
29145,Newton County,,MO,4559,57777,62336
29147,Nodaway County,,MO,1470,21234,22704
29149,Oregon County,,MO,740,9503,10243
29151,Osage County,,MO,674,15244,15918
29153,Ozark County,,MO,662,9223,9885
29155,Pemiscot County,,MO,1258,18657,19915
29157,Perry County,,MO,961,21078,22039
29159,Pettis County,,MO,2908,43393,46301
29161,Phelps County,,MO,3695,42445,46140
29163,Pike County,,MO,995,18514,19509
29165,Platte County,,MO,11634,89794,101428
29167,Polk County,,MO,2073,29206,31279
29169,Pulaski County,,MO,7913,39390,47303
29171,Putnam County,,MO,309,5866,6175
29173,Ralls County,,MO,625,11448,12073
29175,Randolph County,,MO,1728,25349,27077
29177,Ray County,,MO,1930,27072,29002
29179,Reynolds County,,MO,449,6459,6908
29181,Ripley County,,MO,783,13378,14161
29183,St. Charles County,,MO,22693,383401,406094
29185,St. Clair County,,MO,635,8814,9449
29186,Ste. Genevieve County,,MO,1320,21359,22679
29187,St. Francois County,,MO,3253,60759,64012
29189,St. Louis County,,MO,79124,1180591,1259715
29195,Saline County,,MO,1463,24246,25709
29197,Schuyler County,,MO,297,4197,4494
29199,Scotland County,,MO,240,5446,5686
29201,Scott County,,MO,2793,43291,46084
29203,Shannon County,,MO,436,8107,8543
29205,Shelby County,,MO,410,7543,7953
29207,Stoddard County,,MO,1845,32285,34130
29209,Stone County,,MO,3199,29912,33111
29211,Sullivan County,,MO,665,7587,8252
29213,Taney County,,MO,4150,43421,47571
29215,Texas County,,MO,1736,23306,25042
29217,Vernon County,,MO,1360,21473,22833
29219,Warren County,,MO,2376,31252,33628
29221,Washington County,,MO,1505,21726,23231
29223,Wayne County,,MO,936,12046,12982
29225,Webster County,,MO,2673,35916,38589
29227,Worth County,,MO,162,2429,2591
29229,Wright County,,MO,1423,18305,19728
29510,St. Louis city,,MO,38617,309603,348220
30001,Beaverhead County,,MT,799,8859,9658
30003,Big Horn County,,MT,866,12232,13098
30005,Blaine County,,MT,477,6718,7195
30007,Broadwater County,,MT,452,4658,5110
30009,Carbon County,,MT,870,10081,10951
30011,Carter County,,MT,58,1479,1537
30013,Cascade County,,MT,7597,89450,97047
30015,Chouteau County,,MT,368,5182,5550
30017,Custer County,,MT,997,12635,13632
30019,Daniels County,,MT,118,2292,2410
30021,Dawson County,,MT,635,9885,10520
30023,Deer Lodge County,,MT,612,9621,10233
30025,Fallon County,,MT,283,3287,3570
30027,Fergus County,,MT,911,13061,13972
30029,Flathead County,,MT,5165,91963,97128
30031,Gallatin County,,MT,7202,80577,87779
30033,Garfield County,,MT,88,1386,1474
30035,Glacier County,,MT,820,13851,14671
30037,Golden Valley County,,MT,81,1060,1141
30039,Granite County,,MT,301,2800,3101
30041,Hill County,,MT,1238,18059,19297
30043,Jefferson County,,MT,1015,11294,12309
30045,Judith Basin County,,MT,133,2342,2475
30047,Lake County,,MT,1949,26446,28395
30049,Lewis and Clark County,,MT,4496,66165,70661
30051,Liberty County,,MT,143,2231,2374
30053,Lincoln County,,MT,1274,18789,20063
30055,McCone County,,MT,97,2022,2119
30057,Madison County,,MT,521,7113,7634
30059,Meagher County,,MT,159,2350,2509
30061,Mineral County,,MT,281,4058,4339
30063,Missoula County,,MT,8916,103705,112621
30065,Musselshell County,,MT,527,4354,4881
30067,Park County,,MT,1454,16686,18140
30069,Petroleum County,,MT,-2,-2,-4
30071,Phillips County,,MT,353,4716,5069
30073,Pondera County,,MT,474,7027,7501
30075,Powder River County,,MT,119,1617,1736
30077,Powell County,,MT,518,5761,6279
30079,Prairie County,,MT,131,1311,1442
30081,Ravalli County,,MT,3234,39893,43127
30083,Richland County,,MT,608,10817,11425
30085,Roosevelt County,,MT,601,11177,11778
30087,Rosebud County,,MT,855,10504,11359
30089,Sanders County,,MT,860,10600,11460
30091,Sheridan County,,MT,274,4393,4667
30093,Silver Bow County,,MT,2503,35150,37653
30095,Stillwater County,,MT,873,9542,10415
30097,Sweet Grass County,,MT,381,3845,4226
30099,Teton County,,MT,488,7391,7879
30101,Toole County,,MT,400,5487,5887
30103,Treasure County,,MT,-2,-2,-4
30105,Valley County,,MT,550,8376,8926
30107,Wheatland County,,MT,158,2168,2326
30109,Wibaux County,,MT,73,1094,1167
30111,Yellowstone County,,MT,8549,154204,162753
31001,Adams County,,NE,1886,33723,35609
31003,Antelope County,,NE,469,8257,8726
31005,Arthur County,,NE,-2,-2,-4
31007,Banner County,,NE,71,710,781
31009,Blaine County,,NE,-2,-2,-4
31011,Boone County,,NE,314,6737,7051
31013,Box Butte County,,NE,946,14132,15078
31015,Boyd County,,NE,110,2670,2780
31017,Brown County,,NE,350,3742,4092
31019,Buffalo County,,NE,3621,47540,51161
31021,Burt County,,NE,616,8533,9149
31023,Butler County,,NE,717,10356,11073
31025,Cass County,,NE,2566,29027,31593
31027,Cedar County,,NE,576,11372,11948
31029,Chase County,,NE,319,4664,4983
31031,Cherry County,,NE,454,6841,7295
31033,Cheyenne County,,NE,824,11720,12544
31035,Clay County,,NE,582,7519,8101
31037,Colfax County,,NE,852,11730,12582
31039,Cuming County,,NE,665,11529,12194
31041,Custer County,,NE,723,13334,14057
31043,Dakota County,,NE,2407,22996,25403
31045,Dawes County,,NE,849,8579,9428
31047,Dawson County,,NE,2068,28068,30136
31049,Deuel County,,NE,223,2233,2456
31051,Dixon County,,NE,405,7235,7640
31053,Dodge County,,NE,2529,41880,44409
31055,Douglas County,,NE,33753,543653,577406
31057,Dundy County,,NE,173,2377,2550
31059,Fillmore County,,NE,430,7692,8122
31061,Franklin County,,NE,201,4059,4260
31063,Frontier County,,NE,301,2978,3279
31065,Furnas County,,NE,424,6095,6519
31067,Gage County,,NE,1709,26459,28168
31069,Garden County,,NE,238,2360,2598
31071,Garfield County,,NE,123,2121,2244
31073,Gosper County,,NE,263,2571,2834
31075,Grant County,,NE,73,943,1016
31077,Greeley County,,NE,194,3056,3250
31079,Hall County,,NE,4156,62133,66289
31081,Hamilton County,,NE,819,11670,12489
31083,Harlan County,,NE,271,3913,4184
31085,Hayes County,,NE,91,1120,1211
31087,Hitchcock County,,NE,298,3450,3748
31089,Holt County,,NE,642,12250,12892
31091,Hooker County,,NE,76,1064,1140
31093,Howard County,,NE,595,7525,8120
31095,Jefferson County,,NE,505,9397,9902
31097,Johnson County,,NE,435,5230,5665
31099,Kearney County,,NE,654,7663,8317
31101,Keith County,,NE,705,9496,10201
31103,Keya Paha County,,NE,75,1076,1151
31105,Kimball County,,NE,337,4258,4595
31107,Knox County,,NE,501,10392,10893
31109,Lancaster County,,NE,17255,297856,315111
31111,Lincoln County,,NE,2307,41012,43319
31113,Logan County,,NE,81,1009,1090
31115,Loup County,,NE,43,780,823
31117,McPherson County,,NE,57,573,630
31119,Madison County,,NE,3190,41537,44727
31121,Merrick County,,NE,785,9035,9820
31123,Morrill County,,NE,493,5481,5974
31125,Nance County,,NE,235,4337,4572
31127,Nemaha County,,NE,572,7854,8426
31129,Nuckolls County,,NE,271,5846,6117
31131,Otoe County,,NE,1267,18159,19426
31133,Pawnee County,,NE,165,3153,3318
31135,Perkins County,,NE,269,3638,3907
31137,Phelps County,,NE,820,11240,12060
31139,Pierce County,,NE,532,8977,9509
31141,Platte County,,NE,2220,38201,40421
31143,Polk County,,NE,376,6601,6977
31145,Red Willow County,,NE,840,12834,13674
31147,Richardson County,,NE,535,10214,10749
31149,Rock County,,NE,133,1675,1808
31151,Saline County,,NE,1169,15884,17053
31153,Sarpy County,,NE,17981,159239,177220
31155,Saunders County,,NE,1483,23901,25384
31157,Scotts Bluff County,,NE,2492,39392,41884
31159,Seward County,,NE,1457,18284,19741
31161,Sheridan County,,NE,528,6440,6968
31163,Sherman County,,NE,241,3658,3899
31165,Sioux County,,NE,81,1306,1387
31167,Stanton County,,NE,452,7524,7976
31169,Thayer County,,NE,394,6593,6987
31171,Thomas County,,NE,102,912,1014
31173,Thurston County,,NE,397,7457,7854
31175,Valley County,,NE,293,5119,5412
31177,Washington County,,NE,1557,22790,24347
31179,Wayne County,,NE,776,9298,10074
31181,Webster County,,NE,265,4348,4613
31183,Wheeler County,,NE,69,964,1033
31185,York County,,NE,1043,16153,17196
32001,Churchill County,,NV,3029,25092,28121
32003,Clark County,,NV,100325,1721219,1821544
32005,Douglas County,,NV,5463,51508,56971
32007,Elko County,,NV,4067,47988,52055
32009,Esmeralda County,,NV,93,799,892
32011,Eureka County,,NV,192,1390,1582
32013,Humboldt County,,NV,1388,16697,18085
32015,Lander County,,NV,497,5618,6115
32017,Lincoln County,,NV,354,4007,4361
32019,Lyon County,,NV,4936,43800,48736
32021,Mineral County,,NV,522,4992,5514
32023,Nye County,,NV,3638,36086,39724
32027,Pershing County,,NV,496,5051,5547
32029,Storey County,,NV,490,3581,4071
32031,Washoe County,,NV,26029,416183,442212
32033,White Pine County,,NV,647,8409,9056
32510,Carson City,,NV,6510,58748,65258
33001,Belknap County,,NH,5226,71668,76894
33003,Carroll County,,NH,3603,54780,58383
33005,Cheshire County,,NH,5091,87164,92255
33007,Coos County,,NH,1956,39213,41169
33009,Grafton County,,NH,7601,93954,101555
33011,Hillsborough County,,NH,29514,468352,497866
33013,Merrimack County,,NH,11664,165341,177005
33015,Rockingham County,,NH,25532,351724,377256
33017,Strafford County,,NH,10149,130911,141060
33019,Sullivan County,,NH,2966,48184,51150
34001,Atlantic County,,NJ,14165,323902,338067
34003,Bergen County,,NJ,62688,1031411,1094099
34005,Burlington County,,NJ,33247,528525,561772
34007,Camden County,,NJ,32343,586149,618492
34009,Cape May County,,NJ,7687,113967,121654
34011,Cumberland County,,NJ,6271,160792,167063
34013,Essex County,,NJ,58670,818783,877453
34015,Gloucester County,,NJ,16282,322142,338424
34017,Hudson County,,NJ,62837,637390,700227
34019,Hunterdon County,,NJ,9544,149026,158570
34021,Mercer County,,NJ,24880,393857,418737
34023,Middlesex County,,NJ,67417,903347,970764
34025,Monmouth County,,NJ,38853,727461,766314
34027,Morris County,,NJ,37147,572527,609674
34029,Ocean County,,NJ,28745,634363,663108
34031,Passaic County,,NJ,36402,563884,600286
34033,Salem County,,NJ,3570,76486,80056
34035,Somerset County,,NJ,29838,362753,392591
34037,Sussex County,,NJ,10435,178220,188655
34039,Union County,,NJ,43923,599207,643130
34041,Warren County,,NJ,9148,127753,136901
35001,Bernalillo County,,NM,38717,633202,671919
35003,Catron County,,NM,275,2800,3075
35005,Chaves County,,NM,3903,59615,63518
35006,Cibola County,,NM,1902,23291,25193
35007,Colfax County,,NM,1199,14170,15369
35009,Curry County,,NM,6053,45721,51774
35011,De Baca County,,NM,156,2121,2277
35013,Dona Ana County,,NM,12118,185758,197876
35015,Eddy County,,NM,3496,52916,56412
35017,Grant County,,NM,1941,29436,31377
35019,Guadalupe County,,NM,315,4434,4749
35021,Harding County,,NM,74,720,794
35023,Hidalgo County,,NM,398,5020,5418
35025,Lea County,,NM,3188,58196,61384
35027,Lincoln County,,NM,1929,19378,21307
35028,Los Alamos County,,NM,2049,22936,24985
35029,Luna County,,NM,1714,25009,26723
35031,McKinley County,,NM,9075,84127,93202
35033,Mora County,,NM,380,4949,5329
35035,Otero County,,NM,6910,59479,66389
35037,Quay County,,NM,730,9023,9753
35039,Rio Arriba County,,NM,2448,41535,43983
35041,Roosevelt County,,NM,1872,17047,18919
35043,Sandoval County,,NM,9801,108831,118632
35045,San Juan County,,NM,11958,139207,151165
35047,San Miguel County,,NM,1757,26828,28585
35049,Santa Fe County,,NM,10595,137862,148457
35051,Sierra County,,NM,877,10370,11247
35053,Socorro County,,NM,1419,16363,17782
35055,Taos County,,NM,1987,31865,33852
35057,Torrance County,,NM,1506,13625,15131
35059,Union County,,NM,317,4208,4525
35061,Valencia County,,NM,4990,68582,73572
36001,Albany County,,NY,22750,333100,355850
36003,Allegany County,,NY,2791,49531,52322
36005,Bronx County,,NY,95357,1270570,1365927
36007,Broome County,,NY,10394,220848,231242
36009,Cattaraugus County,,NY,4753,89870,94623
36011,Cayuga County,,NY,3860,87441,91301
36013,Chautauqua County,,NY,5756,147460,153216
36015,Chemung County,,NY,4706,97841,102547
36017,Chenango County,,NY,3042,58892,61934
36019,Clinton County,,NY,3270,89829,93099
36021,Columbia County,,NY,3736,70481,74217
36023,Cortland County,,NY,3018,50662,53680
36025,Delaware County,,NY,2794,48320,51114
36027,Dutchess County,,NY,17721,323172,340893
36029,Erie County,,NY,33409,1059122,1092531
36031,Essex County,,NY,2454,41211,43665
36033,Franklin County,,NY,2075,50144,52219
36035,Fulton County,,NY,2839,62158,64997
36037,Genesee County,,NY,3477,70740,74217
36039,Greene County,,NY,2704,50525,53229
36041,Hamilton County,,NY,437,5839,6276
36043,Herkimer County,,NY,3365,71765,75130
36045,Jefferson County,,NY,13225,116302,129527
36047,Kings County,,NY,161137,2317952,2479089
36049,Lewis County,,NY,1475,27411,28886
36051,Livingston County,,NY,4199,69981,74180
36053,Madison County,,NY,4853,74188,79041
36055,Monroe County,,NY,33724,851881,885605
36057,Montgomery County,,NY,3374,57895,61269
36059,Nassau County,,NY,82682,1587406,1670088
36061,New York County,,NY,163144,1507101,1670245
36063,Niagara County,,NY,10476,252760,263236
36065,Oneida County,,NY,10451,259378,269829
36067,Onondaga County,,NY,23748,521789,545537
36069,Ontario County,,NY,6799,120878,127677
36071,Orange County,,NY,25274,400635,425909
36073,Orleans County,,NY,2749,47263,50012
36075,Oswego County,,NY,7280,136270,143550
36077,Otsego County,,NY,3708,66373,70081
36079,Putnam County,,NY,8043,113072,121115
36081,Queens County,,NY,160783,2247662,2408445
36083,Rensselaer County,,NY,11393,176515,187908
36085,Richmond County,,NY,27129,493629,520758
36087,Rockland County,,NY,18263,335432,353695
36089,St. Lawrence County,,NY,4453,113077,117530
36091,Saratoga County,,NY,16643,248715,265358
36093,Schenectady County,,NY,10286,172592,182878
36095,Schoharie County,,NY,1553,31480,33033
36097,Schuyler County,,NY,1263,21057,22320
36099,Seneca County,,NY,2327,37709,40036
36101,Steuben County,,NY,5536,109864,115400
36103,Suffolk County,,NY,74791,1769551,1844342
36105,Sullivan County,,NY,5009,79776,84785
36107,Tioga County,,NY,3594,60484,64078
36109,Tompkins County,,NY,8429,90088,98517
36111,Ulster County,,NY,10185,196644,206829
36113,Warren County,,NY,4859,75602,80461
36115,Washington County,,NY,4002,67343,71345
36117,Wayne County,,NY,5814,112338,118152
36119,Westchester County,,NY,60513,1026013,1086526
36121,Wyoming County,,NY,2523,46473,48996
36123,Yates County,,NY,1533,28175,29708
37001,Alamance County,,NC,7137,149550,156687
37003,Alexander County,,NC,2279,39121,41400
37005,Alleghany County,,NC,562,11238,11800
37007,Anson County,,NC,1375,25891,27266
37009,Ashe County,,NC,1114,26468,27582
37011,Avery County,,NC,1153,16507,17660
37013,Beaufort County,,NC,2492,49017,51509
37015,Bertie County,,NC,1164,21788,22952
37017,Bladen County,,NC,1676,31409,33085
37019,Brunswick County,,NC,5286,83900,89186
37021,Buncombe County,,NC,14202,231797,245999
37023,Burke County,,NC,4679,94777,99456
37025,Cabarrus County,,NC,11185,161072,172257
37027,Caldwell County,,NC,3886,89404,93290
37029,Camden County,,NC,825,9480,10305
37031,Carteret County,,NC,4836,66608,71444
37033,Caswell County,,NC,1494,24295,25789
37035,Catawba County,,NC,9751,168228,177979
37037,Chatham County,,NC,4545,58182,62727
37039,Cherokee County,,NC,1293,24627,25920
37041,Chowan County,,NC,918,15416,16334
37043,Clay County,,NC,590,9368,9958
37045,Cleveland County,,NC,5554,105139,110693
37047,Columbus County,,NC,2259,54280,56539
37049,Craven County,,NC,12231,103038,115269
37051,Cumberland County,,NC,48523,310016,358539
37053,Currituck County,,NC,1843,22083,23926
37055,Dare County,,NC,3354,35347,38701
37057,Davidson County,,NC,8567,174929,183496
37059,Davie County,,NC,2232,41928,44160
37061,Duplin County,,NC,2822,49376,52198
37063,Durham County,,NC,23618,239147,262765
37065,Edgecombe County,,NC,4682,58875,63557
37067,Forsyth County,,NC,20036,349290,369326
37069,Franklin County,,NC,3709,51743,55452
37071,Gaston County,,NC,10786,210501,221287
37073,Gates County,,NC,680,10888,11568
37075,Graham County,,NC,394,8431,8825
37077,Granville County,,NC,3165,52042,55207
37079,Greene County,,NC,1336,18060,19396
37081,Guilford County,,NC,29153,475657,504810
37083,Halifax County,,NC,2954,58245,61199
37085,Harnett County,,NC,9070,92307,101377
37087,Haywood County,,NC,2942,60302,63244
37089,Henderson County,,NC,6293,103603,109896
37091,Hertford County,,NC,1336,21843,23179
37093,Hoke County,,NC,4939,34718,39657
37095,Hyde County,,NC,307,5057,5364
37097,Iredell County,,NC,9040,153987,163027
37099,Jackson County,,NC,2481,29893,32374
37101,Johnston County,,NC,8959,143589,152548
37103,Jones County,,NC,813,9766,10579
37105,Lee County,,NC,3700,56034,59734
37107,Lenoir County,,NC,3219,63965,67184
37109,Lincoln County,,NC,4877,75667,80544
37111,McDowell County,,NC,1998,44479,46477
37113,Macon County,,NC,1821,33019,34840
37115,Madison County,,NC,1206,19666,20872
37117,Martin County,,NC,1408,26807,28215
37119,Mecklenburg County,,NC,61016,826515,887531
37121,Mitchell County,,NC,842,16633,17475
37123,Montgomery County,,NC,1528,26993,28521
37125,Moore County,,NC,5170,87686,92856
37127,Nash County,,NC,7593,99764,107357
37129,New Hanover County,,NC,14832,174713,189545
37131,Northampton County,,NC,1486,21787,23273
37133,Onslow County,,NC,34401,154298,188699
37135,Orange County,,NC,13230,114578,127808
37137,Pamlico County,,NC,864,13181,14045
37139,Pasquotank County,,NC,2843,37381,40224
37141,Pender County,,NC,3544,42321,45865
37143,Perquimans County,,NC,828,11880,12708
37145,Person County,,NC,1731,40804,42535
37147,Pitt County,,NC,9621,138922,148543
37149,Polk County,,NC,1262,20535,21797
37151,Randolph County,,NC,7438,148209,155647
37153,Richmond County,,NC,2251,47636,49887
37155,Robeson County,,NC,5023,121803,126826
37157,Rockingham County,,NC,4299,102237,106536
37159,Rowan County,,NC,7568,142544,150112
37161,Rutherford County,,NC,2860,66848,69708
37163,Sampson County,,NC,3231,61558,64789
37165,Scotland County,,NC,2335,37861,40196
37167,Stanly County,,NC,2811,64456,67267
37169,Stokes County,,NC,2945,50840,53785
37171,Surry County,,NC,3452,77007,80459
37173,Swain County,,NC,966,17635,18601
37175,Transylvania County,,NC,1763,31501,33264
37177,Tyrrell County,,NC,257,3781,4038
37179,Union County,,NC,9840,166751,176591
37181,Vance County,,NC,2810,47357,50167
37183,Wake County,,NC,50044,794741,844785
37185,Warren County,,NC,1307,17274,18581
37187,Washington County,,NC,816,14018,14834
37189,Watauga County,,NC,3503,36909,40412
37191,Wayne County,,NC,8652,119470,128122
37193,Wilkes County,,NC,2730,73451,76181
37195,Wilson County,,NC,4198,81935,86133
37197,Yadkin County,,NC,1981,41452,43433
37199,Yancey County,,NC,782,17980,18762
38001,Adams County,,ND,168,2893,3061
38003,Barnes County,,ND,707,12867,13574
38005,Benson County,,ND,458,7168,7626
38007,Billings County,,ND,84,956,1040
38009,Bottineau County,,ND,439,8064,8503
38011,Bowman County,,ND,229,3830,4059
38013,Burke County,,ND,173,2634,2807
38015,Burleigh County,,ND,5032,86298,91330
38017,Cass County,,ND,11167,150141,161308
38019,Cavalier County,,ND,243,5736,5979
38021,Dickey County,,ND,406,6121,6527
38023,Divide County,,ND,138,2621,2759
38025,Dunn County,,ND,209,3840,4049
38027,Eddy County,,ND,170,2925,3095
38029,Emmons County,,ND,261,4696,4957
38031,Foster County,,ND,223,4191,4414
38033,Golden Valley County,,ND,141,1955,2096
38035,Grand Forks County,,ND,7617,69474,77091
38037,Grant County,,ND,127,3110,3237
38039,Griggs County,,ND,184,3162,3346
38041,Hettinger County,,ND,157,3067,3224
38043,Kidder County,,ND,192,3117,3309
38045,LaMoure County,,ND,318,5303,5621
38047,Logan County,,ND,111,2369,2480
38049,McHenry County,,ND,420,6518,6938
38051,McIntosh County,,ND,171,3762,3933
38053,McKenzie County,,ND,361,5556,5917
38055,McLean County,,ND,766,10693,11459
38057,Mercer County,,ND,527,10612,11139
38059,Morton County,,ND,2266,29784,32050
38061,Mountrail County,,ND,599,8113,8712
38063,Nelson County,,ND,255,4087,4342
38065,Oliver County,,ND,178,2410,2588
38067,Pembina County,,ND,611,10004,10615
38069,Pierce County,,ND,317,5102,5419
38071,Ramsey County,,ND,910,13479,14389
38073,Ransom County,,ND,485,6679,7164
38075,Renville County,,ND,272,3012,3284
38077,Richland County,,ND,1474,19604,21078
38079,Rolette County,,ND,674,14033,14707
38081,Sargent County,,ND,336,5100,5436
38083,Sheridan County,,ND,84,1723,1807
38085,Sioux County,,ND,293,3677,3970
38087,Slope County,,ND,-2,-2,-4
38089,Stark County,,ND,1500,26371,27871
38091,Steele County,,ND,199,2522,2721
38093,Stutsman County,,ND,1366,24144,25510
38095,Towner County,,ND,188,3200,3388
38097,Traill County,,ND,575,9506,10081
38099,Walsh County,,ND,729,13902,14631
38101,Ward County,,ND,7072,67019,74091
38103,Wells County,,ND,288,5641,5929
38105,Williams County,,ND,1156,23068,24224
39001,Adams County,,OH,1473,30604,32077
39003,Allen County,,OH,5899,123185,129084
39005,Ashland County,,OH,3310,59321,62631
39007,Ashtabula County,,OH,5014,118325,123339
39009,Athens County,,OH,4294,52801,57095
39011,Auglaize County,,OH,2821,58102,60923
39013,Belmont County,,OH,3125,77048,80173
39015,Brown County,,OH,3272,49611,52883
39017,Butler County,,OH,24456,387049,411505
39019,Carroll County,,OH,2122,32938,35060
39021,Champaign County,,OH,2939,45978,48917
39023,Clark County,,OH,7507,162717,170224
39025,Clermont County,,OH,14363,219346,233709
39027,Clinton County,,OH,3378,47442,50820
39029,Columbiana County,,OH,5415,123251,128666
39031,Coshocton County,,OH,1848,42891,44739
39033,Crawford County,,OH,2878,55203,58081
39035,Cuyahoga County,,OH,67916,1503884,1571800
39037,Darke County,,OH,2873,65738,68611
39039,Defiance County,,OH,2643,48540,51183
39041,Delaware County,,OH,12581,167254,179835
39043,Erie County,,OH,5387,93991,99378
39045,Fairfield County,,OH,10342,155347,165689
39047,Fayette County,,OH,2022,32211,34233
39049,Franklin County,,OH,78471,1247042,1325513
39051,Fulton County,,OH,2976,54013,56989
39053,Gallia County,,OH,1556,32459,34015
39055,Geauga County,,OH,6059,110310,116369
39057,Greene County,,OH,16452,170371,186823
39059,Guernsey County,,OH,2183,47134,49317
39061,Hamilton County,,OH,53986,925442,979428
39063,Hancock County,,OH,5203,86847,92050
39065,Hardin County,,OH,2012,34438,36450
39067,Harrison County,,OH,1034,17533,18567
39069,Henry County,,OH,1957,36570,38527
39071,Highland County,,OH,3092,47283,50375
39073,Hocking County,,OH,1980,31544,33524
39075,Holmes County,,OH,1691,42017,43708
39077,Huron County,,OH,4121,74371,78492
39079,Jackson County,,OH,1780,35739,37519
39081,Jefferson County,,OH,3642,80783,84425
39083,Knox County,,OH,3244,64319,67563
39085,Lake County,,OH,12966,280313,293279
39087,Lawrence County,,OH,2814,66301,69115
39089,Licking County,,OH,10068,185431,195499
39091,Logan County,,OH,3099,56149,59248
39093,Lorain County,,OH,14996,343444,358440
39095,Lucas County,,OH,24387,499510,523897
39097,Madison County,,OH,3476,44091,47567
39099,Mahoning County,,OH,12172,279339,291511
39101,Marion County,,OH,3405,72796,76201
39103,Medina County,,OH,11932,199615,211547
39105,Meigs County,,OH,1136,23971,25107
39107,Mercer County,,OH,2094,52441,54535
39109,Miami County,,OH,6558,122621,129179
39111,Monroe County,,OH,788,17596,18384
39113,Montgomery County,,OH,34783,625858,660641
39115,Morgan County,,OH,1029,17405,18434
39117,Morrow County,,OH,2634,36713,39347
39119,Muskingum County,,OH,3972,100773,104745
39121,Noble County,,OH,647,13654,14301
39123,Ottawa County,,OH,2896,50849,53745
39125,Paulding County,,OH,1290,24035,25325
39127,Perry County,,OH,2359,38508,40867
39129,Pickaway County,,OH,3593,55812,59405
39131,Pike County,,OH,1793,29519,31312
39133,Portage County,,OH,11717,171426,183143
39135,Preble County,,OH,2856,50242,53098
39137,Putnam County,,OH,1653,44729,46382
39139,Richland County,,OH,6589,148202,154791
39141,Ross County,,OH,3817,82254,86071
39143,Sandusky County,,OH,3594,75710,79304
39145,Scioto County,,OH,3012,77899,80911
39147,Seneca County,,OH,3538,68762,72300
39149,Shelby County,,OH,3050,60440,63490
39151,Stark County,,OH,17112,448996,466108
39153,Summit County,,OH,30927,626836,657763
39155,Trumbull County,,OH,10533,260277,270810
39157,Tuscarawas County,,OH,4757,113681,118438
39159,Union County,,OH,3583,51621,55204
39161,Van Wert County,,OH,1595,36758,38353
39163,Vinton County,,OH,921,13651,14572
39165,Warren County,,OH,16169,216473,232642
39167,Washington County,,OH,3696,68490,72186
39169,Wayne County,,OH,6683,136196,142879
39171,Williams County,,OH,2405,47249,49654
39173,Wood County,,OH,10635,134901,145536
39175,Wyandot County,,OH,1677,27800,29477
40001,Adair County,,OK,1175,21423,22598
40003,Alfalfa County,,OK,463,5172,5635
40005,Atoka County,,OK,838,13492,14330
40007,Beaver County,,OK,522,5643,6165
40009,Beckham County,,OK,1384,18899,20283
40011,Blaine County,,OK,801,10524,11325
40013,Bryan County,,OK,2572,32683,35255
40015,Caddo County,,OK,2016,28442,30458
40017,Canadian County,,OK,8329,102503,110832
40019,Carter County,,OK,2947,47720,50667
40021,Cherokee County,,OK,3047,38604,41651
40023,Choctaw County,,OK,937,14157,15094
40025,Cimarron County,,OK,273,2955,3228
40027,Cleveland County,,OK,21439,223934,245373
40029,Coal County,,OK,412,5100,5512
40031,Comanche County,,OK,15584,109921,125505
40033,Cotton County,,OK,480,6183,6663
40035,Craig County,,OK,1035,13842,14877
40037,Creek County,,OK,6284,69225,75509
40039,Custer County,,OK,2140,24285,26425
40041,Delaware County,,OK,2873,33061,35934
40043,Dewey County,,OK,405,5066,5471
40045,Ellis County,,OK,302,4030,4332
40047,Garfield County,,OK,5297,61162,66459
40049,Garvin County,,OK,1928,27103,29031
40051,Grady County,,OK,3315,46752,50067
40053,Grant County,,OK,437,4907,5344
40055,Greer County,,OK,396,4814,5210
40057,Harmon County,,OK,177,2951,3128
40059,Harper County,,OK,270,3648,3918
40061,Haskell County,,OK,734,11920,12654
40063,Hughes County,,OK,954,11880,12834
40065,Jackson County,,OK,4097,28083,32180
40067,Jefferson County,,OK,477,5782,6259
40069,Johnston County,,OK,930,9474,10404
40071,Kay County,,OK,3550,49288,52838
40073,Kingfisher County,,OK,928,15852,16780
40075,Kiowa County,,OK,791,9635,10426
40077,Latimer County,,OK,892,11338,12230
40079,Le Flore County,,OK,2865,43969,46834
40081,Lincoln County,,OK,2672,32126,34798
40083,Logan County,,OK,3005,34741,37746
40085,Love County,,OK,696,8984,9680
40087,McClain County,,OK,2907,31083,33990
40089,McCurtain County,,OK,1667,31214,32881
40091,McIntosh County,,OK,1360,17257,18617
40093,Major County,,OK,583,8223,8806
40095,Marshall County,,OK,967,12919,13886
40097,Mayes County,,OK,2731,39483,42214
40099,Murray County,,OK,962,11919,12881
40101,Muskogee County,,OK,4523,69453,73976
40103,Noble County,,OK,1004,11966,12970
40105,Nowata County,,OK,696,10743,11439
40107,Okfuskee County,,OK,856,10499,11355
40109,Oklahoma County,,OK,49641,686733,736374
40111,Okmulgee County,,OK,3101,37849,40950
40113,Osage County,,OK,3521,40769,44290
40115,Ottawa County,,OK,2446,33160,35606
40117,Pawnee County,,OK,1524,16265,17789
40119,Payne County,,OK,6819,60016,66835
40121,Pittsburg County,,OK,2532,42585,45117
40123,Pontotoc County,,OK,2394,34325,36719
40125,Pottawatomie County,,OK,5139,66040,71179
40127,Pushmataha County,,OK,726,10122,10848
40129,Roger Mills County,,OK,244,3765,4009
40131,Rogers County,,OK,6163,82950,89113
40133,Seminole County,,OK,1932,22630,24562
40135,Sequoyah County,,OK,2419,38790,41209
40137,Stephens County,,OK,2784,43803,46587
40139,Texas County,,OK,2045,19927,21972
40141,Tillman County,,OK,719,7955,8674
40143,Tulsa County,,OK,42050,593669,635719
40145,Wagoner County,,OK,6365,62130,68495
40147,Washington County,,OK,3521,53493,57014
40149,Washita County,,OK,970,11214,12184
40151,Woods County,,OK,621,8364,8985
40153,Woodward County,,OK,1326,19749,21075
41001,Baker County,,OR,1257,15930,17187
41003,Benton County,,OR,8164,77144,85308
41005,Clackamas County,,OR,31792,377501,409293
41007,Clatsop County,,OR,2820,34473,37293
41009,Columbia County,,OR,3391,49498,52889
41011,Coos County,,OR,4033,61153,65186
41013,Crook County,,OR,1656,19747,21403
41015,Curry County,,OR,1957,22865,24822
41017,Deschutes County,,OR,10280,140192,150472
41019,Douglas County,,OR,6264,106514,112778
41021,Gilliam County,,OR,190,1958,2148
41023,Grant County,,OR,645,7332,7977
41025,Harney County,,OR,687,7239,7926
41027,Hood River County,,OR,1574,22990,24564
41029,Jackson County,,OR,10972,201551,212523
41031,Jefferson County,,OR,1760,19725,21485
41033,Josephine County,,OR,4820,78726,83546
41035,Klamath County,,OR,4347,64108,68455
41037,Lake County,,OR,670,7258,7928
41039,Lane County,,OR,19221,338034,357255
41041,Lincoln County,,OR,3806,42750,46556
41043,Linn County,,OR,7769,110109,117878
41045,Malheur County,,OR,2194,27555,29749
41047,Marion County,,OR,19909,300673,320582
41049,Morrow County,,OR,1098,11248,12346
41051,Multnomah County,,OR,60921,682818,743739
41053,Polk County,,OR,6117,65503,71620
41055,Sherman County,,OR,148,1760,1908
41057,Tillamook County,,OR,1818,25162,26980
41059,Umatilla County,,OR,5267,73353,78620
41061,Union County,,OR,1984,26129,28113
41063,Wallowa County,,OR,535,7482,8017
41065,Wasco County,,OR,1780,23651,25431
41067,Washington County,,OR,40971,514959,555930
41069,Wheeler County,,OR,102,1288,1390
41071,Yamhill County,,OR,6486,89474,95960
42001,Adams County,,PA,5593,115684,121277
42003,Allegheny County,,PA,57175,1436980,1494155
42005,Armstrong County,,PA,3658,80899,84557
42007,Beaver County,,PA,8088,208825,216913
42009,Bedford County,,PA,2044,59339,61383
42011,Berks County,,PA,17030,468173,485203
42013,Blair County,,PA,4737,147813,152550
42015,Bradford County,,PA,2931,72472,75403
42017,Bucks County,,PA,38052,757444,795496
42019,Butler County,,PA,9997,216148,226145
42021,Cambria County,,PA,5590,168517,174107
42023,Cameron County,,PA,308,6590,6898
42025,Carbon County,,PA,3420,71451,74871
42027,Centre County,,PA,9025,132817,141842
42029,Chester County,,PA,29875,550463,580338
42031,Clarion County,,PA,1889,44478,46367
42033,Clearfield County,,PA,3494,92540,96034
42035,Clinton County,,PA,1916,41210,43126
42037,Columbia County,,PA,3108,70645,73753
42039,Crawford County,,PA,4291,99819,104110
42041,Cumberland County,,PA,15474,265195,280669
42043,Dauphin County,,PA,17006,310422,327428
42045,Delaware County,,PA,33598,634667,668265
42047,Elk County,,PA,1385,42448,43833
42049,Erie County,,PA,10751,316215,326966
42051,Fayette County,,PA,4867,154842,159709
42053,Forest County,,PA,363,5560,5923
42055,Franklin County,,PA,5830,172019,177849
42057,Fulton County,,PA,693,17578,18271
42059,Greene County,,PA,1665,40073,41738
42061,Huntingdon County,,PA,1947,48889,50836
42063,Indiana County,,PA,4200,93989,98189
42065,Jefferson County,,PA,2481,53938,56419
42067,Juniata County,,PA,1042,28865,29907
42069,Lackawanna County,,PA,8098,236130,244228
42071,Lancaster County,,PA,19670,611760,631430
42073,Lawrence County,,PA,3682,105802,109484
42075,Lebanon County,,PA,5993,155117,161110
42077,Lehigh County,,PA,21721,385572,407293
42079,Luzerne County,,PA,11040,360390,371430
42081,Lycoming County,,PA,4831,134991,139822
42083,McKean County,,PA,2023,49647,51670
42085,Mercer County,,PA,5127,136280,141407
42087,Mifflin County,,PA,1596,54317,55913
42089,Monroe County,,PA,11713,170172,181885
42091,Montgomery County,,PA,54534,926642,981176
42093,Montour County,,PA,1486,20714,22200
42095,Northampton County,,PA,18174,332025,350199
42097,Northumberland County,,PA,4716,106830,111546
42099,Perry County,,PA,2720,55654,58374
42101,Philadelphia County,,PA,80866,1427139,1508005
42103,Pike County,,PA,4287,56004,60291
42105,Potter County,,PA,1191,20701,21892
42107,Schuylkill County,,PA,5070,169311,174381
42109,Snyder County,,PA,2012,42540,44552
42111,Somerset County,,PA,3034,89923,92957
42113,Sullivan County,,PA,480,7068,7548
42115,Susquehanna County,,PA,2320,49663,51983
42117,Tioga County,,PA,2149,46512,48661
42119,Union County,,PA,2462,41225,43687
42121,Venango County,,PA,2375,64533,66908
42123,Warren County,,PA,2168,48603,50771
42125,Washington County,,PA,9121,244082,253203
42127,Wayne County,,PA,3543,56476,60019
42129,Westmoreland County,,PA,15498,446456,461954
42131,Wyoming County,,PA,1882,33165,35047
42133,York County,,PA,18757,496672,515429
44001,Bristol County,,RI,3605,55925,59530
44003,Kent County,,RI,13426,200053,213479
44005,Newport County,,RI,9410,94070,103480
44007,Providence County,,RI,36456,673704,710160
44009,Washington County,,RI,8989,144498,153487
45001,Abbeville County,,SC,1623,26816,28439
45003,Aiken County,,SC,8760,160538,169298
45005,Allendale County,,SC,606,10026,10632
45007,Anderson County,,SC,8836,188758,197594
45009,Bamberg County,,SC,914,15604,16518
45011,Barnwell County,,SC,1249,24038,25287
45013,Beaufort County,,SC,14394,140545,154939
45015,Berkeley County,,SC,18075,154154,172229
45017,Calhoun County,,SC,1044,15377,16421
45019,Charleston County,,SC,30869,325185,356054
45021,Cherokee County,,SC,2464,56557,59021
45023,Chester County,,SC,2234,37157,39391
45025,Chesterfield County,,SC,2146,46218,48364
45027,Clarendon County,,SC,1812,33118,34930
45029,Colleton County,,SC,2265,40709,42974
45031,Darlington County,,SC,3900,73587,77487
45033,Dillon County,,SC,1545,33456,35001
45035,Dorchester County,,SC,11245,115748,126993
45037,Edgefield County,,SC,1615,24825,26440
45039,Fairfield County,,SC,1431,24995,26426
45041,Florence County,,SC,7552,139791,147343
45043,Georgetown County,,SC,3749,63527,67276
45045,Greenville County,,SC,25324,430711,456035
45047,Greenwood County,,SC,3546,71269,74815
45049,Hampton County,,SC,1151,21102,22253
45051,Horry County,,SC,13807,231975,245782
45053,Jasper County,,SC,1417,15373,16790
45055,Kershaw County,,SC,3588,61587,65175
45057,Lancaster County,,SC,3139,67526,70665
45059,Laurens County,,SC,3758,67967,71725
45061,Lee County,,SC,1087,19308,20395
45063,Lexington County,,SC,16988,254451,271439
45065,McCormick County,,SC,583,9646,10229
45067,Marion County,,SC,1884,36287,38171
45069,Marlboro County,,SC,1569,30552,32121
45071,Newberry County,,SC,1802,38239,40041
45073,Oconee County,,SC,3625,76150,79775
45075,Orangeburg County,,SC,4858,94791,99649
45077,Pickens County,,SC,7676,113117,120793
45079,Richland County,,SC,29501,341450,370951
45081,Saluda County,,SC,1053,18920,19973
45083,Spartanburg County,,SC,12661,285566,298227
45085,Sumter County,,SC,9268,114110,123378
45087,Union County,,SC,1121,31932,33053
45089,Williamsburg County,,SC,2036,36089,38125
45091,York County,,SC,10792,203957,214749
46003,Aurora County,,SD,210,3400,3610
46005,Beadle County,,SD,1234,18166,19400
46007,Bennett County,,SD,233,3236,3469
46009,Bon Homme County,,SD,398,7213,7611
46011,Brookings County,,SD,2352,28142,30494
46013,Brown County,,SD,2350,41050,43400
46015,Brule County,,SD,348,5209,5557
46017,Buffalo County,,SD,154,1885,2039
46019,Butte County,,SD,927,9698,10625
46021,Campbell County,,SD,93,1915,2008
46023,Charles Mix County,,SD,485,9824,10309
46025,Clark County,,SD,287,4199,4486
46027,Clay County,,SD,1610,11669,13279
46029,Codington County,,SD,2010,30914,32924
46031,Corson County,,SD,308,3638,3946
46033,Custer County,,SD,914,8033,8947
46035,Davison County,,SD,1740,21572,23312
46037,Day County,,SD,394,6856,7250
46039,Deuel County,,SD,280,5494,5774
46041,Dewey County,,SD,437,6634,7071
46043,Douglas County,,SD,185,3835,4020
46045,Edmunds County,,SD,279,4517,4796
46047,Fall River County,,SD,628,7492,8120
46049,Faulk County,,SD,172,2593,2765
46051,Grant County,,SD,533,9383,9916
46053,Gregory County,,SD,287,5301,5588
46055,Haakon County,,SD,181,2504,2685
46057,Hamlin County,,SD,439,6067,6506
46059,Hand County,,SD,194,4141,4335
46061,Hanson County,,SD,129,3355,3484
46063,Harding County,,SD,140,1522,1662
46065,Hughes County,,SD,1478,19538,21016
46067,Hutchinson County,,SD,438,8901,9339
46069,Hyde County,,SD,137,1798,1935
46071,Jackson County,,SD,201,2802,3003
46073,Jerauld County,,SD,154,2647,2801
46075,Jones County,,SD,97,1283,1380
46077,Kingsbury County,,SD,278,6471,6749
46079,Lake County,,SD,815,11903,12718
46081,Lawrence County,,SD,2339,23877,26216
46083,Lincoln County,,SD,3516,35278,38794
46085,Lyman County,,SD,289,4130,4419
46087,McCook County,,SD,477,6665,7142
46089,McPherson County,,SD,149,2850,2999
46091,Marshall County,,SD,235,4986,5221
46093,Meade County,,SD,4525,28771,33296
46095,Mellette County,,SD,127,1824,1951
46097,Miner County,,SD,187,2927,3114
46099,Minnehaha County,,SD,13327,192606,205933
46101,Moody County,,SD,520,7663,8183
46103,Pennington County,,SD,9058,104134,113192
46105,Perkins County,,SD,264,3526,3790
46107,Potter County,,SD,242,3116,3358
46109,Roberts County,,SD,712,11387,12099
46111,Sanborn County,,SD,229,3011,3240
46113,Shannon County,,SD,551,11161,11712
46115,Spink County,,SD,428,7529,7957
46117,Stanley County,,SD,426,3490,3916
46119,Sully County,,SD,118,1857,1975
46121,Todd County,,SD,510,8134,8644
46123,Tripp County,,SD,368,7067,7435
46125,Turner County,,SD,726,9877,10603
46127,Union County,,SD,1534,15841,17375
46129,Walworth County,,SD,469,6505,6974
46135,Yankton County,,SD,1416,24132,25548
46137,Ziebach County,,SD,107,1176,1283
47001,Anderson County,,TN,5069,78243,83312
47003,Bedford County,,TN,2535,43850,46385
47005,Benton County,,TN,1001,17074,18075
47007,Bledsoe County,,TN,666,11105,11771
47009,Blount County,,TN,6806,125892,132698
47011,Bradley County,,TN,6050,97592,103642
47013,Campbell County,,TN,1724,37733,39457
47015,Cannon County,,TN,1088,13882,14970
47017,Carroll County,,TN,2065,31167,33232
47019,Carter County,,TN,3297,56622,59919
47021,Cheatham County,,TN,3181,41461,44642
47023,Chester County,,TN,1208,15674,16882
47025,Claiborne County,,TN,1626,32460,34086
47027,Clay County,,TN,484,8177,8661
47029,Cocke County,,TN,1606,36159,37765
47031,Coffee County,,TN,3645,54400,58045
47033,Crockett County,,TN,1065,15468,16533
47035,Cumberland County,,TN,2592,54734,57326
47037,Davidson County,,TN,53411,606811,660222
47039,Decatur County,,TN,690,11562,12252
47041,DeKalb County,,TN,1249,18185,19434
47043,Dickson County,,TN,3031,49852,52883
47045,Dyer County,,TN,2271,41750,44021
47047,Fayette County,,TN,2724,36285,39009
47049,Fentress County,,TN,590,16894,17484
47051,Franklin County,,TN,2478,43084,45562
47053,Gibson County,,TN,2869,52731,55600
47055,Giles County,,TN,1789,32162,33951
47057,Grainger County,,TN,1337,21397,22734
47059,Greene County,,TN,2667,71771,74438
47061,Grundy County,,TN,625,14857,15482
47063,Hamblen County,,TN,3900,62073,65973
47065,Hamilton County,,TN,18537,349232,367769
47067,Hancock County,,TN,273,4662,4935
47069,Hardeman County,,TN,1479,27268,28747
47071,Hardin County,,TN,1342,26298,27640
47073,Hawkins County,,TN,3377,59579,62956
47075,Haywood County,,TN,1253,22025,23278
47077,Henderson County,,TN,1540,29193,30733
47079,Henry County,,TN,1844,33826,35670
47081,Hickman County,,TN,1731,23210,24941
47083,Houston County,,TN,459,8080,8539
47085,Humphreys County,,TN,1038,19823,20861
47087,Jackson County,,TN,884,11512,12396
47089,Jefferson County,,TN,3779,48373,52152
47091,Johnson County,,TN,605,16071,16676
47093,Knox County,,TN,25729,421848,447577
47095,Lake County,,TN,391,5318,5709
47097,Lauderdale County,,TN,1448,25870,27318
47099,Lawrence County,,TN,1613,43091,44704
47101,Lewis County,,TN,765,11729,12494
47103,Lincoln County,,TN,1621,34994,36615
47105,Loudon County,,TN,3201,48419,51620
47107,McMinn County,,TN,2975,52626,55601
47109,McNairy County,,TN,1441,26467,27908
47111,Macon County,,TN,1130,21913,23043
47113,Madison County,,TN,6725,101824,108549
47115,Marion County,,TN,1541,30027,31568
47117,Marshall County,,TN,1817,31720,33537
47119,Maury County,,TN,4821,81646,86467
47121,Meigs County,,TN,927,11083,12010
47123,Monroe County,,TN,2251,42792,45043
47125,Montgomery County,,TN,20682,149570,170252
47127,Moore County,,TN,480,6493,6973
47129,Morgan County,,TN,1198,20067,21265
47131,Obion County,,TN,2149,35989,38138
47133,Overton County,,TN,1123,21643,22766
47135,Perry County,,TN,487,7562,8049
47137,Pickett County,,TN,275,4980,5255
47139,Polk County,,TN,1167,16514,17681
47141,Putnam County,,TN,4571,66999,71570
47143,Rhea County,,TN,1687,30583,32270
47145,Roane County,,TN,3429,57130,60559
47147,Robertson County,,TN,4704,67782,72486
47149,Rutherford County,,TN,16820,230511,247331
47151,Scott County,,TN,727,21704,22431
47153,Sequatchie County,,TN,739,12508,13247
47155,Sevier County,,TN,5744,84870,90614
47157,Shelby County,,TN,50400,1022223,1072623
47159,Smith County,,TN,1132,19738,20870
47161,Stewart County,,TN,1045,13355,14400
47163,Sullivan County,,TN,8647,168678,177325
47165,Sumner County,,TN,11227,156847,168074
47167,Tipton County,,TN,3770,62297,66067
47169,Trousdale County,,TN,543,7867,8410
47171,Unicoi County,,TN,1223,18254,19477
47173,Union County,,TN,1446,18550,19996
47175,Van Buren County,,TN,355,5206,5561
47177,Warren County,,TN,1885,41761,43646
47179,Washington County,,TN,8142,116706,124848
47181,Wayne County,,TN,692,15712,16404
47183,Weakley County,,TN,2044,33161,35205
47185,White County,,TN,1381,25600,26981
47187,Williamson County,,TN,13094,166461,179555
47189,Wilson County,,TN,7680,110633,118313
48001,Anderson County,,TX,3081,43642,46723
48003,Andrews County,,TX,1176,14201,15377
48005,Angelina County,,TX,5020,84604,89624
48007,Aransas County,,TX,2112,21285,23397
48009,Archer County,,TX,946,8925,9871
48011,Armstrong County,,TX,192,2054,2246
48013,Atascosa County,,TX,3372,43018,46390
48015,Austin County,,TX,1971,28201,30172
48017,Bailey County,,TX,601,7054,7655
48019,Bandera County,,TX,1790,18007,19797
48021,Bastrop County,,TX,5826,63691,69517
48023,Baylor County,,TX,337,3746,4083
48025,Bee County,,TX,2047,24299,26346
48027,Bell County,,TX,37845,269149,306994
48029,Bexar County,,TX,83404,1608162,1691566
48031,Blanco County,,TX,817,9149,9966
48033,Borden County,,TX,77,616,693
48035,Bosque County,,TX,1565,17446,19011
48037,Bowie County,,TX,6445,91491,97936
48039,Brazoria County,,TX,19094,281179,300273
48041,Brazos County,,TX,14943,132726,147669
48043,Brewster County,,TX,1111,8659,9770
48045,Briscoe County,,TX,172,1819,1991
48047,Brooks County,,TX,515,8031,8546
48049,Brown County,,TX,2516,36328,38844
48051,Burleson County,,TX,1373,17525,18898
48053,Burnet County,,TX,3309,38891,42200
48055,Caldwell County,,TX,3246,34157,37403
48057,Calhoun County,,TX,1593,21396,22989
48059,Callahan County,,TX,1358,12944,14302
48061,Cameron County,,TX,15566,375477,391043
48063,Camp County,,TX,974,11959,12933
48065,Carson County,,TX,614,6241,6855
48067,Cass County,,TX,2084,31697,33781
48069,Castro County,,TX,666,8020,8686
48071,Chambers County,,TX,2506,31724,34230
48073,Cherokee County,,TX,2872,46760,49632
48075,Childress County,,TX,533,5924,6457
48077,Clay County,,TX,1079,11664,12743
48079,Cochran County,,TX,295,3504,3799
48081,Coke County,,TX,387,3376,3763
48083,Coleman County,,TX,716,8350,9066
48085,Collin County,,TX,60886,648337,709223
48087,Collingsworth County,,TX,280,2996,3276
48089,Colorado County,,TX,1403,21347,22750
48091,Comal County,,TX,7795,96119,103914
48093,Comanche County,,TX,1053,13467,14520
48095,Concho County,,TX,273,2664,2937
48097,Cooke County,,TX,2875,39108,41983
48099,Coryell County,,TX,11803,55672,67475
48101,Cottle County,,TX,137,1733,1870
48103,Crane County,,TX,425,4291,4716
48105,Crockett County,,TX,348,3974,4322
48107,Crosby County,,TX,638,6546,7184
48109,Culberson County,,TX,298,2765,3063
48111,Dallam County,,TX,688,6837,7525
48113,Dallas County,,TX,175031,2265996,2441027
48115,Dawson County,,TX,987,12958,13945
48117,Deaf Smith County,,TX,1449,19634,21083
48119,Delta County,,TX,582,5060,5642
48121,Denton County,,TX,55568,542817,598385
48123,DeWitt County,,TX,1017,19457,20474
48125,Dickens County,,TX,237,2097,2334
48127,Dimmit County,,TX,736,9950,10686
48129,Donley County,,TX,371,3534,3905
48131,Duval County,,TX,855,12223,13078
48133,Eastland County,,TX,1444,17472,18916
48135,Ector County,,TX,7861,133493,141354
48137,Edwards County,,TX,176,2010,2186
48139,Ellis County,,TX,9886,134730,144616
48141,El Paso County,,TX,39142,799358,838500
48143,Erath County,,TX,2904,30285,33189
48145,Falls County,,TX,1277,15125,16402
48147,Fannin County,,TX,2209,30035,32244
48149,Fayette County,,TX,1430,24765,26195
48151,Fisher County,,TX,269,3916,4185
48153,Floyd County,,TX,589,7659,8248
48155,Foard County,,TX,133,1488,1621
48157,Fort Bend County,,TX,35441,463771,499212
48159,Franklin County,,TX,999,9861,10860
48161,Freestone County,,TX,1369,17882,19251
48163,Frio County,,TX,919,14196,15115
48165,Gaines County,,TX,1025,15402,16427
48167,Galveston County,,TX,20284,285382,305666
48169,Garza County,,TX,407,4520,4927
48171,Gillespie County,,TX,1397,23671,25068
48173,Glasscock County,,TX,117,1473,1590
48175,Goliad County,,TX,484,7030,7514
48177,Gonzales County,,TX,1155,19057,20212
48179,Gray County,,TX,1581,21446,23027
48181,Grayson County,,TX,7617,119130,126747
48183,Gregg County,,TX,10058,121993,132051
48185,Grimes County,,TX,2056,22718,24774
48187,Guadalupe County,,TX,9290,110407,119697
48189,Hale County,,TX,3267,36583,39850
48191,Hall County,,TX,348,3436,3784
48193,Hamilton County,,TX,700,8330,9030
48195,Hansford County,,TX,462,5560,6022
48197,Hardeman County,,TX,358,4374,4732
48199,Hardin County,,TX,4185,53821,58006
48201,Harris County,,TX,198375,3797481,3995856
48203,Harrison County,,TX,4735,63847,68582
48205,Hartley County,,TX,463,3875,4338
48207,Haskell County,,TX,478,5719,6197
48209,Hays County,,TX,12139,109023,121162
48211,Hemphill County,,TX,302,3551,3853
48213,Henderson County,,TX,6100,72188,78288
48215,Hidalgo County,,TX,22038,653173,675211
48217,Hill County,,TX,2761,33089,35850
48219,Hockley County,,TX,1972,23553,25525
48221,Hood County,,TX,3811,45625,49436
48223,Hopkins County,,TX,2406,33420,35826
48225,Houston County,,TX,1462,20259,21721
48227,Howard County,,TX,2356,30177,32533
48229,Hudspeth County,,TX,305,3365,3670
48231,Hunt County,,TX,7376,79512,86888
48233,Hutchinson County,,TX,1861,24589,26450
48235,Irion County,,TX,155,1659,1814
48237,Jack County,,TX,670,7599,8269
48239,Jackson County,,TX,1057,15001,16058
48241,Jasper County,,TX,2673,35734,38407
48243,Jeff Davis County,,TX,212,2142,2354
48245,Jefferson County,,TX,13835,253969,267804
48247,Jim Hogg County,,TX,328,5320,5648
48249,Jim Wells County,,TX,2856,42599,45455
48251,Johnson County,,TX,11458,143538,154996
48253,Jones County,,TX,1628,15188,16816
48255,Karnes County,,TX,850,12639,13489
48257,Kaufman County,,TX,7878,89013,96891
48259,Kendall County,,TX,2415,30185,32600
48261,Kenedy County,,TX,37,411,448
48263,Kent County,,TX,76,818,894
48265,Kerr County,,TX,3316,46869,50185
48267,Kimble County,,TX,355,4559,4914
48269,King County,,TX,-2,-2,-4
48271,Kinney County,,TX,250,3175,3425
48273,Kleberg County,,TX,3166,30143,33309
48275,Knox County,,TX,433,3889,4322
48277,Lamar County,,TX,3045,51202,54247
48279,Lamb County,,TX,1218,14961,16179
48281,Lampasas County,,TX,3622,18406,22028
48283,La Salle County,,TX,343,5551,5894
48285,Lavaca County,,TX,1115,21864,22979
48287,Lee County,,TX,1185,16743,17928
48289,Leon County,,TX,1319,16333,17652
48291,Liberty County,,TX,6523,68588,75111
48293,Limestone County,,TX,1608,21421,23029
48295,Lipscomb County,,TX,381,3072,3453
48297,Live Oak County,,TX,744,9079,9823
48299,Llano County,,TX,1465,15260,16725
48301,Loving County,,TX,-2,-2,-4
48303,Lubbock County,,TX,17695,249531,267226
48305,Lynn County,,TX,603,6486,7089
48307,McCulloch County,,TX,716,8398,9114
48309,McLennan County,,TX,12725,220822,233547
48311,McMullen County,,TX,52,833,885
48313,Madison County,,TX,1015,10752,11767
48315,Marion County,,TX,894,8849,9743
48317,Martin County,,TX,380,4463,4843
48319,Mason County,,TX,251,3741,3992
48321,Matagorda County,,TX,2723,38377,41100
48323,Maverick County,,TX,3165,58183,61348
48325,Medina County,,TX,3149,40981,44130
48327,Menard County,,TX,219,2234,2453
48329,Midland County,,TX,8860,128939,137799
48331,Milam County,,TX,1783,25150,26933
48333,Mills County,,TX,279,4732,5011
48335,Mitchell County,,TX,584,6739,7323
48337,Montague County,,TX,1394,19416,20810
48339,Montgomery County,,TX,28835,362566,391401
48341,Moore County,,TX,2030,21469,23499
48343,Morris County,,TX,1176,14162,15338
48345,Motley County,,TX,113,1203,1316
48347,Nacogdoches County,,TX,4205,54631,58836
48349,Navarro County,,TX,3265,46555,49820
48351,Newton County,,TX,1000,10582,11582
48353,Nolan County,,TX,1385,15449,16834
48355,Nueces County,,TX,22254,331953,354207
48357,Ochiltree County,,TX,623,9707,10330
48359,Oldham County,,TX,268,2052,2320
48361,Orange County,,TX,5391,91277,96668
48363,Palo Pinto County,,TX,1963,26402,28365
48365,Panola County,,TX,1528,23825,25353
48367,Parker County,,TX,8946,100122,109068
48369,Parmer County,,TX,1174,10810,11984
48371,Pecos County,,TX,1239,13570,14809
48373,Polk County,,TX,5743,52202,57945
48375,Potter County,,TX,12318,110063,122381
48377,Presidio County,,TX,980,10098,11078
48379,Rains County,,TX,927,8852,9779
48381,Randall County,,TX,11913,113835,125748
48383,Reagan County,,TX,292,3578,3870
48385,Real County,,TX,345,3099,3444
48387,Red River County,,TX,978,13687,14665
48389,Reeves County,,TX,944,11376,12320
48391,Refugio County,,TX,538,8413,8951
48393,Roberts County,,TX,103,827,930
48395,Robertson County,,TX,1268,17084,18352
48397,Rockwall County,,TX,5562,58558,64120
48399,Runnels County,,TX,888,11682,12570
48401,Rusk County,,TX,3353,46336,49689
48403,Sabine County,,TX,850,10049,10899
48405,San Augustine County,,TX,564,8420,8984
48407,San Jacinto County,,TX,2059,20828,22887
48409,San Patricio County,,TX,7627,71448,79075
48411,San Saba County,,TX,420,5615,6035
48413,Schleicher County,,TX,253,3052,3305
48415,Scurry County,,TX,1309,15824,17133
48417,Shackelford County,,TX,287,3448,3735
48419,Shelby County,,TX,1245,24351,25596
48421,Sherman County,,TX,262,2625,2887
48423,Smith County,,TX,12271,196303,208574
48425,Somervell County,,TX,688,7323,8011
48427,Starr County,,TX,2950,61537,64487
48429,Stephens County,,TX,603,8676,9279
48431,Sterling County,,TX,133,1176,1309
48433,Stonewall County,,TX,126,1527,1653
48435,Sutton County,,TX,450,4810,5260
48437,Swisher County,,TX,684,7762,8446
48439,Tarrant County,,TX,109652,1687872,1797524
48441,Taylor County,,TX,13023,129991,143014
48443,Terrell County,,TX,116,887,1003
48445,Terry County,,TX,1155,11885,13040
48447,Throckmorton County,,TX,111,1670,1781
48449,Titus County,,TX,2174,28606,30780
48451,Tom Green County,,TX,10696,108954,119650
48453,Travis County,,TX,76552,839499,916051
48455,Trinity County,,TX,1135,13143,14278
48457,Tyler County,,TX,1502,18130,19632
48459,Upshur County,,TX,3106,35707,38813
48461,Upton County,,TX,382,3264,3646
48463,Uvalde County,,TX,1862,28053,29915
48465,Val Verde County,,TX,4439,50619,55058
48467,Van Zandt County,,TX,3793,48116,51909
48469,Victoria County,,TX,5850,92619,98469
48471,Walker County,,TX,4676,44961,49637
48473,Waller County,,TX,3481,32376,35857
48475,Ward County,,TX,901,10880,11781
48477,Washington County,,TX,1948,32395,34343
48479,Webb County,,TX,7605,237456,245061
48481,Wharton County,,TX,2674,45152,47826
48483,Wheeler County,,TX,387,5245,5632
48485,Wichita County,,TX,14177,126538,140715
48487,Wilbarger County,,TX,1241,13768,15009
48489,Willacy County,,TX,1352,19669,21021
48491,Williamson County,,TX,32133,329917,362050
48493,Wilson County,,TX,2775,38910,41685
48495,Winkler County,,TX,656,7013,7669
48497,Wise County,,TX,4631,53835,58466
48499,Wood County,,TX,3036,38855,41891
48501,Yoakum County,,TX,672,8173,8845
48503,Young County,,TX,1344,17918,19262
48505,Zapata County,,TX,546,12358,12904
48507,Zavala County,,TX,719,10959,11678
49001,Beaver County,,UT,460,6570,7030
49003,Box Elder County,,UT,3485,51734,55219
49005,Cache County,,UT,9292,102028,111320
49007,Carbon County,,UT,1662,20807,22469
49009,Daggett County,,UT,114,865,979
49011,Davis County,,UT,25067,292298,317365
49013,Duchesne County,,UT,1045,16128,17173
49015,Emery County,,UT,855,11500,12355
49017,Garfield County,,UT,466,4584,5050
49019,Grand County,,UT,805,8649,9454
49021,Iron County,,UT,3752,34905,38657
49023,Juab County,,UT,744,9161,9905
49025,Kane County,,UT,622,6059,6681
49027,Millard County,,UT,1001,12801,13802
49029,Morgan County,,UT,571,8951,9522
49031,Piute County,,UT,100,1346,1446
49033,Rich County,,UT,218,2015,2233
49035,Salt Lake County,,UT,56901,1027840,1084741
49037,San Juan County,,UT,1202,9085,10287
49039,Sanpete County,,UT,1777,22208,23985
49041,Sevier County,,UT,1600,20033,21633
49043,Summit County,,UT,3600,35152,38752
49045,Tooele County,,UT,4737,52728,57465
49047,Uintah County,,UT,1765,27138,28903
49049,Utah County,,UT,31447,419214,450661
49051,Wasatch County,,UT,1937,18633,20570
49053,Washington County,,UT,8181,106462,114643
49055,Wayne County,,UT,264,2498,2762
49057,Weber County,,UT,17262,229343,246605
50001,Addison County,,VT,2281,41917,44198
50003,Bennington County,,VT,2470,42228,44698
50005,Caledonia County,,VT,1935,34516,36451
50007,Chittenden County,,VT,11636,175009,186645
50009,Essex County,,VT,542,7331,7873
50011,Franklin County,,VT,2752,54228,56980
50013,Grand Isle County,,VT,817,8570,9387
50015,Lamoille County,,VT,2088,27870,29958
50017,Orange County,,VT,2337,33175,35512
50019,Orleans County,,VT,1369,31148,32517
50021,Rutland County,,VT,3347,73950,77297
50023,Washington County,,VT,3935,70586,74521
50025,Windham County,,VT,3168,51067,54235
50027,Windsor County,,VT,4690,67947,72637
51001,Accomack County,,VA,1880,37382,39262
51003,Albemarle County,,VA,10041,90806,100847
51005,Alleghany County,,VA,812,18775,19587
51007,Amelia County,,VA,962,14178,15140
51009,Amherst County,,VA,2014,33998,36012
51011,Appomattox County,,VA,954,15889,16843
51013,Arlington County,,VA,44566,201124,245690
51015,Augusta County,,VA,4365,78822,83187
51017,Bath County,,VA,405,5822,6227
51019,Bedford County,,VA,4749,72410,77159
51021,Bland County,,VA,412,6559,6971
51023,Botetourt County,,VA,2392,37220,39612
51025,Brunswick County,,VA,1019,16971,17990
51027,Buchanan County,,VA,1127,22509,23636
51029,Buckingham County,,VA,664,14178,14842
51031,Campbell County,,VA,3668,57784,61452
51033,Caroline County,,VA,2165,27165,29330
51035,Carroll County,,VA,1283,30526,31809
51036,Charles City County,,VA,529,7920,8449
51037,Charlotte County,,VA,680,13579,14259
51041,Chesterfield County,,VA,24386,329072,353458
51043,Clarke County,,VA,1388,14104,15492
51045,Craig County,,VA,316,5507,5823
51047,Culpeper County,,VA,3397,42927,46324
51049,Cumberland County,,VA,605,9541,10146
51051,Dickenson County,,VA,614,14582,15196
51053,Dinwiddie County,,VA,2062,28254,30316
51057,Essex County,,VA,749,11572,12321
51059,Fairfax County,,VA,129613,1141019,1270632
51061,Fauquier County,,VA,6055,67393,73448
51063,Floyd County,,VA,730,15591,16321
51065,Fluvanna County,,VA,2104,24677,26781
51067,Franklin County,,VA,2828,55630,58458
51069,Frederick County,,VA,6609,77453,84062
51071,Giles County,,VA,828,19007,19835
51073,Gloucester County,,VA,2822,40776,43598
51075,Goochland County,,VA,1493,19905,21398
51077,Grayson County,,VA,834,16720,17554
51079,Greene County,,VA,1619,18551,20170
51081,Greensville County,,VA,561,8943,9504
51083,Halifax County,,VA,1500,38791,40291
51085,Hanover County,,VA,7743,109891,117634
51087,Henrico County,,VA,28384,312767,341151
51089,Henry County,,VA,3038,62140,65178
51091,Highland County,,VA,124,2691,2815
51093,Isle of Wight County,,VA,2727,36888,39615
51095,James City County,,VA,5761,63385,69146
51097,King and Queen County,,VA,535,6901,7436
51099,King George County,,VA,2364,21534,23898
51101,King William County,,VA,1202,16874,18076
51103,Lancaster County,,VA,698,13473,14171
51105,Lee County,,VA,835,21175,22010
51107,Loudoun County,,VA,29561,273607,303168
51109,Louisa County,,VA,2030,30706,32736
51111,Lunenburg County,,VA,656,11778,12434
51113,Madison County,,VA,889,13381,14270
51115,Mathews County,,VA,580,9821,10401
51117,Mecklenburg County,,VA,1824,33288,35112
51119,Middlesex County,,VA,796,11100,11896
51121,Montgomery County,,VA,7905,71821,79726
51125,Nelson County,,VA,1091,16192,17283
51127,New Kent County,,VA,1216,17624,18840
51131,Northampton County,,VA,828,13670,14498
51133,Northumberland County,,VA,812,13225,14037
51135,Nottoway County,,VA,944,15799,16743
51137,Orange County,,VA,2691,32711,35402
51139,Page County,,VA,1268,26481,27749
51141,Patrick County,,VA,916,19567,20483
51143,Pittsylvania County,,VA,3368,70764,74132
51145,Powhatan County,,VA,1757,26894,28651
51147,Prince Edward County,,VA,1224,16045,17269
51149,Prince George County,,VA,4982,32480,37462
51153,Prince William County,,VA,51245,373698,424943
51155,Pulaski County,,VA,2182,36594,38776
51157,Rappahannock County,,VA,607,8310,8917
51159,Richmond County,,VA,538,8309,8847
51161,Roanoke County,,VA,8590,103718,112308
51163,Rockbridge County,,VA,1197,23068,24265
51165,Rockingham County,,VA,4412,83769,88181
51167,Russell County,,VA,1128,26419,27547
51169,Scott County,,VA,944,23448,24392
51171,Shenandoah County,,VA,2536,44315,46851
51173,Smyth County,,VA,1325,34762,36087
51175,Southampton County,,VA,976,17830,18806
51177,Spotsylvania County,,VA,12786,122196,134982
51179,Stafford County,,VA,17047,122684,139731
51181,Surry County,,VA,480,7323,7803
51183,Sussex County,,VA,946,10820,11766
51185,Tazewell County,,VA,2119,43761,45880
51187,Warren County,,VA,3063,38848,41911
51191,Washington County,,VA,3188,55345,58533
51193,Westmoreland County,,VA,1298,17777,19075
51195,Wise County,,VA,1804,39072,40876
51197,Wythe County,,VA,1428,31387,32815
51199,York County,,VA,9938,68949,78887
51510,Alexandria city,,VA,34606,133628,168234
51515,Bedford city,,VA,610,6658,7268
51520,Bristol city,,VA,1944,16609,18553
51530,Buena Vista city,,VA,582,6775,7357
51540,Charlottesville city,,VA,6232,34394,40626
51550,Chesapeake city,,VA,25404,229563,254967
51570,Colonial Heights city,,VA,2524,19432,21956
51580,Covington city,,VA,471,7094,7565
51590,Danville city,,VA,3375,47510,50885
51595,Emporia city,,VA,506,6136,6642
51600,Fairfax city,,VA,4807,24000,28807
51610,Falls Church city,,VA,1896,11476,13372
51620,Franklin city,,VA,892,8979,9871
51630,Fredericksburg city,,VA,4963,17657,22620
51640,Galax city,,VA,567,7528,8095
51650,Hampton city,,VA,20388,140037,160425
51660,Harrisonburg city,,VA,4852,30698,35550
51670,Hopewell city,,VA,2823,22909,25732
51678,Lexington city,,VA,703,5506,6209
51680,Lynchburg city,,VA,5955,62594,68549
51683,Manassas city,,VA,8018,38523,46541
51685,Manassas Park city,,VA,2968,12300,15268
51690,Martinsville city,,VA,1225,14947,16172
51700,Newport News city,,VA,30448,184905,215353
51710,Norfolk city,,VA,37049,213485,250534
51720,Norton city,,VA,534,4003,4537
51730,Petersburg city,,VA,4088,33020,37108
51735,Poquoson city,,VA,1137,13798,14935
51740,Portsmouth city,,VA,12403,99752,112155
51750,Radford city,,VA,1696,10281,11977
51760,Richmond city,,VA,23192,177397,200589
51770,Roanoke city,,VA,10029,96430,106459
51775,Salem city,,VA,2647,26231,28878
51790,Staunton city,,VA,2142,24500,26642
51800,Suffolk city,,VA,8256,80386,88642
51810,Virginia Beach city,,VA,59387,477753,537140
51820,Waynesboro city,,VA,2281,22453,24734
51830,Williamsburg city,,VA,1581,8359,9940
51840,Winchester city,,VA,4405,25453,29858
53001,Adams County,,WA,1325,17425,18750
53003,Asotin County,,WA,2063,20888,22951
53005,Benton County,,WA,12747,170053,182800
53007,Chelan County,,WA,5536,73471,79007
53009,Clallam County,,WA,3972,72484,76456
53011,Clark County,,WA,24099,420968,445067
53013,Columbia County,,WA,382,4208,4590
53015,Cowlitz County,,WA,6263,101039,107302
53017,Douglas County,,WA,3303,33800,37103
53019,Ferry County,,WA,635,6353,6988
53021,Franklin County,,WA,5072,60148,65220
53023,Garfield County,,WA,159,2389,2548
53025,Grant County,,WA,4978,80243,85221
53027,Grays Harbor County,,WA,4142,68645,72787
53029,Island County,,WA,11211,81599,92810
53031,Jefferson County,,WA,2203,30348,32551
53033,King County,,WA,124024,1992316,2116340
53035,Kitsap County,,WA,26466,262513,288979
53037,Kittitas County,,WA,2924,32407,35331
53039,Klickitat County,,WA,1661,19567,21228
53041,Lewis County,,WA,4688,74343,79031
53043,Lincoln County,,WA,883,11093,11976
53045,Mason County,,WA,4281,54930,59211
53047,Okanogan County,,WA,2455,39339,41794
53049,Pacific County,,WA,1355,20756,22111
53051,Pend Oreille County,,WA,1139,11996,13135
53053,Pierce County,,WA,59402,795734,855136
53055,San Juan County,,WA,1179,16066,17245
53057,Skagit County,,WA,7467,117099,124566
53059,Skamania County,,WA,781,9807,10588
53061,Snohomish County,,WA,47218,710090,757308
53063,Spokane County,,WA,24792,471859,496651
53065,Stevens County,,WA,3338,42424,45762
53067,Thurston County,,WA,18178,249805,267983
53069,Wahkiakum County,,WA,270,3862,4132
53071,Walla Walla County,,WA,3848,56380,60228
53073,Whatcom County,,WA,10882,194076,204958
53075,Whitman County,,WA,4749,33564,38313
53077,Yakima County,,WA,10709,241818,252527
54001,Barbour County,,WV,702,15899,16601
54003,Berkeley County,,WV,5692,100172,105864
54005,Boone County,,WV,1181,24736,25917
54007,Braxton County,,WV,606,13385,13991
54009,Brooke County,,WV,1412,28023,29435
54011,Cabell County,,WV,6450,95402,101852
54013,Calhoun County,,WV,340,6937,7277
54015,Clay County,,WV,610,9474,10084
54017,Doddridge County,,WV,293,5152,5445
54019,Fayette County,,WV,2274,44519,46793
54021,Gilmer County,,WV,427,6137,6564
54023,Grant County,,WV,643,13107,13750
54025,Greenbrier County,,WV,1478,36838,38316
54027,Hampshire County,,WV,1255,23594,24849
54029,Hancock County,,WV,1921,37470,39391
54031,Hardy County,,WV,872,14771,15643
54033,Harrison County,,WV,3469,76491,79960
54035,Jackson County,,WV,1377,30937,32314
54037,Jefferson County,,WV,4239,52404,56643
54039,Kanawha County,,WV,10542,217417,227959
54041,Lewis County,,WV,864,18880,19744
54043,Lincoln County,,WV,1090,21224,22314
54045,Logan County,,WV,1340,35486,36826
54047,McDowell County,,WV,1014,17833,18847
54049,Marion County,,WV,2643,60559,63202
54051,Marshall County,,WV,1678,37030,38708
54053,Mason County,,WV,1102,26653,27755
54055,Mercer County,,WV,3189,61491,64680
54057,Mineral County,,WV,1419,31056,32475
54059,Mingo County,,WV,1156,24657,25813
54061,Monongalia County,,WV,5767,78271,84038
54063,Monroe County,,WV,641,12984,13625
54065,Morgan County,,WV,963,17524,18487
54067,Nicholas County,,WV,1172,26794,27966
54069,Ohio County,,WV,2671,51381,54052
54071,Pendleton County,,WV,529,8929,9458
54073,Pleasants County,,WV,514,8155,8669
54075,Pocahontas County,,WV,483,9421,9904
54077,Preston County,,WV,1223,33033,34256
54079,Putnam County,,WV,4095,60128,64223
54081,Raleigh County,,WV,3830,77430,81260
54083,Randolph County,,WV,1211,30947,32158
54085,Ritchie County,,WV,659,11816,12475
54087,Roane County,,WV,683,15173,15856
54089,Summers County,,WV,621,11278,11899
54091,Taylor County,,WV,864,16724,17588
54093,Tucker County,,WV,424,7833,8257
54095,Tyler County,,WV,560,9879,10439
54097,Upshur County,,WV,1164,23935,25099
54099,Wayne County,,WV,2308,40797,43105
54101,Webster County,,WV,387,8811,9198
54103,Wetzel County,,WV,904,19249,20153
54105,Wirt County,,WV,391,5459,5850
54107,Wood County,,WV,4421,97519,101940
54109,Wyoming County,,WV,876,21909,22785
55001,Adams County,,WI,1453,20807,22260
55003,Ashland County,,WI,1233,18544,19777
55005,Barron County,,WI,2868,54606,57474
55007,Bayfield County,,WI,971,17602,18573
55009,Brown County,,WI,13386,288634,302020
55011,Buffalo County,,WI,872,17064,17936
55013,Burnett County,,WI,1117,18041,19158
55015,Calumet County,,WI,3922,53050,56972
55017,Chippewa County,,WI,3786,70092,73878
55019,Clark County,,WI,2211,39587,41798
55021,Columbia County,,WI,4731,67728,72459
55023,Crawford County,,WI,1140,19346,20486
55025,Dane County,,WI,30830,533588,564418
55027,Dodge County,,WI,6366,100782,107148
55029,Door County,,WI,1670,35246,36916
55031,Douglas County,,WI,2561,49420,51981
55033,Dunn County,,WI,3155,42456,45611
55035,Eau Claire County,,WI,7555,102409,109964
55037,Florence County,,WI,381,5510,5891
55039,Fond du Lac County,,WI,5338,120766,126104
55041,Forest County,,WI,598,10491,11089
55043,Grant County,,WI,3079,57626,60705
55045,Green County,,WI,2316,42760,45076
55047,Green Lake County,,WI,1487,23506,24993
55049,Iowa County,,WI,1896,27942,29838
55051,Iron County,,WI,425,7319,7744
55053,Jackson County,,WI,1224,21432,22656
55055,Jefferson County,,WI,6468,91429,97897
55057,Juneau County,,WI,2019,29311,31330
55059,Kenosha County,,WI,10927,180314,191241
55061,Kewaunee County,,WI,1257,25072,26329
55063,La Crosse County,,WI,6978,122118,129096
55065,Lafayette County,,WI,1131,20131,21262
55067,Langlade County,,WI,1106,24163,25269
55069,Lincoln County,,WI,1640,36153,37793
55071,Manitowoc County,,WI,3678,100937,104615
55073,Marathon County,,WI,6254,156368,162622
55075,Marinette County,,WI,2730,49836,52566
55077,Marquette County,,WI,1257,18009,19266
55078,Menominee County,,WI,313,4501,4814
55079,Milwaukee County,,WI,54752,1025120,1079872
55081,Monroe County,,WI,2846,48932,51778
55083,Oconto County,,WI,2635,44952,47587
55085,Oneida County,,WI,2859,46151,49010
55087,Outagamie County,,WI,13320,209995,223315
55089,Ozaukee County,,WI,6671,104628,111299
55091,Pepin County,,WI,610,9087,9697
55093,Pierce County,,WI,2969,43730,46699
55095,Polk County,,WI,2754,51586,54340
55097,Portage County,,WI,4186,76953,81139
55099,Price County,,WI,942,18276,19218
55101,Racine County,,WI,10952,228690,239642
55103,Richland County,,WI,1190,20098,21288
55105,Rock County,,WI,7980,184717,192697
55107,Rusk County,,WI,1021,17308,18329
55109,St. Croix County,,WI,5345,89568,94913
55111,Sauk County,,WI,4174,71323,75497
55113,Sawyer County,,WI,1185,19531,20716
55115,Shawano County,,WI,2701,47745,50446
55117,Sheboygan County,,WI,5441,141509,146950
55119,Taylor County,,WI,1128,22906,24034
55121,Trempealeau County,,WI,1877,35249,37126
55123,Vernon County,,WI,1686,33761,35447
55125,Vilas County,,WI,1541,25266,26807
55127,Walworth County,,WI,6706,110424,117130
55129,Washburn County,,WI,1190,19036,20226
55131,Washington County,,WI,8787,156582,165369
55133,Waukesha County,,WI,28042,473922,501964
55135,Waupaca County,,WI,3143,61366,64509
55137,Waushara County,,WI,1671,26040,27711
55139,Winnebago County,,WI,11799,186291,198090
55141,Wood County,,WI,4645,92821,97466
56001,Albany County,,WY,4631,29773,34404
56003,Big Horn County,,WY,976,11657,12633
56005,Campbell County,,WY,3007,42630,45637
56007,Carbon County,,WY,1603,16239,17842
56009,Converse County,,WY,1071,14188,15259
56011,Crook County,,WY,492,6994,7486
56013,Fremont County,,WY,2457,40045,42502
56015,Goshen County,,WY,1029,12951,13980
56017,Hot Springs County,,WY,481,4912,5393
56019,Johnson County,,WY,639,8003,8642
56021,Laramie County,,WY,8487,97344,105831
56023,Lincoln County,,WY,1570,17584,19154
56025,Natrona County,,WY,5099,77409,82508
56027,Niobrara County,,WY,179,2635,2814
56029,Park County,,WY,2300,30466,32766
56031,Platte County,,WY,872,9587,10459
56033,Sheridan County,,WY,2152,30614,32766
56035,Sublette County,,WY,676,7548,8224
56037,Sweetwater County,,WY,3688,44429,48117
56039,Teton County,,WY,2694,21606,24300
56041,Uinta County,,WY,1890,22068,23958
56043,Washakie County,,WY,709,9200,9909
56045,Weston County,,WY,513,7368,7881
2230,Skagway Hoonah Ango,,AK,342,3450,3792
2198,Prince Of Wales Oute,,AK,491,4790,5281
2275,Wrangell Peters,,AK,2320,4961,7281
