Id,Label,timeset,state,totalmig,totalnonmig,population,indegree,outdegree,Degree,weighted indegree,weighted outdegree,Weighted Degree,Eccentricity,closnesscentrality,harmonicclosnesscentrality,betweenesscentrality,Authority,Hub,modularity_class,pageranks,componentnumber,strongcompnum,clustering,eigencentrality
1001,Autauga County,,AL,6044,58104,64148,22,26,48,14606,14500,29106,5,0.359142,0.380296,750.613331,0.004994,0.006361,14,0.000238,0,16,0.573563,0.04483
1003,Baldwin County,,AL,10504,188262,198766,94,70,164,35182,24211,59393,5,0.392104,0.42032,9846.167776,0.024506,0.019699,14,0.000867,0,16,0.450029,0.21885
1005,Barbour County,,AL,1692,26144,27836,11,11,22,3504,4190,7694,6,0.312623,0.325982,6390.24273,0.001517,0.000983,14,0.000213,0,16,0.530303,0.013972
1007,Bibb County,,AL,1547,22324,23871,5,5,10,3871,4205,8076,6,0.308389,0.319798,0.85,0.00053,0.000492,14,0.0001,0,16,0.8,0.004684
1009,Blount County,,AL,3627,59387,63014,11,14,25,11588,10583,22171,6,0.31073,0.324007,3.070013,0.001003,0.001053,14,0.000152,0,16,0.851648,0.009605
1011,Bullock County,,AL,551,9755,10306,4,5,9,1645,1577,3222,6,0.296641,0.307923,1.195833,0.000218,0.000285,14,0.000098,0,16,0.75,0.001973
1013,Butler County,,AL,1244,22691,23935,8,10,18,2087,2339,4426,6,0.31073,0.323594,73.506005,0.000762,0.000804,14,0.000139,0,16,0.609091,0.006627
1015,Calhoun County,,AL,6335,129740,136075,31,34,65,14641,16333,30974,5,0.35732,0.379388,4823.486108,0.00473,0.006258,14,0.000337,0,16,0.488739,0.042977
1017,Chambers County,,AL,2127,38337,40464,10,11,21,6366,6615,12981,5,0.326085,0.342418,53.740771,0.001262,0.00155,14,0.000148,0,16,0.736364,0.011473
1019,Cherokee County,,AL,1355,25510,26865,6,7,13,3352,2915,6267,6,0.272025,0.282299,8.537357,0.000134,0.000104,14,0.000101,0,16,0.5,0.001226
1021,Chilton County,,AL,2466,45657,48123,13,14,27,6912,6323,13235,6,0.322337,0.337499,28.226144,0.001208,0.001646,14,0.000166,0,16,0.6375,0.010408
1023,Choctaw County,,AL,700,15134,15834,6,5,11,843,864,1707,6,0.299279,0.311368,19.586064,0.00036,0.000309,14,0.000121,0,16,0.571429,0.003165
1025,Clarke County,,AL,1538,30277,31815,10,9,19,2692,3195,5887,6,0.310699,0.323429,33.891354,0.000955,0.000895,14,0.000176,0,16,0.633333,0.008559
1027,Clay County,,AL,880,16005,16885,7,7,14,1975,2285,4260,6,0.283588,0.294404,51.263695,0.000368,0.000149,14,0.000131,0,16,0.696429,0.003597
1029,Cleburne County,,AL,1008,14970,15978,6,6,12,2762,2769,5531,6,0.267438,0.277402,8.406837,0.000114,0.00011,14,0.000117,0,16,0.533333,0.001387
1031,Coffee County,,AL,5595,49033,54628,39,34,73,13276,13297,26573,5,0.35606,0.378744,1649.166303,0.010388,0.008431,14,0.000362,0,16,0.655052,0.092671
1033,Colbert County,,AL,3430,61520,64950,13,12,25,9079,8976,18055,6,0.322371,0.336981,596.45823,0.000954,0.001385,14,0.000197,0,16,0.549451,0.008928
1035,Conecuh County,,AL,803,13525,14328,5,5,10,1361,1681,3042,6,0.296061,0.307043,1.294007,0.000229,0.0002,14,0.000103,0,16,0.7,0.00209
1037,Coosa County,,AL,1189,11384,12573,7,7,14,3500,2890,6390,6,0.309745,0.321696,25.52727,0.000662,0.000621,14,0.000118,0,16,0.833333,0.005932
1039,Covington County,,AL,2050,39429,41479,18,18,36,4560,4662,9222,6,0.317638,0.332723,184.768647,0.00209,0.001951,14,0.000229,0,16,0.581871,0.01905
1041,Crenshaw County,,AL,907,14851,15758,6,6,12,2331,2660,4991,6,0.297106,0.308281,1.265171,0.000294,0.000274,14,0.000109,0,16,0.733333,0.002818
1043,Cullman County,,AL,3977,87842,91819,14,18,32,9487,9802,19289,6,0.311658,0.325933,20.67213,0.001017,0.001357,14,0.000185,0,16,0.738562,0.009576
1045,Dale County,,AL,8014,49704,57718,36,34,70,16086,18050,34136,5,0.357236,0.379449,2831.963935,0.008585,0.008192,14,0.000353,0,16,0.622132,0.077117
1047,Dallas County,,AL,2412,46366,48778,14,18,32,3844,6096,9940,6,0.328169,0.345334,205.402036,0.001462,0.002756,14,0.000194,0,16,0.578947,0.013335
1049,DeKalb County,,AL,3833,73451,77284,12,19,31,9066,9787,18853,5,0.344832,0.36358,638.611844,0.000896,0.002252,14,0.000171,0,16,0.497619,0.008773
1051,Elmore County,,AL,7179,83793,90972,26,29,55,21076,19741,40817,5,0.349446,0.369924,913.531059,0.003329,0.004139,14,0.000299,0,16,0.488911,0.030391
1053,Escambia County,,AL,2146,38691,40837,11,11,22,4615,5046,9661,6,0.313496,0.327275,55.491698,0.001461,0.00146,14,0.000155,0,16,0.719697,0.013168
1055,Etowah County,,AL,5178,112019,117197,22,24,46,13233,13576,26809,5,0.356018,0.376609,1642.142623,0.003175,0.004335,14,0.000251,0,16,0.576923,0.028927
1057,Fayette County,,AL,1032,18065,19097,5,5,10,2170,2394,4564,6,0.308452,0.319908,15.240639,0.000108,0.000384,14,0.00012,0,16,0.733333,0.001176
1059,Franklin County,,AL,2009,34549,36558,13,14,27,4870,6239,11109,6,0.310826,0.324254,1220.395611,0.000759,0.000747,14,0.000215,0,16,0.472527,0.007489
1061,Geneva County,,AL,1869,26523,28392,9,9,18,4520,4532,9052,6,0.30661,0.319258,6.560069,0.000687,0.000768,14,0.000131,0,16,0.744444,0.006224
1063,Greene County,,AL,681,9680,10361,4,3,7,993,1387,2380,6,0.282741,0.292836,0,0.000409,0.000083,14,0.000095,0,16,1,0.003616
1065,Hale County,,AL,1112,17964,19076,3,4,7,2620,3345,5965,6,0.308358,0.319632,0,0.000105,0.00038,14,0.000087,0,16,1,0.000977
1067,Henry County,,AL,1332,18011,19343,3,4,7,3583,3378,6961,6,0.297573,0.308749,0,0.000134,0.00029,14,0.000082,0,16,1,0.001262
1069,Houston County,,AL,7224,107446,114670,45,52,97,21290,20070,41360,5,0.368491,0.393997,12267.657714,0.010403,0.013645,14,0.00048,0,16,0.511364,0.092191
1071,Jackson County,,AL,2678,58368,61046,10,12,22,5682,6161,11843,6,0.312075,0.325636,106.567558,0.000899,0.000982,14,0.000156,0,16,0.483516,0.008539
1073,Jefferson County,,AL,36934,732168,769102,196,189,385,108957,123516,232473,5,0.44531,0.481573,93653.584434,0.050352,0.051817,14,0.001759,0,16,0.362448,0.44612
1075,Lamar County,,AL,710,15820,16530,6,6,12,1630,1800,3430,6,0.285297,0.296423,16.122196,0.000148,0.000108,14,0.000132,0,16,0.5,0.001403
1077,Lauderdale County,,AL,4986,98347,103333,23,22,45,11459,11958,23417,6,0.328525,0.346016,538.50237,0.002662,0.002758,14,0.000297,0,16,0.45,0.024866
1079,Lawrence County,,AL,1917,38108,40025,7,9,16,5416,5780,11196,6,0.310062,0.322466,2.556516,0.000354,0.00067,14,0.000125,0,16,0.833333,0.003727
1081,Lee County,,AL,11078,129223,140301,72,69,141,35894,29760,65654,5,0.39353,0.421861,9543.414591,0.015445,0.018057,14,0.000686,0,16,0.435904,0.13963
1083,Limestone County,,AL,4479,85590,90069,21,20,41,18526,13260,31786,5,0.34049,0.359332,346.720367,0.002898,0.002769,14,0.00025,0,16,0.512681,0.026579
1085,Lowndes County,,AL,1061,14297,15358,4,5,9,2656,3209,5865,6,0.296061,0.307043,0.525,0.000242,0.000232,14,0.000086,0,16,0.8,0.002052
1087,Macon County,,AL,1905,21390,23295,9,9,18,3524,4811,8335,5,0.325769,0.341757,102.027005,0.001439,0.001437,14,0.000137,0,16,0.708333,0.013003
1089,Madison County,,AL,19072,372371,391443,182,148,330,65776,56367,122143,5,0.428855,0.463673,38912.942608,0.050723,0.045735,14,0.001543,0,16,0.415521,0.447463
1091,Marengo County,,AL,1247,23711,24958,12,14,26,2602,2974,5576,6,0.312075,0.32574,173.542538,0.000852,0.001208,14,0.000219,0,16,0.494505,0.007516
1093,Marion County,,AL,1703,30193,31896,10,11,21,3679,3585,7264,6,0.310571,0.323539,348.272158,0.000443,0.000723,14,0.000188,0,16,0.492424,0.004359
1095,Marshall County,,AL,5397,98617,104014,19,22,41,15393,15919,31312,5,0.342608,0.361357,571.037324,0.002405,0.002883,14,0.000218,0,16,0.53,0.021901
1097,Mobile County,,AL,17371,450225,467596,123,133,256,43552,48838,92390,5,0.423992,0.457797,33563.803044,0.032789,0.037374,14,0.001122,0,16,0.411663,0.292686
1099,Monroe County,,AL,1228,25074,26302,8,10,18,2039,2546,4585,6,0.313172,0.326808,41.40293,0.00086,0.001224,14,0.000142,0,16,0.7,0.007936
1101,Montgomery County,,AL,19172,249687,268859,109,121,230,47249,56505,103754,5,0.420286,0.452999,46345.961221,0.028774,0.033357,14,0.001028,0,16,0.430022,0.255245
1103,Morgan County,,AL,6919,134809,141728,28,30,58,18154,19430,37584,5,0.361974,0.384747,1266.082534,0.003657,0.005412,14,0.000317,0,16,0.500891,0.033821
1105,Perry County,,AL,640,11381,12021,7,7,14,1425,1735,3160,6,0.309682,0.321668,46.274395,0.000625,0.000559,14,0.000131,0,16,0.690476,0.005386
1107,Pickens County,,AL,1068,21522,22590,4,5,9,2016,2690,4706,6,0.308893,0.320485,60.567682,0.000441,0.000396,14,0.000092,0,16,0.75,0.003766
1109,Pike County,,AL,2147,29586,31733,15,14,29,4649,5205,9854,6,0.311882,0.325542,79.652274,0.001211,0.001221,14,0.000201,0,16,0.604167,0.01077
1111,Randolph County,,AL,1258,23811,25069,10,10,20,2866,2736,5602,6,0.30984,0.322549,125.245848,0.00036,0.000613,14,0.000162,0,16,0.527273,0.003529
1113,Russell County,,AL,6336,52109,58445,42,24,66,23788,19769,43557,5,0.353649,0.374739,651.288459,0.010339,0.006955,14,0.000399,0,16,0.578073,0.093165
1115,St. Clair County,,AL,5279,86117,91396,18,18,36,20012,15810,35822,6,0.326085,0.343606,45.987735,0.001959,0.002048,14,0.000211,0,16,0.707895,0.017784
1117,Shelby County,,AL,15211,208632,223843,70,67,137,54002,46632,100634,5,0.396882,0.424673,7889.610056,0.018625,0.019889,14,0.000651,0,16,0.496451,0.168026
1119,Sumter County,,AL,788,13851,14639,5,6,11,979,1593,2572,6,0.308924,0.320815,34.527937,0.000441,0.000412,14,0.000115,0,16,0.7,0.003962
1121,Talladega County,,AL,4870,86870,91740,19,18,37,13064,12828,25892,6,0.314081,0.328651,567.620671,0.002418,0.001539,14,0.000232,0,16,0.61039,0.021693
1123,Tallapoosa County,,AL,2927,44721,47648,18,20,38,7512,10117,17629,6,0.315422,0.330885,223.928866,0.00154,0.001474,14,0.000227,0,16,0.471861,0.014055
1125,Tuscaloosa County,,AL,10197,189804,200001,68,75,143,28709,26977,55686,5,0.393991,0.422879,28635.132706,0.012729,0.016028,14,0.000759,0,16,0.333496,0.116418
1127,Walker County,,AL,3108,69982,73090,17,14,31,7619,7592,15211,6,0.310507,0.323787,210.879813,0.001532,0.001009,14,0.000225,0,16,0.580882,0.013868
1129,Washington County,,AL,1020,18810,19830,5,4,9,2248,2459,4707,6,0.29813,0.309442,10.088825,0.000345,0.000345,14,0.000116,0,16,0.55,0.003391
1131,Wilcox County,,AL,818,13500,14318,7,7,14,1203,1743,2946,6,0.310539,0.322934,2.504645,0.000758,0.000684,14,0.000123,0,16,0.833333,0.006448
1133,Winston County,,AL,1446,25462,26908,9,10,19,3644,3628,7272,6,0.310221,0.322851,5.169744,0.000728,0.00084,14,0.000145,0,16,0.790909,0.006911
2013,Aleutians East Borough,,AK,339,1753,2092,2,2,4,322,421,743,5,0.331038,0.344448,0,0.000871,0.000937,17,0.000065,0,16,1,0.008131
2016,Aleutians West Census Area,,AK,694,4350,5044,5,4,9,659,770,1429,5,0.332018,0.346071,0,0.00229,0.001313,17,0.000084,0,16,1,0.020606
2020,Anchorage Municipality,,AK,28706,311726,340432,238,234,472,80737,83483,164220,4,0.454532,0.493755,91692.616956,0.060532,0.057943,17,0.002227,0,16,0.323345,0.535378
2050,Bethel Census Area,,AK,1042,17127,18169,5,7,12,1635,2619,4254,5,0.312978,0.325096,4.526384,0.00057,0.000603,17,0.000103,0,16,0.619048,0.005442
2060,Bristol Bay Borough,,AK,226,1133,1359,1,1,2,62,61,123,5,0.312526,0.323803,0,0.000341,0.000357,17,0.000057,0,16,0,0.003163
2068,Denali Borough,,AK,263,2316,2579,2,2,4,328,286,614,5,0.312655,0.324106,0,0.000487,0.000501,17,0.000065,0,16,1,0.004506
2070,Dillingham Census Area,,AK,386,4979,5365,2,2,4,372,466,838,5,0.312558,0.323968,0,0.000345,0.000408,17,0.00007,0,16,1,0.003259
2090,Fairbanks North Star Borough,,AK,12822,101261,114083,86,92,178,22245,26010,48255,5,0.400291,0.430401,12238.178355,0.024538,0.024788,17,0.000835,0,16,0.455128,0.2213
2100,Haines Borough,,AK,195,2699,2894,0,1,1,0,105,105,6,0.263158,0.270391,0,0,0.000031,17,0.000049,0,17,0,0
2105,Hoonah-Angoon Census Area,,AK,236,2077,2313,1,1,2,122,252,374,6,0.263117,0.270315,0,0.000027,0.000031,17,0.000067,0,16,0,0.000346
2110,Juneau City and Borough,,AK,3075,34187,37262,19,17,36,3829,4038,7867,5,0.357025,0.376081,12204.27117,0.005299,0.004542,17,0.000351,0,16,0.5,0.048512
2122,Kenai Peninsula Borough,,AK,3766,59463,63229,17,18,35,6705,6598,13303,5,0.356605,0.375861,423.658779,0.004886,0.005087,17,0.000231,0,16,0.642105,0.045032
2130,Ketchikan Gateway Borough,,AK,1464,14958,16422,6,6,12,980,1140,2120,5,0.331364,0.345384,3045.060173,0.001209,0.001312,17,0.000162,0,16,0.547619,0.011403
2150,Kodiak Island Borough,,AK,1930,15099,17029,10,9,19,1537,1976,3513,5,0.348161,0.366089,80.459114,0.003008,0.003118,17,0.000135,0,16,0.602564,0.026698
2164,Lake and Peninsula Borough,,AK,165,1526,1691,1,1,2,147,187,334,5,0.312526,0.323803,0,0.000341,0.000357,17,0.000057,0,16,0,0.003163
2170,Matanuska-Susitna Borough,,AK,6236,88852,95088,32,27,59,20190,13750,33940,5,0.36912,0.391125,2213.791237,0.008721,0.008443,17,0.000399,0,16,0.533784,0.079791
2180,Nome Census Area,,AK,604,8722,9326,3,3,6,727,909,1636,5,0.312687,0.324271,0,0.000491,0.000553,17,0.000077,0,16,0.833333,0.004585
2185,North Slope Borough,,AK,615,6775,7390,2,3,5,698,1199,1897,5,0.312687,0.324271,0,0.000487,0.000553,17,0.000065,0,16,1,0.004506
2188,Northwest Arctic Borough,,AK,504,6504,7008,1,4,5,448,1291,1739,5,0.312719,0.324436,0,0.000341,0.000555,17,0.000057,0,16,0.916667,0.003163
2195,Petersburg Census Area,,AK,360,4030,4390,0,2,2,0,200,200,6,0.263181,0.270556,0,0,0.000033,17,0.000049,0,18,1,0
2198,Prince of Wales-Hyder Census Area,,AK,401,4863,5264,4,3,7,396,352,748,5,0.312623,0.324188,0,0.000906,0.000395,17,0.000106,0,16,1,0.008606
2220,Sitka City and Borough,,AK,888,9628,10516,3,3,6,490,635,1125,5,0.331111,0.344668,419.485124,0.000368,0.000968,17,0.000096,0,16,0.583333,0.003571
2230,Skagway Municipality,,AK,161,1228,1389,0,0,0,0,0,0,0,0,0,0,0,0,0,0.000049,1,19,0,0
2240,Southeast Fairbanks Census Area,,AK,841,7908,8749,3,3,6,1124,1364,2488,5,0.312687,0.324271,0,0.000537,0.000553,17,0.000077,0,16,1,0.005035
2261,Valdez-Cordova Census Area,,AK,1216,10689,11905,5,4,9,1329,1691,3020,5,0.312719,0.324436,0,0.001097,0.000581,17,0.000096,0,16,1,0.010328
2270,Wade Hampton Census Area,,AK,480,7234,7714,2,4,6,808,1110,1918,5,0.312719,0.324436,0,0.000345,0.000556,17,0.00007,0,16,1,0.003259
2275,Wrangell City and Borough,,AK,212,2443,2655,0,1,1,0,103,103,6,0.248952,0.254697,0,0,0.000007,17,0.000049,0,20,0,0
2282,Yakutat City and Borough,,AK,47,554,601,0,0,0,0,0,0,0,0,0,0,0,0,1,0.000049,2,21,0,0
2290,Yukon-Koyukuk Census Area,,AK,632,5541,6173,2,2,4,957,1197,2154,5,0.312655,0.324106,0,0.000487,0.000501,17,0.000065,0,16,1,0.004506
4001,Apache County,,AZ,6803,65128,71931,18,17,35,23119,20771,43890,5,0.352537,0.371019,114.235771,0.005087,0.0034,2,0.000208,0,16,0.702381,0.045986
4003,Cochise County,,AZ,13670,130856,144526,70,72,142,29522,31709,61231,5,0.394658,0.422505,1040.672457,0.022825,0.02283,2,0.000584,0,16,0.590786,0.204306
4005,Coconino County,,AZ,12776,132183,144959,46,58,104,31447,35253,66700,5,0.377117,0.40329,516.268612,0.013795,0.018131,2,0.000424,0,16,0.666579,0.125445
4007,Gila County,,AZ,3832,54593,58425,15,13,28,9655,9910,19565,5,0.356437,0.374816,12.16128,0.004714,0.003939,2,0.00017,0,16,0.838095,0.042715
4009,Graham County,,AZ,2308,30595,32903,11,9,20,5061,5125,10186,5,0.350052,0.367112,3.862725,0.001783,0.001855,2,0.000152,0,16,0.781818,0.017171
4011,Greenlee County,,AZ,1084,8401,9485,4,8,12,1114,2030,3144,5,0.350173,0.367167,1.960409,0.001292,0.001764,2,0.00009,0,16,0.714286,0.012531
4012,La Paz County,,AZ,1318,15640,16958,8,6,14,2640,2771,5411,5,0.349971,0.366727,0,0.003206,0.001979,4,0.000103,0,16,1,0.027815
4013,Maricopa County,,AZ,196634,4059391,4256025,768,741,1509,704580,683147,1387727,4,0.537247,0.604985,750929.586071,0.116668,0.112679,2,0.006803,0,16,0.091534,1
4015,Mohave County,,AZ,14927,191351,206278,67,64,131,37088,33798,70886,5,0.382353,0.409783,2364.273822,0.017393,0.019539,4,0.00062,0,16,0.595072,0.157428
4017,Navajo County,,AZ,8667,101816,110483,25,25,50,24434,24738,49172,5,0.360081,0.380401,194.973067,0.0066,0.007209,2,0.000265,0,16,0.668091,0.059288
4019,Pima County,,AZ,49046,1028429,1077475,328,293,621,147834,149602,297436,5,0.47269,0.513971,46683.906809,0.08281,0.077686,2,0.002547,0,16,0.284743,0.698762
4021,Pinal County,,AZ,35968,300753,336721,141,87,228,132605,100045,232650,5,0.397246,0.42694,3610.376022,0.040283,0.02708,2,0.001159,0,16,0.491497,0.347921
4023,Santa Cruz County,,AZ,2707,53983,56690,7,7,14,6497,8448,14945,5,0.355391,0.37278,0,0.003335,0.003345,2,0.000102,0,16,1,0.03076
4025,Yavapai County,,AZ,15843,222474,238317,81,81,162,44377,40261,84638,5,0.387935,0.416991,999.651366,0.025888,0.025565,2,0.00067,0,16,0.624763,0.23024
4027,Yuma County,,AZ,12511,217786,230297,64,61,125,30991,30952,61943,5,0.384586,0.411324,631.351289,0.020841,0.020389,4,0.00052,0,16,0.672945,0.185457
5001,Arkansas County,,AR,1213,21295,22508,5,8,13,1708,2294,4002,6,0.309334,0.320557,5.044368,0.000322,0.000397,3,0.000114,0,16,0.696429,0.003019
5003,Ashley County,,AR,1394,23683,25077,8,9,17,1667,2138,3805,6,0.310062,0.321866,67.574092,0.00041,0.000409,3,0.000158,0,16,0.430556,0.003896
5005,Baxter County,,AR,2711,43783,46494,16,15,31,4073,4019,8092,5,0.349931,0.367431,9094.791588,0.002343,0.001463,3,0.000312,0,16,0.385965,0.021714
5007,Benton County,,AR,16415,231494,247909,120,94,214,54303,43083,97386,5,0.416186,0.445818,29920.268514,0.033234,0.028099,3,0.001223,0,16,0.423995,0.293199
5009,Boone County,,AR,2557,39288,41845,12,14,26,4522,4927,9449,6,0.315094,0.328343,9188.268553,0.001242,0.00082,3,0.000259,0,16,0.366667,0.011858
5011,Bradley County,,AR,850,11677,12527,4,6,10,864,1207,2071,6,0.309019,0.319869,3.357082,0.000264,0.000288,3,0.000107,0,16,0.633333,0.002446
5013,Calhoun County,,AR,365,5246,5611,3,3,6,601,568,1169,6,0.257831,0.265627,1.322024,0.000023,0.00002,3,0.000087,0,16,0.666667,0.000399
5015,Carroll County,,AR,1836,27716,29552,9,8,17,3347,3545,6892,6,0.303082,0.314867,1021.685463,0.000486,0.000502,3,0.000205,0,16,0.569444,0.005117
5017,Chicot County,,AR,841,11425,12266,5,6,11,1158,1489,2647,6,0.310221,0.321124,29.662951,0.000291,0.000298,3,0.000117,0,16,0.566667,0.002662
5019,Clark County,,AR,1849,21699,23548,9,14,23,2521,3784,6305,5,0.338398,0.355629,910.927618,0.000343,0.001877,3,0.000183,0,16,0.489011,0.003534
5021,Clay County,,AR,1165,16552,17717,5,6,11,1955,2428,4383,6,0.264172,0.273638,214.936854,0.000043,0.000045,3,0.00013,0,16,0.533333,0.000802
5023,Cleburne County,,AR,1674,26369,28043,11,12,23,3848,4156,8004,6,0.323992,0.33883,348.24151,0.000973,0.000951,3,0.000198,0,16,0.593407,0.008795
5025,Cleveland County,,AR,640,8973,9613,5,6,11,1190,1337,2527,6,0.308893,0.319649,3.459524,0.000292,0.000273,3,0.000124,0,16,0.7,0.002781
5027,Columbia County,,AR,1637,24463,26100,10,14,24,2151,3062,5213,5,0.335029,0.351117,1675.236807,0.000903,0.001098,3,0.000172,0,16,0.456044,0.008857
5029,Conway County,,AR,1518,22239,23757,6,6,12,3578,3649,7227,6,0.308893,0.319676,1.906494,0.000325,0.000295,3,0.000137,0,16,0.833333,0.003126
5031,Craighead County,,AR,6355,94181,100536,42,37,79,19544,16680,36224,5,0.356731,0.379008,33941.018287,0.005876,0.004565,3,0.000627,0,16,0.274747,0.056048
5033,Crawford County,,AR,4469,63194,67663,14,14,28,12721,12335,25056,5,0.320801,0.335017,693.543923,0.001636,0.001318,3,0.000231,0,16,0.609524,0.015316
5035,Crittenden County,,AR,3624,55827,59451,13,14,27,8011,8500,16511,5,0.356185,0.374915,495.106601,0.001501,0.0021,3,0.000207,0,16,0.475,0.013861
5037,Cross County,,AR,1339,19554,20893,7,9,16,2585,2918,5503,6,0.323024,0.337097,57.701692,0.000743,0.000789,3,0.000141,0,16,0.680556,0.006856
5039,Dallas County,,AR,612,8235,8847,6,7,13,914,1111,2025,6,0.308987,0.319924,345.814777,0.000306,0.000274,3,0.000135,0,16,0.5,0.002865
5041,Desha County,,AR,981,14035,15016,6,6,12,1516,1938,3454,6,0.308987,0.31972,3.96526,0.00034,0.000311,3,0.000141,0,16,0.733333,0.003267
5043,Drew County,,AR,1389,18655,20044,8,9,17,2585,2588,5173,6,0.309113,0.320271,10.470871,0.000298,0.000342,3,0.000177,0,16,0.533333,0.003038
5045,Faulkner County,,AR,8049,109935,117984,53,40,93,25168,21868,47036,5,0.377916,0.40241,15381.713443,0.00681,0.008012,3,0.000727,0,16,0.258318,0.065802
5047,Franklin County,,AR,1333,18312,19645,7,7,14,3119,3270,6389,6,0.289607,0.300352,4.805327,0.000364,0.000217,3,0.000142,0,16,0.946429,0.003841
5049,Fulton County,,AR,874,11196,12070,7,6,13,1915,1480,3395,6,0.270037,0.279663,74.259796,0.000047,0.000051,3,0.000193,0,16,0.357143,0.00103
5051,Garland County,,AR,5855,101535,107390,39,31,70,14354,12514,26868,5,0.374182,0.397183,16557.477198,0.007994,0.006093,3,0.000516,0,16,0.414103,0.07536
5053,Grant County,,AR,1286,19169,20455,6,6,12,3194,3189,6383,6,0.308956,0.319759,0.166667,0.000392,0.000382,3,0.000127,0,16,0.952381,0.003801
5055,Greene County,,AR,2397,43211,45608,12,13,25,6383,5534,11917,6,0.324165,0.339243,1986.362936,0.000755,0.000939,3,0.000235,0,16,0.354167,0.007327
5057,Hempstead County,,AR,1379,22841,24220,9,12,21,2636,3207,5843,6,0.309619,0.321575,523.818268,0.000339,0.000343,91,0.000176,0,16,0.484848,0.003305
5059,Hot Spring County,,AR,2296,32479,34775,8,8,16,5445,5818,11263,6,0.309936,0.321437,6.667403,0.00042,0.000492,3,0.00016,0,16,0.736111,0.004133
5061,Howard County,,AR,1060,14820,15880,7,8,15,1813,1966,3779,6,0.309397,0.320749,307.249293,0.000321,0.000334,91,0.000159,0,16,0.607143,0.003103
5063,Independence County,,AR,2266,37935,40201,13,16,29,4772,5036,9808,6,0.313302,0.326587,707.871914,0.000438,0.000746,3,0.000271,0,16,0.426471,0.004731
5065,Izard County,,AR,920,12710,13630,6,6,12,1717,1532,3249,6,0.269029,0.27859,18.47351,0.000042,0.000054,3,0.000168,0,16,0.566667,0.000954
5067,Jackson County,,AR,1058,16105,17163,8,6,14,1850,2085,3935,6,0.309239,0.320199,147.541896,0.000321,0.000297,3,0.000176,0,16,0.571429,0.003357
5069,Jefferson County,,AR,5043,82146,87189,27,25,52,8788,12333,21121,5,0.37483,0.39688,4855.173791,0.005031,0.005,3,0.000386,0,16,0.375616,0.047344
5071,Johnson County,,AR,1565,25775,27340,11,9,20,3012,2926,5938,6,0.312075,0.323836,42.294757,0.000691,0.000608,3,0.000194,0,16,0.781818,0.006861
5073,Lafayette County,,AR,536,7151,7687,4,5,9,745,905,1650,6,0.265492,0.27497,3.030482,0.000039,0.000067,91,0.000098,0,16,0.7,0.000565
5075,Lawrence County,,AR,1229,16952,18181,6,6,12,2384,2761,5145,6,0.263185,0.272219,5.039176,0.00004,0.000044,3,0.00016,0,16,0.666667,0.000867
5077,Lee County,,AR,731,8313,9044,6,5,11,929,1278,2207,6,0.309239,0.320089,0.566667,0.000314,0.000289,3,0.000117,0,16,0.833333,0.003059
5079,Lincoln County,,AR,808,11430,12238,5,5,10,1494,1717,3211,6,0.30883,0.319429,0.833333,0.000293,0.000271,3,0.000125,0,16,0.85,0.002791
5081,Little River County,,AR,795,13508,14303,5,4,9,1629,1711,3340,6,0.265144,0.274254,0.295455,0.000065,0.00005,91,0.000119,0,16,0.9,0.00086
5083,Logan County,,AR,1645,23498,25143,8,11,19,2896,4107,7003,6,0.312139,0.324166,53.645732,0.000199,0.000652,3,0.000166,0,16,0.736364,0.002238
5085,Lonoke County,,AR,6340,71251,77591,23,26,49,18773,16136,34909,5,0.370293,0.39261,1856.294571,0.004521,0.005325,3,0.000322,0,16,0.496552,0.042715
5087,Madison County,,AR,1233,16209,17442,3,3,6,2487,2950,5437,6,0.296409,0.306416,0,0.000287,0.000307,3,0.000094,0,16,1,0.002931
5089,Marion County,,AR,1409,16172,17581,4,2,6,1959,2155,4114,6,0.259377,0.266381,0.8125,0.000015,0.000021,3,0.000115,0,16,0.583333,0.000481
5091,Miller County,,AR,4082,42512,46594,17,19,36,11486,11510,22996,5,0.346647,0.365588,5597.438817,0.001661,0.003026,91,0.000278,0,16,0.436842,0.016639
5093,Mississippi County,,AR,3171,49777,52948,9,16,25,4491,6339,10830,5,0.349648,0.368246,1039.244274,0.000749,0.002256,3,0.000168,0,16,0.458333,0.007087
5095,Monroe County,,AR,734,8674,9408,5,10,15,743,1443,2186,6,0.309397,0.320914,9.412499,0.000276,0.00035,3,0.000113,0,16,0.511111,0.002576
5097,Montgomery County,,AR,608,8680,9288,3,3,6,915,877,1792,6,0.27249,0.281264,1.914621,0.000037,0.000048,3,0.000105,0,16,0.666667,0.000664
5099,Nevada County,,AR,682,9398,10080,5,5,10,1210,1377,2587,6,0.309019,0.319787,1.302053,0.000043,0.000255,91,0.000106,0,16,0.8,0.00056
5101,Newton County,,AR,639,8201,8840,1,2,3,808,1058,1866,7,0.239674,0.245373,0,0.000005,0.00001,3,0.000065,0,16,1,0.000138
5103,Ouachita County,,AR,1729,26995,28724,8,13,21,2472,3256,5728,5,0.334696,0.350622,1104.41032,0.000331,0.001025,3,0.000158,0,16,0.521978,0.003381
5105,Perry County,,AR,852,10359,11211,6,6,12,2213,2354,4567,6,0.308861,0.319621,1.331818,0.000358,0.000319,3,0.000135,0,16,0.833333,0.003371
5107,Phillips County,,AR,1521,21838,23359,8,13,21,1505,2735,4240,6,0.324027,0.338968,143.333656,0.000798,0.000982,3,0.000154,0,16,0.525641,0.007502
5109,Pike County,,AR,797,11266,12063,5,5,10,1301,1572,2873,6,0.272613,0.28176,7.863619,0.000051,0.000053,3,0.000133,0,16,0.5,0.000851
5111,Poinsett County,,AR,1658,24756,26414,6,7,13,3844,4141,7985,6,0.320563,0.333713,16.486827,0.000495,0.000497,3,0.000122,0,16,0.642857,0.004711
5113,Polk County,,AR,1113,20241,21354,6,7,13,945,1326,2271,6,0.28969,0.300517,73.842452,0.000094,0.000206,3,0.000154,0,16,0.380952,0.00134
5115,Pope County,,AR,4287,61815,66102,22,20,42,9297,9707,19004,5,0.345816,0.365148,1416.991284,0.002141,0.002344,3,0.000345,0,16,0.456667,0.020767
5117,Prairie County,,AR,515,8796,9311,5,4,9,1210,1343,2553,6,0.308767,0.319236,0.625,0.000315,0.000286,3,0.000106,0,16,0.75,0.00296
5119,Pulaski County,,AR,27487,421112,448599,164,168,332,82785,86321,169106,5,0.44636,0.479911,159356.59844,0.040089,0.043775,3,0.00174,0,16,0.32845,0.363703
5121,Randolph County,,AR,1167,18235,19402,4,5,9,1875,2109,3984,6,0.26314,0.271971,2.862505,0.000033,0.00004,3,0.00012,0,16,0.75,0.000675
5123,St. Francis County,,AR,1830,24564,26394,9,11,20,3440,4363,7803,5,0.340299,0.356889,141.912542,0.000862,0.001506,3,0.000157,0,16,0.651515,0.008015
5125,Saline County,,AR,7042,111810,118852,32,27,59,28008,20132,48140,5,0.37052,0.393023,2622.776427,0.004435,0.005849,3,0.000443,0,16,0.412605,0.043474
5127,Scott County,,AR,840,11339,12179,5,6,11,1345,1565,2910,6,0.28922,0.299609,4.967205,0.000069,0.000166,3,0.00012,0,16,0.7,0.000902
5129,Searcy County,,AR,579,7785,8364,2,5,7,287,569,856,6,0.275364,0.285083,4.590018,0.000007,0.000063,3,0.000081,0,16,0.6,0.000228
5131,Sebastian County,,AR,9443,131086,140529,33,37,70,23785,25110,48895,5,0.374923,0.398883,8637.738813,0.006946,0.008605,3,0.000441,0,16,0.46859,0.065168
5133,Sevier County,,AR,979,16222,17201,6,7,13,1494,1756,3250,6,0.290384,0.301398,50.059722,0.000068,0.000167,91,0.000149,0,16,0.52381,0.000997
5135,Sharp County,,AR,1419,17224,18643,8,8,16,2577,3378,5955,6,0.309397,0.320667,375.06905,0.000067,0.00028,3,0.000197,0,16,0.427273,0.001209
5137,Stone County,,AR,734,11937,12671,6,5,11,619,862,1481,6,0.27459,0.284115,53.652616,0.000317,0.000051,3,0.000142,0,16,0.666667,0.003053
5139,Union County,,AR,2473,47921,50394,15,18,33,3498,4729,8227,5,0.347004,0.365973,6236.088951,0.002762,0.00266,3,0.000238,0,16,0.407895,0.0269
5141,Van Buren County,,AR,1239,16601,17840,8,9,17,1999,2431,4430,6,0.309082,0.320337,651.992053,0.000358,0.000346,3,0.00017,0,16,0.588889,0.003543
5143,Washington County,,AR,16178,197214,213392,87,76,163,42485,41772,84257,5,0.405815,0.433895,30424.437554,0.018372,0.020124,3,0.001041,0,16,0.3314,0.168202
5145,White County,,AR,4858,77064,81922,28,22,50,12606,11193,23799,5,0.352989,0.372846,2940.592541,0.003662,0.003695,3,0.000415,0,16,0.4,0.035936
5147,Woodruff County,,AR,571,7558,8129,5,5,10,791,925,1716,6,0.308861,0.319511,2.875,0.000288,0.000266,3,0.000122,0,16,0.6,0.002752
5149,Yell County,,AR,1766,22026,23792,6,9,15,3657,4663,8320,6,0.309967,0.32163,17.248126,0.000283,0.000447,3,0.000142,0,16,0.736111,0.002751
6001,Alameda County,,CA,102648,1635126,1737774,256,258,514,391788,390188,781976,5,0.458731,0.499774,15765.31308,0.076368,0.073603,4,0.001848,0,16,0.394816,0.648157
6003,Alpine County,,CA,143,1037,1180,1,1,2,72,85,157,6,0.263483,0.270804,0,0.000042,0.000058,4,0.000062,0,16,0,0.000556
6005,Amador County,,CA,2304,38881,41185,14,14,28,5747,5167,10914,5,0.349406,0.366793,0.114396,0.004462,0.004004,4,0.000136,0,16,0.981618,0.038269
6007,Butte County,,CA,11876,214857,226733,59,65,124,33742,34677,68419,5,0.369751,0.396434,666.425282,0.014481,0.016554,4,0.000468,0,16,0.692221,0.128251
6009,Calaveras County,,CA,3112,47440,50552,20,20,40,8812,8759,17571,5,0.356143,0.375256,4.251446,0.005598,0.005872,4,0.000176,0,16,0.948052,0.048823
6011,Colusa County,,CA,1476,27212,28688,9,8,17,2704,3314,6018,6,0.31169,0.324491,1.729298,0.001764,0.000993,4,0.000114,0,16,0.866667,0.01491
6013,Contra Costa County,,CA,61341,1151408,1212749,183,183,366,258728,225741,484469,5,0.433892,0.471476,5711.805869,0.057462,0.056983,4,0.001322,0,16,0.494803,0.496508
6015,Del Norte County,,CA,1527,24348,25875,13,10,23,2273,2393,4666,5,0.349044,0.365858,4.867245,0.003252,0.00232,4,0.000141,0,16,0.862637,0.028611
6017,El Dorado County,,CA,12529,196315,208844,57,61,118,41909,39883,81792,5,0.368895,0.395004,217.060851,0.014648,0.016322,4,0.000444,0,16,0.675983,0.130036
6019,Fresno County,,CA,33525,951290,984815,131,122,253,108742,109831,218573,5,0.418833,0.451618,3267.941028,0.0406,0.037881,4,0.000996,0,16,0.539017,0.359788
6021,Glenn County,,CA,1917,30779,32696,8,6,14,3997,4359,8356,6,0.310826,0.323253,1.030745,0.001779,0.000636,4,0.000107,0,16,0.861111,0.015612
6023,Humboldt County,,CA,7099,129559,136658,51,60,111,16338,17834,34172,5,0.361585,0.386426,2684.355523,0.012885,0.013966,4,0.000417,0,16,0.703279,0.113653
6025,Imperial County,,CA,8314,207978,216292,28,31,59,27866,26428,54294,5,0.365336,0.387466,3.151394,0.009173,0.010326,4,0.000232,0,16,0.902462,0.079971
6027,Inyo County,,CA,1236,20042,21278,10,10,20,2503,2386,4889,5,0.351596,0.368901,2.408126,0.004252,0.003964,4,0.000115,0,16,0.918182,0.03658
6029,Kern County,,CA,35218,820575,855793,137,143,280,110562,106169,216731,5,0.414477,0.44978,4698.887258,0.038725,0.038773,4,0.001077,0,16,0.450961,0.346489
6031,Kings County,,CA,10732,138130,148862,46,54,100,26294,29459,55753,5,0.382691,0.408573,225.98588,0.0151,0.018444,4,0.000361,0,16,0.707481,0.132442
6033,Lake County,,CA,3697,59816,63513,26,29,55,10328,9558,19886,5,0.357404,0.377897,3.011834,0.007723,0.008422,4,0.000212,0,16,0.967816,0.066942
6035,Lassen County,,CA,2005,26345,28350,16,14,30,3403,3498,6901,5,0.349527,0.366958,299.851918,0.004141,0.003018,4,0.000156,0,16,0.820261,0.035795
6037,Los Angeles County,,CA,368527,10532053,10900580,622,655,1277,1135686,1405589,2541275,4,0.527333,0.589744,351880.707116,0.113735,0.110803,4,0.004989,0,16,0.120371,0.965153
6039,Madera County,,CA,8449,141548,149997,30,30,60,26525,25940,52465,5,0.357362,0.377952,16.739888,0.008943,0.009156,4,0.000241,0,16,0.905303,0.077476
6041,Marin County,,CA,14890,250193,265083,68,70,138,53318,50011,103329,5,0.39185,0.419605,3201.762185,0.023334,0.024542,4,0.000522,0,16,0.742632,0.205013
6043,Mariposa County,,CA,1545,18220,19765,11,10,21,2815,2762,5577,5,0.348963,0.365748,0.097619,0.003299,0.00283,4,0.000116,0,16,0.981818,0.028569
6045,Mendocino County,,CA,4245,91664,95909,31,35,66,9330,10597,19927,5,0.358674,0.380098,5.55419,0.009298,0.009696,4,0.000247,0,16,0.937922,0.081254
6047,Merced County,,CA,16897,256931,273828,40,53,93,47270,48560,95830,5,0.375853,0.401337,122.083541,0.011842,0.016136,4,0.000311,0,16,0.804682,0.103968
6049,Modoc County,,CA,576,8855,9431,4,3,7,435,451,886,6,0.295887,0.307791,0.205357,0.000198,0.000395,4,0.000083,0,16,0.75,0.0021
6051,Mono County,,CA,1497,13117,14614,10,11,21,2608,2771,5379,5,0.349608,0.366601,1.74483,0.003891,0.00369,4,0.00012,0,16,0.856061,0.033324
6053,Monterey County,,CA,27340,462263,489603,126,135,261,76220,86075,162295,5,0.41762,0.452058,2263.264718,0.039959,0.041923,4,0.000942,0,16,0.544637,0.355387
6055,Napa County,,CA,8546,151577,160123,40,42,82,28927,27552,56479,5,0.367776,0.391125,20.817044,0.012405,0.01302,4,0.000307,0,16,0.942414,0.108521
6057,Nevada County,,CA,6395,106948,113343,41,37,78,20518,19379,39897,5,0.359142,0.380896,729.813897,0.011234,0.010699,4,0.000332,0,16,0.879878,0.098318
6059,Orange County,,CA,155659,3354199,3509858,343,381,724,573622,577308,1150930,5,0.478818,0.528348,44431.302356,0.090458,0.092082,4,0.002526,0,16,0.269854,0.763828
6061,Placer County,,CA,26487,371378,397865,97,97,194,111009,90318,201327,5,0.388284,0.419412,1505.488289,0.024905,0.028451,4,0.000771,0,16,0.585425,0.226149
6063,Plumas County,,CA,1654,22044,23698,12,11,23,2228,2745,4973,5,0.349366,0.366408,168.134953,0.002616,0.002446,4,0.000144,0,16,0.82967,0.022887
6065,Riverside County,,CA,137145,2183084,2320229,295,334,629,580236,485650,1065886,5,0.47144,0.517822,35541.271522,0.0782,0.080506,4,0.002243,0,16,0.2777,0.671044
6067,Sacramento County,,CA,80887,1529032,1609919,217,236,453,281588,281752,563340,5,0.450476,0.490943,21460.434336,0.062073,0.064014,4,0.001664,0,16,0.374816,0.541856
6069,San Benito County,,CA,4431,61725,66156,18,21,39,13589,12494,26083,5,0.356689,0.376081,0,0.00621,0.006926,4,0.000159,0,16,0.995671,0.053822
6071,San Bernardino County,,CA,148595,2119858,2268453,294,340,634,515973,515420,1031393,4,0.475286,0.521129,35167.640478,0.076912,0.082525,4,0.002285,0,16,0.283093,0.668998
6073,San Diego County,,CA,174615,3407490,3582105,616,628,1244,615951,612083,1228034,4,0.518398,0.581545,262239.381716,0.113172,0.109972,4,0.004836,0,16,0.132166,0.96053
6075,San Francisco County,,CA,70028,846300,916328,243,178,421,273325,276956,550281,5,0.43797,0.474023,6624.088376,0.073762,0.058257,4,0.001698,0,16,0.452281,0.618447
6077,San Joaquin County,,CA,40355,719514,759869,92,119,211,136285,130927,267212,5,0.405543,0.438946,2162.210715,0.025154,0.032799,4,0.000713,0,16,0.524452,0.224703
6079,San Luis Obispo County,,CA,14990,273340,288330,69,77,146,49176,45195,94371,5,0.386057,0.414873,346.371155,0.019628,0.023165,4,0.000526,0,16,0.699453,0.17483
6081,San Mateo County,,CA,51675,800581,852256,142,134,276,196020,192847,388867,5,0.415786,0.450116,2042.949095,0.048777,0.045202,4,0.000995,0,16,0.599586,0.417477
6083,Santa Barbara County,,CA,23453,433056,456509,103,108,211,65071,71009,136080,5,0.407781,0.43965,1490.676827,0.033288,0.035041,4,0.000797,0,16,0.619948,0.296137
6085,Santa Clara County,,CA,96208,2032646,2128854,276,253,529,340398,356209,696607,5,0.454123,0.495565,15282.356378,0.077974,0.073188,4,0.001994,0,16,0.365614,0.657375
6087,Santa Cruz County,,CA,14371,282419,296790,66,67,133,47709,49944,97653,5,0.376741,0.404033,245.153541,0.018846,0.019664,4,0.000499,0,16,0.724696,0.168012
6089,Shasta County,,CA,9348,185360,194708,67,69,136,27666,25981,53647,5,0.369435,0.396489,5947.583438,0.015418,0.016489,4,0.000574,0,16,0.637018,0.137991
6091,Sierra County,,CA,298,3211,3509,3,3,6,392,511,903,6,0.295656,0.307351,0.090909,0.000333,0.000333,4,0.000075,0,16,0.833333,0.003104
6093,Siskiyou County,,CA,2573,46348,48921,24,22,46,4630,5053,9683,5,0.357573,0.377264,612.104366,0.007258,0.006366,4,0.000208,0,16,0.848522,0.063866
6095,Solano County,,CA,31729,455580,487309,99,114,213,100621,98695,199316,5,0.410045,0.44272,2441.342851,0.029733,0.034987,4,0.000764,0,16,0.562418,0.265991
6097,Sonoma County,,CA,21097,531974,553071,96,101,197,71624,65488,137112,5,0.39435,0.425768,1165.918357,0.028668,0.030536,4,0.000727,0,16,0.587547,0.255901
6099,Stanislaus County,,CA,29765,549142,578907,76,91,167,88102,91666,179768,5,0.387935,0.418339,700.181496,0.020303,0.024672,4,0.000579,0,16,0.616678,0.181988
6101,Sutter County,,CA,8117,99361,107478,29,31,60,20912,23893,44805,5,0.35825,0.379135,234.283321,0.008398,0.009272,4,0.00025,0,16,0.870766,0.073186
6103,Tehama County,,CA,4001,62406,66407,25,24,49,10343,9800,20143,5,0.34989,0.368554,67.94974,0.00583,0.005591,4,0.000218,0,16,0.835979,0.050108
6105,Trinity County,,CA,848,11449,12297,2,2,4,992,1165,2157,6,0.270037,0.279735,0,0.000179,0.000167,4,0.000062,0,16,1,0.001594
6107,Tulare County,,CA,16497,447334,463831,57,62,119,53296,51427,104723,5,0.376694,0.403263,183.415341,0.018087,0.018665,4,0.000446,0,16,0.781119,0.161601
6109,Tuolumne County,,CA,3302,57321,60623,21,26,47,7678,7672,15350,5,0.356479,0.376356,14.386051,0.006544,0.007637,4,0.000185,0,16,0.926154,0.057306
6111,Ventura County,,CA,41996,943941,985937,152,174,326,139338,141642,280980,5,0.434079,0.470606,3529.595503,0.049055,0.054943,4,0.001129,0,16,0.524412,0.429304
6113,Yolo County,,CA,17239,195815,213054,56,62,118,51465,55096,106561,5,0.377304,0.404061,429.315456,0.016823,0.01985,4,0.000429,0,16,0.770089,0.14979
6115,Yuba County,,CA,9842,69463,79305,35,32,67,23312,24276,47588,5,0.362624,0.384472,175.509929,0.010266,0.010445,4,0.000292,0,16,0.832148,0.090032
8001,Adams County,,CO,45997,466546,512543,132,130,262,183382,162396,345778,5,0.427161,0.459327,18333.788071,0.038285,0.037601,2,0.001243,0,16,0.450244,0.342846
8003,Alamosa County,,CO,1561,14812,16373,10,13,23,2666,2963,5629,5,0.352619,0.370661,14642.140053,0.001826,0.003197,2,0.000248,0,16,0.538462,0.018165
8005,Arapahoe County,,CO,65169,608120,673289,248,193,441,252741,232350,485091,5,0.450007,0.485523,36850.198166,0.069958,0.058973,2,0.002116,0,16,0.389546,0.604821
8007,Archuleta County,,CO,1193,11942,13135,3,4,7,652,849,1501,5,0.350012,0.366535,0,0.001006,0.000878,2,0.000073,0,16,1,0.009521
8009,Baca County,,CO,281,4017,4298,0,1,1,0,97,97,6,0.247448,0.252921,0,0,0.000004,2,0.000049,0,22,0,0
8011,Bent County,,CO,314,4409,4723,2,3,5,531,655,1186,6,0.272172,0.281006,0,0.000021,0.000084,2,0.000083,0,16,1,0.000246
8013,Boulder County,,CO,26683,305211,331894,172,139,311,82529,84872,167401,5,0.4262,0.45975,9120.700548,0.056135,0.046139,2,0.001337,0,16,0.515443,0.483211
8014,Broomfield County,,CO,13407,100850,114257,40,29,69,45376,44079,89455,5,0.378011,0.400704,47.696461,0.01569,0.012841,2,0.000367,0,16,0.893293,0.143682
8015,Chaffee County,,CO,1395,17835,19230,13,9,22,2253,1952,4205,5,0.329454,0.343348,1479.397443,0.002502,0.002143,2,0.000178,0,16,0.671429,0.025458
8017,Cheyenne County,,CO,160,2106,2266,0,0,0,0,0,0,0,0,0,0,0,0,5,0.000049,3,23,0,0
8019,Clear Creek County,,CO,1114,9540,10654,5,5,10,1846,1791,3637,6,0.317405,0.329256,0,0.001265,0.001706,2,0.000094,0,16,1,0.012854
8021,Conejos County,,CO,603,8071,8674,1,2,3,495,670,1165,6,0.260739,0.267795,0,0.000019,0.000016,2,0.000065,0,16,1,0.000169
8023,Costilla County,,CO,273,3118,3391,1,1,2,78,160,238,6,0.260716,0.26763,0,0.000019,0.000011,2,0.000065,0,16,0,0.000169
8025,Crowley County,,CO,340,2927,3267,2,2,4,401,523,924,6,0.272147,0.280841,0,0.00009,0.000081,2,0.000075,0,16,1,0.000879
8027,Custer County,,CO,340,4035,4375,3,3,6,383,479,862,5,0.327778,0.340376,0,0.000606,0.000645,2,0.000084,0,16,1,0.00577
8029,Delta County,,CO,2022,32345,34367,13,12,25,4126,3879,8005,5,0.353277,0.371349,11.625651,0.003206,0.003317,2,0.000168,0,16,0.912088,0.031679
8031,Denver County,,CO,78599,591065,669664,304,229,533,321049,295004,616053,5,0.460334,0.497628,54984.655305,0.079701,0.065269,2,0.00252,0,16,0.326872,0.6781
8033,Dolores County,,CO,156,2134,2290,0,1,1,0,126,126,6,0.260533,0.267343,0,0,0.000019,2,0.000049,0,24,0,0
8035,Douglas County,,CO,27417,305712,333129,144,107,251,102540,87462,190002,5,0.424765,0.454622,4918.954486,0.047049,0.039118,2,0.001187,0,16,0.56596,0.414288
8037,Eagle County,,CO,5632,51485,57117,32,40,72,10225,12939,23164,5,0.385222,0.409316,386.749029,0.012301,0.015807,2,0.000309,0,16,0.782317,0.113156
8039,Elbert County,,CO,1860,23657,25517,9,10,19,6852,5334,12186,5,0.352086,0.369616,32.07146,0.002304,0.003357,2,0.000145,0,16,0.844444,0.023366
8041,El Paso County,,CO,53379,663882,717261,419,381,800,189029,171285,360314,4,0.487134,0.53395,144498.768092,0.093329,0.086574,2,0.003562,0,16,0.217696,0.801722
8043,Fremont County,,CO,2908,42150,45058,18,14,32,5304,5137,10441,5,0.352619,0.370716,126.923712,0.003883,0.003377,2,0.000244,0,16,0.681287,0.038006
8045,Garfield County,,CO,5695,55660,61355,26,31,57,10399,11694,22093,5,0.366308,0.388484,1901.44369,0.007463,0.009298,2,0.000277,0,16,0.672348,0.069082
8047,Gilpin County,,CO,480,4145,4625,6,5,11,1561,1534,3095,6,0.317672,0.329504,0,0.002119,0.00176,2,0.0001,0,16,1,0.020725
8049,Grand County,,CO,1634,14108,15742,9,10,19,1924,2285,4209,5,0.329992,0.34409,0,0.00249,0.003041,2,0.000131,0,16,0.988889,0.025332
8051,Gunnison County,,CO,1606,14318,15924,10,12,22,1440,2101,3541,5,0.3301,0.344503,1.953288,0.002375,0.003044,2,0.000149,0,16,0.897436,0.024212
8053,Hinsdale County,,CO,82,831,913,0,0,0,0,0,0,0,0,0,0,0,0,6,0.000049,4,25,0,0
8055,Huerfano County,,CO,676,6523,7199,3,2,5,504,788,1292,5,0.327743,0.340211,0,0.000599,0.000622,2,0.00008,0,16,1,0.005649
8057,Jackson County,,CO,155,1462,1617,0,0,0,0,0,0,0,0,0,0,0,0,7,0.000049,5,26,0,0
8059,Jefferson County,,CO,49010,560646,609656,185,159,344,175285,168594,343879,5,0.440134,0.473578,26412.766187,0.054648,0.046796,2,0.001646,0,16,0.441915,0.480338
8061,Kiowa County,,CO,145,1526,1671,0,0,0,0,0,0,0,0,0,0,0,0,8,0.000049,6,27,0,0
8063,Kit Carson County,,CO,542,8295,8837,2,2,4,210,217,427,5,0.328027,0.340448,3008.73257,0.000858,0.00055,2,0.000066,0,16,0.333333,0.008291
8065,Lake County,,CO,881,6886,7767,5,8,13,722,1125,1847,5,0.329382,0.343155,0.268564,0.000904,0.002112,2,0.000094,0,16,0.916667,0.009211
8067,La Plata County,,CO,4191,50473,54664,29,35,64,7763,8714,16477,5,0.369571,0.392583,393.278394,0.008567,0.0112,2,0.000314,0,16,0.685256,0.080017
8069,Larimer County,,CO,23347,320041,343388,170,123,293,70487,65752,136239,5,0.425004,0.456768,20674.74479,0.047605,0.036184,2,0.001576,0,16,0.421486,0.420316
8071,Las Animas County,,CO,1117,15868,16985,7,9,16,1046,1811,2857,5,0.330496,0.344861,72.514604,0.00182,0.002152,2,0.000115,0,16,0.569444,0.017949
8073,Lincoln County,,CO,417,4963,5380,3,3,6,385,227,612,5,0.328133,0.340817,0,0.000751,0.000976,2,0.000078,0,16,1,0.006986
8075,Logan County,,CO,1331,20960,22291,12,13,25,2481,2466,4947,5,0.330028,0.344558,1364.633416,0.00209,0.002439,2,0.000234,0,16,0.544872,0.021442
8077,Mesa County,,CO,9298,158670,167968,67,66,133,23851,22142,45993,5,0.379004,0.406861,7207.117308,0.014561,0.016714,2,0.00071,0,16,0.42037,0.135644
8079,Mineral County,,CO,94,875,969,0,0,0,0,0,0,0,0,0,0,0,0,9,0.000049,7,28,0,0
8081,Moffat County,,CO,1362,14918,16280,6,7,13,947,1511,2458,5,0.329526,0.34321,284.556262,0.00107,0.001729,2,0.000108,0,16,0.833333,0.009875
8083,Montezuma County,,CO,1824,25608,27432,16,9,25,3074,2773,5847,5,0.352209,0.369726,3101.716982,0.003216,0.0023,2,0.000221,0,16,0.679739,0.029969
8085,Montrose County,,CO,2690,43456,46146,19,20,39,5593,6071,11664,5,0.357236,0.376686,5642.23317,0.004688,0.005229,2,0.000246,0,16,0.692857,0.045051
8087,Morgan County,,CO,2201,30380,32581,12,11,23,3666,4313,7979,5,0.330821,0.34507,2260.222046,0.003672,0.002419,2,0.000173,0,16,0.659341,0.035916
8089,Otero County,,CO,1292,19784,21076,8,11,19,1942,2412,4354,5,0.329992,0.344256,2967.60839,0.001475,0.002464,2,0.000172,0,16,0.609091,0.014554
8091,Ouray County,,CO,500,4250,4750,2,2,4,574,492,1066,6,0.263254,0.2707,0,0.000036,0.000032,2,0.000076,0,16,1,0.000435
8093,Park County,,CO,1689,15188,16877,9,12,21,3654,3658,7312,5,0.352209,0.370001,1.187922,0.002301,0.003178,2,0.000131,0,16,0.852564,0.023128
8095,Phillips County,,CO,373,4716,5089,3,2,5,244,240,484,6,0.282609,0.29228,0,0.000132,0.00014,2,0.000096,0,16,1,0.001513
8097,Pitkin County,,CO,1742,15228,16970,12,11,23,2973,3410,6383,5,0.358844,0.376995,7.050437,0.00488,0.004261,2,0.00014,0,16,0.92381,0.045045
8099,Prowers County,,CO,950,13079,14029,5,6,11,820,1090,1910,5,0.328703,0.341945,4006.649549,0.000601,0.001081,2,0.000148,0,16,0.52381,0.005759
8101,Pueblo County,,CO,7803,169078,176881,48,41,89,19529,17433,36962,5,0.373766,0.397617,11587.226208,0.012237,0.012891,2,0.000588,0,16,0.479167,0.114762
8103,Rio Blanco County,,CO,764,6763,7527,3,4,7,593,841,1434,6,0.275264,0.285595,0.923718,0.000163,0.000151,2,0.000079,0,16,0.583333,0.001446
8105,Rio Grande County,,CO,1277,14983,16260,6,8,14,1338,1850,3188,5,0.329669,0.343595,2095.046765,0.000827,0.001736,2,0.000164,0,16,0.625,0.007823
8107,Routt County,,CO,2388,23348,25736,15,16,31,3176,3680,6856,5,0.357869,0.376714,31.508859,0.003526,0.00523,2,0.000185,0,16,0.908088,0.034887
8109,Saguache County,,CO,340,3625,3965,3,2,5,388,292,680,6,0.260739,0.267795,0.833333,0.000042,0.000016,2,0.000099,0,16,0.333333,0.000489
8111,San Juan County,,CO,91,595,686,0,0,0,0,0,0,0,0,0,0,0,0,10,0.000049,8,29,0,0
8113,San Miguel County,,CO,913,6591,7504,5,6,11,550,940,1490,6,0.316642,0.328266,570.658585,0.000786,0.000964,2,0.000119,0,16,0.733333,0.008048
8115,Sedgwick County,,CO,222,2575,2797,0,0,0,0,0,0,0,0,0,0,0,0,11,0.000049,9,30,0,0
8117,Summit County,,CO,4060,29636,33696,25,23,48,6403,8325,14728,5,0.363277,0.383366,396.917541,0.00771,0.006026,2,0.000262,0,16,0.688424,0.072052
8119,Teller County,,CO,2429,25274,27703,12,12,24,5029,5102,10131,5,0.353236,0.371212,14.795346,0.004006,0.004077,2,0.000162,0,16,0.891026,0.038724
8121,Washington County,,CO,384,4741,5125,3,4,7,455,636,1091,6,0.282661,0.29261,0.25,0.000031,0.000165,2,0.0001,0,16,0.916667,0.000558
8123,Weld County,,CO,20087,263026,283113,82,74,156,70144,58341,128485,5,0.393786,0.421921,19178.65349,0.021709,0.019615,2,0.000895,0,16,0.426535,0.199461
8125,Yuma County,,CO,746,10555,11301,6,5,11,794,788,1582,6,0.299634,0.310443,205.814337,0.00058,0.000422,2,0.000128,0,16,0.690476,0.006275
9001,Fairfield County,,CT,41826,994523,1036349,177,212,389,141824,145653,287477,5,0.434701,0.47552,4263.931251,0.061487,0.067891,69,0.00114,0,16,0.506908,0.512057
9003,Hartford County,,CT,41768,1063133,1104901,194,216,410,129149,142620,271769,5,0.434577,0.475669,8871.716852,0.064302,0.068298,69,0.001278,0,16,0.48786,0.536217
9005,Litchfield County,,CT,9877,228914,238791,31,51,82,27207,27331,54538,5,0.376788,0.401502,85.009197,0.011963,0.020251,69,0.000216,0,16,0.83164,0.096653
9007,Middlesex County,,CT,10730,197243,207973,34,45,79,32684,31775,64459,5,0.379622,0.404171,40.68059,0.013844,0.017843,69,0.000236,0,16,0.855496,0.113226
9009,New Haven County,,CT,41224,985211,1026435,179,207,386,123004,140036,263040,5,0.435326,0.475641,3576.088147,0.061014,0.067661,69,0.001147,0,16,0.523018,0.506734
9011,New London County,,CT,18378,322866,341244,99,121,220,44522,50671,95193,5,0.399288,0.433141,633.591833,0.034213,0.042575,69,0.000638,0,16,0.619278,0.281672
9013,Tolland County,,CT,10230,166445,176675,25,35,60,30107,29474,59581,5,0.372938,0.395587,20.747408,0.009391,0.014494,69,0.000183,0,16,0.911095,0.076097
9015,Windham County,,CT,7060,135795,142855,20,26,46,16027,18860,34887,5,0.362104,0.382992,1.850872,0.005832,0.009966,69,0.000147,0,16,0.922414,0.044185
10001,Kent County,,DE,10313,180320,190633,72,62,134,30340,18792,49132,5,0.39099,0.418064,1626.371747,0.025349,0.023565,69,0.000495,0,16,0.704966,0.207856
10003,New Castle County,,DE,26602,625755,652357,140,164,304,80550,82806,163356,5,0.42662,0.462947,3417.62104,0.050533,0.058023,69,0.000905,0,16,0.638459,0.417717
10005,Sussex County,,DE,9029,214023,223052,84,63,147,30156,22765,52921,5,0.376086,0.40268,1560.503935,0.025516,0.02038,69,0.000557,0,16,0.616818,0.205128
11001,District of Columbia,,DC,58001,575642,633643,303,234,537,235640,219677,455317,5,0.456037,0.494894,23274.191409,0.085545,0.073369,98,0.002158,0,16,0.378565,0.713419
12001,Alachua County,,FL,22250,231611,253861,117,137,254,60028,70176,130204,5,0.429889,0.463052,6443.812737,0.040736,0.050118,12,0.000943,0,16,0.62176,0.358508
12003,Baker County,,FL,1700,26882,28582,10,12,22,4393,4488,8881,5,0.343814,0.359761,71.196773,0.001942,0.003216,12,0.000138,0,16,0.742424,0.017202
12005,Bay County,,FL,15284,183899,199183,113,119,232,32372,33104,65476,5,0.4159,0.448993,14479.107768,0.033761,0.037156,12,0.00097,0,16,0.497812,0.301924
12007,Bradford County,,FL,1980,25229,27209,9,11,20,4779,5446,10225,5,0.342647,0.358287,24.247947,0.002024,0.002919,12,0.000121,0,16,0.863636,0.017629
12009,Brevard County,,FL,33113,617994,651107,277,240,517,102085,91342,193427,5,0.448874,0.490079,14004.910827,0.080136,0.073441,12,0.001928,0,16,0.371559,0.668153
12011,Broward County,,FL,121299,1915575,2036874,430,438,868,526793,506196,1032989,5,0.49005,0.542214,98137.384544,0.100344,0.098157,12,0.003208,0,16,0.210647,0.846637
12013,Calhoun County,,FL,923,12289,13212,5,5,10,1982,1897,3879,6,0.3043,0.316221,6.258297,0.000552,0.000476,12,0.000122,0,16,0.65,0.004438
12015,Charlotte County,,FL,13442,166724,180166,94,62,156,36445,32499,68944,5,0.393837,0.421173,228.731696,0.034677,0.024454,12,0.000598,0,16,0.718586,0.279313
12017,Citrus County,,FL,9485,151401,160886,55,41,96,21660,20132,41792,5,0.380193,0.404253,109.764154,0.020746,0.016237,12,0.000414,0,16,0.825424,0.175618
12019,Clay County,,FL,20890,214450,235340,87,97,184,61686,58404,120090,5,0.403705,0.435012,2342.743574,0.030486,0.03458,12,0.000677,0,16,0.610893,0.268565
12021,Collier County,,FL,23567,341377,364944,187,165,352,78235,72685,150920,5,0.433954,0.469616,3259.211197,0.061023,0.057289,12,0.001226,0,16,0.502172,0.497055
12023,Columbia County,,FL,4906,65465,70371,32,34,66,13249,12384,25633,5,0.347163,0.366722,3191.895257,0.008613,0.009464,12,0.000314,0,16,0.600794,0.074997
12027,DeSoto County,,FL,2185,28473,30658,14,12,26,4626,4800,9426,5,0.343736,0.360047,2.889015,0.005509,0.004911,12,0.000148,0,16,0.928571,0.048923
12029,Dixie County,,FL,1074,13003,14077,8,7,15,1701,1830,3531,5,0.335437,0.350083,1.782304,0.001814,0.001315,12,0.000122,0,16,0.805556,0.015961
12031,Duval County,,FL,69199,973599,1042798,373,350,723,226604,231956,458560,5,0.475809,0.522681,79231.530981,0.092991,0.089151,12,0.002865,0,16,0.268722,0.788107
12033,Escambia County,,FL,27190,318206,345396,178,167,345,69421,77187,146608,5,0.432962,0.469275,12488.045337,0.055236,0.052295,12,0.001414,0,16,0.46143,0.48862
12035,Flagler County,,FL,8807,102331,111138,65,44,109,24883,19871,44754,5,0.376929,0.400924,42.464596,0.025909,0.018727,12,0.000435,0,16,0.838235,0.212807
12037,Franklin County,,FL,712,9719,10431,4,4,8,806,1016,1822,6,0.304269,0.316056,0.666667,0.000538,0.000455,12,0.000099,0,16,0.833333,0.004197
12039,Gadsden County,,FL,3451,50186,53637,15,13,28,9791,10152,19943,5,0.344949,0.361439,367.297527,0.004392,0.004018,12,0.000204,0,16,0.585714,0.038323
12041,Gilchrist County,,FL,1565,15135,16700,7,7,14,3638,3368,7006,5,0.335437,0.350083,0.443452,0.001583,0.001341,12,0.000109,0,16,0.910714,0.0137
12043,Glades County,,FL,989,8633,9622,9,8,17,2897,2432,5329,5,0.343775,0.359404,0.071429,0.00326,0.003019,12,0.000111,0,16,0.972222,0.028576
12045,Gulf County,,FL,1110,13231,14341,4,4,8,1668,1894,3562,6,0.304269,0.316056,0.666667,0.000524,0.000444,12,0.000105,0,16,0.833333,0.004108
12047,Hamilton County,,FL,943,12156,13099,6,8,14,1844,2266,4110,5,0.336705,0.351843,0.814009,0.001368,0.002007,12,0.000102,0,16,0.821429,0.012282
12049,Hardee County,,FL,1972,25158,27130,6,9,15,3525,4479,8004,5,0.343074,0.358809,0,0.001985,0.0036,12,0.000095,0,16,1,0.018098
12051,Hendry County,,FL,3544,36728,40272,11,16,27,8167,9314,17481,5,0.345895,0.363173,4.549245,0.0042,0.006029,12,0.000129,0,16,0.854167,0.03692
12053,Hernando County,,FL,13650,180852,194502,66,60,126,38350,34157,72507,5,0.394452,0.421338,58.617302,0.026816,0.024944,12,0.000456,0,16,0.835285,0.220725
12055,Highlands County,,FL,6304,97943,104247,35,32,67,13895,14026,27921,5,0.365028,0.386393,125.349097,0.011483,0.011388,12,0.000294,0,16,0.76746,0.1003
12057,Hillsborough County,,FL,90764,1309952,1400716,571,503,1074,411169,390416,801585,4,0.503742,0.558435,245505.129063,0.109354,0.101946,12,0.004458,0,16,0.141167,0.92274
12059,Holmes County,,FL,1501,18137,19638,7,9,16,3459,3839,7298,6,0.312784,0.326268,4.513015,0.000686,0.001221,12,0.000115,0,16,0.861111,0.006121
12061,Indian River County,,FL,9462,150685,160147,66,50,116,26032,21460,47492,5,0.387489,0.413057,125.297506,0.025125,0.022413,12,0.000453,0,16,0.819825,0.208047
12063,Jackson County,,FL,2967,47092,50059,18,20,38,5873,6497,12370,5,0.346132,0.363695,606.268905,0.005583,0.004934,12,0.000206,0,16,0.603896,0.048523
12065,Jefferson County,,FL,1086,14212,15298,5,4,9,1983,2308,4291,6,0.301034,0.312347,1.511914,0.000955,0.000298,12,0.000104,0,16,0.7,0.008382
12067,Lafayette County,,FL,371,6108,6479,2,3,5,813,603,1416,6,0.257831,0.265462,0.111111,0.0001,0.000108,12,0.000065,0,16,0.666667,0.000902
12069,Lake County,,FL,25549,321813,347362,141,106,247,88579,73919,162498,5,0.412614,0.444316,961.272379,0.049863,0.040166,12,0.000945,0,16,0.630108,0.410574
12071,Lee County,,FL,47948,647577,695525,357,308,665,163050,139954,303004,5,0.460404,0.50668,35221.781193,0.087562,0.081754,12,0.002505,0,16,0.262849,0.723754
12073,Leon County,,FL,23972,261046,285018,133,152,285,68166,78059,146225,5,0.430133,0.46506,29608.870314,0.040561,0.050844,12,0.00121,0,16,0.521391,0.362565
12075,Levy County,,FL,3361,40098,43459,18,17,35,8445,8606,17051,5,0.345185,0.362182,36.210958,0.006586,0.006359,12,0.000186,0,16,0.839181,0.058079
12077,Liberty County,,FL,525,6686,7211,4,3,7,965,965,1930,6,0.300854,0.311935,0.5,0.000355,0.000268,12,0.000099,0,16,0.833333,0.002848
12079,Madison County,,FL,1077,18396,19473,10,9,19,1657,2000,3657,5,0.342957,0.358507,99.768359,0.002269,0.002215,12,0.000149,0,16,0.711111,0.019809
12081,Manatee County,,FL,24170,338371,362541,185,135,320,82131,68479,150610,5,0.427523,0.460823,2271.642593,0.060295,0.050201,12,0.001248,0,16,0.52574,0.495792
12083,Marion County,,FL,21510,355561,377071,158,129,287,69069,60032,129101,5,0.428248,0.460906,4672.006247,0.053542,0.046247,12,0.001088,0,16,0.558359,0.441356
12085,Martin County,,FL,11433,150412,161845,63,51,114,34691,31005,65696,5,0.386796,0.412507,89.711618,0.02534,0.021254,12,0.000439,0,16,0.858648,0.212146
12086,Miami-Dade County,,FL,119866,2685923,2805789,454,480,934,474659,551491,1026150,5,0.500248,0.553742,199288.075622,0.102382,0.099601,12,0.003553,0,16,0.182169,0.867291
12087,Monroe County,,FL,8902,78808,87710,62,55,117,18131,18862,36993,5,0.388682,0.414955,47.214305,0.024368,0.022936,12,0.000458,0,16,0.819693,0.20997
12089,Nassau County,,FL,5913,81310,87223,29,26,55,14828,12938,27766,5,0.350092,0.369407,231.169138,0.010296,0.00896,12,0.000264,0,16,0.75504,0.090701
12091,Okaloosa County,,FL,23365,209742,233107,169,168,337,55479,61093,116572,5,0.43759,0.473033,15051.091854,0.049296,0.050407,12,0.001374,0,16,0.44453,0.436411
12093,Okeechobee County,,FL,2835,37417,40252,14,16,30,5343,5733,11076,5,0.3444,0.361164,2.947974,0.004791,0.005608,12,0.00015,0,16,0.8875,0.04254
12095,Orange County,,FL,113618,1210804,1324422,397,374,771,407246,403524,810770,4,0.47551,0.525091,49209.080044,0.097564,0.093701,12,0.002895,0,16,0.24935,0.820214
12097,Osceola County,,FL,36359,283555,319914,144,129,273,122119,112528,234647,5,0.41762,0.451579,680.659476,0.052455,0.048505,12,0.000939,0,16,0.670381,0.434144
12099,Palm Beach County,,FL,73987,1387864,1461851,360,370,730,308142,280734,588876,5,0.471733,0.5218,44448.742982,0.092298,0.091554,12,0.002579,0,16,0.265589,0.777365
12101,Pasco County,,FL,39140,484953,524093,213,195,408,139512,122080,261592,5,0.43778,0.476395,5297.654574,0.06704,0.06276,12,0.001403,0,16,0.446009,0.550104
12103,Pinellas County,,FL,58761,1001505,1060266,383,374,757,217869,207224,425093,5,0.474914,0.524689,54861.08905,0.093792,0.092022,12,0.002782,0,16,0.244347,0.783808
12105,Polk County,,FL,42793,637653,680446,257,234,491,146425,136562,282987,5,0.444656,0.486591,12203.575481,0.074297,0.068861,12,0.001749,0,16,0.363052,0.61283
12107,Putnam County,,FL,5140,74083,79223,21,20,41,11783,12559,24342,5,0.3455,0.362953,7.334883,0.007615,0.007532,12,0.000195,0,16,0.930952,0.066551
12109,St. Johns County,,FL,15340,196487,211827,131,82,213,59518,42262,101780,5,0.406577,0.435787,1214.981383,0.046697,0.032903,12,0.00095,0,16,0.658586,0.399808
12111,St. Lucie County,,FL,23524,295533,319057,127,103,230,74454,65195,139649,5,0.409934,0.441614,517.751017,0.045229,0.040028,12,0.000815,0,16,0.673484,0.372122
12113,Santa Rosa County,,FL,15987,157256,173243,96,83,179,43192,39739,82931,5,0.400767,0.430406,2671.637425,0.031022,0.029878,12,0.000793,0,16,0.579596,0.275837
12115,Sarasota County,,FL,28611,408468,437079,222,173,395,100243,85416,185659,5,0.430256,0.467426,3818.177035,0.067852,0.060435,12,0.001464,0,16,0.453097,0.554174
12117,Seminole County,,FL,46548,456336,502884,184,186,370,157017,157148,314165,5,0.441224,0.47793,2644.444705,0.064481,0.066214,12,0.001278,0,16,0.56926,0.542637
12119,Sumter County,,FL,4839,86146,90985,96,22,118,25881,13771,39652,5,0.346528,0.364603,18.616183,0.034651,0.00908,12,0.000622,0,16,0.724671,0.279482
12121,Suwannee County,,FL,3010,39445,42455,23,26,49,7720,7733,15453,5,0.34633,0.364768,2682.212673,0.007013,0.007506,12,0.000244,0,16,0.622507,0.060873
12123,Taylor County,,FL,1145,20983,22128,10,8,18,1518,1721,3239,5,0.342647,0.357956,484.204861,0.002744,0.00234,12,0.000144,0,16,0.663636,0.023601
12125,Union County,,FL,998,11437,12435,7,7,14,2768,2641,5409,6,0.323473,0.337218,0.907955,0.00116,0.001281,12,0.000103,0,16,0.857143,0.009533
12127,Volusia County,,FL,35741,539654,575395,240,216,456,107945,104475,212420,5,0.439942,0.480626,8109.984038,0.072316,0.069034,12,0.001642,0,16,0.413273,0.602097
12129,Wakulla County,,FL,2283,29549,31832,9,9,18,6387,5096,11483,5,0.343463,0.359194,212.427288,0.002305,0.002821,12,0.000148,0,16,0.7,0.020036
12131,Walton County,,FL,4997,50675,55672,31,22,53,13911,11049,24960,5,0.361931,0.382194,652.014943,0.009638,0.007703,12,0.000295,0,16,0.735795,0.085272
12133,Washington County,,FL,2095,22502,24597,9,9,18,4788,5154,9942,5,0.337493,0.352779,30.341586,0.002103,0.001853,12,0.000123,0,16,0.9,0.018253
13001,Appling County,,GA,983,18508,19491,9,9,18,1694,1679,3373,6,0.308767,0.321052,738.737968,0.000488,0.000479,14,0.000204,0,16,0.5,0.004828
13003,Atkinson County,,GA,631,8449,9080,3,2,5,974,1189,2163,6,0.25676,0.263882,3.642165,0.000024,0.000017,14,0.000114,0,16,0.333333,0.00056
13005,Bacon County,,GA,613,10637,11250,4,5,9,1061,1224,2285,6,0.258668,0.266694,4.787814,0.00003,0.000046,14,0.000124,0,16,0.7,0.000683
13007,Baker County,,GA,293,3365,3658,2,2,4,372,522,894,6,0.269268,0.278244,0,0.000061,0.000059,14,0.000078,0,16,1,0.000652
13009,Baldwin County,,GA,2797,43356,46153,15,18,33,5938,7214,13152,5,0.328703,0.345692,3457.486419,0.002676,0.003571,14,0.000217,0,16,0.602339,0.02344
13011,Banks County,,GA,1738,18091,19829,10,10,20,5470,5577,11047,6,0.318976,0.332591,2.509205,0.000799,0.00077,14,0.000156,0,16,0.811111,0.007254
13013,Barrow County,,GA,6093,73883,79976,21,19,40,21683,17053,38736,5,0.346647,0.365385,423.681629,0.004366,0.004217,14,0.000242,0,16,0.666008,0.03895
13015,Bartow County,,GA,7996,108770,116766,27,32,59,20833,20016,40849,5,0.366885,0.389612,516.501504,0.005,0.007876,14,0.000273,0,16,0.569069,0.044332
13017,Ben Hill County,,GA,1362,18315,19677,6,8,14,2407,2463,4870,6,0.292912,0.305277,157.884323,0.000189,0.00037,14,0.000146,0,16,0.482143,0.00183
13019,Berrien County,,GA,1622,17653,19275,6,6,12,3336,3151,6487,6,0.282372,0.293381,210.458649,0.000167,0.000141,14,0.000208,0,16,0.4,0.00165
13021,Bibb County,,GA,10602,165345,175947,62,70,132,28907,32742,61649,5,0.391394,0.419742,20705.273879,0.014037,0.016889,14,0.000666,0,16,0.424843,0.124586
13023,Bleckley County,,GA,730,12676,13406,6,6,12,1763,1533,3296,6,0.291278,0.302564,4.578225,0.000285,0.000262,14,0.000139,0,16,0.766667,0.00272
13025,Brantley County,,GA,1216,16299,17515,7,7,14,3453,2981,6434,6,0.322956,0.336558,2.947194,0.000704,0.000712,12,0.000135,0,16,0.785714,0.006448
13027,Brooks County,,GA,1482,16192,17674,5,4,9,3730,3741,7471,6,0.280749,0.291361,48.390026,0.000699,0.000161,14,0.000113,0,16,0.8,0.006338
13029,Bryan County,,GA,4300,33589,37889,28,15,43,11072,8646,19718,5,0.350822,0.369214,521.448938,0.008,0.004404,14,0.000283,0,16,0.687356,0.071931
13031,Bulloch County,,GA,4924,55928,60852,34,36,70,13321,13683,27004,5,0.359867,0.382084,2289.669843,0.006615,0.008169,14,0.000401,0,16,0.468961,0.057591
13033,Burke County,,GA,1687,25649,27336,11,11,22,4376,5199,9575,5,0.326859,0.342385,225.484019,0.001814,0.00186,58,0.000179,0,16,0.6,0.01651
13035,Butts County,,GA,2117,23539,25656,12,11,23,5861,5846,11707,6,0.325874,0.341048,8.24294,0.002224,0.002189,14,0.000153,0,16,0.801282,0.019776
13037,Calhoun County,,GA,368,5450,5818,3,2,5,480,461,941,6,0.269316,0.278354,1.033333,0.000063,0.000059,14,0.0001,0,16,0.666667,0.000715
13039,Camden County,,GA,7064,52145,59209,34,39,73,11410,12580,23990,5,0.368491,0.392759,870.090836,0.01024,0.012845,12,0.000319,0,16,0.642857,0.090419
13043,Candler County,,GA,809,10194,11003,6,6,12,2014,1848,3862,6,0.308452,0.320199,3.189578,0.000408,0.000411,14,0.000137,0,16,0.833333,0.003896
13045,Carroll County,,GA,8967,114268,123235,39,40,79,25035,25478,50513,5,0.362537,0.385826,5146.095753,0.008984,0.008858,14,0.000373,0,16,0.520833,0.079147
13047,Catoosa County,,GA,5222,65814,71036,14,13,27,17049,15412,32461,6,0.325384,0.341576,237.069153,0.001886,0.002003,77,0.000191,0,16,0.638095,0.016987
13049,Charlton County,,GA,819,9446,10265,6,6,12,1773,1733,3506,6,0.322783,0.336173,3.499802,0.00069,0.000708,12,0.000113,0,16,0.7,0.006317
13051,Chatham County,,GA,21626,262847,284473,219,196,415,74209,70138,144347,5,0.445245,0.482194,58448.799609,0.060659,0.056769,14,0.001831,0,16,0.39767,0.525148
13053,Chattahoochee County,,GA,3769,6740,10509,23,28,51,6038,7974,14012,5,0.357025,0.377891,438.529987,0.006143,0.006985,14,0.000233,0,16,0.708046,0.055405
13055,Chattooga County,,GA,1384,26089,27473,9,11,20,2678,3582,6260,6,0.32493,0.340778,280.58924,0.000874,0.001387,14,0.000132,0,16,0.7,0.007972
13057,Cherokee County,,GA,15995,228883,244878,84,76,160,56910,47679,104589,5,0.397663,0.426593,2787.547531,0.026628,0.025789,14,0.000691,0,16,0.583548,0.233407
13059,Clarke County,,GA,12578,94831,107409,72,78,150,28131,33614,61745,5,0.395276,0.424722,12656.03054,0.017596,0.022965,14,0.00068,0,16,0.465526,0.15805
13061,Clay County,,GA,207,3136,3343,0,0,0,0,0,0,0,0,0,0,0,0,13,0.000049,10,31,0,0
13063,Clayton County,,GA,41226,278030,319256,152,147,299,141447,150852,292299,5,0.4329,0.467178,12508.362501,0.047757,0.048349,14,0.001173,0,16,0.515942,0.408776
13065,Clinch County,,GA,380,6760,7140,2,3,5,494,663,1157,6,0.280775,0.291306,1.664286,0.000142,0.000134,14,0.000073,0,16,0.666667,0.001307
13067,Cobb County,,GA,71001,753097,824098,324,302,626,253476,259160,512636,5,0.465857,0.510135,60063.461751,0.084704,0.081504,14,0.002532,0,16,0.309249,0.721813
13069,Coffee County,,GA,2279,40674,42953,16,14,30,4092,3772,7864,5,0.345264,0.363019,13649.268121,0.002682,0.001749,14,0.000321,0,16,0.359477,0.024299
13071,Colquitt County,,GA,2243,44306,46549,15,18,33,5142,6230,11372,5,0.347004,0.364768,1915.35941,0.002961,0.003696,14,0.000231,0,16,0.523684,0.026216
13073,Columbia County,,GA,11239,129528,140767,73,64,137,38682,29168,67850,5,0.387638,0.415143,9816.299457,0.02289,0.021587,58,0.000677,0,16,0.550521,0.205781
13075,Cook County,,GA,1308,16919,18227,6,6,12,3234,3156,6390,6,0.282424,0.293491,8.663812,0.000189,0.000162,14,0.000171,0,16,0.6,0.001829
13077,Coweta County,,GA,9389,138108,147497,59,73,132,32356,32082,64438,5,0.395328,0.423979,8333.118188,0.016738,0.020428,14,0.00053,0,16,0.468126,0.149258
13079,Crawford County,,GA,1196,13105,14301,4,5,9,2603,2878,5481,6,0.291026,0.302014,0.7,0.000271,0.000255,14,0.000097,0,16,0.85,0.002491
13081,Crisp County,,GA,1476,22277,23753,14,13,27,3595,3594,7189,5,0.327601,0.34376,2751.381403,0.002679,0.001724,14,0.000216,0,16,0.590476,0.024078
13083,Dade County,,GA,1144,16346,17490,6,6,12,2549,2903,5452,6,0.296961,0.308177,2.61335,0.000252,0.000262,77,0.000121,0,16,0.733333,0.00272
13085,Dawson County,,GA,2009,21893,23902,10,10,20,6611,5583,12194,6,0.325874,0.340855,1.611742,0.002351,0.002446,14,0.00014,0,16,0.9,0.021216
13087,Decatur County,,GA,1672,29153,30825,12,11,23,3218,3265,6483,6,0.324304,0.34036,6776.588962,0.001669,0.001081,12,0.000237,0,16,0.455128,0.015004
13089,DeKalb County,,GA,87934,696335,784269,313,293,606,328683,346854,675537,5,0.467294,0.510108,83671.19425,0.081486,0.07776,14,0.002496,0,16,0.306462,0.694169
13091,Dodge County,,GA,1096,19605,20701,6,6,12,1838,2230,4068,6,0.29139,0.302729,66.673331,0.000285,0.000261,14,0.000143,0,16,0.7,0.002711
13093,Dooly County,,GA,829,10793,11622,5,4,9,1525,1872,3397,6,0.288806,0.299351,4.229167,0.00019,0.000171,14,0.000128,0,16,0.6,0.001963
13095,Dougherty County,,GA,7758,97257,105015,42,44,86,19993,22277,42270,5,0.368402,0.393006,28759.117937,0.009955,0.010277,14,0.000536,0,16,0.442646,0.087302
13097,Douglas County,,GA,16228,136795,153023,69,68,137,50491,49669,100160,5,0.398868,0.427006,1568.349215,0.023594,0.023613,14,0.00054,0,16,0.652213,0.203813
13099,Early County,,GA,655,11725,12380,5,6,11,805,1157,1962,6,0.27382,0.284797,238.718336,0.000142,0.000131,12,0.000173,0,16,0.466667,0.00138
13101,Echols County,,GA,206,3186,3392,1,1,2,541,657,1198,6,0.280567,0.290646,0,0.000129,0.00011,14,0.000058,0,16,0,0.001033
13103,Effingham County,,GA,4252,55982,60234,11,11,22,11913,10311,22224,5,0.329992,0.34639,75.30362,0.002583,0.002989,14,0.000157,0,16,0.712121,0.023495
13105,Elbert County,,GA,1230,23266,24496,6,7,13,1906,2485,4391,6,0.31901,0.332315,31.362361,0.000701,0.000692,14,0.00011,0,16,0.761905,0.006277
13107,Emanuel County,,GA,1532,23891,25423,10,12,22,2516,2894,5410,5,0.324721,0.34074,1306.437603,0.000433,0.001198,14,0.000227,0,16,0.431818,0.00446
13109,Evans County,,GA,890,11046,11936,5,7,12,1712,2031,3743,6,0.324165,0.338263,19.142232,0.000415,0.001003,14,0.000121,0,16,0.738095,0.004149
13111,Fannin County,,GA,1349,23765,25114,12,10,22,2716,2417,5133,6,0.324269,0.33965,287.820689,0.002675,0.001842,14,0.000191,0,16,0.538462,0.024052
13113,Fayette County,,GA,9426,119008,128434,53,48,101,28124,26071,54195,5,0.388682,0.41413,1107.808366,0.018615,0.017998,14,0.000436,0,16,0.693169,0.162874
13115,Floyd County,,GA,5170,101934,107104,24,29,53,11508,13245,24753,5,0.366219,0.388566,1827.384024,0.003622,0.006641,14,0.000249,0,16,0.526738,0.032323
13117,Forsyth County,,GA,11777,182114,193891,73,62,135,50192,33276,83468,5,0.393172,0.420172,2045.961099,0.024871,0.021446,14,0.000605,0,16,0.609868,0.217962
13119,Franklin County,,GA,1834,24474,26308,11,13,24,5159,5034,10193,6,0.323992,0.339623,17.727044,0.000834,0.001395,14,0.00017,0,16,0.705128,0.007799
13121,Fulton County,,GA,107644,869068,976712,413,387,800,481110,457820,938930,5,0.475436,0.526697,188216.844081,0.092519,0.088487,14,0.003401,0,16,0.217374,0.787955
13123,Gilmer County,,GA,2019,28841,30860,13,12,25,3565,3645,7210,6,0.324235,0.339815,53.861571,0.002527,0.002022,14,0.00016,0,16,0.758242,0.022502
13125,Glascock County,,GA,183,2983,3166,3,2,5,227,146,373,6,0.243,0.249065,0,0.00024,0.000005,58,0.000098,0,16,1,0.002051
13127,Glynn County,,GA,5782,82704,88486,39,41,80,11328,11237,22565,5,0.364852,0.388148,1557.992547,0.010078,0.011994,12,0.000405,0,16,0.582126,0.089619
13129,Gordon County,,GA,3868,61910,65778,16,16,32,9721,9046,18767,6,0.327318,0.343606,62.66894,0.002137,0.002625,14,0.00019,0,16,0.650327,0.019148
13131,Grady County,,GA,1577,24896,26473,10,9,19,4323,3975,8298,5,0.336406,0.351651,304.694151,0.001288,0.001138,14,0.000163,0,16,0.644444,0.011294
13133,Greene County,,GA,1078,17109,18187,6,9,15,1793,1950,3743,6,0.325629,0.340442,3043.311484,0.001619,0.00171,14,0.000099,0,16,0.708333,0.014177
13135,Gwinnett County,,GA,69928,861106,931034,312,310,622,271268,254454,525722,5,0.467438,0.512199,83249.710511,0.081979,0.080739,14,0.002463,0,16,0.304173,0.698813
13137,Habersham County,,GA,2798,44816,47614,13,14,27,7330,6943,14273,6,0.325839,0.341323,34.467034,0.001819,0.001887,14,0.000193,0,16,0.615385,0.016363
13139,Hall County,,GA,12901,196155,209056,62,58,120,35095,34428,69523,5,0.387836,0.41435,4724.045305,0.015518,0.01645,14,0.000605,0,16,0.478471,0.140072
13141,Hancock County,,GA,563,9245,9808,2,2,4,644,854,1498,6,0.318674,0.330758,0,0.00003,0.000496,14,0.000071,0,16,0.833333,0.000288
13143,Haralson County,,GA,2246,29697,31943,9,10,19,6668,6233,12901,6,0.32605,0.341103,415.026081,0.001813,0.001863,14,0.000125,0,16,0.818182,0.016063
13145,Harris County,,GA,2444,33308,35752,9,9,18,7473,6561,14034,5,0.324478,0.339914,63.244417,0.000991,0.001086,14,0.000143,0,16,0.655556,0.009382
13147,Hart County,,GA,1566,26744,28310,10,10,20,3965,3493,7458,6,0.322097,0.336052,18.552613,0.001702,0.001283,14,0.000149,0,16,0.781818,0.015336
13149,Heard County,,GA,1056,10987,12043,4,4,8,2350,2568,4918,6,0.284146,0.294608,20.254901,0.000718,0.000181,14,0.000082,0,16,0.9,0.006427
13151,Henry County,,GA,20691,214507,235198,107,96,203,76683,65557,142240,5,0.406632,0.437818,5421.356282,0.034135,0.031185,14,0.000856,0,16,0.554598,0.296195
13153,Houston County,,GA,12689,154552,167241,101,93,194,35663,30831,66494,5,0.405652,0.436052,43258.397633,0.025378,0.026118,14,0.001002,0,16,0.405847,0.226561
13155,Irwin County,,GA,866,9193,10059,5,4,9,2156,2007,4163,6,0.266286,0.275041,4.482968,0.000061,0.000047,14,0.000135,0,16,0.6,0.000814
13157,Jackson County,,GA,5361,63722,69083,21,18,39,17581,15017,32598,6,0.32626,0.342341,466.523842,0.003195,0.002486,14,0.000268,0,16,0.580952,0.029328
13159,Jasper County,,GA,1189,14989,16178,10,9,19,3142,3588,6730,6,0.321926,0.335666,1.476248,0.001848,0.001356,14,0.000135,0,16,0.888889,0.016597
13161,Jeff Davis County,,GA,911,14428,15339,6,4,10,1645,1454,3099,6,0.259066,0.267217,19.334461,0.000023,0.000024,14,0.000172,0,16,0.433333,0.000639
13163,Jefferson County,,GA,989,20112,21101,7,7,14,1892,2439,4331,6,0.295772,0.307698,694.686086,0.000392,0.000362,58,0.000169,0,16,0.428571,0.003624
13165,Jenkins County,,GA,561,8438,8999,5,5,10,1052,1263,2315,6,0.295685,0.307313,2.188363,0.000302,0.000264,14,0.000112,0,16,0.85,0.002629
13167,Johnson County,,GA,524,8391,8915,3,3,6,1124,1152,2276,6,0.255246,0.262743,0.900433,0.000041,0.00003,14,0.00009,0,16,0.666667,0.000478
13169,Jones County,,GA,2221,30570,32791,8,8,16,6347,5780,12127,6,0.291306,0.302867,21.459625,0.000305,0.000286,14,0.000152,0,16,0.527778,0.002998
13171,Lamar County,,GA,1389,17464,18853,11,10,21,4509,3991,8500,6,0.325105,0.340024,4.492178,0.001728,0.001658,14,0.000146,0,16,0.827273,0.015601
13173,Lanier County,,GA,1032,7858,8890,4,3,7,2882,2171,5053,6,0.280671,0.291086,1.166667,0.000132,0.000112,14,0.000132,0,16,0.666667,0.001259
13175,Laurens County,,GA,2525,54314,56839,24,24,48,4684,5277,9961,5,0.342415,0.360889,18653.098158,0.00433,0.004204,14,0.000372,0,16,0.396923,0.039047
13177,Lee County,,GA,3210,31950,35160,10,13,23,8768,7087,15855,5,0.327283,0.344212,820.63143,0.000942,0.002376,14,0.000176,0,16,0.566667,0.008524
13179,Liberty County,,GA,14015,61188,75203,86,91,177,28641,36263,64904,5,0.403705,0.433966,6118.032306,0.02856,0.028536,14,0.000731,0,16,0.575131,0.25271
13181,Lincoln County,,GA,525,8686,9211,4,4,8,836,1002,1838,6,0.295339,0.30668,1.669484,0.000367,0.000347,58,0.000105,0,16,0.75,0.003285
13183,Long County,,GA,1568,9179,10747,5,4,9,5138,3343,8481,6,0.308767,0.320221,11.123818,0.000901,0.000543,14,0.000101,0,16,0.75,0.008383
13185,Lowndes County,,GA,9621,102824,112445,74,81,155,23665,24692,48357,5,0.389933,0.419709,39214.196389,0.018606,0.02193,14,0.000828,0,16,0.43712,0.16656
13187,Lumpkin County,,GA,2597,26917,29514,12,12,24,5624,5870,11494,6,0.326014,0.341295,14.236457,0.002779,0.002479,14,0.000167,0,16,0.730769,0.025384
13189,McDuffie County,,GA,1430,25005,26435,8,8,16,3337,3399,6736,5,0.320597,0.334511,2411.927066,0.000445,0.000919,58,0.000199,0,16,0.416667,0.004332
13191,McIntosh County,,GA,907,11933,12840,4,3,7,1614,1793,3407,6,0.308735,0.320056,0,0.000585,0.000585,12,0.000083,0,16,1,0.005352
13193,Macon County,,GA,839,12901,13740,6,8,14,1411,2004,3415,6,0.323231,0.338379,819.555177,0.000704,0.000803,14,0.000145,0,16,0.517857,0.006538
13195,Madison County,,GA,2246,30203,32449,14,14,28,7467,7369,14836,6,0.325734,0.341158,229.519984,0.001797,0.001821,14,0.000203,0,16,0.659341,0.016338
13197,Marion County,,GA,562,7257,7819,4,3,7,857,1007,1864,6,0.294822,0.30641,205.755629,0.000256,0.000258,14,0.000108,0,16,0.4,0.002524
13199,Meriwether County,,GA,2037,24126,26163,12,15,27,5379,6739,12118,5,0.326753,0.342632,141.473727,0.001807,0.002093,14,0.000161,0,16,0.614286,0.016287
13201,Miller County,,GA,452,5812,6264,3,3,6,929,1002,1931,7,0.244985,0.251896,0.295455,0.000008,0.000011,12,0.00012,0,16,0.833333,0.000301
13205,Mitchell County,,GA,1503,22888,24391,8,8,16,3253,3542,6795,6,0.269556,0.279564,15.427822,0.000136,0.000136,14,0.000177,0,16,0.517857,0.001711
13207,Monroe County,,GA,2076,26988,29064,12,11,23,5540,4653,10193,6,0.325419,0.340629,208.371594,0.002233,0.001791,14,0.000166,0,16,0.681818,0.019933
13209,Montgomery County,,GA,705,8233,8938,3,3,6,1324,1422,2746,7,0.24618,0.252892,2.258974,0.000009,0.000006,14,0.000118,0,16,0.5,0.000261
13211,Morgan County,,GA,1246,20316,21562,12,12,24,3097,3250,6347,5,0.326965,0.342418,14.635768,0.002039,0.00202,14,0.000155,0,16,0.787879,0.017834
13213,Murray County,,GA,3414,42841,46255,8,10,18,8660,9133,17793,6,0.319515,0.333564,8.560004,0.000377,0.000877,14,0.000128,0,16,0.688889,0.003716
13215,Muscogee County,,GA,20872,202178,223050,155,143,298,68229,68592,136821,5,0.417563,0.453043,38756.980257,0.041393,0.039737,14,0.001347,0,16,0.41462,0.363558
13217,Newton County,,GA,9994,103381,113375,35,37,72,33217,29035,62252,5,0.38303,0.406867,705.447725,0.009735,0.012374,14,0.000312,0,16,0.676004,0.083361
13219,Oconee County,,GA,2548,35040,37588,13,11,24,7713,6859,14572,6,0.326014,0.341185,246.131919,0.00224,0.002215,14,0.000176,0,16,0.724359,0.020042
13221,Oglethorpe County,,GA,1120,14853,15973,5,5,10,2917,2824,5741,6,0.283455,0.293991,0.616667,0.000178,0.000172,14,0.000108,0,16,0.8,0.001674
13223,Paulding County,,GA,12042,148452,160494,40,46,86,41664,35899,77563,5,0.376741,0.402019,810.274987,0.014176,0.014707,14,0.000335,0,16,0.696017,0.122748
13225,Peach County,,GA,2669,27074,29743,8,7,15,7410,6954,14364,6,0.325314,0.340024,148.5131,0.001244,0.001266,14,0.000144,0,16,0.571429,0.011273
13227,Pickens County,,GA,2320,32355,34675,12,12,24,6316,5684,12000,6,0.326014,0.341295,5.011009,0.002399,0.002481,14,0.000157,0,16,0.810606,0.021603
13229,Pierce County,,GA,1341,18980,20321,8,7,15,3745,3248,6993,6,0.323024,0.33664,523.295323,0.000638,0.000651,14,0.000167,0,16,0.678571,0.006142
13231,Pike County,,GA,1482,19148,20630,9,9,18,4214,4002,8216,6,0.322956,0.337966,1.479427,0.001281,0.001291,14,0.000122,0,16,0.888889,0.011491
13233,Polk County,,GA,2662,43653,46315,11,12,23,6656,7227,13883,6,0.326506,0.342038,489.448938,0.001973,0.001883,14,0.000135,0,16,0.637363,0.017241
13235,Pulaski County,,GA,629,9759,10388,6,6,12,1294,1395,2689,6,0.319785,0.333333,92.465319,0.000258,0.00072,14,0.000152,0,16,0.452381,0.00249
13237,Putnam County,,GA,1681,22648,24329,15,16,31,3924,3534,7458,6,0.326859,0.343056,162.073906,0.002594,0.002746,14,0.000186,0,16,0.679167,0.023212
13239,Quitman County,,GA,225,2319,2544,1,1,2,323,418,741,7,0.238185,0.243794,0,0.000006,0.000009,14,0.000066,0,16,0,0.000149
13241,Rabun County,,GA,1051,17306,18357,6,4,10,1185,1116,2301,6,0.322646,0.336976,7.963705,0.00113,0.000675,14,0.000115,0,16,0.7,0.010243
13243,Randolph County,,GA,411,7681,8092,2,4,6,323,695,1018,6,0.295195,0.307153,24.053719,0.000061,0.000303,14,0.000078,0,16,0.5,0.000642
13245,Richmond County,,GA,20860,205524,226384,122,132,254,55636,63875,119511,5,0.418601,0.45274,43796.41088,0.035249,0.039434,58,0.001105,0,16,0.464147,0.314388
13247,Rockdale County,,GA,10647,86355,97002,35,37,72,32898,32898,65796,5,0.377117,0.400622,642.002276,0.009936,0.010921,14,0.000311,0,16,0.624155,0.084846
13249,Schley County,,GA,366,4542,4908,3,1,4,782,473,1255,6,0.247326,0.253995,0,0.000023,0.000014,14,0.000114,0,16,0.666667,0.000371
13251,Screven County,,GA,880,15340,16220,6,6,12,2022,2291,4313,6,0.309334,0.321349,13.738634,0.000645,0.000632,14,0.000119,0,16,0.766667,0.005792
13253,Seminole County,,GA,675,9189,9864,4,4,8,1596,1495,3091,6,0.26982,0.279619,114.723871,0.000088,0.000072,12,0.000134,0,16,0.666667,0.000897
13255,Spalding County,,GA,5516,67124,72640,20,26,46,15852,16926,32778,5,0.347761,0.366694,201.559711,0.00408,0.005131,14,0.000221,0,16,0.596866,0.03667
13257,Stephens County,,GA,1915,28457,30372,11,13,24,3337,4044,7381,6,0.325699,0.340993,25.470201,0.001305,0.0018,14,0.000169,0,16,0.647436,0.011911
13259,Stewart County,,GA,322,4776,5098,2,2,4,420,427,847,6,0.29465,0.305998,283.393324,0.000275,0.000244,14,0.000064,0,16,0.333333,0.002547
13261,Sumter County,,GA,2131,32290,34421,15,17,32,3137,4680,7817,5,0.328561,0.345334,11603.755983,0.002319,0.002881,14,0.000381,0,16,0.428105,0.020845
13263,Talbot County,,GA,579,7063,7642,3,4,7,1206,1380,2586,6,0.294793,0.306493,1.433766,0.000253,0.000262,14,0.00008,0,16,0.666667,0.002448
13265,Taliaferro County,,GA,131,1770,1901,1,0,1,106,0,106,0,0,0,0,0.00001,0,14,0.000058,0,11,0,0.000144
13267,Tattnall County,,GA,1410,19876,21286,9,8,17,3218,2953,6171,6,0.308956,0.320992,14.662853,0.000608,0.000628,14,0.000177,0,16,0.597222,0.006064
13269,Taylor County,,GA,587,9044,9631,5,6,11,509,797,1306,6,0.299042,0.31156,12.042694,0.0005,0.000489,14,0.000107,0,16,0.566667,0.004579
13271,Telfair County,,GA,777,10880,11657,5,6,11,1241,1592,2833,6,0.289358,0.300561,205.426882,0.000037,0.000193,14,0.000159,0,16,0.366667,0.000727
13273,Terrell County,,GA,699,10929,11628,3,4,7,1316,1547,2863,6,0.269436,0.278849,1.958333,0.000076,0.000078,14,0.000088,0,16,0.666667,0.000758
13275,Thomas County,,GA,3041,47703,50744,19,17,36,6892,6605,13497,5,0.346766,0.364328,1839.8425,0.005522,0.004284,14,0.000255,0,16,0.6,0.048458
13277,Tift County,,GA,2967,41618,44585,27,28,55,8373,8660,17033,5,0.353195,0.373303,7105.529108,0.004927,0.006065,14,0.000377,0,16,0.450605,0.044263
13279,Toombs County,,GA,2115,27638,29753,13,12,25,3690,3400,7090,6,0.326401,0.342088,9428.568635,0.000951,0.001459,14,0.000294,0,16,0.346154,0.009194
13281,Towns County,,GA,666,11041,11707,5,3,8,1079,1000,2079,7,0.245442,0.252364,412.450135,0.001009,0.000036,14,0.000136,0,16,0.6,0.009265
13283,Treutlen County,,GA,350,6243,6593,4,4,8,729,574,1303,6,0.255375,0.263129,40.50921,0.00004,0.000034,14,0.000133,0,16,0.666667,0.000584
13285,Troup County,,GA,4070,71044,75114,25,21,46,11593,10714,22307,5,0.329168,0.346655,418.605912,0.004595,0.00405,14,0.00027,0,16,0.569801,0.040844
13287,Turner County,,GA,650,9821,10471,7,11,18,1809,3417,5226,6,0.340299,0.35674,1298.172583,0.00109,0.002114,14,0.000131,0,16,0.522727,0.010022
13289,Twiggs County,,GA,842,10379,11221,5,6,11,1807,2382,4189,6,0.291278,0.302564,14.810129,0.000257,0.000262,14,0.000122,0,16,0.733333,0.002424
13291,Union County,,GA,1239,22205,23444,13,10,23,2302,1729,4031,6,0.3242,0.33954,5332.681625,0.003414,0.001686,14,0.000226,0,16,0.543956,0.03021
13293,Upson County,,GA,1506,28977,30483,10,13,23,2886,3199,6085,5,0.327071,0.342907,8.409002,0.001728,0.002162,14,0.000133,0,16,0.801282,0.015338
13295,Walker County,,GA,4520,69008,73528,15,17,32,13800,13828,27628,6,0.331654,0.348778,411.551471,0.002341,0.002501,77,0.000201,0,16,0.51462,0.021031
13297,Walton County,,GA,6037,88169,94206,25,23,48,21671,19865,41536,6,0.343113,0.361494,156.294154,0.006009,0.005306,14,0.000264,0,16,0.695385,0.05351
13299,Ware County,,GA,2597,35640,38237,19,15,34,5711,5956,11667,6,0.330496,0.347326,5590.285945,0.003971,0.002202,14,0.000276,0,16,0.444737,0.035806
13301,Warren County,,GA,505,6542,7047,2,3,5,726,1086,1812,6,0.295311,0.306515,0,0.000238,0.000345,58,0.000077,0,16,1,0.001962
13303,Washington County,,GA,976,22373,23349,6,10,16,1237,1610,2847,5,0.326788,0.34222,1013.417074,0.00038,0.001509,14,0.000134,0,16,0.533333,0.003321
13305,Wayne County,,GA,1938,28638,30576,12,15,27,3417,3485,6902,5,0.329885,0.346748,274.55001,0.002296,0.001933,12,0.000197,0,16,0.5125,0.021091
13307,Webster County,,GA,158,2603,2761,2,1,3,118,82,200,6,0.247326,0.253995,1.516399,0.000018,0.000014,14,0.000095,0,16,0,0.000266
13309,Wheeler County,,GA,305,4934,5239,3,5,8,564,746,1310,6,0.255418,0.263266,45.227803,0.000026,0.000032,14,0.000118,0,16,0.5,0.000434
13311,White County,,GA,2082,26306,28388,13,11,24,4918,4597,9515,6,0.324131,0.33954,20.748431,0.002239,0.001837,14,0.000186,0,16,0.717949,0.020517
13313,Whitfield County,,GA,7717,120299,128016,19,32,51,15553,17026,32579,5,0.378957,0.40186,1113.421367,0.004362,0.008891,14,0.000217,0,16,0.50947,0.039806
13315,Wilcox County,,GA,457,7158,7615,3,4,7,760,696,1456,6,0.288944,0.299543,3.437934,0.000025,0.000168,14,0.000089,0,16,0.45,0.000408
13317,Wilkes County,,GA,555,11161,11716,3,4,7,416,609,1025,6,0.29638,0.308166,6.491901,0.00037,0.000316,14,0.000086,0,16,0.666667,0.002938
13319,Wilkinson County,,GA,728,11295,12023,5,5,10,1630,1762,3392,6,0.281689,0.292154,4.233532,0.000149,0.000127,14,0.000114,0,16,0.75,0.001462
13321,Worth County,,GA,1596,23413,25009,8,8,16,4762,4484,9246,6,0.283216,0.294894,90.286492,0.000677,0.000243,14,0.000144,0,16,0.694444,0.006312
15001,Hawaii County,,HI,9034,192486,201520,54,56,110,20831,20141,40972,5,0.384391,0.410499,118.900084,0.016814,0.02061,4,0.000443,0,16,0.819347,0.151338
15003,Honolulu County,,HI,68102,1083165,1151267,368,381,749,195575,206328,401903,4,0.479348,0.528722,48793.560312,0.092412,0.09213,4,0.002766,0,16,0.266355,0.788348
15005,Kalawao County,,HI,-2,-2,-4,0,0,0,0,0,0,0,0,0,0,0,0,15,0.000049,11,32,0,0
15007,Kauai County,,HI,3149,75932,79081,18,15,33,3867,5815,9682,5,0.35808,0.377044,0,0.007666,0.006859,4,0.00017,0,16,0.996732,0.067788
15009,Maui County,,HI,8754,168375,177129,51,50,101,17556,17986,35542,5,0.380003,0.405106,49.455063,0.018222,0.018013,4,0.000413,0,16,0.891291,0.163649
16001,Ada County,,ID,26914,427250,454164,156,165,321,89258,79663,168921,5,0.417103,0.454413,78713.514949,0.032452,0.038005,17,0.001611,0,16,0.328469,0.300378
16003,Adams County,,ID,347,4178,4525,3,4,7,395,525,920,6,0.294478,0.306471,1.277027,0.000308,0.000197,17,0.000085,0,16,0.6,0.002796
16005,Bannock County,,ID,6489,86737,93226,37,36,73,14148,14405,28553,5,0.360295,0.382106,14593.559587,0.006504,0.006234,2,0.000495,0,16,0.419712,0.0596
16007,Bear Lake County,,ID,462,6858,7320,4,2,6,340,373,713,6,0.269436,0.27848,0,0.000509,0.00008,2,0.000091,0,16,0.75,0.004549
16009,Benewah County,,ID,782,10072,10854,4,4,8,963,1264,2227,6,0.292375,0.304292,1.015152,0.000317,0.000315,17,0.000089,0,16,0.8,0.003031
16011,Bingham County,,ID,3549,50131,53680,14,13,27,8307,9246,17553,5,0.352168,0.370249,1613.087833,0.002497,0.001971,2,0.000205,0,16,0.761905,0.022671
16013,Blaine County,,ID,1803,25531,27334,10,11,21,2062,2642,4704,5,0.352455,0.370111,945.570115,0.002729,0.00308,17,0.000152,0,16,0.704545,0.024547
16015,Boise County,,ID,727,7281,8008,2,3,5,1442,1542,2984,6,0.294678,0.306553,0,0.000306,0.000283,17,0.000067,0,16,1,0.002716
16017,Bonner County,,ID,3004,43222,46226,17,16,33,5920,5855,11775,5,0.356605,0.375669,791.202674,0.005898,0.004655,17,0.000204,0,16,0.669048,0.052273
16019,Bonneville County,,ID,7970,114234,122204,40,37,77,20977,20289,41266,5,0.362407,0.384665,8320.476775,0.008718,0.006959,2,0.00046,0,16,0.443027,0.078079
16021,Boundary County,,ID,828,11686,12514,3,3,6,1004,1109,2113,6,0.292233,0.303934,0,0.000318,0.000314,17,0.000077,0,16,1,0.003021
16023,Butte County,,ID,233,3172,3405,0,2,2,0,256,256,6,0.266093,0.274351,0,0,0.000053,2,0.000049,0,33,0.5,0
16025,Camas County,,ID,90,1086,1176,0,0,0,0,0,0,0,0,0,0,0,0,16,0.000049,12,34,0,0
16027,Canyon County,,ID,15089,198524,213613,74,70,144,46130,43277,89407,5,0.370339,0.397672,10386.601626,0.015278,0.01401,17,0.000776,0,16,0.440053,0.137593
16029,Caribou County,,ID,502,7998,8500,1,4,5,391,765,1156,6,0.269484,0.27881,0,0.000037,0.000088,2,0.000061,0,16,0.833333,0.000425
16031,Cassia County,,ID,2038,24061,26099,13,11,24,5003,5090,10093,5,0.352086,0.369919,153.331796,0.00246,0.001786,17,0.000185,0,16,0.785714,0.022401
16033,Clark County,,ID,99,1051,1150,0,1,1,0,57,57,6,0.26607,0.274186,0,0,0.000051,2,0.000049,0,35,0,0
16035,Clearwater County,,ID,610,8819,9429,3,3,6,631,901,1532,6,0.261707,0.269522,0,0.00026,0.000046,17,0.000084,0,16,1,0.002311
16037,Custer County,,ID,412,4588,5000,4,2,6,415,194,609,6,0.294392,0.306086,53.508788,0.000267,0.000193,17,0.000114,0,16,0.583333,0.002503
16039,Elmore County,,ID,4762,29077,33839,15,23,38,4013,6292,10305,5,0.364369,0.385435,674.130375,0.004209,0.006468,17,0.000181,0,16,0.651667,0.038217
16041,Franklin County,,ID,918,14574,15492,6,5,11,1563,1813,3376,6,0.318876,0.331468,95.62736,0.000868,0.000869,2,0.000105,0,16,0.785714,0.007563
16043,Fremont County,,ID,1270,14421,15691,6,7,13,1985,2623,4608,6,0.318943,0.332348,0.333333,0.000349,0.000759,2,0.000113,0,16,0.892857,0.00343
16045,Gem County,,ID,1565,18124,19689,4,3,7,2909,3184,6093,6,0.294678,0.306553,0.333333,0.00031,0.000283,17,0.000112,0,16,0.833333,0.002879
16047,Gooding County,,ID,1443,16557,18000,8,7,15,3088,3506,6594,6,0.294822,0.307269,346.268395,0.001074,0.00036,17,0.000135,0,16,0.722222,0.010028
16049,Idaho County,,ID,818,15315,16133,5,5,10,1718,1395,3113,6,0.294564,0.306746,511.386292,0.000313,0.000237,17,0.000137,0,16,0.571429,0.002997
16051,Jefferson County,,ID,2214,28003,30217,10,9,19,6905,6316,13221,6,0.319616,0.333366,78.389133,0.001749,0.001016,2,0.000146,0,16,0.911111,0.015774
16053,Jerome County,,ID,2023,23598,25621,13,10,23,5820,5981,11801,6,0.319245,0.333064,517.773077,0.002149,0.000815,17,0.00019,0,16,0.647436,0.019518
16055,Kootenai County,,ID,8832,153793,162625,67,61,128,27874,22408,50282,5,0.364369,0.38992,5268.579383,0.014626,0.012964,17,0.000656,0,16,0.506294,0.131295
16057,Latah County,,ID,4026,34812,38838,23,22,45,7058,7598,14656,5,0.354228,0.37399,2984.639189,0.004125,0.004152,17,0.000304,0,16,0.604615,0.038525
16059,Lemhi County,,ID,646,8367,9013,3,4,7,186,281,467,6,0.294736,0.306966,3.557576,0.000266,0.000282,17,0.000116,0,16,0.75,0.002443
16061,Lewis County,,ID,370,4785,5155,2,2,4,697,1403,2100,7,0.24769,0.253981,0,0.000013,0.000014,17,0.000087,0,16,1,0.000261
16063,Lincoln County,,ID,580,5310,5890,5,6,11,1157,1263,2420,6,0.294535,0.306801,0.766667,0.00007,0.000268,17,0.000118,0,16,0.866667,0.00103
16065,Madison County,,ID,5504,28512,34016,25,26,51,8608,12698,21306,5,0.362061,0.383124,636.801079,0.006166,0.006179,2,0.000276,0,16,0.671264,0.05568
16067,Minidoka County,,ID,1741,22689,24430,9,8,17,4401,4775,9176,6,0.309303,0.322323,208.491884,0.001061,0.000613,17,0.000152,0,16,0.777778,0.010046
16069,Nez Perce County,,ID,3075,43423,46498,14,14,28,7617,7769,15386,6,0.329168,0.344536,6339.932398,0.001981,0.001906,17,0.000249,0,16,0.579167,0.018839
16071,Oneida County,,ID,274,4814,5088,2,3,5,199,412,611,6,0.26946,0.278645,0,0.000047,0.000094,2,0.000074,0,16,1,0.000616
16073,Owyhee County,,ID,1279,11741,13020,3,3,6,2759,3253,6012,6,0.29508,0.307049,0,0.000345,0.000306,17,0.000074,0,16,1,0.003002
16075,Payette County,,ID,2156,24541,26697,6,5,11,4700,4866,9566,6,0.294793,0.306994,2.675,0.000319,0.000294,17,0.000156,0,16,0.666667,0.003111
16077,Power County,,ID,734,8718,9452,2,2,4,1183,1479,2662,6,0.264912,0.273,0,0.000048,0.000053,2,0.000074,0,16,1,0.000626
16079,Shoshone County,,ID,1125,13317,14442,2,5,7,1350,1769,3119,6,0.292657,0.304925,0.820983,0.000291,0.000355,17,0.000066,0,16,0.5,0.002657
16081,Teton County,,ID,999,9891,10890,4,7,11,1196,1376,2572,6,0.318943,0.332348,12.071301,0.000526,0.000763,2,0.000085,0,16,0.785714,0.004836
16083,Twin Falls County,,ID,5769,83112,88881,30,34,64,15564,14425,29989,5,0.362364,0.384335,2479.067057,0.005957,0.007032,17,0.000351,0,16,0.54958,0.054093
16085,Valley County,,ID,1360,10509,11869,3,4,7,1593,2055,3648,6,0.294707,0.306718,1.042516,0.000308,0.000285,17,0.000085,0,16,0.75,0.002796
16087,Washington County,,ID,786,10492,11278,5,4,9,1492,1577,3069,6,0.294764,0.306828,1.895457,0.000316,0.000292,17,0.000124,0,16,0.75,0.003031
17001,Adams County,,IL,3054,81771,84825,19,20,39,4891,4772,9663,5,0.348441,0.366138,16232.476227,0.003006,0.002177,32,0.000321,0,16,0.387352,0.024598
17003,Alexander County,,IL,634,8115,8749,3,4,7,931,1302,2233,6,0.278068,0.287796,16.898244,0.00002,0.000043,32,0.000119,0,16,0.833333,0.000362
17005,Bond County,,IL,1216,18637,19853,5,7,12,2295,2481,4776,6,0.319481,0.331952,49.395277,0.00031,0.000645,32,0.00011,0,16,0.690476,0.002427
17007,Boone County,,IL,4726,68510,73236,11,12,23,12967,12907,25874,5,0.357742,0.376021,10.849107,0.002769,0.002789,99,0.000113,0,16,0.901515,0.021791
17009,Brown County,,IL,294,6119,6413,3,3,6,362,381,743,6,0.258624,0.265825,0.326923,0.000021,0.000023,32,0.000092,0,16,0.666667,0.0004
17011,Bureau County,,IL,2113,44062,46175,12,15,27,4472,5037,9509,5,0.344949,0.361159,1672.549481,0.001766,0.001788,99,0.000171,0,16,0.599265,0.013929
17013,Calhoun County,,IL,251,6048,6299,2,3,5,332,384,716,6,0.289109,0.298894,8.423427,0.000124,0.000082,32,0.00007,0,16,0.333333,0.000846
17015,Carroll County,,IL,989,20102,21091,8,8,16,1963,1918,3881,5,0.344361,0.359563,4.973158,0.001257,0.000788,99,0.000116,0,16,0.708333,0.010149
17017,Cass County,,IL,1281,16103,17384,8,5,13,1814,2136,3950,6,0.284253,0.294289,2034.429453,0.001316,0.000069,99,0.000151,0,16,0.321429,0.011649
17019,Champaign County,,IL,14329,199746,214075,91,115,206,31753,37086,68839,5,0.429158,0.459398,34605.370407,0.023638,0.036407,99,0.000831,0,16,0.474261,0.199026
17021,Christian County,,IL,1909,41371,43280,8,9,17,3960,4160,8120,6,0.30433,0.315759,516.196512,0.000771,0.000323,99,0.000147,0,16,0.536364,0.006871
17023,Clark County,,IL,1014,20042,21056,5,5,10,1772,2063,3835,6,0.273104,0.282398,175.26581,0.000044,0.000035,99,0.000139,0,16,0.4,0.000647
17025,Clay County,,IL,889,16907,17796,6,5,11,1312,1353,2665,6,0.258823,0.26648,1193.173589,0.000019,0.000016,77,0.000156,0,16,0.433333,0.00055
17027,Clinton County,,IL,2104,44446,46550,8,8,16,5094,5063,10157,6,0.319548,0.332145,37.185561,0.000754,0.000871,32,0.000141,0,16,0.666667,0.00612
17029,Coles County,,IL,3434,52808,56242,20,19,39,7179,7371,14550,5,0.346845,0.364075,7335.82594,0.002056,0.001861,99,0.000293,0,16,0.396104,0.015744
17031,Cook County,,IL,219405,6072075,6291480,593,614,1207,713453,840982,1554435,4,0.524139,0.583223,555820.629611,0.107713,0.105641,99,0.004881,0,16,0.128102,0.910337
17033,Crawford County,,IL,858,23292,24150,5,5,10,932,907,1839,6,0.272417,0.281446,318.887963,0.000004,0.000021,99,0.00015,0,16,0.366667,0.000383
17035,Cumberland County,,IL,841,13265,14106,5,5,10,1779,2138,3917,6,0.258778,0.266315,13.866337,0.000022,0.000022,99,0.000135,0,16,0.55,0.000524
17037,DeKalb County,,IL,8534,112049,120583,22,28,50,22497,23358,45855,5,0.370339,0.392396,209.49349,0.004508,0.006173,99,0.000202,0,16,0.641626,0.035541
17039,De Witt County,,IL,1312,19958,21270,6,6,12,2678,2493,5171,6,0.303811,0.314383,3.495655,0.000489,0.000342,99,0.00011,0,16,0.866667,0.00328
17041,Douglas County,,IL,1504,25952,27456,7,7,14,2860,3441,6301,6,0.301573,0.312061,7.140165,0.000286,0.000205,99,0.000141,0,16,0.714286,0.002178
17043,DuPage County,,IL,70821,1122818,1193639,205,248,453,234245,248410,482655,5,0.457139,0.497381,26219.484617,0.061995,0.071227,99,0.001528,0,16,0.398364,0.52219
17045,Edgar County,,IL,1108,22006,23114,7,7,14,1830,2061,3891,6,0.301633,0.31249,118.920428,0.000278,0.000193,99,0.000148,0,16,0.595238,0.002104
17047,Edwards County,,IL,381,8173,8554,4,4,8,819,766,1585,7,0.222901,0.228564,56.982119,0.000001,0.000001,77,0.000152,0,16,0.5,0.000288
17049,Effingham County,,IL,2061,44003,46064,13,15,28,3772,3963,7735,5,0.347641,0.364433,15042.968325,0.00149,0.001603,99,0.000234,0,16,0.425,0.012187
17051,Fayette County,,IL,1231,25008,26239,8,8,16,2291,2513,4804,6,0.289552,0.300187,218.361688,0.000149,0.0001,99,0.000165,0,16,0.428571,0.001422
17053,Ford County,,IL,1218,17085,18303,7,6,13,2722,2779,5501,6,0.302779,0.313283,0.823691,0.001047,0.000305,99,0.000107,0,16,0.928571,0.008463
17055,Franklin County,,IL,2219,44416,46635,10,10,20,4840,4869,9709,5,0.345461,0.361214,2440.261747,0.001006,0.000931,32,0.000201,0,16,0.6,0.00869
17057,Fulton County,,IL,1858,42901,44759,7,9,16,4023,4309,8332,5,0.344871,0.360388,345.328167,0.00033,0.000954,99,0.00012,0,16,0.708333,0.002665
17059,Gallatin County,,IL,471,6513,6984,2,2,4,540,704,1244,7,0.223378,0.228678,0,0.000001,0.000005,32,0.000106,0,16,1,0.000189
17061,Greene County,,IL,836,16224,17060,6,6,12,1719,1978,3697,6,0.293138,0.303599,569.887977,0.000228,0.000155,32,0.000148,0,16,0.633333,0.001742
17063,Grundy County,,IL,4346,62124,66470,8,10,18,12436,11874,24310,5,0.357025,0.374865,7.353978,0.00169,0.002276,99,0.000098,0,16,0.9,0.012938
17065,Hamilton County,,IL,412,9592,10004,5,4,9,834,826,1660,6,0.259822,0.267228,16.826955,0.000018,0.000019,32,0.000161,0,16,0.5,0.000517
17067,Hancock County,,IL,1301,23407,24708,5,5,10,1915,2258,4173,6,0.260447,0.268565,32.751108,0.000034,0.000036,18,0.000132,0,16,0.5,0.000649
17069,Hardin County,,IL,264,4493,4757,1,2,3,165,331,496,7,0.223279,0.228441,0,0.000001,0.000004,32,0.000077,0,16,1,0.000113
17071,Henderson County,,IL,629,8691,9320,4,4,8,773,957,1730,6,0.258579,0.265902,4.521402,0.000024,0.00002,18,0.000112,0,16,0.6,0.000473
17073,Henry County,,IL,3548,63069,66617,12,15,27,7330,7984,15314,5,0.359397,0.378304,616.633692,0.001206,0.002099,99,0.000166,0,16,0.561905,0.010895
17075,Iroquois County,,IL,2053,37150,39203,9,9,18,4210,4267,8477,5,0.344714,0.360168,39.789013,0.00134,0.001153,99,0.000126,0,16,0.736111,0.010367
17077,Jackson County,,IL,5993,53332,59325,32,36,68,10517,12276,22793,5,0.379574,0.403428,16173.681712,0.004518,0.008503,32,0.000418,0,16,0.434146,0.035678
17079,Jasper County,,IL,629,12611,13240,4,6,10,899,1089,1988,6,0.259044,0.266865,697.937677,0.00001,0.000021,99,0.000132,0,16,0.433333,0.000352
17081,Jefferson County,,IL,2328,43636,45964,13,16,29,4250,4389,8639,5,0.349487,0.366694,10384.030584,0.001326,0.001898,32,0.000239,0,16,0.5,0.01139
17083,Jersey County,,IL,1555,27572,29127,6,8,14,3703,3861,7564,6,0.319111,0.331732,172.998223,0.000727,0.000922,32,0.000126,0,16,0.666667,0.00587
17085,Jo Daviess County,,IL,1284,28785,30069,9,7,16,2762,2697,5459,5,0.344596,0.359728,78.625251,0.001485,0.000781,99,0.00013,0,16,0.555556,0.011805
17087,Johnson County,,IL,731,12777,13508,6,6,12,1598,1672,3270,6,0.275915,0.285496,843.749791,0.000062,0.000047,32,0.000206,0,16,0.5,0.000804
17089,Kane County,,IL,33318,607688,641006,94,121,215,115375,113597,228972,5,0.427946,0.458974,4849.13186,0.031218,0.040176,99,0.000728,0,16,0.572226,0.268049
17091,Kankakee County,,IL,5802,132070,137872,17,26,43,13040,13522,26562,5,0.371976,0.393738,519.128184,0.003698,0.006838,99,0.000179,0,16,0.597884,0.029398
17093,Kendall County,,IL,9319,135235,144554,17,25,42,37531,31796,69327,5,0.374274,0.396192,117.700926,0.004759,0.008462,99,0.000158,0,16,0.757835,0.038201
17095,Knox County,,IL,2871,59394,62265,14,15,29,5720,5551,11271,5,0.345303,0.361654,1396.176202,0.001776,0.001715,99,0.000176,0,16,0.5875,0.014121
17097,Lake County,,IL,42171,834515,876686,171,211,382,126775,140709,267484,5,0.44894,0.486844,7873.286489,0.057028,0.065482,99,0.00122,0,16,0.472414,0.481468
17099,LaSalle County,,IL,6233,141151,147384,26,28,54,15693,15285,30978,5,0.361154,0.381716,5079.215754,0.00479,0.003637,99,0.000259,0,16,0.545161,0.038667
17101,Lawrence County,,IL,891,16980,17871,4,5,9,1458,1520,2978,6,0.284467,0.294228,349.47795,0.000004,0.000061,77,0.000137,0,16,0.4,0.000318
17103,Lee County,,IL,2253,42641,44894,11,11,22,5643,5902,11545,5,0.344596,0.360223,3.589989,0.001825,0.001496,99,0.000127,0,16,0.807692,0.013933
17105,Livingston County,,IL,2231,45907,48138,11,14,25,4606,5329,9935,5,0.34491,0.360994,88.364894,0.001493,0.00167,99,0.00014,0,16,0.659341,0.011502
17107,Logan County,,IL,1851,32795,34646,10,11,21,3405,3932,7337,5,0.344949,0.360719,336.679288,0.00066,0.001112,99,0.000163,0,16,0.6,0.00468
17109,McDonough County,,IL,2266,30215,32481,14,15,29,3418,3557,6975,5,0.3455,0.361874,4024.570827,0.001411,0.001595,99,0.000205,0,16,0.477941,0.011361
17111,McHenry County,,IL,18000,391676,409676,42,71,113,54198,55879,110077,5,0.406577,0.434296,645.174933,0.014371,0.026405,99,0.000319,0,16,0.667928,0.119972
17113,McLean County,,IL,10591,188413,199004,77,83,160,26230,25654,51884,5,0.420228,0.447788,17841.189028,0.018482,0.023041,99,0.000703,0,16,0.448524,0.156502
17115,Macon County,,IL,6175,129999,136174,27,33,60,10287,11847,22134,5,0.374135,0.396847,5723.678637,0.004997,0.006753,99,0.000329,0,16,0.491742,0.04064
17117,Macoupin County,,IL,3224,57280,60504,10,10,20,7653,8168,15821,6,0.319987,0.333053,293.098208,0.001682,0.000928,32,0.000162,0,16,0.581818,0.013969
17119,Madison County,,IL,15253,322309,337562,63,78,141,38361,41136,79497,5,0.406359,0.434665,31042.18498,0.01313,0.020189,32,0.000687,0,16,0.37591,0.11334
17121,Marion County,,IL,2330,47114,49444,11,14,25,4164,4448,8612,5,0.347243,0.363772,3584.689237,0.001006,0.001559,32,0.000194,0,16,0.519048,0.008671
17123,Marshall County,,IL,943,15899,16842,8,7,15,2274,2314,4588,6,0.297954,0.308254,154.977867,0.000361,0.000285,99,0.000132,0,16,0.696429,0.002996
17125,Mason County,,IL,1111,17839,18950,6,7,13,2111,2661,4772,6,0.293992,0.304286,23.922233,0.000277,0.000204,99,0.000121,0,16,0.595238,0.002056
17127,Massac County,,IL,994,17884,18878,4,5,9,1513,1678,3191,6,0.264334,0.272857,511.458231,0.000018,0.000031,77,0.000177,0,16,0.25,0.000421
17129,Menard County,,IL,967,15798,16765,4,4,8,2274,2274,4548,6,0.28396,0.293656,1.326923,0.000099,0.000072,99,0.000111,0,16,0.75,0.000878
17131,Mercer County,,IL,1215,21323,22538,6,6,12,2608,2922,5530,6,0.297573,0.307533,3.736156,0.000251,0.000284,99,0.000111,0,16,0.733333,0.002779
17133,Monroe County,,IL,1958,41911,43869,7,7,14,5880,5071,10951,6,0.319548,0.33198,1.384389,0.001214,0.001049,32,0.000109,0,16,0.880952,0.009399
17135,Montgomery County,,IL,1752,34253,36005,6,8,14,3447,3613,7060,6,0.31992,0.332695,50.277591,0.000222,0.000708,32,0.000124,0,16,0.625,0.001728
17137,Morgan County,,IL,2264,40267,42531,11,12,23,4129,4631,8760,5,0.347243,0.363635,8113.536154,0.000853,0.001234,99,0.000252,0,16,0.371795,0.007681
17139,Moultrie County,,IL,1201,17771,18972,6,6,12,3025,2720,5745,6,0.301483,0.311786,24.622742,0.000269,0.000185,99,0.000128,0,16,0.766667,0.001949
17141,Ogle County,,IL,4048,66842,70890,13,15,28,9269,9307,18576,5,0.357236,0.375691,29.681928,0.001995,0.002476,99,0.00014,0,16,0.757143,0.014915
17143,Peoria County,,IL,12495,221742,234237,68,75,143,32993,35408,68401,5,0.411046,0.438583,18369.16378,0.017325,0.023149,99,0.00061,0,16,0.477546,0.146848
17145,Perry County,,IL,1163,23681,24844,7,7,14,2588,2795,5383,6,0.297194,0.307956,5.939063,0.000268,0.000221,32,0.000139,0,16,0.738095,0.00235
17147,Piatt County,,IL,1306,20410,21716,6,6,12,3256,3096,6352,6,0.303477,0.313805,9.856166,0.000394,0.000284,99,0.000122,0,16,0.733333,0.002778
17149,Pike County,,IL,913,18800,19713,7,5,12,1104,1241,2345,6,0.28436,0.294426,72.99139,0.000121,0.000091,32,0.000176,0,16,0.333333,0.00125
17151,Pope County,,IL,258,4289,4547,4,3,7,507,592,1099,7,0.223526,0.229052,13.814657,0.000001,0.000005,32,0.000169,0,16,0.5,0.000318
17153,Pulaski County,,IL,406,6796,7202,4,4,8,659,818,1477,6,0.26659,0.275019,48.27603,0.000021,0.000017,32,0.000144,0,16,0.5,0.000429
17155,Putnam County,,IL,464,7499,7963,3,3,6,1056,1058,2114,6,0.265469,0.273358,0,0.000034,0.000041,99,0.000083,0,16,1,0.000537
17157,Randolph County,,IL,1724,36568,38292,8,10,18,3450,4185,7635,6,0.319987,0.33286,69.054199,0.000785,0.000909,32,0.000147,0,16,0.577778,0.006246
17159,Richland County,,IL,873,19478,20351,6,8,14,1285,1307,2592,6,0.260268,0.268785,300.861406,0.000001,0.000013,77,0.0002,0,16,0.285714,0.000413
17161,Rock Island County,,IL,9205,179582,188787,37,42,79,20031,22961,42992,5,0.391546,0.416496,3109.17279,0.008221,0.01085,99,0.000363,0,16,0.508696,0.070066
17163,St. Clair County,,IL,17830,309330,327160,101,100,201,44192,47930,92122,5,0.420578,0.450501,25265.983754,0.026879,0.030708,32,0.00093,0,16,0.436835,0.23316
17165,Saline County,,IL,1356,27708,29064,11,10,21,2540,2627,5167,6,0.287354,0.29847,17448.817867,0.000759,0.000105,32,0.000329,0,16,0.263636,0.007103
17167,Sangamon County,,IL,10126,242149,252275,55,59,114,26220,24028,50248,5,0.396207,0.422994,26643.491276,0.009943,0.01541,99,0.000616,0,16,0.396633,0.082223
17169,Schuyler County,,IL,629,8401,9030,3,7,10,795,1097,1892,6,0.284467,0.294866,11.13027,0.000015,0.000099,99,0.000098,0,16,0.5,0.000357
17171,Scott County,,IL,304,6285,6589,2,2,4,884,653,1537,6,0.257809,0.264323,0,0.000008,0.000006,99,0.000088,0,16,1,0.000194
17173,Shelby County,,IL,1377,26599,27976,7,8,15,3315,3555,6870,6,0.301783,0.312463,145.772189,0.000064,0.000197,99,0.000157,0,16,0.517857,0.000959
17175,Stark County,,IL,446,7466,7912,2,3,5,647,950,1597,6,0.291586,0.3012,0.193529,0.000149,0.00012,99,0.000065,0,16,0.833333,0.001065
17177,Stephenson County,,IL,2630,58377,61007,13,14,27,5349,5131,10480,5,0.357657,0.376131,137.712842,0.002545,0.002461,99,0.000154,0,16,0.659341,0.021174
17179,Tazewell County,,IL,8379,166444,174823,30,30,60,24287,21987,46274,5,0.371065,0.393414,1988.498057,0.004937,0.006243,99,0.000299,0,16,0.492492,0.03881
17181,Union County,,IL,899,20348,21247,6,6,12,1593,1849,3442,6,0.278324,0.288401,73.466267,0.000082,0.000059,32,0.000175,0,16,0.566667,0.00091
17183,Vermilion County,,IL,4164,92507,96671,21,21,42,7281,7997,15278,5,0.360509,0.380505,3276.020396,0.003175,0.002936,99,0.000275,0,16,0.452569,0.025593
17185,Wabash County,,IL,705,14625,15330,5,5,10,841,1155,1996,6,0.28428,0.293925,2968.004946,0.000073,0.00006,77,0.000162,0,16,0.35,0.000879
17187,Warren County,,IL,1070,20333,21403,8,11,19,2213,2449,4662,5,0.34491,0.360636,1740.663089,0.00072,0.001056,99,0.000159,0,16,0.522727,0.006714
17189,Washington County,,IL,1190,18429,19619,7,8,15,2308,2571,4879,6,0.319548,0.332145,18.998282,0.000332,0.000657,32,0.000133,0,16,0.714286,0.002717
17191,Wayne County,,IL,887,19635,20522,5,6,11,1114,1398,2512,6,0.260112,0.267998,1195.342662,0.000012,0.000008,77,0.000171,0,16,0.333333,0.000424
17193,White County,,IL,871,17519,18390,8,8,16,1419,1358,2777,6,0.284627,0.294888,4414.876396,0.000071,0.000062,32,0.000276,0,16,0.267857,0.0011
17195,Whiteside County,,IL,3234,74742,77976,15,19,34,6940,7299,14239,5,0.357657,0.376681,57.963695,0.001781,0.002758,99,0.000171,0,16,0.649123,0.014835
17197,Will County,,IL,42402,825758,868160,108,154,262,142909,142741,285650,5,0.436959,0.470529,8844.63656,0.035409,0.049165,99,0.000831,0,16,0.516997,0.302003
17199,Williamson County,,IL,4042,73393,77435,20,17,37,10494,9050,19544,5,0.348562,0.365836,4727.254274,0.002597,0.001873,32,0.000318,0,16,0.426407,0.020135
17201,Winnebago County,,IL,15462,360978,376440,55,82,137,34439,40628,75067,5,0.413402,0.442027,3215.254871,0.014955,0.025889,99,0.000447,0,16,0.546512,0.123979
17203,Woodford County,,IL,2787,47009,49796,7,9,16,7381,6887,14268,5,0.357151,0.37492,132.457037,0.000964,0.00174,99,0.000111,0,16,0.861111,0.008266
18001,Adams County,,IN,1610,42510,44120,6,8,14,3030,3309,6339,6,0.317206,0.330791,45.95089,0.000652,0.000853,99,0.000111,0,16,0.553571,0.005536
18003,Allen County,,IN,17328,429351,446679,116,124,240,44045,45558,89603,5,0.427161,0.458738,35572.11343,0.030678,0.036477,99,0.000962,0,16,0.410959,0.259048
18005,Bartholomew County,,IN,5423,95987,101410,25,21,46,12969,12616,25585,5,0.371065,0.392456,1553.629884,0.004256,0.003822,99,0.000303,0,16,0.440476,0.035017
18007,Benton County,,IN,897,10549,11446,5,4,9,1835,1833,3668,6,0.295541,0.305607,34.013265,0.000605,0.00012,99,0.000108,0,16,0.65,0.004831
18009,Blackford County,,IN,934,15961,16895,4,6,10,1810,2052,3862,6,0.31651,0.329416,1.070952,0.000052,0.000483,99,0.000096,0,16,0.733333,0.000622
18011,Boone County,,IN,3985,65601,69586,18,14,32,14798,10545,25343,5,0.346687,0.363387,146.469919,0.002734,0.001661,99,0.000212,0,16,0.712418,0.022471
18013,Brown County,,IN,1259,18247,19506,6,6,12,3405,3394,6799,6,0.31651,0.329388,0.445833,0.00064,0.00062,99,0.000113,0,16,0.933333,0.005633
18015,Carroll County,,IN,1636,24905,26541,6,6,12,4003,4163,8166,6,0.316543,0.329471,0,0.000633,0.000559,99,0.000106,0,16,1,0.005106
18017,Cass County,,IN,2530,48052,50582,12,12,24,5372,5696,11068,6,0.319279,0.333515,47.223501,0.001086,0.001112,99,0.000171,0,16,0.5,0.009058
18019,Clark County,,IN,8396,128885,137281,27,23,50,27884,24209,52093,5,0.364852,0.38549,2352.465687,0.004452,0.003303,77,0.000365,0,16,0.407407,0.040802
18021,Clay County,,IN,1939,31848,33787,10,10,20,4820,5074,9894,6,0.316841,0.330379,6.948619,0.000714,0.000839,99,0.000165,0,16,0.7,0.006295
18023,Clinton County,,IN,2265,41392,43657,9,11,20,4473,5641,10114,6,0.316841,0.330516,6.291688,0.000872,0.000854,99,0.000142,0,16,0.663636,0.007323
18025,Crawford County,,IN,765,12151,12916,7,7,14,1864,1834,3698,6,0.314734,0.326885,21.315903,0.000439,0.000438,77,0.000144,0,16,0.738095,0.004225
18027,Daviess County,,IN,1228,36104,37332,9,9,18,2657,2891,5548,6,0.317472,0.330984,760.624228,0.000645,0.000603,77,0.000171,0,16,0.638889,0.005724
18029,Dearborn County,,IN,3509,62248,65757,12,13,25,9853,9317,19170,6,0.320326,0.334907,94.786296,0.001425,0.001214,65,0.000167,0,16,0.557692,0.010855
18031,Decatur County,,IN,2043,32306,34349,10,10,20,4268,4469,8737,6,0.316742,0.330213,18.310693,0.000519,0.000528,99,0.000179,0,16,0.527273,0.005075
18033,DeKalb County,,IN,3127,51764,54891,8,9,17,7887,7889,15776,6,0.317106,0.330736,58.076099,0.000659,0.000645,99,0.000132,0,16,0.569444,0.00576
18035,Delaware County,,IN,7005,121080,128085,29,30,59,14471,15963,30434,5,0.372204,0.394509,3403.346215,0.003266,0.005701,99,0.000329,0,16,0.437815,0.027391
18037,Dubois County,,IN,2348,54460,56808,13,14,27,4306,4886,9192,6,0.321482,0.336481,1163.578079,0.00066,0.001214,77,0.000244,0,16,0.414286,0.006073
18039,Elkhart County,,IN,12380,244567,256947,30,47,77,24225,26870,51095,5,0.387291,0.412754,2121.88581,0.0057,0.013435,99,0.000284,0,16,0.512755,0.046718
18041,Fayette County,,IN,1528,28050,29578,8,9,17,3128,3167,6295,6,0.317505,0.331072,61.808843,0.000453,0.000608,99,0.000162,0,16,0.555556,0.004334
18043,Floyd County,,IN,6672,87155,93827,14,17,31,20279,19793,40072,5,0.356269,0.374618,434.296425,0.00135,0.002709,77,0.000231,0,16,0.48538,0.012214
18045,Fountain County,,IN,1480,21718,23198,8,8,16,3239,3855,7094,6,0.316974,0.330324,197.688432,0.000653,0.000572,99,0.000148,0,16,0.642857,0.005351
18047,Franklin County,,IN,1658,29869,31527,9,9,18,4075,4672,8747,6,0.320021,0.333999,103.62213,0.001035,0.000946,65,0.00016,0,16,0.555556,0.008464
18049,Fulton County,,IN,1612,25170,26782,12,12,24,3555,3567,7122,6,0.31714,0.331121,32.804446,0.001,0.000845,99,0.000156,0,16,0.589744,0.007747
18051,Gibson County,,IN,1955,40436,42391,9,10,19,4623,4500,9123,6,0.317672,0.331397,415.586268,0.000511,0.000513,77,0.0002,0,16,0.533333,0.004783
18053,Grant County,,IN,3745,78383,82128,16,16,32,6449,7494,13943,5,0.347124,0.364213,1694.673937,0.002471,0.001807,99,0.000199,0,16,0.584967,0.021443
18055,Greene County,,IN,2003,37563,39566,11,12,23,5216,5618,10834,6,0.31694,0.330709,619.535192,0.00062,0.000625,99,0.00019,0,16,0.560606,0.005674
18057,Hamilton County,,IN,20803,311237,332040,132,114,246,84921,63030,147951,5,0.423933,0.45487,19726.634154,0.03738,0.037031,99,0.001108,0,16,0.449119,0.315274
18059,Hancock County,,IN,5370,83440,88810,16,15,31,18322,16830,35152,5,0.346925,0.363827,163.781699,0.001393,0.001673,99,0.000214,0,16,0.625,0.011478
18061,Harrison County,,IN,2574,46832,49406,9,8,17,6858,6936,13794,6,0.320767,0.33483,104.168705,0.00087,0.000877,77,0.000167,0,16,0.583333,0.008043
18063,Hendricks County,,IN,11823,168977,180800,37,37,74,43549,34240,77789,5,0.383709,0.407698,2632.03867,0.008052,0.010028,99,0.000384,0,16,0.505226,0.068744
18065,Henry County,,IN,3008,57989,60997,11,12,23,7126,7452,14578,6,0.316907,0.330736,13.614435,0.000784,0.000779,99,0.000179,0,16,0.621212,0.007144
18067,Howard County,,IN,5382,103154,108536,25,27,52,11242,12941,24183,5,0.363713,0.38499,996.167243,0.00321,0.004467,99,0.000294,0,16,0.43871,0.02682
18069,Huntington County,,IN,2301,47153,49454,8,10,18,4639,4775,9414,6,0.317073,0.330791,21.078838,0.000708,0.000908,99,0.00013,0,16,0.733333,0.006105
18071,Jackson County,,IN,3004,55552,58556,16,15,31,8664,7973,16637,6,0.323059,0.33844,268.962139,0.002265,0.001276,99,0.000229,0,16,0.362573,0.019216
18073,Jasper County,,IN,2366,40076,42442,10,10,20,6264,5748,12012,5,0.346528,0.362727,69.542522,0.001542,0.001419,99,0.000132,0,16,0.788889,0.012639
18075,Jay County,,IN,1285,26355,27640,7,8,15,2486,2932,5418,6,0.31704,0.330516,66.667277,0.000273,0.000633,99,0.000127,0,16,0.535714,0.002295
18077,Jefferson County,,IN,1912,37996,39908,13,15,28,3918,4112,8030,6,0.321073,0.336096,223.565456,0.001267,0.001275,99,0.000216,0,16,0.470833,0.011329
18079,Jennings County,,IN,2173,33684,35857,9,8,17,5403,5930,11333,6,0.316708,0.329938,28.054932,0.000895,0.000518,99,0.000154,0,16,0.736111,0.00824
18081,Johnson County,,IN,13451,164250,177701,43,38,81,43309,39501,82810,5,0.378011,0.401453,4147.620228,0.007394,0.007936,99,0.000468,0,16,0.364796,0.062333
18083,Knox County,,IN,1906,42402,44308,11,13,24,3449,3972,7421,6,0.317838,0.331974,7022.104611,0.000672,0.000631,77,0.000213,0,16,0.417582,0.006028
18085,Kosciusko County,,IN,5164,97194,102358,23,23,46,10852,11607,22459,5,0.361888,0.382183,1048.567257,0.003324,0.00359,99,0.000256,0,16,0.504615,0.028415
18087,LaGrange County,,IN,2555,45760,48315,7,10,17,5843,6456,12299,6,0.317106,0.330846,7.691007,0.000523,0.000825,99,0.00011,0,16,0.644444,0.0036
18089,Lake County,,IN,27085,580076,607161,86,110,196,78965,85521,164486,5,0.423045,0.453742,7336.107529,0.028471,0.036613,99,0.000674,0,16,0.564693,0.240428
18091,LaPorte County,,IN,5392,129528,134920,15,19,34,13733,12200,25933,5,0.363189,0.383146,85.077469,0.003483,0.004512,99,0.000151,0,16,0.760526,0.0272
18093,Lawrence County,,IN,2390,54653,57043,10,13,23,5366,5328,10694,6,0.317705,0.331837,667.409507,0.000655,0.000913,99,0.000172,0,16,0.5,0.006024
18095,Madison County,,IN,7387,152405,159792,30,25,55,18422,18553,36975,5,0.368447,0.389573,1206.472772,0.004518,0.005043,99,0.000337,0,16,0.456328,0.038577
18097,Marion County,,IN,64338,1057922,1122260,294,288,582,208752,226694,435446,5,0.462443,0.505965,215968.195358,0.070771,0.070521,99,0.002531,0,16,0.275813,0.599206
18099,Marshall County,,IN,3084,57170,60254,12,15,27,7041,7760,14801,5,0.359653,0.378744,161.73641,0.001871,0.002687,99,0.000141,0,16,0.771429,0.014918
18101,Martin County,,IN,595,12484,13079,5,6,11,962,1364,2326,6,0.293082,0.303329,3.066825,0.000025,0.000133,77,0.000118,0,16,0.666667,0.000521
18103,Miami County,,IN,2783,40263,43046,11,12,23,6154,6306,12460,6,0.317306,0.331397,8.522288,0.001097,0.001036,99,0.000159,0,16,0.711538,0.009081
18105,Monroe County,,IN,11101,120246,131347,78,80,158,24752,26213,50965,5,0.413628,0.441757,19366.583411,0.01935,0.023994,99,0.000754,0,16,0.449781,0.165376
18107,Montgomery County,,IN,2442,46730,49172,11,14,25,5202,6160,11362,5,0.348923,0.366138,231.094534,0.001422,0.002032,99,0.000164,0,16,0.580952,0.011907
18109,Morgan County,,IN,5828,84009,89837,17,16,33,17019,16225,33244,6,0.317206,0.331644,28.670332,0.001182,0.001043,99,0.000239,0,16,0.621324,0.01019
18111,Newton County,,IN,1169,16922,18091,8,10,18,2759,2907,5666,5,0.346528,0.362727,145.441514,0.001096,0.001424,99,0.000131,0,16,0.644444,0.008885
18113,Noble County,,IN,3423,56562,59985,8,8,16,8689,9302,17991,6,0.316974,0.330406,29.629151,0.000748,0.000665,99,0.000124,0,16,0.767857,0.00611
18115,Ohio County,,IN,642,7404,8046,4,5,9,1524,2061,3585,6,0.309872,0.321987,0.234987,0.000399,0.000417,65,0.000091,0,16,0.85,0.003267
18117,Orange County,,IN,1251,22368,23619,9,11,20,2552,2727,5279,6,0.320835,0.335298,673.456987,0.000603,0.000972,99,0.000171,0,16,0.6,0.005514
18119,Owen County,,IN,1750,24710,26460,10,9,19,5234,5123,10357,6,0.316675,0.329993,2.224047,0.00072,0.000664,99,0.000158,0,16,0.822222,0.006353
18121,Parke County,,IN,1253,17967,19220,7,8,15,2648,2812,5460,6,0.316642,0.329828,122.549234,0.000476,0.000509,99,0.000136,0,16,0.696429,0.004357
18123,Perry County,,IN,1022,21336,22358,6,7,13,2511,1906,4417,6,0.284573,0.294751,146.324542,0.000106,0.00008,77,0.000165,0,16,0.47619,0.001103
18125,Pike County,,IN,950,15271,16221,6,6,12,1923,2314,4237,6,0.28428,0.294063,1.911492,0.000097,0.000076,77,0.000138,0,16,0.866667,0.001104
18127,Porter County,,IN,11406,194916,206322,32,36,68,34066,29377,63443,5,0.378011,0.401722,1157.89388,0.008553,0.010469,99,0.000281,0,16,0.605938,0.070168
18129,Posey County,,IN,1704,31894,33598,5,5,10,4098,4630,8728,6,0.284173,0.293733,10.464387,0.000087,0.00007,77,0.00014,0,16,0.6,0.000973
18131,Pulaski County,,IN,1049,16023,17072,9,10,19,2237,2448,4685,6,0.316808,0.330351,8.642297,0.0005,0.000786,99,0.000131,0,16,0.677778,0.003666
18133,Putnam County,,IN,2843,39957,42800,13,13,26,6605,6771,13376,6,0.31704,0.331039,9.614823,0.001122,0.001009,99,0.000188,0,16,0.737179,0.009384
18135,Randolph County,,IN,1965,31413,33378,7,7,14,4195,4777,8972,6,0.316742,0.329911,31.155665,0.00051,0.00049,99,0.000124,0,16,0.619048,0.0046
18137,Ripley County,,IN,2001,33249,35250,10,14,24,5218,5443,10661,6,0.320326,0.335045,111.831378,0.001042,0.001083,65,0.000168,0,16,0.450549,0.008616
18139,Rush County,,IN,1341,20986,22327,8,7,15,3220,3193,6413,6,0.316477,0.329471,4.342136,0.000494,0.000447,99,0.000151,0,16,0.714286,0.004689
18141,St. Joseph County,,IN,16213,312608,328821,69,94,163,34524,41407,75931,5,0.41837,0.447783,5684.001148,0.023251,0.0336,99,0.000545,0,16,0.619495,0.196761
18143,Scott County,,IN,1633,27074,28707,8,9,17,4267,4583,8850,6,0.320733,0.334885,10.779782,0.000462,0.000893,77,0.000152,0,16,0.777778,0.004611
18145,Shelby County,,IN,3368,54761,58129,13,13,26,9005,9158,18163,6,0.316841,0.330736,18.763284,0.00094,0.000922,99,0.000201,0,16,0.582418,0.008481
18147,Spencer County,,IN,1510,25857,27367,5,6,11,3011,4266,7277,6,0.317539,0.330764,42.365295,0.000103,0.000492,77,0.000129,0,16,0.8,0.001036
18149,Starke County,,IN,1585,27304,28889,9,10,19,4278,4223,8501,5,0.34491,0.360554,82.907081,0.001158,0.001142,99,0.000121,0,16,0.755556,0.009368
18151,Steuben County,,IN,2638,39295,41933,11,10,21,5538,5494,11032,6,0.317272,0.331121,58.293591,0.000998,0.00081,99,0.000143,0,16,0.492424,0.007686
18153,Sullivan County,,IN,1285,23233,24518,5,6,11,2563,2974,5537,6,0.316742,0.329718,1.497074,0.000459,0.000564,99,0.000109,0,16,0.933333,0.004133
18155,Switzerland County,,IN,734,9899,10633,5,6,11,2001,1413,3414,6,0.309999,0.322345,5.510455,0.000407,0.000378,65,0.000104,0,16,0.533333,0.003402
18157,Tippecanoe County,,IN,13784,169635,183419,74,96,170,30083,33232,63315,5,0.419181,0.448773,20970.423918,0.01747,0.0289,99,0.000706,0,16,0.473046,0.146895
18159,Tipton County,,IN,1210,19865,21075,5,5,10,2972,2889,5861,6,0.31651,0.329306,0.434524,0.000695,0.000689,99,0.000096,0,16,0.833333,0.006098
18161,Union County,,IN,552,8401,8953,5,4,9,1663,1454,3117,6,0.297515,0.307967,2.383666,0.000246,0.000176,99,0.000104,0,16,0.65,0.001842
18163,Vanderburgh County,,IN,10522,204191,214713,49,51,100,27624,27891,55515,5,0.396414,0.422114,62309.22433,0.009584,0.011784,77,0.00067,0,16,0.351299,0.083765
18165,Vermillion County,,IN,1099,19668,20767,5,6,11,2605,2877,5482,6,0.316808,0.329828,17.010488,0.000056,0.000465,99,0.000119,0,16,0.733333,0.000756
18167,Vigo County,,IN,6788,113917,120705,30,33,63,13856,13961,27817,5,0.373305,0.39578,12406.7432,0.003518,0.005335,99,0.000414,0,16,0.352381,0.030076
18169,Wabash County,,IN,1918,40061,41979,10,10,20,3964,4573,8537,6,0.317007,0.330681,23.762109,0.000742,0.000688,99,0.000147,0,16,0.733333,0.006473
18171,Warren County,,IN,722,10423,11145,4,4,8,1801,1818,3619,6,0.296032,0.306295,3.942949,0.000192,0.000129,99,0.000105,0,16,0.666667,0.001352
18173,Warrick County,,IN,4645,70545,75190,12,13,25,13416,12089,25505,5,0.349487,0.366639,1509.262905,0.000904,0.001737,77,0.000241,0,16,0.428571,0.008335
18175,Washington County,,IN,1945,32730,34675,10,10,20,4287,4777,9064,6,0.320767,0.33505,50.323787,0.000863,0.000868,77,0.000178,0,16,0.655556,0.008032
18177,Wayne County,,IN,3706,81714,85420,15,19,34,6128,7116,13244,5,0.355183,0.374673,525.063076,0.001828,0.00262,99,0.000207,0,16,0.5,0.014299
18179,Wells County,,IN,1821,33308,35129,7,8,15,4139,4189,8328,6,0.316907,0.330296,217.639541,0.000658,0.000641,99,0.000124,0,16,0.696429,0.005685
18181,White County,,IN,2229,30467,32696,13,14,27,4822,5130,9952,5,0.346687,0.363387,320.864599,0.001549,0.001649,99,0.000185,0,16,0.576923,0.012942
18183,Whitley County,,IN,2352,42060,44412,6,8,14,6027,6335,12362,6,0.31694,0.330351,3.102303,0.000253,0.000668,99,0.000114,0,16,0.732143,0.002235
19001,Adair County,,IA,603,9210,9813,5,6,11,956,1088,2044,6,0.304239,0.315269,6.938131,0.000261,0.000252,18,0.00015,0,16,0.533333,0.002565
19003,Adams County,,IA,281,5020,5301,2,4,6,266,426,692,6,0.304361,0.315159,263.493386,0.000001,0.00022,18,0.000099,0,16,0.333333,0.000152
19005,Allamakee County,,IA,947,17436,18383,8,9,17,1317,1439,2756,6,0.288834,0.30049,66.889132,0.000209,0.000167,18,0.00015,0,16,0.430556,0.001883
19007,Appanoose County,,IA,748,14649,15397,4,6,10,791,1050,1841,6,0.304239,0.315269,356.930319,0.000241,0.000229,18,0.000141,0,16,0.533333,0.002297
19009,Audubon County,,IA,405,7581,7986,4,5,9,469,628,1097,6,0.304392,0.315434,11.007724,0.000244,0.000241,18,0.000124,0,16,0.65,0.002278
19011,Benton County,,IA,1911,31398,33309,8,7,15,5239,4981,10220,6,0.30661,0.318125,27.181845,0.000566,0.000442,18,0.000153,0,16,0.75,0.004533
19013,Black Hawk County,,IA,7485,143558,151043,47,50,97,16290,17960,34250,5,0.386057,0.411439,24634.338866,0.005144,0.009882,18,0.000658,0,16,0.280508,0.04629
19015,Boone County,,IA,1812,31464,33276,7,6,13,4121,3993,8114,6,0.30433,0.315352,3.35892,0.000386,0.000287,18,0.000165,0,16,0.761905,0.003372
19017,Bremer County,,IA,1853,27823,29676,8,10,18,3657,3912,7569,6,0.306765,0.31873,156.404419,0.000415,0.000478,18,0.000158,0,16,0.6,0.003546
19019,Buchanan County,,IA,1439,25188,26627,7,8,15,2999,3377,6376,6,0.306641,0.31829,7.937619,0.000182,0.000445,18,0.00014,0,16,0.708333,0.001551
19021,Buena Vista County,,IA,1738,23616,25354,14,11,25,2154,2349,4503,5,0.34985,0.366705,4275.032873,0.002679,0.001198,18,0.000231,0,16,0.404167,0.023355
19023,Butler County,,IA,1275,18034,19309,7,7,14,2283,2219,4502,6,0.304453,0.315737,7.073545,0.000071,0.000262,18,0.000157,0,16,0.589286,0.000914
19025,Calhoun County,,IA,742,12159,12901,4,6,10,989,1392,2381,6,0.304361,0.315407,5.715614,0.000013,0.000258,18,0.000125,0,16,0.566667,0.00036
19027,Carroll County,,IA,1307,26205,27512,10,9,19,2004,2091,4095,6,0.313431,0.325547,1554.871047,0.000611,0.000556,18,0.000225,0,16,0.433333,0.005659
19029,Cass County,,IA,880,16704,17584,7,6,13,1192,1313,2505,6,0.313075,0.324695,73.567905,0.000537,0.000505,18,0.000175,0,16,0.52381,0.004964
19031,Cedar County,,IA,1346,22790,24136,6,7,13,3378,3452,6830,6,0.307481,0.319198,5.324962,0.000436,0.00063,18,0.000113,0,16,0.880952,0.003936
19033,Cerro Gordo County,,IA,2728,52926,55654,17,20,37,4916,5626,10542,5,0.357362,0.377292,12920.986265,0.001749,0.002106,18,0.0003,0,16,0.354762,0.015519
19035,Cherokee County,,IA,738,14814,15552,5,6,11,1147,1006,2153,6,0.304575,0.315819,18.542554,0.000053,0.000269,18,0.00014,0,16,0.6,0.000823
19037,Chickasaw County,,IA,728,15526,16254,7,10,17,1265,1566,2831,6,0.305466,0.31747,167.017937,0.000084,0.000346,18,0.000146,0,16,0.566667,0.000985
19039,Clarke County,,IA,863,10833,11696,4,6,10,1259,1475,2734,6,0.304178,0.315159,5.353788,0.000244,0.000252,18,0.000128,0,16,0.6,0.002255
19041,Clay County,,IA,1196,20946,22142,7,8,15,1720,1873,3593,6,0.308013,0.320276,515.28426,0.000248,0.000364,18,0.000176,0,16,0.472222,0.002606
19043,Clayton County,,IA,1098,22323,23421,8,10,18,1833,2333,4166,6,0.298159,0.309514,47.420451,0.000207,0.000261,99,0.000148,0,16,0.509091,0.00181
19045,Clinton County,,IA,2815,59344,62159,13,16,29,5740,6579,12319,5,0.359781,0.378854,429.678851,0.001396,0.0021,99,0.000186,0,16,0.591667,0.012514
19047,Crawford County,,IA,1095,20409,21504,10,14,24,1526,2247,3773,6,0.313788,0.326703,1178.174148,0.001241,0.00063,18,0.000201,0,16,0.419048,0.011473
19049,Dallas County,,IA,5843,72482,78325,30,22,52,25724,17681,43405,5,0.36939,0.390167,4347.90225,0.00468,0.003724,18,0.000466,0,16,0.389655,0.041739
19051,Davis County,,IA,530,9930,10460,2,1,3,680,635,1315,7,0.235463,0.240834,0,0.000005,0.000008,18,0.000088,0,16,1,0.000223
19053,Decatur County,,IA,562,8440,9002,3,4,7,605,842,1447,6,0.304055,0.314719,1.866667,0.000237,0.000221,18,0.000118,0,16,0.5,0.00215
19055,Delaware County,,IA,998,22065,23063,6,8,14,2305,2595,4900,6,0.306765,0.31851,9.193452,0.000199,0.000463,99,0.00012,0,16,0.732143,0.001629
19057,Des Moines County,,IA,2687,48186,50873,13,11,24,4527,4347,8874,5,0.347323,0.36369,4036.315616,0.001303,0.001287,18,0.000229,0,16,0.434066,0.011899
19059,Dickinson County,,IA,1345,20660,22005,10,8,18,2133,1736,3869,6,0.308013,0.320276,5490.305972,0.000837,0.000344,18,0.000211,0,16,0.388889,0.007663
19061,Dubuque County,,IA,4565,113276,117841,23,24,47,8989,9051,18040,5,0.364238,0.38499,2532.802326,0.003998,0.003894,99,0.000287,0,16,0.469231,0.033714
19063,Emmet County,,IA,742,11985,12727,4,6,10,718,1081,1799,6,0.304514,0.315737,33.999831,0.000009,0.000229,18,0.000128,0,16,0.5,0.000372
19065,Fayette County,,IA,1286,23504,24790,9,10,19,2522,2835,5357,6,0.30689,0.31895,153.112226,0.00042,0.000444,18,0.00016,0,16,0.633333,0.0036
19067,Floyd County,,IA,1006,19396,20402,8,8,16,1727,1830,3557,6,0.306238,0.31796,1730.964708,0.000934,0.000373,18,0.000156,0,16,0.541667,0.008353
19069,Franklin County,,IA,750,12440,13190,6,6,12,1190,1428,2618,6,0.304545,0.315792,252.490686,0.000795,0.000261,18,0.000135,0,16,0.52381,0.006878
19071,Fremont County,,IA,721,8832,9553,5,6,11,1155,1466,2621,5,0.343502,0.359282,113.23178,0.000303,0.000964,18,0.000141,0,16,0.533333,0.002917
19073,Greene County,,IA,605,11469,12074,7,6,13,1024,1095,2119,6,0.304269,0.315242,2.679831,0.000331,0.000284,18,0.000171,0,16,0.714286,0.00308
19075,Grundy County,,IA,922,15115,16037,5,7,12,2207,2054,4261,6,0.305189,0.316645,4.216836,0.000067,0.00034,18,0.000133,0,16,0.738095,0.000798
19077,Guthrie County,,IA,972,13168,14140,4,5,9,1726,1835,3561,6,0.304116,0.314939,1.2,0.00026,0.000251,18,0.000125,0,16,0.8,0.002486
19079,Hamilton County,,IA,1093,18949,20042,8,6,14,2223,2173,4396,6,0.304422,0.315517,54.785396,0.000851,0.000259,18,0.000169,0,16,0.5,0.007286
19081,Hancock County,,IA,793,14152,14945,4,5,9,1205,1268,2473,6,0.304361,0.315352,1.975,0.000017,0.00023,18,0.000118,0,16,0.75,0.000408
19083,Hardin County,,IA,1281,20199,21480,8,8,16,1918,2034,3952,6,0.304575,0.315984,130.98892,0.000363,0.000301,18,0.000182,0,16,0.553571,0.003286
19085,Harrison County,,IA,903,17809,18712,7,6,13,1998,1810,3808,6,0.313431,0.324023,124.243699,0.000435,0.00042,18,0.000156,0,16,0.595238,0.004252
19087,Henry County,,IA,1595,22814,24409,8,10,18,2608,2753,5361,6,0.307076,0.31906,858.164842,0.000281,0.000432,18,0.000175,0,16,0.544444,0.002392
19089,Howard County,,IA,576,12189,12765,4,5,9,653,754,1407,6,0.278862,0.288489,8.558543,0.000011,0.000036,18,0.000108,0,16,0.45,0.000326
19091,Humboldt County,,IA,752,12041,12793,3,5,8,661,918,1579,6,0.304239,0.315159,3.65169,0.00001,0.000224,18,0.0001,0,16,0.55,0.000274
19093,Ida County,,IA,583,8871,9454,4,5,9,621,725,1346,6,0.304545,0.315654,5.303403,0.000047,0.000266,18,0.000119,0,16,0.733333,0.000658
19095,Iowa County,,IA,1142,20614,21756,7,7,14,2496,2395,4891,6,0.306517,0.31796,32.742476,0.000507,0.000415,18,0.000145,0,16,0.690476,0.004162
19097,Jackson County,,IA,1161,24642,25803,5,7,12,2411,2847,5258,6,0.307575,0.319363,4.74471,0.0003,0.000645,99,0.000102,0,16,0.928571,0.003
19099,Jasper County,,IA,2679,43502,46181,11,11,22,5097,5849,10946,6,0.306734,0.318785,8.920872,0.000656,0.000518,18,0.000203,0,16,0.754545,0.005437
19101,Jefferson County,,IA,1080,17238,18318,6,8,14,1511,1804,3315,6,0.306952,0.31851,722.602936,0.000163,0.000348,18,0.000149,0,16,0.464286,0.001518
19103,Johnson County,,IA,11845,131710,143555,85,90,175,29221,30108,59329,5,0.418081,0.446704,48036.01678,0.019144,0.025723,18,0.000956,0,16,0.39368,0.168148
19105,Jones County,,IA,1281,23678,24959,7,8,15,3030,2890,5920,6,0.306703,0.3184,7.990852,0.000309,0.000443,18,0.000126,0,16,0.732143,0.002477
19107,Keokuk County,,IA,732,12696,13428,6,7,13,1364,1648,3012,6,0.306021,0.317354,6.781468,0.000165,0.000344,18,0.00014,0,16,0.642857,0.001542
19109,Kossuth County,,IA,798,19895,20693,7,7,14,896,887,1783,6,0.304606,0.315929,1123.075983,0.000254,0.000261,18,0.000167,0,16,0.357143,0.002515
19111,Lee County,,IA,2063,41214,43277,8,10,18,3146,3532,6678,6,0.308484,0.320876,7436.608629,0.000286,0.000638,18,0.000188,0,16,0.366667,0.002455
19113,Linn County,,IA,12067,252095,264162,66,75,141,29462,29801,59263,5,0.402632,0.430604,37185.753008,0.01293,0.018906,18,0.000784,0,16,0.364146,0.113521
19115,Louisa County,,IA,1264,13449,14713,7,6,13,1870,2317,4187,6,0.300854,0.311104,293.169433,0.00121,0.000338,99,0.000133,0,16,0.607143,0.010588
19117,Lucas County,,IA,669,10317,10986,4,4,8,924,1075,1999,6,0.304055,0.314719,1.833333,0.000245,0.000223,18,0.000134,0,16,0.666667,0.002263
19119,Lyon County,,IA,717,14245,14962,4,5,9,1027,1312,2339,6,0.286512,0.296968,355.497662,0.000122,0.000118,18,0.000123,0,16,0.6,0.001385
19121,Madison County,,IA,1221,18391,19612,6,6,12,2738,2634,5372,6,0.3043,0.315297,5.144783,0.000268,0.000283,18,0.000161,0,16,0.642857,0.002662
19123,Mahaska County,,IA,1660,25546,27206,7,10,17,2817,3072,5889,6,0.306672,0.318565,29.114019,0.00025,0.000458,18,0.000169,0,16,0.633333,0.002591
19125,Marion County,,IA,2142,39332,41474,10,10,20,3732,4268,8000,6,0.30596,0.317685,22.570322,0.000338,0.000409,18,0.000228,0,16,0.536364,0.003373
19127,Marshall County,,IA,2695,47489,50184,16,12,28,4332,5015,9347,6,0.30689,0.31917,1147.637031,0.001981,0.000516,18,0.000261,0,16,0.483333,0.017754
19129,Mills County,,IA,1256,17138,18394,7,6,13,2659,2658,5317,6,0.313529,0.324106,12.097675,0.000437,0.00042,18,0.000173,0,16,0.666667,0.004215
19131,Mitchell County,,IA,579,13012,13591,5,6,11,843,706,1549,6,0.279196,0.289287,86.558965,0.000021,0.000053,18,0.000133,0,16,0.3,0.00055
19133,Monona County,,IA,547,11007,11554,3,4,7,768,898,1666,6,0.311241,0.321778,3.071801,0.000046,0.00031,18,0.000096,0,16,0.75,0.000596
19135,Monroe County,,IA,543,8867,9410,5,5,10,936,1171,2107,6,0.304208,0.315104,0.916667,0.000245,0.000229,18,0.000134,0,16,0.85,0.002392
19137,Montgomery County,,IA,750,12752,13502,6,5,11,1110,988,2098,6,0.310954,0.321421,23.304558,0.000305,0.000291,18,0.000166,0,16,0.533333,0.002981
19139,Muscatine County,,IA,2692,52317,55009,13,14,27,5451,6227,11678,5,0.347362,0.364075,462.93439,0.001421,0.001386,99,0.000209,0,16,0.552381,0.012617
19141,O'Brien County,,IA,1030,17570,18600,8,8,16,1643,1799,3442,6,0.287272,0.298564,120.524328,0.000055,0.000142,18,0.000199,0,16,0.458333,0.00101
19143,Osceola County,,IA,507,7961,8468,3,5,8,420,688,1108,6,0.286647,0.297216,5.588709,0.000004,0.000104,18,0.000113,0,16,0.5,0.000264
19145,Page County,,IA,1108,17677,18785,7,8,15,1511,1596,3107,6,0.313464,0.32552,1688.989409,0.000311,0.000509,18,0.000191,0,16,0.446429,0.00307
19147,Palo Alto County,,IA,645,11321,11966,5,6,11,906,1033,1939,6,0.304453,0.315627,504.703293,0.000241,0.000224,18,0.000135,0,16,0.533333,0.002298
19149,Plymouth County,,IA,1663,31126,32789,9,9,18,3196,3153,6349,6,0.315619,0.328508,401.469829,0.000673,0.000628,18,0.0002,0,16,0.569444,0.006246
19151,Pocahontas County,,IA,634,9022,9656,5,7,12,747,945,1692,6,0.30433,0.315544,32.804019,0.000018,0.000244,18,0.000134,0,16,0.392857,0.000523
19153,Polk County,,IA,24658,502800,527458,179,158,337,82051,75387,157438,5,0.436644,0.470419,239537.093108,0.036729,0.039795,18,0.002267,0,16,0.265164,0.324008
19155,Pottawattamie County,,IA,6103,106479,112582,21,21,42,15326,15899,31225,5,0.358462,0.378315,1941.763334,0.002721,0.002017,18,0.000383,0,16,0.347826,0.024112
19157,Poweshiek County,,IA,1414,21178,22592,10,11,21,2124,2651,4775,6,0.306734,0.318785,10.05946,0.00063,0.000494,18,0.000185,0,16,0.690909,0.005105
19159,Ringgold County,,IA,356,5513,5869,4,3,7,288,394,682,6,0.304086,0.314664,264.085806,0.000237,0.000219,18,0.000136,0,16,0.5,0.002223
19161,Sac County,,IA,605,12689,13294,6,5,11,1183,1057,2240,6,0.304208,0.315104,586.067664,0.000252,0.000236,18,0.000151,0,16,0.533333,0.002575
19163,Scott County,,IA,12502,195634,208136,112,77,189,39490,29444,68934,5,0.42128,0.448256,20304.574461,0.03492,0.025522,99,0.000946,0,16,0.517804,0.293558
19165,Shelby County,,IA,948,14973,15921,6,8,14,1467,1606,3073,6,0.313334,0.325272,37.861451,0.000305,0.000547,18,0.000156,0,16,0.625,0.003044
19167,Sioux County,,IA,1664,39197,40861,8,9,17,2327,2654,4981,6,0.315751,0.328645,802.576945,0.001061,0.000665,18,0.00018,0,16,0.6,0.009985
19169,Story County,,IA,8448,84284,92732,45,46,91,14413,19028,33441,5,0.387588,0.412611,11156.508743,0.005519,0.010319,18,0.000689,0,16,0.306546,0.050145
19171,Tama County,,IA,1373,21828,23201,7,8,15,2386,2948,5334,6,0.305343,0.316947,69.395154,0.000415,0.000375,18,0.000149,0,16,0.767857,0.003557
19173,Taylor County,,IA,433,7345,7778,4,5,9,517,676,1193,7,0.244314,0.251241,89.300387,0.000012,0.000008,18,0.000137,0,16,0.3,0.000336
19175,Union County,,IA,930,14275,15205,8,7,15,1559,1508,3067,6,0.304422,0.315599,3963.069925,0.000251,0.000222,18,0.000218,0,16,0.267857,0.002607
19177,Van Buren County,,IA,546,8712,9258,4,4,8,642,797,1439,7,0.236752,0.243004,7.133811,0.000012,0.000012,18,0.000115,0,16,0.583333,0.000388
19179,Wapello County,,IA,2362,40917,43279,15,15,30,3827,4231,8058,6,0.30795,0.320793,9760.961241,0.001343,0.000672,18,0.000331,0,16,0.359477,0.012144
19181,Warren County,,IA,3427,53779,57206,10,12,22,10180,9297,19477,5,0.35303,0.371157,304.967728,0.00059,0.001193,18,0.000215,0,16,0.575758,0.00495
19183,Washington County,,IA,1541,26291,27832,8,9,17,3126,3204,6330,6,0.306796,0.318565,21.93579,0.000282,0.000427,18,0.000164,0,16,0.569444,0.002413
19185,Wayne County,,IA,395,7234,7629,4,3,7,664,498,1162,6,0.304055,0.314609,2.416667,0.000238,0.000219,18,0.000135,0,16,0.5,0.002228
19187,Webster County,,IA,2297,43210,45507,12,15,27,3248,4115,7363,5,0.347961,0.364955,3254.762975,0.000666,0.001174,18,0.000231,0,16,0.442857,0.005416
19189,Winnebago County,,IA,830,13415,14245,6,7,13,1196,1268,2464,6,0.304667,0.316094,173.178394,0.000025,0.000235,18,0.000154,0,16,0.428571,0.000587
19191,Winneshiek County,,IA,1103,24147,25250,8,12,20,1480,1972,3452,6,0.325594,0.340982,973.348631,0.00033,0.000941,18,0.000153,0,16,0.492424,0.002591
19193,Woodbury County,,IA,6336,118408,124744,36,39,75,13982,15342,29324,5,0.385712,0.409695,23876.324123,0.005499,0.006795,18,0.000571,0,16,0.334038,0.04864
19195,Worth County,,IA,526,9335,9861,4,4,8,1019,1150,2169,6,0.263598,0.271811,3.781059,0.00002,0.000017,18,0.000113,0,16,0.583333,0.000435
19197,Wright County,,IA,926,15581,16507,8,9,17,1351,1582,2933,6,0.30482,0.316535,1050.815366,0.00032,0.000303,18,0.00018,0,16,0.486111,0.003
20001,Allen County,,KS,972,15380,16352,5,8,13,1205,1632,2837,6,0.316312,0.328596,6099.07462,0.000271,0.000612,32,0.000167,0,16,0.428571,0.002394
20003,Anderson County,,KS,642,9657,10299,5,6,11,859,1094,1953,6,0.312332,0.323638,26.377632,0.000361,0.000328,32,0.000115,0,16,0.533333,0.003129
20005,Atchison County,,KS,1119,18541,19660,11,10,21,1766,2372,4138,6,0.316444,0.32941,618.780673,0.001028,0.000902,32,0.000205,0,16,0.581818,0.008653
20007,Barber County,,KS,400,5649,6049,3,2,5,286,358,644,6,0.307325,0.317646,15.225906,0.000268,0.000225,32,0.000121,0,16,0.333333,0.002235
20009,Barton County,,KS,2000,32145,34145,15,16,31,2821,3249,6070,6,0.320767,0.334995,13448.230356,0.001985,0.000861,32,0.000432,0,16,0.365497,0.01807
20011,Bourbon County,,KS,1000,16973,17973,6,6,12,1308,1491,2799,6,0.312752,0.324353,40.099727,0.000428,0.000376,32,0.000138,0,16,0.452381,0.003767
20013,Brown County,,KS,771,11838,12609,7,7,14,1204,1183,2387,6,0.312526,0.324078,345.377658,0.000435,0.000379,32,0.000169,0,16,0.404762,0.003786
20015,Butler County,,KS,5114,71741,76855,17,22,39,12970,12744,25714,5,0.353483,0.373286,3388.513829,0.001829,0.004317,32,0.000273,0,16,0.46558,0.016205
20017,Chase County,,KS,224,3112,3336,2,1,3,355,229,584,6,0.265213,0.273055,0.860673,0.000021,0.000012,32,0.00007,0,16,0,0.00025
20019,Chautauqua County,,KS,274,4043,4317,1,2,3,222,353,575,6,0.24584,0.252537,0.333333,0.000008,0.00001,32,0.000061,0,16,0,0.000122
20021,Cherokee County,,KS,1644,23389,25033,5,5,10,3383,3883,7266,6,0.272809,0.282244,1,0.000074,0.00008,32,0.000123,0,16,0.8,0.001099
20023,Cheyenne County,,KS,233,3290,3523,0,0,0,0,0,0,0,0,0,0,0,0,19,0.000049,13,36,0,0
20025,Clark County,,KS,177,2451,2628,1,1,2,154,127,281,6,0.267863,0.275388,0,0.000021,0.000019,32,0.000067,0,16,0,0.000236
20027,Clay County,,KS,782,10464,11246,4,5,9,1230,895,2125,6,0.289912,0.300187,113.634384,0.000222,0.000243,32,0.000087,0,16,0.633333,0.002268
20029,Cloud County,,KS,788,10790,11578,6,6,12,9745,785,10530,6,0.310858,0.322125,3697.839709,0.000023,0.000335,32,0.000246,0,16,0.375,0.000575
20031,Coffey County,,KS,705,10270,10975,6,6,12,899,1110,2009,6,0.312946,0.324491,5.381275,0.000452,0.00039,32,0.000118,0,16,0.8,0.003815
20033,Comanche County,,KS,170,2091,2261,0,0,0,0,0,0,0,0,0,0,0,0,20,0.000049,14,37,0,0
20035,Cowley County,,KS,2993,40151,43144,8,10,18,3747,5067,8814,5,0.323162,0.337279,1486.728322,0.000702,0.001134,32,0.000151,0,16,0.403846,0.005908
20037,Crawford County,,KS,2963,40560,43523,20,18,38,5547,5971,11518,6,0.322852,0.338329,921.025404,0.001663,0.001726,32,0.000334,0,16,0.383117,0.014489
20039,Decatur County,,KS,295,3529,3824,0,1,1,0,121,121,8,0.195069,0.198185,0,0,0,32,0.000049,0,38,0,0
20041,Dickinson County,,KS,2115,23638,25753,8,9,17,2857,3397,6254,6,0.318641,0.331363,111.843577,0.001433,0.000896,32,0.000141,0,16,0.755556,0.012535
20043,Doniphan County,,KS,718,8745,9463,4,4,8,1261,1379,2640,6,0.269988,0.278585,7.705336,0.000034,0.000036,32,0.00013,0,16,0.5,0.000601
20045,Douglas County,,KS,10041,105564,115605,53,58,111,22495,24074,46569,5,0.400344,0.426439,16360.896628,0.010827,0.017781,32,0.000689,0,16,0.43913,0.09884
20047,Edwards County,,KS,313,3603,3916,2,2,4,183,194,377,6,0.267911,0.275608,6.705798,0.000022,0.000019,32,0.000113,0,16,0,0.000303
20049,Elk County,,KS,236,3230,3466,0,2,2,0,180,180,6,0.26159,0.269571,0,0,0.000017,32,0.000049,0,39,0.5,0
20051,Ellis County,,KS,2313,31503,33816,21,16,37,3538,3850,7388,6,0.319481,0.333427,51292.59535,0.000992,0.000829,32,0.000819,0,16,0.188312,0.008788
20053,Ellsworth County,,KS,442,6844,7286,2,3,5,307,496,803,6,0.307919,0.318554,0,0.000024,0.000251,32,0.000094,0,16,1,0.000406
20055,Finney County,,KS,3064,44222,47286,16,23,39,3709,4712,8421,5,0.371155,0.392385,26695.193242,0.003344,0.00429,32,0.0004,0,16,0.409231,0.030754
20057,Ford County,,KS,2677,38132,40809,18,21,39,4457,4020,8477,5,0.365821,0.386134,22574.482262,0.003159,0.003504,32,0.000438,0,16,0.339921,0.028261
20059,Franklin County,,KS,2140,30176,32316,10,13,23,4461,5066,9527,6,0.320495,0.334329,61.721295,0.000944,0.001131,32,0.000164,0,16,0.621795,0.007741
20061,Geary County,,KS,11615,33134,44749,66,59,125,21149,23671,44820,5,0.395018,0.421338,7938.054501,0.020811,0.016837,32,0.000602,0,16,0.623139,0.185804
20063,Gove County,,KS,178,3349,3527,0,0,0,0,0,0,0,0,0,0,0,0,21,0.000049,15,40,0,0
20065,Graham County,,KS,263,3325,3588,0,2,2,0,296,296,7,0.242303,0.248243,0,0,0.000006,32,0.000049,0,41,0.5,0
20067,Grant County,,KS,657,9027,9684,1,4,5,250,453,703,6,0.308013,0.318802,26.957333,0.000025,0.000255,32,0.000064,0,16,0.666667,0.00025
20069,Gray County,,KS,575,7006,7581,3,3,6,803,658,1461,6,0.274989,0.283355,11.563482,0.000046,0.000038,32,0.000124,0,16,0.666667,0.000551
20071,Greeley County,,KS,137,1501,1638,0,0,0,0,0,0,0,0,0,0,0,0,22,0.000049,16,42,0,0
20073,Greenwood County,,KS,587,7382,7969,3,3,6,799,875,1674,6,0.307888,0.318581,0,0.000307,0.000246,32,0.000078,0,16,1,0.002399
20075,Hamilton County,,KS,235,2912,3147,0,0,0,0,0,0,0,0,0,0,0,0,23,0.000049,17,43,0,0
20077,Harper County,,KS,528,6985,7513,2,2,4,365,652,1017,6,0.307294,0.317591,0,0.000265,0.000225,32,0.000075,0,16,1,0.00214
20079,Harvey County,,KS,2352,40397,42749,9,11,20,5541,5776,11317,6,0.32036,0.333944,24.317477,0.000804,0.001086,32,0.000165,0,16,0.833333,0.006659
20081,Haskell County,,KS,460,4687,5147,2,2,4,246,315,561,6,0.270737,0.278673,0,0.000026,0.00002,32,0.000099,0,16,1,0.000318
20083,Hodgeman County,,KS,163,2349,2512,1,1,2,132,150,282,6,0.267863,0.275388,0,0.000021,0.000019,32,0.000067,0,16,0,0.000236
20085,Jackson County,,KS,1013,16099,17112,6,7,13,2309,2449,4758,6,0.286891,0.297133,5.554337,0.0002,0.000145,32,0.000143,0,16,0.571429,0.001679
20087,Jefferson County,,KS,1560,22314,23874,8,7,15,3859,3932,7791,6,0.313853,0.325536,38.980291,0.000685,0.000582,32,0.000145,0,16,0.696429,0.005696
20089,Jewell County,,KS,246,3928,4174,2,1,3,3855,47,3902,7,0.237159,0.242019,0,0.000003,0,32,0.000087,0,16,0.5,0.000139
20091,Johnson County,,KS,39476,633505,672981,204,210,414,133608,126721,260329,5,0.453579,0.490134,136783.852615,0.052128,0.057942,32,0.00206,0,16,0.341347,0.457825
20093,Kearny County,,KS,359,4672,5031,1,1,2,507,528,1035,6,0.270712,0.278508,0,0.000025,0.00002,32,0.000064,0,16,0,0.00025
20095,Kingman County,,KS,616,9372,9988,3,3,6,1047,1217,2264,6,0.307388,0.317866,0,0.000278,0.000237,32,0.000121,0,16,1,0.002333
20097,Kiowa County,,KS,262,2511,2773,1,1,2,77,62,139,7,0.23539,0.240171,0,0.000001,0.000002,32,0.000093,0,16,0,0.000086
20099,Labette County,,KS,1337,25855,27192,7,9,16,2119,2546,4665,6,0.319178,0.332613,233.352102,0.000637,0.000963,32,0.000144,0,16,0.722222,0.005755
20101,Lane County,,KS,138,2137,2275,0,0,0,0,0,0,0,0,0,0,0,0,24,0.000049,18,44,0,0
20103,Leavenworth County,,KS,9608,77206,86814,52,49,101,22850,22469,45319,5,0.384879,0.410207,2156.233196,0.014123,0.013738,32,0.000499,0,16,0.579855,0.126286
20105,Lincoln County,,KS,321,3879,4200,1,1,2,206,237,443,6,0.267438,0.27519,0,0.000019,0.000016,32,0.000071,0,16,0,0.000228
20107,Linn County,,KS,751,10676,11427,8,6,14,1894,1511,3405,6,0.312526,0.323968,9.634359,0.000749,0.000391,32,0.000149,0,16,0.583333,0.006415
20109,Logan County,,KS,246,3293,3539,1,1,2,190,201,391,8,0.195004,0.198097,0,0,0,32,0.000142,0,16,0,0.000068
20111,Lyon County,,KS,4616,37187,41803,16,30,46,3572,6364,9936,5,0.360896,0.382233,7342.466105,0.001998,0.002997,32,0.000295,0,16,0.258065,0.016872
20113,McPherson County,,KS,2132,35026,37158,11,10,21,3693,4008,7701,6,0.318507,0.331336,48.829905,0.000877,0.000787,32,0.000202,0,16,0.704545,0.007329
20115,Marion County,,KS,882,14348,15230,4,7,11,1444,1767,3211,6,0.316114,0.328156,246.045141,0.0003,0.000563,32,0.000099,0,16,0.690476,0.002449
20117,Marshall County,,KS,728,13149,13877,5,5,10,744,801,1545,6,0.289165,0.299901,275.799786,0.000465,0.000163,32,0.000116,0,16,0.466667,0.003906
20119,Meade County,,KS,379,5272,5651,1,1,2,243,201,444,6,0.245621,0.25181,0,0.000007,0.000012,32,0.000073,0,16,0,0.000176
20121,Miami County,,KS,2546,37231,39777,11,12,23,7065,6651,13716,6,0.320292,0.333862,57.337011,0.001079,0.001197,32,0.000178,0,16,0.628205,0.008974
20123,Mitchell County,,KS,449,7473,7922,5,6,11,494,612,1106,6,0.310858,0.322125,7362.635892,0.000022,0.000335,32,0.000221,0,16,0.357143,0.000496
20125,Montgomery County,,KS,2742,39602,42344,12,16,28,3842,5073,8915,6,0.320903,0.335798,5401.471446,0.000996,0.001362,32,0.000232,0,16,0.393382,0.008919
20127,Morris County,,KS,456,6972,7428,3,3,6,515,528,1043,6,0.292572,0.302581,0.572151,0.000234,0.00023,32,0.000076,0,16,0.666667,0.002231
20129,Morton County,,KS,296,3858,4154,0,0,0,0,0,0,0,0,0,0,0,0,25,0.000049,19,45,0,0
20131,Nemaha County,,KS,725,12982,13707,6,6,12,939,1048,1987,6,0.31493,0.326571,65.405176,0.000544,0.00047,32,0.000136,0,16,0.6,0.004537
20133,Neosho County,,KS,1213,18918,20131,7,8,15,2005,2378,4383,6,0.31651,0.328926,50.883614,0.000634,0.000603,32,0.000145,0,16,0.678571,0.005327
20135,Ness County,,KS,265,3781,4046,0,1,1,0,109,109,7,0.242187,0.247896,0,0,0.000006,32,0.000049,0,46,0,0
20137,Norton County,,KS,404,5931,6335,3,2,5,378,152,530,7,0.242262,0.24816,3030,0,0.000006,32,0.000165,0,16,0.166667,0.000188
20139,Osage County,,KS,1460,19477,20937,6,7,13,2900,3350,6250,6,0.312913,0.324574,1.47619,0.000555,0.000456,32,0.000114,0,16,0.809524,0.004387
20141,Osborne County,,KS,281,4870,5151,1,2,3,104,210,314,7,0.242301,0.248281,3.785714,0.000002,0.000006,32,0.00008,0,16,0,0.00007
20143,Ottawa County,,KS,605,7435,8040,2,2,4,1006,998,2004,6,0.267485,0.27541,0,0.000021,0.000017,32,0.000106,0,16,1,0.000299
20145,Pawnee County,,KS,585,7502,8087,3,3,6,517,626,1143,6,0.307731,0.318306,149.947172,0.00001,0.000235,32,0.000164,0,16,0.5,0.000375
20147,Phillips County,,KS,353,7028,7381,2,2,4,196,175,371,7,0.242262,0.24816,3042.94152,0.000001,0.000006,32,0.000126,0,16,0.166667,0.000135
20149,Pottawatomie County,,KS,1977,24700,26677,8,8,16,4015,3754,7769,6,0.318406,0.330896,120.487372,0.000827,0.000875,32,0.000147,0,16,0.680556,0.007023
20151,Pratt County,,KS,913,10832,11745,8,6,14,1027,965,1992,6,0.307825,0.318802,6232.145245,0.000305,0.00025,32,0.000308,0,16,0.357143,0.002944
20153,Rawlins County,,KS,199,3023,3222,0,1,1,0,51,51,8,0.195043,0.198196,0,0,0,32,0.000049,0,47,0,0
20155,Reno County,,KS,3525,74606,78131,22,20,42,7129,7741,14870,5,0.357784,0.377413,5497.038466,0.002083,0.002182,32,0.000435,0,16,0.420949,0.01835
20157,Republic County,,KS,294,6353,6647,2,1,3,6383,143,6526,7,0.237159,0.242019,0,0.000003,0,32,0.000091,0,16,0.5,0.000141
20159,Rice County,,KS,899,11041,11940,4,4,8,1220,1440,2660,6,0.307731,0.318416,0.693731,0.000286,0.000252,32,0.000117,0,16,0.833333,0.002538
20161,Riley County,,KS,12300,53748,66048,75,78,153,24243,27572,51815,5,0.404244,0.432497,49340.946454,0.016212,0.019806,32,0.00089,0,16,0.404994,0.145642
20163,Rooks County,,KS,446,6223,6669,1,1,2,278,309,587,7,0.242146,0.247813,0,0.000005,0.000006,32,0.000093,0,16,0,0.000131
20165,Rush County,,KS,306,4013,4319,2,2,4,298,457,755,7,0.243196,0.249365,0,0.00001,0.000018,32,0.000116,0,16,1,0.00031
20167,Russell County,,KS,518,7942,8460,2,3,5,483,589,1072,6,0.268243,0.27673,0,0.00001,0.000034,32,0.000116,0,16,1,0.00031
20169,Saline County,,KS,4054,66439,70493,27,22,49,7968,8173,16141,5,0.365028,0.385936,28208.439342,0.002778,0.003193,32,0.000562,0,16,0.347291,0.024944
20171,Scott County,,KS,378,5955,6333,1,1,2,228,210,438,6,0.270712,0.278508,0,0.000025,0.00002,32,0.000064,0,16,0,0.00025
20173,Sedgwick County,,KS,23857,574017,597874,155,166,321,66701,71467,138168,5,0.443485,0.477281,133944.289733,0.03787,0.044752,32,0.001852,0,16,0.348736,0.342122
20175,Seward County,,KS,2278,26764,29042,13,12,25,3537,3425,6962,5,0.325559,0.340822,14576.715177,0.002033,0.001223,32,0.000343,0,16,0.366667,0.018464
20177,Shawnee County,,KS,9805,210768,220573,54,57,111,22240,23163,45403,5,0.389532,0.415599,18353.960693,0.010281,0.013904,32,0.000746,0,16,0.388221,0.093232
20179,Sheridan County,,KS,178,3383,3561,0,0,0,0,0,0,0,0,0,0,0,0,26,0.000049,20,48,0,0
20181,Sherman County,,KS,590,6669,7259,2,2,4,286,294,580,7,0.242204,0.248088,28.817039,0.000003,0.000006,32,0.00017,0,16,0.333333,0.000176
20183,Smith County,,KS,287,4939,5226,1,0,1,4427,0,4427,0,0,0,0,0.000001,0,32,0.000056,0,9,0,0.000069
20185,Stafford County,,KS,374,5104,5478,2,3,5,282,459,741,6,0.264172,0.272098,0,0.000018,0.000026,32,0.000091,0,16,1,0.000364
20187,Stanton County,,KS,252,2637,2889,0,0,0,0,0,0,0,0,0,0,0,0,27,0.000049,21,49,0,0
20189,Stevens County,,KS,434,6484,6918,2,1,3,203,247,450,6,0.245621,0.25181,0,0.000009,0.000012,32,0.000087,0,16,0.5,0.00024
20191,Sumner County,,KS,1935,28375,30310,4,6,10,3909,4627,8536,6,0.307544,0.318471,5.515354,0.000297,0.000262,32,0.000114,0,16,0.533333,0.002406
20193,Thomas County,,KS,830,8382,9212,4,3,7,568,505,1073,7,0.242223,0.248253,9146.514166,0.000005,0.000006,32,0.000328,0,16,0.083333,0.000321
20195,Trego County,,KS,215,3823,4038,1,1,2,192,229,421,7,0.242146,0.247813,0,0.000005,0.000006,32,0.000093,0,16,0,0.000131
20197,Wabaunsee County,,KS,627,8473,9100,3,3,6,1207,1241,2448,6,0.288696,0.298828,0,0.000204,0.000161,32,0.000086,0,16,1,0.001665
20199,Wallace County,,KS,122,1748,1870,0,0,0,0,0,0,0,0,0,0,0,0,28,0.000049,22,50,0,0
20201,Washington County,,KS,381,7425,7806,2,10,12,229,24677,24906,6,0.288586,0.299598,14502.633674,0.000118,0.000116,32,0.000079,0,16,0.222222,0.001016
20203,Wichita County,,KS,225,2742,2967,0,0,0,0,0,0,0,0,0,0,0,0,29,0.000049,23,51,0,0
20205,Wilson County,,KS,822,11098,11920,3,4,7,1048,1175,2223,6,0.307575,0.318306,0,0.000275,0.000243,32,0.000086,0,16,1,0.002281
20207,Woodson County,,KS,242,3619,3861,1,1,2,241,166,407,7,0.240321,0.245491,0,0.000004,0.000002,32,0.000067,0,16,0,0.00008
20209,Wyandotte County,,KS,13432,165891,179323,35,38,73,39239,42013,81252,5,0.392358,0.416259,2997.991211,0.010233,0.011396,32,0.000391,0,16,0.610994,0.091014
21001,Adair County,,KY,930,17444,18374,6,10,16,1743,2044,3787,6,0.316708,0.329636,1306.175474,0.000391,0.000661,77,0.000163,0,16,0.427273,0.00375
21003,Allen County,,KY,1221,19806,21027,6,7,13,2625,2500,5125,6,0.315127,0.327407,107.47265,0.000127,0.000545,77,0.000166,0,16,0.547619,0.001844
21005,Anderson County,,KY,1575,25548,27123,11,9,20,4841,4295,9136,6,0.316543,0.329196,25.704873,0.000652,0.000642,77,0.000232,0,16,0.613636,0.006279
21007,Ballard County,,KY,626,9264,9890,2,2,4,1141,1113,2254,6,0.2633,0.270788,0,0.000018,0.000015,77,0.000102,0,16,1,0.000281
21009,Barren County,,KY,2468,46311,48779,12,10,22,5979,5908,11887,5,0.324756,0.339446,3042.714537,0.000623,0.001255,77,0.00026,0,16,0.357143,0.006611
21011,Bath County,,KY,880,11783,12663,7,6,13,1873,1713,3586,6,0.303537,0.314636,1431.649026,0.000248,0.000215,77,0.000215,0,16,0.571429,0.002381
21013,Bell County,,KY,1340,25738,27078,7,9,16,2426,2967,5393,6,0.311754,0.324832,381.643174,0.000024,0.000551,77,0.000213,0,16,0.486111,0.000749
21015,Boone County,,KY,11638,133575,145213,36,36,72,37068,32868,69936,5,0.390536,0.414493,7759.918978,0.008776,0.011076,65,0.000436,0,16,0.484541,0.075389
21017,Bourbon County,,KY,1518,21885,23403,8,8,16,3742,4272,8014,6,0.30372,0.315132,14.421253,0.000257,0.000236,77,0.000225,0,16,0.611111,0.002578
21019,Boyd County,,KY,2976,51818,54794,11,11,22,7521,7253,14774,6,0.326929,0.343023,2727.711089,0.001181,0.001123,65,0.000235,0,16,0.490909,0.010277
21021,Boyle County,,KY,2373,29437,31810,11,10,21,5539,5630,11169,6,0.316609,0.329416,83.654508,0.00065,0.000627,77,0.000256,0,16,0.6,0.0062
21023,Bracken County,,KY,715,9980,10695,5,5,10,1463,1533,2996,6,0.282004,0.291163,3889.855725,0.000098,0.000069,65,0.000133,0,16,0.45,0.000898
21025,Breathitt County,,KY,548,13396,13944,4,4,8,570,723,1293,6,0.303598,0.314499,4004.252997,0.000001,0.000208,77,0.000184,0,16,0.2,0.000277
21027,Breckinridge County,,KY,1267,21241,22508,7,6,13,3203,2717,5920,6,0.315652,0.327787,880.240006,0.000546,0.000556,77,0.000168,0,16,0.595238,0.005296
21029,Bullitt County,,KY,5441,86607,92048,16,14,30,19215,16912,36127,5,0.317872,0.331446,114.543587,0.001084,0.000864,77,0.00025,0,16,0.352941,0.009815
21031,Butler County,,KY,751,13493,14244,5,6,11,1582,1771,3353,6,0.277533,0.287168,6.572457,0.000057,0.000071,77,0.000143,0,16,0.595238,0.000922
21033,Caldwell County,,KY,788,14130,14918,6,6,12,1556,1438,2994,6,0.29277,0.302971,383.972368,0.000148,0.000141,77,0.00018,0,16,0.433333,0.00165
21035,Calloway County,,KY,2523,35340,37863,10,11,21,3671,4153,7824,5,0.325664,0.340795,1020.630484,0.001417,0.001272,77,0.000199,0,16,0.530303,0.013148
21037,Campbell County,,KY,7043,99360,106403,17,16,33,22167,21849,44016,5,0.364852,0.384665,2083.93438,0.002862,0.003451,65,0.000225,0,16,0.634503,0.022561
21039,Carlisle County,,KY,292,5777,6069,4,4,8,552,669,1221,6,0.263483,0.271355,34.118622,0.000023,0.000018,77,0.000156,0,16,0.583333,0.000445
21041,Carroll County,,KY,1031,12876,13907,8,9,17,2320,2484,4804,6,0.314865,0.32727,93.088595,0.000467,0.00051,77,0.000182,0,16,0.477778,0.004474
21043,Carter County,,KY,1270,29529,30799,8,8,16,2460,2762,5222,6,0.303811,0.315352,4607.707274,0.000753,0.000224,65,0.00021,0,16,0.416667,0.006563
21045,Casey County,,KY,670,15886,16556,7,8,15,1612,1750,3362,6,0.303781,0.315242,19.075134,0.000256,0.000232,77,0.00018,0,16,0.535714,0.002483
21047,Christian County,,KY,10856,72358,83214,66,72,138,23753,30630,54383,5,0.410267,0.437911,17130.62023,0.019347,0.020672,77,0.000668,0,16,0.546089,0.17206
21049,Clark County,,KY,2511,39719,42230,12,11,23,6223,6149,12372,6,0.316708,0.329718,1757.476176,0.000648,0.000623,77,0.00031,0,16,0.469697,0.006203
21051,Clay County,,KY,781,18263,19044,4,6,10,1376,1756,3132,6,0.303598,0.314691,1213.141512,0.000239,0.000226,77,0.000144,0,16,0.6,0.00214
21053,Clinton County,,KY,575,9876,10451,4,3,7,853,1174,2027,7,0.242204,0.248628,1322.99995,0.000008,0.000008,77,0.000144,0,16,0.166667,0.000343
21055,Crittenden County,,KY,591,9518,10109,5,5,10,780,788,1568,6,0.263827,0.271954,24.641405,0.000008,0.000017,77,0.000179,0,16,0.433333,0.000441
21057,Cumberland County,,KY,335,6923,7258,2,4,6,222,322,544,6,0.277483,0.286838,130.18741,0,0.000053,77,0.000108,0,16,0.4,0.000136
21059,Daviess County,,KY,4158,111911,116069,23,21,44,9643,8797,18440,5,0.358462,0.378403,10991.975329,0.001457,0.002725,77,0.000457,0,16,0.279202,0.014314
21061,Edmonson County,,KY,742,12836,13578,5,5,10,2145,1909,4054,6,0.277381,0.286728,72.373913,0.000439,0.000058,77,0.00013,0,16,0.7,0.004146
21063,Elliott County,,KY,258,6248,6506,3,3,6,666,514,1180,7,0.240913,0.246916,29.240894,0.000006,0.000006,77,0.000117,0,16,0.666667,0.000262
21065,Estill County,,KY,668,15506,16174,4,5,9,1468,1626,3094,6,0.303598,0.314581,0,0.000252,0.000224,77,0.000131,0,16,1,0.002248
21067,Fayette County,,KY,21662,305242,326904,153,151,304,62408,63058,125466,5,0.435201,0.468862,238064.297029,0.035025,0.039828,77,0.002041,0,16,0.31953,0.307226
21069,Fleming County,,KY,875,16374,17249,5,7,12,1469,1762,3231,6,0.30372,0.315049,281.229923,0.000247,0.000214,77,0.000149,0,16,0.5,0.002199
21071,Floyd County,,KY,1664,38616,40280,8,6,14,3547,3666,7213,6,0.303872,0.315076,4589.547668,0.000243,0.000223,77,0.000277,0,16,0.416667,0.002417
21073,Franklin County,,KY,3432,57812,61244,14,13,27,7770,7878,15648,6,0.324617,0.341196,710.18272,0.002152,0.001403,77,0.000263,0,16,0.466667,0.018301
21075,Fulton County,,KY,657,6489,7146,4,5,9,1060,1395,2455,6,0.263942,0.272263,5.548069,0.000019,0.000029,3,0.000125,0,16,0.6,0.000412
21077,Gallatin County,,KY,846,8351,9197,8,5,13,3283,2063,5346,6,0.282293,0.291746,56.990065,0.00091,0.00011,65,0.000149,0,16,0.642857,0.007619
21079,Garrard County,,KY,1561,17288,18849,7,7,14,3848,3896,7744,6,0.303598,0.314801,1.3,0.000258,0.000232,77,0.000186,0,16,0.857143,0.002554
21081,Grant County,,KY,2575,27922,30497,12,12,24,7003,7649,14652,6,0.318842,0.332965,263.079636,0.001375,0.001076,65,0.000223,0,16,0.564103,0.011153
21083,Graves County,,KY,1941,40061,42002,9,10,19,3996,3930,7926,6,0.323024,0.337251,3535.063758,0.000473,0.0009,77,0.000224,0,16,0.409091,0.005073
21085,Grayson County,,KY,1138,27465,28603,9,9,18,2612,2612,5224,6,0.315916,0.328557,248.026195,0.000556,0.000587,77,0.0002,0,16,0.533333,0.005611
21087,Green County,,KY,620,11859,12479,6,5,11,1067,1022,2089,6,0.314538,0.326334,68.331556,0.000396,0.000399,77,0.000137,0,16,0.571429,0.003785
21089,Greenup County,,KY,2242,40808,43050,9,10,19,6137,5809,11946,6,0.326788,0.342693,1539.136601,0.000797,0.001124,65,0.000196,0,16,0.544444,0.006879
21091,Hancock County,,KY,612,10106,10718,4,3,7,1474,1477,2951,6,0.26408,0.271965,2.529895,0.000022,0.000012,77,0.000132,0,16,0.5,0.000434
21093,Hardin County,,KY,11962,110626,122588,80,69,149,31595,30189,61784,5,0.404352,0.432051,14663.069951,0.022028,0.019647,77,0.000786,0,16,0.489147,0.194007
21095,Harlan County,,KY,864,28484,29348,7,7,14,935,1325,2260,6,0.304086,0.315544,720.62861,0.000257,0.000232,77,0.000192,0,16,0.446429,0.002503
21097,Harrison County,,KY,1148,20759,21907,7,6,13,2276,2584,4860,6,0.303598,0.314719,2204.511872,0.000251,0.000227,77,0.000198,0,16,0.380952,0.002455
21099,Hart County,,KY,1118,19280,20398,7,9,16,2489,2893,5382,6,0.315817,0.328392,1782.571224,0.000552,0.000578,77,0.000163,0,16,0.541667,0.005387
21101,Henderson County,,KY,2718,52242,54960,10,10,20,5550,5449,10999,6,0.317605,0.330808,554.52471,0.000763,0.000721,77,0.00021,0,16,0.577778,0.00693
21103,Henry County,,KY,1086,17306,18392,6,6,12,3441,3492,6933,6,0.314473,0.326334,4.481928,0.000405,0.00042,77,0.000146,0,16,0.633333,0.003965
21105,Hickman County,,KY,299,5164,5463,4,5,9,593,591,1184,6,0.263896,0.272153,8.028102,0.000012,0.000024,77,0.000139,0,16,0.65,0.000359
21107,Hopkins County,,KY,2466,51910,54376,14,15,29,4450,4644,9094,5,0.321141,0.335919,6289.498054,0.001563,0.001097,77,0.000274,0,16,0.404167,0.014514
21109,Jackson County,,KY,602,12762,13364,4,3,7,1087,1262,2349,6,0.247447,0.255079,0.916667,0.000018,0.00002,77,0.000134,0,16,0.75,0.000482
21111,Jefferson County,,KY,36514,840374,876888,258,239,497,115005,119282,234287,5,0.458106,0.497161,215752.343149,0.065525,0.064603,77,0.002591,0,16,0.3181,0.562914
21113,Jessamine County,,KY,4214,49583,53797,14,15,29,11429,10534,21963,6,0.316841,0.330351,120.979029,0.000666,0.000656,77,0.000328,0,16,0.542857,0.006629
21115,Johnson County,,KY,1174,22750,23924,6,6,12,2626,2135,4761,6,0.303751,0.314911,6055.319705,0.00024,0.000212,77,0.000243,0,16,0.4,0.002264
21117,Kenton County,,KY,14740,179698,194438,32,36,68,46636,46957,93593,5,0.390637,0.414658,14555.566631,0.007904,0.011409,65,0.000397,0,16,0.500581,0.066734
21119,Knott County,,KY,617,14731,15348,3,4,7,1261,1441,2702,6,0.30369,0.314526,3.789803,0.000004,0.000211,77,0.000129,0,16,0.833333,0.000245
21121,Knox County,,KY,1655,31166,32821,6,6,12,4126,4402,8528,6,0.316576,0.328893,154.63822,0.000256,0.000615,77,0.000169,0,16,0.714286,0.002444
21123,Larue County,,KY,1096,15520,16616,7,8,15,2837,2995,5832,6,0.315784,0.328227,8.576615,0.000516,0.000584,77,0.000154,0,16,0.642857,0.005057
21125,Laurel County,,KY,3130,59610,62740,15,13,28,8240,7924,16164,6,0.316974,0.330296,6593.847264,0.001243,0.000623,77,0.000339,0,16,0.371429,0.010535
21127,Lawrence County,,KY,844,15606,16450,6,5,11,1702,1514,3216,7,0.247144,0.254702,219.842002,0.000051,0.000014,77,0.000178,0,16,0.333333,0.000687
21129,Lee County,,KY,304,6348,6652,2,3,5,139,325,464,6,0.247488,0.255161,2865.037845,0.000012,0.000011,77,0.000122,0,16,0.333333,0.000252
21131,Leslie County,,KY,475,10982,11457,3,4,7,707,926,1633,7,0.241162,0.247384,1.965018,0.000006,0.000012,77,0.00011,0,16,0.5,0.000292
21133,Letcher County,,KY,793,23653,24446,6,7,13,1347,1546,2893,6,0.304392,0.315929,1489.877149,0.000243,0.000215,77,0.000184,0,16,0.404762,0.002286
21135,Lewis County,,KY,696,13921,14617,6,6,12,1347,1460,2807,7,0.257022,0.265536,29.452418,0.000028,0.000022,65,0.000155,0,16,0.333333,0.000605
21137,Lincoln County,,KY,1540,26365,27905,9,9,18,4532,4656,9188,6,0.303842,0.315407,8.490083,0.000266,0.000241,77,0.000229,0,16,0.722222,0.002778
21139,Livingston County,,KY,727,10327,11054,3,3,6,1620,1772,3392,6,0.263391,0.271063,14.768755,0.000023,0.000015,77,0.000121,0,16,0.5,0.000352
21141,Logan County,,KY,1575,29569,31144,10,10,20,3549,3676,7225,5,0.322097,0.335919,392.478264,0.000944,0.001036,77,0.000197,0,16,0.544444,0.009611
21143,Lyon County,,KY,603,7728,8331,5,4,9,999,957,1956,6,0.26346,0.271338,20.181433,0.00003,0.000016,77,0.000162,0,16,0.5,0.000584
21145,McCracken County,,KY,4558,73872,78430,21,20,41,9337,9333,18670,5,0.357278,0.376764,36577.509091,0.002554,0.003008,77,0.000474,0,16,0.25,0.023733
21147,McCreary County,,KY,698,14541,15239,4,4,8,938,1282,2220,7,0.243783,0.250801,29.243495,0.000011,0.000014,77,0.000148,0,16,0.25,0.000396
21149,McLean County,,KY,653,10626,11279,4,4,8,1451,1792,3243,6,0.264449,0.272708,1.108009,0.000029,0.000025,77,0.000126,0,16,0.833333,0.000519
21151,Madison County,,KY,5852,81425,87277,35,31,66,13460,12699,26159,5,0.328561,0.347315,15725.110267,0.001858,0.002034,77,0.000761,0,16,0.206456,0.016578
21153,Magoffin County,,KY,309,11957,12266,3,2,5,502,607,1109,7,0.233143,0.238295,2.962155,0.000004,0.000003,77,0.000146,0,16,0.333333,0.00023
21155,Marion County,,KY,922,20444,21366,7,6,13,2163,2070,4233,6,0.31618,0.328343,10.617987,0.000633,0.000609,77,0.000159,0,16,0.666667,0.005709
21157,Marshall County,,KY,2142,35585,37727,5,7,12,4295,4119,8414,6,0.322852,0.336673,940.369616,0.000031,0.000892,77,0.000172,0,16,0.547619,0.000591
21159,Martin County,,KY,542,10141,10683,3,5,8,603,1110,1713,7,0.242301,0.248826,12.897755,0.000002,0.000007,77,0.000134,0,16,0.5,0.000227
21161,Mason County,,KY,1371,19183,20554,7,10,17,2587,2829,5416,6,0.339194,0.355315,1750.908978,0.000319,0.001244,65,0.000155,0,16,0.366667,0.002841
21163,Meade County,,KY,4156,30788,34944,17,18,35,7682,7952,15634,5,0.346845,0.365555,457.646501,0.004824,0.004181,77,0.000219,0,16,0.647619,0.044295
21165,Menifee County,,KY,497,6230,6727,3,3,6,644,726,1370,7,0.240932,0.246905,0,0.000009,0.000005,77,0.000128,0,16,1,0.000261
21167,Mercer County,,KY,1495,24731,26226,11,10,21,3464,3442,6906,6,0.303751,0.315407,33.788725,0.000657,0.000252,77,0.00025,0,16,0.663636,0.006261
21169,Metcalfe County,,KY,744,10637,11381,4,6,10,1433,1662,3095,6,0.277533,0.287141,1765.800911,0.000015,0.000057,77,0.000129,0,16,0.452381,0.000369
21171,Monroe County,,KY,513,11893,12406,6,5,11,1156,1121,2277,6,0.27761,0.287086,195.342132,0.000059,0.000056,77,0.000167,0,16,0.433333,0.000944
21173,Montgomery County,,KY,1972,28100,30072,11,10,21,4943,4885,9828,6,0.316675,0.329553,2370.218579,0.000264,0.00062,77,0.000304,0,16,0.474359,0.002841
21175,Morgan County,,KY,559,12083,12642,3,5,8,526,801,1327,6,0.303629,0.314664,1075.093495,0.000004,0.000208,77,0.000134,0,16,0.2,0.000223
21177,Muhlenberg County,,KY,1293,33973,35266,10,8,18,2421,2495,4916,6,0.316345,0.32908,685.525048,0.000581,0.000574,77,0.000217,0,16,0.511111,0.00566
21179,Nelson County,,KY,2391,51791,54182,12,11,23,6968,6266,13234,5,0.317539,0.330566,47.579782,0.000821,0.00078,77,0.000226,0,16,0.50641,0.007974
21181,Nicholas County,,KY,518,7961,8479,4,4,8,985,980,1965,6,0.303416,0.314196,3.038356,0.000239,0.000211,77,0.000131,0,16,0.6,0.002116
21183,Ohio County,,KY,1448,25863,27311,8,8,16,2859,3417,6276,6,0.314832,0.32716,1290.82319,0.000568,0.000449,77,0.000188,0,16,0.402778,0.005273
21185,Oldham County,,KY,4567,63577,68144,12,11,23,12162,10484,22646,5,0.319852,0.333977,130.137793,0.001279,0.001126,77,0.000216,0,16,0.448718,0.011068
21187,Owen County,,KY,724,10840,11564,7,8,15,1870,2349,4219,6,0.303872,0.315407,30.039994,0.000155,0.00034,65,0.000165,0,16,0.625,0.001616
21189,Owsley County,,KY,155,3807,3962,2,2,4,181,110,291,7,0.233018,0.238091,1.333333,0.000001,0,77,0.000123,0,16,0.5,0.000133
21191,Pendleton County,,KY,1120,16280,17400,7,7,14,3247,3556,6803,6,0.310062,0.32251,153.969237,0.000544,0.000473,65,0.000153,0,16,0.619048,0.004389
21193,Perry County,,KY,1181,30221,31402,6,9,15,2292,2428,4720,6,0.304116,0.315792,5186.172302,0.000242,0.000231,77,0.000195,0,16,0.388889,0.002285
21195,Pike County,,KY,2100,60726,62826,11,9,20,3995,4249,8244,6,0.317539,0.330516,4409.496141,0.000637,0.00061,77,0.000299,0,16,0.272727,0.006012
21197,Powell County,,KY,961,13663,14624,6,6,12,1916,2137,4053,6,0.30369,0.314856,3517.145277,0.000255,0.000224,77,0.000183,0,16,0.666667,0.0024
21199,Pulaski County,,KY,2932,65590,68522,19,15,34,6038,4798,10836,6,0.31938,0.334148,13549.736423,0.001358,0.00102,77,0.000411,0,16,0.309942,0.011719
21201,Robertson County,,KY,112,2175,2287,1,2,3,88,119,207,7,0.233108,0.238377,0.919298,0,0.000002,65,0.000072,0,16,0,0.000072
21203,Rockcastle County,,KY,825,16967,17792,6,7,13,1759,2095,3854,6,0.303751,0.315049,178.711176,0.000259,0.000236,77,0.000171,0,16,0.666667,0.002507
21205,Rowan County,,KY,1612,20759,22371,12,13,25,2912,3346,6258,6,0.316974,0.330324,8373.664934,0.000257,0.000616,77,0.000342,0,16,0.301282,0.00284
21207,Russell County,,KY,814,17814,18628,5,5,10,1473,1556,3029,6,0.304208,0.315572,14.726734,0.000247,0.000265,77,0.000142,0,16,0.6,0.002253
21209,Scott County,,KY,3642,50655,54297,16,14,30,10783,8449,19232,6,0.316874,0.330269,209.525546,0.001118,0.000742,77,0.000334,0,16,0.466912,0.010051
21211,Shelby County,,KY,2913,45064,47977,12,13,25,9082,8330,17412,6,0.317239,0.330599,203.74599,0.001384,0.000701,77,0.000227,0,16,0.438095,0.013091
21213,Simpson County,,KY,1394,19570,20964,6,6,12,3251,2999,6250,6,0.318909,0.331551,43.759808,0.000561,0.000651,77,0.000138,0,16,0.8,0.006033
21215,Spencer County,,KY,1281,19039,20320,5,6,11,4214,3541,7755,6,0.31444,0.326279,0.735714,0.000401,0.000417,77,0.000123,0,16,0.766667,0.003856
21217,Taylor County,,KY,1338,25453,26791,8,10,18,2677,2862,5539,5,0.317638,0.330648,73.460257,0.000746,0.000787,77,0.000175,0,16,0.522222,0.006841
21219,Todd County,,KY,822,13200,14022,3,4,7,1653,1761,3414,6,0.302537,0.313761,1.146305,0.000388,0.000392,77,0.000081,0,16,0.833333,0.003544
21221,Trigg County,,KY,963,14915,15878,4,4,8,1561,1406,2967,6,0.302597,0.313816,17.522854,0.00039,0.000392,77,0.000106,0,16,0.5,0.00364
21223,Trimble County,,KY,863,9741,10604,5,5,10,1971,1923,3894,6,0.31444,0.326197,2.30661,0.0004,0.000406,77,0.000125,0,16,0.75,0.003781
21225,Union County,,KY,869,16361,17230,5,6,11,1263,1865,3128,6,0.2846,0.294586,164.033096,0.000081,0.000079,77,0.000144,0,16,0.666667,0.000975
21227,Warren County,,KY,6938,115401,122339,50,41,91,16871,15791,32662,5,0.383369,0.407835,26975.285631,0.008,0.007464,77,0.000752,0,16,0.268797,0.073236
21229,Washington County,,KY,763,12649,13412,5,7,12,1592,1777,3369,6,0.316213,0.328508,9.159582,0.000625,0.000613,77,0.000131,0,16,0.714286,0.005523
21231,Wayne County,,KY,894,20006,20900,3,5,8,1640,1830,3470,6,0.303629,0.314636,839.755853,0.000006,0.000216,77,0.000145,0,16,0.5,0.000281
21233,Webster County,,KY,907,14981,15888,4,5,9,1982,2453,4435,6,0.28444,0.294228,0,0.000081,0.000079,77,0.000114,0,16,0.95,0.000907
21235,Whitley County,,KY,2034,35653,37687,9,8,17,5409,4980,10389,6,0.304025,0.315599,1546.721371,0.000644,0.000238,77,0.000232,0,16,0.466667,0.005532
21237,Wolfe County,,KY,416,6765,7181,3,4,7,448,515,963,7,0.240836,0.246977,17.397835,0.000004,0.000005,77,0.000137,0,16,0.166667,0.000215
21239,Woodford County,,KY,1988,28685,30673,9,9,18,5425,5409,10834,6,0.316477,0.329113,22.602289,0.000653,0.000636,77,0.000205,0,16,0.755556,0.006168
22001,Acadia Parish,,LA,3445,65080,68525,11,12,23,10562,10487,21049,5,0.34049,0.35717,3.700885,0.001285,0.001684,30,0.000177,0,16,0.833333,0.012807
22003,Allen Parish,,LA,1619,23236,24855,9,9,18,3425,4061,7486,5,0.339955,0.356097,2.821779,0.000946,0.001001,91,0.000152,0,16,0.805556,0.009629
22005,Ascension Parish,,LA,7074,113938,121012,28,26,54,25254,19991,45245,5,0.344635,0.363525,550.47592,0.003361,0.003383,30,0.000342,0,16,0.489583,0.034101
22007,Assumption Parish,,LA,1482,25413,26895,7,9,16,3677,4051,7728,6,0.304422,0.316491,1.240909,0.000554,0.000889,30,0.000114,0,16,0.861111,0.005252
22009,Avoyelles Parish,,LA,1801,44327,46128,9,13,22,3620,4668,8288,5,0.340643,0.3575,157.623506,0.00123,0.001713,30,0.000152,0,16,0.692308,0.01209
22011,Beauregard Parish,,LA,2834,35110,37944,10,9,19,6551,5955,12506,5,0.342647,0.359128,337.817989,0.002262,0.001791,91,0.000151,0,16,0.628205,0.020901
22013,Bienville Parish,,LA,1058,15321,16379,8,10,18,2749,3137,5886,5,0.340452,0.356922,164.352954,0.00029,0.000991,91,0.000157,0,16,0.633333,0.002989
22015,Bossier Parish,,LA,13289,120817,134106,69,59,128,38113,35747,73860,5,0.390033,0.416925,8033.243564,0.016302,0.016809,91,0.000708,0,16,0.437729,0.152482
22017,Caddo Parish,,LA,16144,274940,291084,79,83,162,48103,49226,97329,5,0.401724,0.43133,21170.352156,0.021298,0.021452,91,0.000819,0,16,0.395726,0.196381
22019,Calcasieu Parish,,LA,9252,208233,217485,55,49,104,23840,24313,48153,5,0.371474,0.396379,6952.823987,0.010641,0.010881,91,0.000602,0,16,0.410286,0.102308
22021,Caldwell Parish,,LA,564,10430,10994,2,3,5,918,1040,1958,6,0.277,0.286536,0,0.000071,0.000056,91,0.000079,0,16,1,0.000671
22023,Cameron Parish,,LA,1064,7331,8395,2,3,5,1162,1961,3123,6,0.27093,0.280048,0.2,0.000071,0.000082,91,0.000077,0,16,0.833333,0.000807
22025,Catahoula Parish,,LA,651,10629,11280,6,6,12,1313,1414,2727,6,0.299842,0.311621,47.279329,0.000131,0.000331,91,0.000149,0,16,0.571429,0.001361
22027,Claiborne Parish,,LA,878,15258,16136,8,6,14,1863,1888,3751,6,0.29019,0.301161,22.183408,0.000296,0.00025,91,0.000146,0,16,0.553571,0.003072
22029,Concordia Parish,,LA,1295,20418,21713,6,8,14,2497,2615,5112,5,0.34072,0.35706,102.411975,0.000372,0.001348,30,0.000133,0,16,0.625,0.003478
22031,De Soto Parish,,LA,2006,29752,31758,7,7,14,5195,5364,10559,5,0.339764,0.355601,106.625278,0.000871,0.000924,91,0.000133,0,16,0.690476,0.008727
22033,East Baton Rouge Parish,,LA,28992,452238,481230,151,143,294,87303,97911,185214,5,0.42686,0.461208,65484.965073,0.039593,0.040124,30,0.001494,0,16,0.394925,0.355803
22035,East Carroll Parish,,LA,382,7505,7887,3,3,6,545,897,1442,5,0.330641,0.345406,231.053964,0.000608,0.000659,91,0.000094,0,16,0.666667,0.005946
22037,East Feliciana Parish,,LA,1584,21088,22672,6,7,13,4349,4699,9048,6,0.299397,0.310961,7.1375,0.000287,0.000304,30,0.000153,0,16,0.571429,0.002977
22039,Evangeline Parish,,LA,1860,35229,37089,10,10,20,4477,4991,9468,5,0.340375,0.356784,4.719216,0.0011,0.001146,30,0.000163,0,16,0.833333,0.01099
22041,Franklin Parish,,LA,1240,21230,22470,7,6,13,1816,2189,4005,5,0.334105,0.348944,611.334694,0.000859,0.000902,91,0.000168,0,16,0.452381,0.008363
22043,Grant Parish,,LA,1720,20402,22122,6,7,13,4612,4804,9416,6,0.299693,0.311511,58.135051,0.000315,0.000394,30,0.000121,0,16,0.619048,0.003027
22045,Iberia Parish,,LA,4672,83929,88601,17,17,34,12150,13815,25965,5,0.343658,0.361379,22.031485,0.002445,0.002909,30,0.000219,0,16,0.716374,0.024471
22047,Iberville Parish,,LA,2385,34130,36515,7,10,17,5775,7249,13024,5,0.340375,0.356784,47.963265,0.000505,0.00162,30,0.000131,0,16,0.777778,0.005012
22049,Jackson Parish,,LA,1131,16318,17449,4,5,9,2017,2496,4513,6,0.287709,0.298685,3.59447,0.000106,0.000197,91,0.000097,0,16,0.75,0.000975
22051,Jefferson Parish,,LA,35649,455848,491497,133,122,255,100930,113053,213983,5,0.417563,0.450616,19865.406608,0.037318,0.036581,30,0.001211,0,16,0.446241,0.3363
22053,Jefferson Davis Parish,,LA,2062,33726,35788,12,10,22,5516,5616,11132,5,0.340261,0.356619,454.864979,0.000944,0.001112,91,0.0002,0,16,0.621795,0.009916
22055,Lafayette Parish,,LA,15049,228349,243398,71,64,135,49334,46955,96289,5,0.386796,0.414158,5573.909206,0.017667,0.016793,30,0.000722,0,16,0.435897,0.165811
22057,Lafourche Parish,,LA,5733,104178,109911,16,23,39,15637,15649,31286,5,0.347044,0.366634,193.450128,0.002163,0.003664,30,0.00021,0,16,0.597826,0.021572
22059,La Salle Parish,,LA,693,14288,14981,6,6,12,1424,1359,2783,6,0.278811,0.289056,13.436353,0.000123,0.000094,91,0.00014,0,16,0.533333,0.001323
22061,Lincoln Parish,,LA,3404,40204,43608,17,21,38,6790,8023,14813,5,0.357278,0.377501,2122.754507,0.002457,0.004789,91,0.000254,0,16,0.550725,0.024243
22063,Livingston Parish,,LA,8446,130416,138862,31,30,61,29588,24013,53601,5,0.346528,0.366991,925.990887,0.003313,0.003187,30,0.000395,0,16,0.442017,0.032985
22065,Madison Parish,,LA,877,11818,12695,5,4,9,1079,1294,2373,6,0.277584,0.287515,41.839712,0.00022,0.00007,30,0.000121,0,16,0.466667,0.001847
22067,Morehouse Parish,,LA,1801,31633,33434,10,11,21,3536,4426,7962,5,0.345067,0.362534,2042.801519,0.001619,0.002319,91,0.000187,0,16,0.509091,0.015784
22069,Natchitoches Parish,,LA,2583,38810,41393,16,19,35,4668,6105,10773,5,0.34554,0.364075,849.428524,0.002009,0.003263,91,0.000232,0,16,0.581871,0.019779
22071,Orleans Parish,,LA,23788,258599,282387,191,125,316,123651,85549,209200,5,0.431481,0.463096,21447.389311,0.05731,0.041768,30,0.001611,0,16,0.470332,0.502929
22073,Ouachita Parish,,LA,8572,163207,171779,49,55,104,22211,22861,45072,5,0.382885,0.409233,36793.297173,0.009254,0.011956,91,0.000661,0,16,0.359731,0.088426
22075,Plaquemines Parish,,LA,3030,23306,26336,12,13,25,4963,6046,11009,5,0.356857,0.376483,22.998666,0.003679,0.003693,30,0.000164,0,16,0.804762,0.035062
22077,Pointe Coupee Parish,,LA,1449,24442,25891,8,7,15,3297,3659,6956,6,0.299427,0.311016,1.938258,0.000416,0.000386,30,0.000138,0,16,0.785714,0.004284
22079,Rapides Parish,,LA,7482,145418,152900,37,42,79,17224,18582,35806,5,0.362885,0.386415,5424.183047,0.006031,0.007955,30,0.000451,0,16,0.446617,0.058479
22081,Red River Parish,,LA,625,9563,10188,5,5,10,1387,1567,2954,6,0.290051,0.300803,0.526923,0.000256,0.00024,91,0.000108,0,16,0.9,0.002557
22083,Richland Parish,,LA,1556,21456,23012,5,6,11,3291,3501,6792,6,0.277127,0.287075,6.746465,0.00009,0.000072,91,0.000149,0,16,0.5,0.001019
22085,Sabine Parish,,LA,1273,24398,25671,8,8,16,2055,2346,4401,5,0.34007,0.356152,3.380834,0.001029,0.001098,91,0.00013,0,16,0.875,0.010057
22087,St. Bernard Parish,,LA,1740,25813,27553,18,11,29,14202,6141,20343,5,0.34049,0.35706,59.254075,0.002504,0.001702,30,0.000234,0,16,0.754902,0.025207
22089,St. Charles Parish,,LA,4328,59298,63626,14,14,28,11811,12148,23959,5,0.340567,0.3575,38.648984,0.001688,0.001855,30,0.000196,0,16,0.879121,0.017428
22091,St. Helena Parish,,LA,1055,14576,15631,5,5,10,3574,4222,7796,6,0.303659,0.314895,2.094492,0.000498,0.000618,30,0.000108,0,16,0.866667,0.004811
22093,St. James Parish,,LA,1358,26486,27844,7,8,15,2969,4081,7050,6,0.30433,0.316243,0,0.000765,0.000874,30,0.000119,0,16,1,0.007932
22095,St. John the Baptist Parish,,LA,4301,52215,56516,13,14,27,9458,13077,22535,5,0.343307,0.360554,85.651083,0.002609,0.00243,30,0.00018,0,16,0.828571,0.02617
22097,St. Landry Parish,,LA,4895,94228,99123,24,22,46,14401,15467,29868,5,0.343892,0.362259,165.88873,0.001942,0.002629,30,0.000318,0,16,0.558333,0.020185
22099,St. Martin Parish,,LA,3620,57086,60706,12,11,23,11728,11495,23223,5,0.340452,0.357005,18.135885,0.001331,0.001685,30,0.000177,0,16,0.762821,0.013308
22101,St. Mary Parish,,LA,3940,62561,66501,15,17,32,6751,9735,16486,5,0.343502,0.361159,104.830744,0.002218,0.002534,30,0.000201,0,16,0.673203,0.022295
22103,St. Tammany Parish,,LA,14299,239535,253834,81,75,156,43968,37995,81963,5,0.400132,0.429041,5132.854332,0.024593,0.0228,30,0.000759,0,16,0.554432,0.224053
22105,Tangipahoa Parish,,LA,7480,116847,124327,30,26,56,22858,20721,43579,5,0.359142,0.380169,970.595544,0.004356,0.00427,30,0.000369,0,16,0.533333,0.042056
22107,Tensas Parish,,LA,470,5279,5749,4,4,8,292,528,820,6,0.299723,0.311181,0.5,0.00032,0.000295,91,0.000106,0,16,0.833333,0.002925
22109,Terrebonne Parish,,LA,6989,124463,131452,24,31,55,14307,18861,33168,5,0.363538,0.385798,408.251301,0.00516,0.006066,30,0.000272,0,16,0.548413,0.049196
22111,Union Parish,,LA,1610,23331,24941,6,6,12,3537,3889,7426,6,0.2879,0.299153,21.36324,0.00013,0.000222,91,0.000137,0,16,0.571429,0.001355
22113,Vermilion Parish,,LA,3172,62314,65486,12,11,23,9535,9211,18746,5,0.340452,0.357005,2.820754,0.00133,0.001353,30,0.00018,0,16,0.863636,0.013224
22115,Vernon Parish,,LA,7676,48254,55930,52,56,108,18640,20366,39006,5,0.386106,0.412611,1522.958692,0.015032,0.015393,91,0.000475,0,16,0.616014,0.136401
22117,Washington Parish,,LA,2222,44857,47079,11,11,22,4956,5432,10388,5,0.353731,0.372136,387.161574,0.001509,0.002336,30,0.000171,0,16,0.666667,0.015573
22119,Webster Parish,,LA,2763,43548,46311,11,11,22,6324,6818,13142,5,0.344518,0.361819,2399.556876,0.002029,0.002187,91,0.000177,0,16,0.581818,0.019948
22121,West Baton Rouge Parish,,LA,2221,25734,27955,8,8,16,7450,6858,14308,5,0.340299,0.356454,101.505395,0.001238,0.001182,30,0.000138,0,16,0.866667,0.01284
22123,West Carroll Parish,,LA,788,12134,12922,4,4,8,1209,1404,2613,6,0.276975,0.286591,1.833333,0.000088,0.000068,91,0.000121,0,16,0.666667,0.000926
22125,West Feliciana Parish,,LA,907,10979,11886,3,3,6,1517,1794,3311,6,0.299249,0.310245,0,0.00024,0.000237,30,0.000101,0,16,1,0.002294
22127,Winn Parish,,LA,891,14500,15391,6,8,14,1355,1743,3098,6,0.289109,0.300644,36.642811,0.000197,0.000245,91,0.000128,0,16,0.589286,0.002045
23001,Androscoggin County,,ME,7236,121039,128275,22,28,50,16458,17578,34036,5,0.36137,0.382271,1129.902339,0.003815,0.006806,54,0.000217,0,16,0.572414,0.031843
23003,Aroostook County,,ME,2873,82065,84938,13,11,24,3750,4823,8573,6,0.312236,0.327094,24.632473,0.001574,0.001326,54,0.000149,0,16,0.736264,0.011818
23005,Cumberland County,,ME,19548,326746,346294,113,121,234,56633,57888,114521,5,0.411102,0.444338,19514.115301,0.037016,0.041527,54,0.000813,0,16,0.552505,0.315541
23007,Franklin County,,ME,1867,32159,34026,7,8,15,3957,3984,7941,6,0.311818,0.326048,0.142857,0.000544,0.000938,54,0.0001,0,16,0.982143,0.004074
23009,Hancock County,,ME,3085,61814,64899,13,13,26,5749,5648,11397,5,0.33738,0.353549,150.30985,0.001957,0.002018,54,0.000156,0,16,0.741758,0.016502
23011,Kennebec County,,ME,7191,140880,148071,27,33,60,18412,18972,37384,5,0.360853,0.382409,1604.778465,0.005369,0.00825,54,0.000255,0,16,0.571321,0.043957
23013,Knox County,,ME,2387,45322,47709,11,12,23,4029,4412,8441,6,0.312268,0.327039,18.82202,0.001049,0.001376,54,0.000136,0,16,0.863636,0.008533
23015,Lincoln County,,ME,2465,41154,43619,9,11,20,4935,5318,10253,6,0.312236,0.326874,17.826177,0.001031,0.001365,54,0.000114,0,16,0.881818,0.008236
23017,Oxford County,,ME,3628,62867,66495,13,13,26,7951,8471,16422,5,0.337418,0.353604,53.809262,0.002045,0.001617,54,0.00013,0,16,0.658088,0.015426
23019,Penobscot County,,ME,8457,166674,175131,35,46,81,19252,20872,40124,5,0.364369,0.387752,5509.458723,0.007975,0.012933,54,0.000301,0,16,0.584181,0.06555
23021,Piscataquis County,,ME,1130,18527,19657,2,5,7,1623,2157,3780,6,0.29153,0.302806,0,0.000082,0.000405,54,0.000067,0,16,1,0.000586
23023,Sagadahoc County,,ME,3793,42413,46206,8,13,21,8183,8460,16643,5,0.349366,0.367134,58.563019,0.000555,0.002866,54,0.000106,0,16,0.620879,0.00417
23025,Somerset County,,ME,3444,55180,58624,15,12,27,9124,8657,17781,6,0.311946,0.326708,241.248064,0.001377,0.000955,54,0.000173,0,16,0.695238,0.0113
23027,Waldo County,,ME,2492,42711,45203,12,11,23,5953,5850,11803,6,0.291699,0.303797,14.242538,0.001048,0.000464,54,0.000151,0,16,0.863636,0.008666
23029,Washington County,,ME,1746,36084,37830,7,7,14,2035,2817,4852,6,0.291586,0.303136,0,0.000511,0.000424,54,0.000106,0,16,1,0.003946
23031,York County,,ME,12643,235629,248272,60,66,126,36819,34734,71553,5,0.383661,0.410856,7161.004322,0.017053,0.020268,54,0.00046,0,16,0.576095,0.143068
24001,Allegany County,,MD,2707,76491,79198,15,17,32,5017,5647,10664,6,0.324721,0.341191,712.540742,0.002543,0.003179,98,0.000203,0,16,0.529412,0.021731
24003,Anne Arundel County,,MD,42629,612559,655188,237,235,472,151162,143061,294223,5,0.437527,0.480681,19889.960707,0.072136,0.071726,98,0.001672,0,16,0.422869,0.607932
24005,Baltimore County,,MD,60376,928091,988467,187,195,382,210328,207528,417856,5,0.433147,0.47234,10207.746875,0.06303,0.065242,98,0.001269,0,16,0.533667,0.527273
24009,Calvert County,,MD,5701,106159,111860,20,23,43,15110,13113,28223,5,0.354352,0.373952,22.128324,0.00716,0.007602,98,0.000185,0,16,0.818333,0.063804
24011,Caroline County,,MD,2601,37007,39608,12,11,23,6879,7138,14017,6,0.313366,0.327561,2.557699,0.00217,0.001986,98,0.000139,0,16,0.909091,0.019058
24013,Carroll County,,MD,9141,206099,215240,20,33,53,25157,24977,50134,5,0.362234,0.384186,80.659789,0.00508,0.010888,98,0.000183,0,16,0.736486,0.043752
24015,Cecil County,,MD,6256,113918,120174,25,19,44,17992,15731,33723,5,0.353855,0.373082,39.42935,0.007023,0.005585,69,0.000188,0,16,0.847692,0.054179
24017,Charles County,,MD,12724,169840,182564,42,49,91,36478,33095,69573,5,0.380863,0.406806,454.612,0.016015,0.019438,98,0.000352,0,16,0.762013,0.143143
24019,Dorchester County,,MD,2264,37153,39417,12,12,24,5371,5162,10533,6,0.319212,0.333421,1.603711,0.002634,0.002498,98,0.000137,0,16,0.942308,0.022972
24021,Frederick County,,MD,16904,276562,293466,74,81,155,49102,46570,95672,5,0.402739,0.432112,1703.623391,0.026704,0.031064,98,0.000561,0,16,0.688987,0.232901
24023,Garrett County,,MD,1307,34386,35693,10,7,17,1925,2023,3948,6,0.316808,0.330742,597.559817,0.001613,0.00059,98,0.000162,0,16,0.527273,0.013379
24025,Harford County,,MD,16749,297493,314242,81,83,164,48273,45356,93629,5,0.398134,0.427682,995.752157,0.028906,0.030914,98,0.000566,0,16,0.625606,0.244473
24027,Howard County,,MD,25118,322026,347144,129,120,249,92759,81856,174615,5,0.418024,0.450534,3019.512768,0.047122,0.044707,98,0.000889,0,16,0.647637,0.397513
24029,Kent County,,MD,1149,21775,22924,8,9,17,2254,2687,4941,6,0.30965,0.323462,0.919017,0.001745,0.001705,98,0.000105,0,16,0.888889,0.014458
24031,Montgomery County,,MD,69298,1090986,1160284,291,280,571,249579,251563,501142,5,0.460194,0.503257,28871.237867,0.083817,0.081008,98,0.00206,0,16,0.368672,0.701699
24033,Prince George's County,,MD,71110,974155,1045265,229,227,456,234329,251735,486064,5,0.444396,0.485232,24953.75011,0.069846,0.066337,98,0.00166,0,16,0.40753,0.591083
24035,Queen Anne's County,,MD,3007,54371,57378,16,18,34,9445,8478,17923,6,0.321721,0.33691,19.732622,0.003565,0.003783,98,0.000167,0,16,0.765789,0.030734
24037,St. Mary's County,,MD,8014,119138,127152,44,47,91,19718,17304,37022,5,0.379955,0.405541,237.429232,0.014514,0.017427,98,0.000348,0,16,0.648498,0.128164
24039,Somerset County,,MD,1550,22316,23866,7,8,15,3228,3722,6950,6,0.313302,0.327121,2.461765,0.001421,0.001819,98,0.000104,0,16,0.857143,0.01224
24041,Talbot County,,MD,2465,42025,44490,16,13,29,6465,5655,12120,6,0.321073,0.335397,12.851346,0.003926,0.003241,98,0.000165,0,16,0.825,0.034368
24043,Washington County,,MD,9267,169318,178585,34,36,70,24397,23630,48027,5,0.368985,0.391631,6456.371408,0.008453,0.010812,98,0.000323,0,16,0.608527,0.073433
24045,Wicomico County,,MD,6717,103747,110464,30,35,65,16210,16397,32607,5,0.364281,0.387295,402.948824,0.00772,0.010125,98,0.000268,0,16,0.644872,0.066418
24047,Worcester County,,MD,4030,60072,64102,23,20,43,10500,10106,20606,5,0.356479,0.375669,138.242265,0.005291,0.006013,98,0.000204,0,16,0.685185,0.043653
24510,Baltimore city,,MD,48869,593410,642279,190,158,348,159202,179718,338920,5,0.428309,0.463948,9165.344794,0.061637,0.055036,98,0.001323,0,16,0.537333,0.513513
25001,Barnstable County,,MA,11385,267528,278913,80,76,156,35688,32373,68061,5,0.386204,0.414708,1082.130469,0.027631,0.026953,54,0.000528,0,16,0.675107,0.229026
25003,Berkshire County,,MA,4955,152724,157679,36,40,76,9542,10094,19636,5,0.371656,0.394652,271.104591,0.012264,0.014164,54,0.000243,0,16,0.820074,0.096984
25005,Bristol County,,MA,23116,637693,660809,72,96,168,73184,74753,147937,5,0.39251,0.423539,1077.11121,0.025794,0.034961,54,0.000485,0,16,0.691879,0.216537
25007,Dukes County,,MA,920,19567,20487,7,7,14,1119,1275,2394,6,0.312946,0.326741,0,0.002104,0.002029,54,0.000087,0,16,1,0.016773
25009,Essex County,,MA,36128,861478,897606,144,154,298,126596,124472,251068,5,0.416988,0.453444,4034.334958,0.050162,0.053858,54,0.000929,0,16,0.59449,0.417172
25011,Franklin County,,MA,4744,83051,87795,18,18,36,11881,11819,23700,5,0.348722,0.366832,7.718937,0.004842,0.005109,54,0.000145,0,16,0.918421,0.037436
25013,Hampden County,,MA,17626,531580,549206,83,97,180,45486,52872,98358,5,0.394452,0.42563,617.979705,0.030279,0.036162,54,0.00054,0,16,0.74703,0.251285
25015,Hampshire County,,MA,11279,163635,174914,48,58,106,30550,33390,63940,5,0.385614,0.411902,250.694223,0.017474,0.021876,54,0.000329,0,16,0.808567,0.144405
25017,Middlesex County,,MA,96490,1698030,1794520,313,290,603,362757,364873,727630,5,0.451955,0.49814,66942.242401,0.084588,0.080558,54,0.002194,0,16,0.32989,0.705709
25019,Nantucket County,,MA,1013,12182,13195,3,7,10,349,1131,1480,6,0.320427,0.335094,0,0.001021,0.002423,54,0.000068,0,16,1,0.008935
25021,Norfolk County,,MA,49488,765047,814535,162,160,322,186122,183110,369232,5,0.421397,0.457896,4666.511461,0.055585,0.055221,54,0.001052,0,16,0.584555,0.461055
25023,Plymouth County,,MA,24291,585183,609474,76,93,169,86747,82764,169511,5,0.395844,0.426483,1112.498374,0.027548,0.034808,54,0.000513,0,16,0.709338,0.231329
25025,Suffolk County,,MA,71477,695925,767402,238,205,443,245987,271316,517303,5,0.435514,0.475476,16752.0457,0.071821,0.065796,54,0.001595,0,16,0.448866,0.591828
25027,Worcester County,,MA,34165,935473,969638,152,176,328,105695,111081,216776,5,0.424349,0.462474,5217.313226,0.051462,0.058726,54,0.000989,0,16,0.547816,0.429848
26001,Alcona County,,MI,715,12982,13697,6,6,12,1554,1240,2794,6,0.321482,0.33604,0,0.001555,0.001218,66,0.000085,0,16,1,0.010565
26003,Alger County,,MI,463,10596,11059,2,3,5,600,713,1313,6,0.267603,0.275724,0,0.000033,0.00003,99,0.000083,0,16,1,0.000375
26005,Allegan County,,MI,8134,136841,144975,19,19,38,23043,23702,46745,5,0.362668,0.382431,178.7357,0.004698,0.004197,66,0.000161,0,16,0.717391,0.034859
26007,Alpena County,,MI,1721,36028,37749,11,14,25,2339,2363,4702,6,0.322337,0.338038,19.220053,0.002003,0.001988,66,0.000145,0,16,0.657143,0.013805
26009,Antrim County,,MI,2053,28138,30191,11,10,21,4150,4171,8321,6,0.321789,0.336976,2.002573,0.002187,0.001538,66,0.000137,0,16,0.881818,0.014951
26011,Arenac County,,MI,1169,18966,20135,9,7,16,2684,2349,5033,6,0.317672,0.331474,0.284735,0.00169,0.000667,66,0.000107,0,16,0.972222,0.011554
26013,Baraga County,,MI,390,9137,9527,2,2,4,696,605,1301,6,0.267911,0.276004,0,0.000045,0.000036,99,0.00008,0,16,1,0.000413
26015,Barry County,,MI,4283,72294,76577,9,15,24,10288,11251,21539,5,0.353277,0.371817,17.862577,0.001025,0.002344,66,0.000105,0,16,0.838095,0.006759
26017,Bay County,,MI,5189,134764,139953,20,25,45,12273,12972,25245,5,0.359995,0.380092,446.405806,0.003308,0.00368,66,0.000191,0,16,0.618462,0.024668
26019,Benzie County,,MI,1431,21070,22501,8,5,13,3247,2887,6134,6,0.305097,0.316832,0.891667,0.001595,0.000326,66,0.000112,0,16,0.857143,0.011369
26021,Berrien County,,MI,9404,183328,192732,44,51,95,20820,23168,43988,5,0.396518,0.422494,591.849557,0.013452,0.017248,99,0.000329,0,16,0.661688,0.108415
26023,Branch County,,MI,3011,50849,53860,12,12,24,5488,5920,11408,6,0.323093,0.339083,43.202129,0.001816,0.001694,66,0.000131,0,16,0.653846,0.012768
26025,Calhoun County,,MI,8253,156661,164914,33,32,65,16962,18963,35925,5,0.381198,0.404666,708.65025,0.006932,0.00948,66,0.000267,0,16,0.592308,0.055292
26027,Cass County,,MI,3770,59566,63336,8,9,17,10170,9639,19809,5,0.347841,0.364323,2.980895,0.001554,0.001702,99,0.000097,0,16,0.944444,0.01135
26029,Charlevoix County,,MI,1969,31759,33728,10,8,18,4099,3499,7598,6,0.321311,0.336206,0.45,0.001858,0.001185,66,0.000128,0,16,0.933333,0.01302
26031,Cheboygan County,,MI,1876,31278,33154,12,11,23,3109,3193,6302,6,0.321652,0.336948,536.778412,0.001984,0.001325,66,0.000158,0,16,0.679487,0.013809
26033,Chippewa County,,MI,2104,39491,41595,12,12,24,2136,2050,4186,6,0.322303,0.337939,4149.524497,0.0022,0.001708,66,0.00017,0,16,0.674242,0.015069
26035,Clare County,,MI,2274,33448,35722,19,18,37,5535,4925,10460,6,0.322028,0.338241,13.054613,0.002463,0.001882,66,0.000181,0,16,0.719298,0.017003
26037,Clinton County,,MI,5795,88095,93890,21,23,44,17839,17269,35108,5,0.359867,0.379707,257.294085,0.004363,0.003717,66,0.000177,0,16,0.766798,0.032334
26039,Crawford County,,MI,1039,15339,16378,7,6,13,1513,1298,2811,6,0.31992,0.334005,0.236111,0.001597,0.00072,66,0.000097,0,16,0.910714,0.010972
26041,Delta County,,MI,1853,45521,47374,8,9,17,2085,2574,4659,6,0.319785,0.334902,950.035718,0.000433,0.000763,99,0.000199,0,16,0.411111,0.00349
26043,Dickinson County,,MI,1454,32916,34370,8,9,17,2013,2108,4121,6,0.280204,0.291306,46.042921,0.000133,0.000143,99,0.000192,0,16,0.472222,0.001449
26045,Eaton County,,MI,10317,129666,139983,29,33,62,29867,29324,59191,5,0.374413,0.39721,755.359014,0.005723,0.00773,66,0.000246,0,16,0.620635,0.045307
26047,Emmet County,,MI,2701,39531,42232,18,17,35,5824,5168,10992,5,0.347562,0.364735,2340.564573,0.003445,0.002573,66,0.000203,0,16,0.628571,0.025138
26049,Genesee County,,MI,23044,502402,525446,85,139,224,48436,65462,113898,5,0.427221,0.460554,15151.837232,0.022402,0.038956,66,0.000685,0,16,0.414972,0.194253
26051,Gladwin County,,MI,1707,29730,31437,11,12,23,4412,3860,8272,6,0.321721,0.337086,0.979696,0.001965,0.001519,66,0.000118,0,16,0.939394,0.013272
26053,Gogebic County,,MI,845,16894,17739,3,3,6,585,652,1237,6,0.267745,0.27596,6102.112783,0.00001,0.000028,99,0.000177,0,16,0.083333,0.000274
26055,Grand Traverse County,,MI,6331,103947,110278,38,40,78,17289,14221,31510,5,0.372159,0.395725,2478.31343,0.005826,0.007088,66,0.000383,0,16,0.435518,0.046404
26057,Gratiot County,,MI,2653,44680,47333,14,12,26,5841,6241,12082,6,0.317972,0.332657,2.439327,0.00156,0.001048,66,0.000138,0,16,0.813187,0.010881
26059,Hillsdale County,,MI,3109,53439,56548,13,15,28,6692,6793,13485,6,0.322783,0.339001,62.264351,0.002168,0.001959,66,0.000137,0,16,0.642857,0.014865
26061,Houghton County,,MI,2207,36364,38571,10,13,23,1806,2397,4203,5,0.352866,0.370502,12004.57481,0.001424,0.002811,99,0.000243,0,16,0.395238,0.010443
26063,Huron County,,MI,1733,43186,44919,10,14,24,3467,3797,7264,6,0.322371,0.338093,0.842294,0.001753,0.002062,66,0.000104,0,16,0.901099,0.01182
26065,Ingham County,,MI,23824,291141,314965,102,138,240,61599,74629,136228,5,0.426319,0.459805,15089.454514,0.028182,0.042516,66,0.000785,0,16,0.457298,0.239477
26067,Ionia County,,MI,4229,70680,74909,16,17,33,10701,11052,21753,5,0.346726,0.363662,43.908077,0.002079,0.001914,66,0.000151,0,16,0.764706,0.014778
26069,Iosco County,,MI,1856,30473,32329,10,12,22,3696,3571,7267,6,0.321823,0.337251,6.337837,0.001669,0.001586,66,0.000124,0,16,0.787879,0.011519
26071,Iron County,,MI,605,13911,14516,3,3,6,409,528,937,6,0.279583,0.289667,0,0.000106,0.000084,99,0.000091,0,16,1,0.000954
26073,Isabella County,,MI,5061,61806,66867,31,30,61,11671,12169,23840,5,0.360209,0.380918,270.887473,0.003369,0.003944,66,0.000258,0,16,0.582353,0.023374
26075,Jackson County,,MI,7942,181400,189342,28,32,60,17821,19326,37147,5,0.376601,0.399714,314.585248,0.006206,0.008087,66,0.000218,0,16,0.702381,0.047036
26077,Kalamazoo County,,MI,15995,275895,291890,78,99,177,44795,44586,89381,5,0.415387,0.445692,6609.389015,0.018991,0.03218,66,0.000593,0,16,0.485258,0.156445
26079,Kalkaska County,,MI,1595,19173,20768,10,7,17,3103,2838,5941,6,0.321243,0.335985,2.070741,0.001932,0.001167,66,0.000128,0,16,0.866667,0.013435
26081,Kent County,,MI,33472,717185,750657,157,186,343,99313,104731,204044,5,0.438604,0.47574,45597.084028,0.04269,0.054387,66,0.001265,0,16,0.409347,0.366045
26083,Keweenaw County,,MI,150,2506,2656,1,1,2,357,293,650,6,0.260851,0.267597,0,0.000017,0.000008,99,0.000065,0,16,0,0.000128
26085,Lake County,,MI,945,11306,12251,10,9,19,1992,1947,3939,6,0.320156,0.33472,2.686147,0.001034,0.000841,66,0.000139,0,16,0.766667,0.007894
26087,Lapeer County,,MI,6341,108488,114829,14,17,31,16361,16176,32537,5,0.360552,0.379927,88.203967,0.003182,0.004129,66,0.000125,0,16,0.843137,0.022191
26089,Leelanau County,,MI,1588,26105,27693,8,7,15,3480,3901,7381,5,0.34633,0.362012,78.547547,0.002524,0.001785,66,0.000109,0,16,0.857143,0.01905
26091,Lenawee County,,MI,5953,118543,124496,18,24,42,12589,13226,25815,5,0.368536,0.389639,354.663172,0.003844,0.006176,66,0.000162,0,16,0.731884,0.027037
26093,Livingston County,,MI,12021,220855,232876,33,50,83,38022,33038,71060,5,0.387142,0.41281,880.83099,0.008545,0.016348,66,0.00026,0,16,0.625189,0.068396
26095,Luce County,,MI,392,6528,6920,2,2,4,196,164,360,6,0.267674,0.275779,1.781099,0.000012,0.00004,66,0.000075,0,16,0.666667,0.000222
26097,Mackinac County,,MI,941,13634,14575,3,5,8,728,1022,1750,6,0.305127,0.316887,17.855333,0.000033,0.000297,66,0.000083,0,16,0.7,0.000519
26099,Macomb County,,MI,47980,1032270,1080250,124,190,314,169374,166645,336019,5,0.439304,0.476813,22464.138141,0.037822,0.05629,66,0.000942,0,16,0.425746,0.327254
26101,Manistee County,,MI,1556,28419,29975,12,11,23,2566,2462,5028,6,0.321516,0.336783,21.495603,0.002004,0.00136,66,0.000149,0,16,0.741758,0.014081
26103,Marquette County,,MI,3451,73504,76955,29,28,57,5912,5346,11258,5,0.365248,0.386613,30890.223496,0.004661,0.004791,99,0.000485,0,16,0.327094,0.035488
26105,Mason County,,MI,1695,34303,35998,12,9,21,3145,2794,5939,6,0.320292,0.334857,60.822002,0.002545,0.000947,66,0.000143,0,16,0.757576,0.018974
26107,Mecosta County,,MI,3239,41286,44525,20,20,40,7944,7081,15025,5,0.347522,0.364928,103.179179,0.002681,0.002889,66,0.000193,0,16,0.694805,0.01839
26109,Menominee County,,MI,1286,28869,30155,5,5,10,2585,2803,5388,6,0.279634,0.289997,2.031027,0.000116,0.000095,99,0.000123,0,16,0.85,0.001186
26111,Midland County,,MI,5377,101637,107014,27,28,55,12923,12449,25372,5,0.371201,0.393469,882.995052,0.004899,0.005864,66,0.000243,0,16,0.506629,0.039235
26113,Missaukee County,,MI,1178,16891,18069,5,5,10,1821,2147,3968,6,0.305127,0.316887,0.819877,0.000626,0.000324,66,0.000092,0,16,0.785714,0.004834
26115,Monroe County,,MI,9025,187275,196300,21,27,48,24112,23948,48060,5,0.379907,0.402471,424.600019,0.005927,0.008435,66,0.000181,0,16,0.687192,0.045113
26117,Montcalm County,,MI,4879,70801,75680,15,19,34,13015,12939,25954,6,0.321789,0.338104,15.905509,0.001936,0.001745,66,0.00015,0,16,0.69883,0.013965
26119,Montmorency County,,MI,740,11240,11980,7,5,12,1253,1064,2317,6,0.321039,0.335435,5.342434,0.001559,0.000876,66,0.000113,0,16,0.809524,0.010716
26121,Muskegon County,,MI,8593,198369,206962,28,34,62,18505,20240,38745,5,0.375667,0.398751,955.437233,0.006015,0.008185,66,0.000246,0,16,0.577525,0.047423
26123,Newaygo County,,MI,3660,56786,60446,14,12,26,8278,8685,16963,6,0.320393,0.335353,12.623914,0.001797,0.001143,66,0.000163,0,16,0.690476,0.013206
26125,Oakland County,,MI,83669,1418351,1502020,268,324,592,293543,296029,589572,5,0.464642,0.511687,92672.509708,0.070902,0.081524,66,0.002081,0,16,0.292478,0.604077
26127,Oceana County,,MI,1957,31434,33391,7,7,14,3888,4556,8444,6,0.310603,0.323336,10.449033,0.001164,0.000798,66,0.000108,0,16,0.857143,0.009335
26129,Ogemaw County,,MI,1385,24548,25933,11,11,22,3395,2989,6384,6,0.321652,0.336866,12.284034,0.001673,0.00134,66,0.000144,0,16,0.772727,0.011682
26131,Ontonagon County,,MI,360,7773,8133,2,3,5,151,472,623,6,0.268006,0.276307,25.589077,0.000017,0.000036,99,0.000115,0,16,0.5,0.000194
26133,Osceola County,,MI,1844,26455,28299,13,10,23,4049,3937,7986,6,0.321345,0.336481,24.466826,0.001754,0.001177,66,0.000158,0,16,0.660256,0.012874
26135,Oscoda County,,MI,575,9694,10269,5,3,8,741,225,966,6,0.317339,0.330621,0.333333,0.001539,0.000437,66,0.000087,0,16,0.866667,0.010411
26137,Otsego County,,MI,2062,29132,31194,16,15,31,3790,3216,7006,6,0.32196,0.337801,18.47258,0.002225,0.001783,66,0.000201,0,16,0.643382,0.01566
26139,Ottawa County,,MI,17132,310871,328003,57,68,125,50810,49506,100316,5,0.398815,0.426538,4649.242911,0.015079,0.019786,66,0.000448,0,16,0.504561,0.125709
26141,Presque Isle County,,MI,753,16357,17110,5,4,9,1002,1022,2024,6,0.317405,0.330841,0.492857,0.001324,0.000462,66,0.000085,0,16,0.8,0.00938
26143,Roscommon County,,MI,1852,27571,29423,18,16,34,4206,3304,7510,6,0.32196,0.337911,38.785179,0.002416,0.001816,66,0.00018,0,16,0.647368,0.016693
26145,Saginaw County,,MI,9975,235417,245392,41,57,98,21876,26368,48244,5,0.391749,0.418587,3271.751724,0.008366,0.013903,66,0.000335,0,16,0.461718,0.068395
26147,St. Clair County,,MI,10499,201852,212351,24,36,60,21294,23861,45155,5,0.37754,0.401172,547.624583,0.006763,0.011762,66,0.00019,0,16,0.625178,0.053047
26149,St. Joseph County,,MI,4159,73648,77807,12,17,29,7519,8810,16329,5,0.360081,0.379432,175.61349,0.00211,0.003072,66,0.00013,0,16,0.680147,0.015543
26151,Sanilac County,,MI,2978,52190,55168,9,11,20,6378,7233,13611,6,0.321823,0.337141,0.154762,0.001734,0.001596,66,0.000096,0,16,0.954545,0.011606
26153,Schoolcraft County,,MI,348,9844,10192,3,2,5,554,317,871,6,0.26758,0.275558,0,0.000033,0.00003,99,0.000106,0,16,1,0.000441
26155,Shiawassee County,,MI,4934,86503,91437,16,19,35,10770,12117,22887,5,0.353607,0.372615,30.145646,0.002954,0.00295,66,0.000142,0,16,0.813158,0.019674
26157,Tuscola County,,MI,3726,69047,72773,11,15,26,7807,8770,16577,6,0.322406,0.338258,1.624857,0.001788,0.002082,66,0.000111,0,16,0.880952,0.012123
26159,Van Buren County,,MI,5342,90131,95473,19,18,37,14589,15152,29741,5,0.36494,0.384604,61.159885,0.004279,0.004268,66,0.000169,0,16,0.730952,0.033067
26161,Washtenaw County,,MI,29221,360452,389673,146,161,307,85491,92291,177782,5,0.431113,0.46648,8770.756354,0.046005,0.053288,66,0.00104,0,16,0.510459,0.383741
26163,Wayne County,,MI,101713,2037729,2139442,267,352,619,255123,370292,625415,5,0.469467,0.518389,97929.335119,0.071943,0.083641,66,0.002025,0,16,0.269128,0.61149
26165,Wexford County,,MI,2717,37607,40324,16,18,34,5869,5598,11467,6,0.322165,0.338379,59.554658,0.002322,0.001952,66,0.000197,0,16,0.617647,0.016221
27001,Aitkin County,,MN,1002,17483,18485,10,8,18,2486,1875,4361,6,0.322887,0.336442,1.256178,0.001135,0.000984,60,0.000148,0,16,0.8,0.009441
27003,Anoka County,,MN,25821,400189,426010,60,78,138,89884,88370,178254,5,0.399604,0.428029,10608.560063,0.010086,0.018179,60,0.00068,0,16,0.345095,0.091213
27005,Becker County,,MN,2118,38012,40130,13,13,26,4563,4823,9386,5,0.355225,0.373825,3347.21063,0.001038,0.001561,60,0.000208,0,16,0.747619,0.009056
27007,Beltrami County,,MN,2772,47035,49807,20,22,42,6034,6222,12256,5,0.355767,0.375531,3811.469369,0.001332,0.001875,60,0.000345,0,16,0.554113,0.011588
27009,Benton County,,MN,4612,43964,48576,17,17,34,14245,14161,28406,6,0.324304,0.339496,21.973836,0.001218,0.00117,60,0.000224,0,16,0.716374,0.010674
27011,Big Stone County,,MN,337,6329,6666,1,1,2,75,107,182,7,0.222721,0.227458,0,0.000001,0.000001,18,0.000092,0,16,0,0.000073
27013,Blue Earth County,,MN,5832,65932,71764,34,26,60,15115,14921,30036,5,0.363015,0.383504,4147.236163,0.001632,0.002636,60,0.000461,0,16,0.38254,0.014794
27015,Brown County,,MN,1560,32985,34545,9,9,18,2288,2590,4878,6,0.322921,0.336607,807.212599,0.000703,0.000913,60,0.000169,0,16,0.536364,0.006285
27017,Carlton County,,MN,1942,40025,41967,10,9,19,4792,4632,9424,6,0.32299,0.336717,3.518624,0.00114,0.00104,60,0.00015,0,16,0.772727,0.009393
27019,Carver County,,MN,6752,107248,114000,23,21,44,22920,19542,42462,5,0.364063,0.384164,712.053071,0.004291,0.003733,60,0.000281,0,16,0.612308,0.037522
27021,Cass County,,MN,2295,33623,35918,16,14,30,6082,6199,12281,6,0.324165,0.338946,11.720592,0.001229,0.001081,60,0.000218,0,16,0.735294,0.0107
27023,Chippewa County,,MN,958,15620,16578,8,8,16,1792,1774,3566,6,0.322783,0.33636,3800.228556,0.000507,0.000497,60,0.000176,0,16,0.482143,0.004861
27025,Chisago County,,MN,4020,64142,68162,14,19,33,12454,13265,25719,5,0.354186,0.37322,82.886945,0.001273,0.00183,60,0.000187,0,16,0.669591,0.010755
27027,Clay County,,MN,4433,61935,66368,25,21,46,13119,12260,25379,5,0.358165,0.378145,2095.144927,0.001376,0.002156,60,0.000424,0,16,0.440476,0.012362
27029,Clearwater County,,MN,577,9781,10358,3,2,5,876,807,1683,6,0.262547,0.270205,0.277778,0.000022,0.000013,60,0.000094,0,16,0.666667,0.000383
27031,Cook County,,MN,434,6422,6856,2,3,5,301,433,734,6,0.322474,0.335314,0,0.000509,0.000489,60,0.000069,0,16,1,0.004345
27033,Cottonwood County,,MN,771,14174,14945,7,6,13,938,968,1906,6,0.322715,0.336029,1073.037882,0.000475,0.000468,60,0.000145,0,16,0.472222,0.004462
27035,Crow Wing County,,MN,3806,72960,76766,24,29,53,10472,10144,20616,5,0.356941,0.377704,490.293954,0.00211,0.002509,60,0.000325,0,16,0.559113,0.018851
27037,Dakota County,,MN,33350,489067,522417,127,140,267,109919,110761,220680,5,0.4262,0.459497,42155.36169,0.029001,0.035946,60,0.001299,0,16,0.339286,0.256528
27039,Dodge County,,MN,1544,24403,25947,8,8,16,3904,3448,7352,6,0.322852,0.33647,2.487636,0.000785,0.00071,60,0.000134,0,16,0.788889,0.006751
27041,Douglas County,,MN,2385,44589,46974,19,18,37,5304,5332,10636,5,0.355308,0.374486,1050.986935,0.001293,0.001792,60,0.00029,0,16,0.6,0.011371
27043,Faribault County,,MN,1003,18440,19443,6,8,14,1388,1953,3341,6,0.322956,0.336607,69.245919,0.000111,0.000527,60,0.000136,0,16,0.607143,0.001114
27045,Fillmore County,,MN,1235,25525,26760,7,7,14,2488,2845,5333,6,0.322956,0.336525,2351.357339,0.000558,0.000521,60,0.000136,0,16,0.52381,0.004982
27047,Freeborn County,,MN,1668,38897,40565,13,14,27,3355,3726,7081,6,0.323542,0.33812,2371.498438,0.001067,0.001022,60,0.000218,0,16,0.52381,0.009258
27049,Goodhue County,,MN,3037,57126,60163,13,15,28,7146,8022,15168,6,0.3233,0.337873,84.032748,0.001819,0.001168,60,0.000178,0,16,0.620833,0.015623
27051,Grant County,,MN,523,7513,8036,2,4,6,662,916,1578,6,0.322646,0.335672,0.664225,0.000022,0.000472,60,0.000077,0,16,0.833333,0.000332
27053,Hennepin County,,MN,86998,1333531,1420529,364,346,710,306858,316106,622964,5,0.47566,0.522114,366958.421994,0.076284,0.076484,60,0.003565,0,16,0.218252,0.651221
27055,Houston County,,MN,1118,24080,25198,6,6,12,2022,2458,4480,6,0.323128,0.33669,83.094392,0.000572,0.00054,99,0.000119,0,16,0.666667,0.005106
27057,Hubbard County,,MN,1582,22669,24251,10,13,23,3614,3336,6950,6,0.324165,0.338836,900.511789,0.000912,0.00102,60,0.000167,0,16,0.758242,0.007772
27059,Isanti County,,MN,3130,44291,47421,13,14,27,10377,9928,20305,6,0.323093,0.337433,2.238032,0.00127,0.001106,60,0.000173,0,16,0.873626,0.010617
27061,Itasca County,,MN,1832,52135,53967,14,14,28,4077,4040,8117,5,0.3551,0.37377,77.320138,0.001264,0.001824,60,0.000198,0,16,0.705882,0.010585
27063,Jackson County,,MN,790,12972,13762,4,7,11,904,1266,2170,6,0.324478,0.338533,42.416819,0.000013,0.000568,60,0.000126,0,16,0.547619,0.000415
27065,Kanabec County,,MN,1378,18909,20287,9,12,21,3130,3419,6549,6,0.32299,0.337047,1.278283,0.000955,0.000894,60,0.000134,0,16,0.818182,0.00808
27067,Kandiyohi County,,MN,2664,51099,53763,17,23,40,4733,5754,10487,6,0.329562,0.3466,2000.658451,0.001375,0.001548,60,0.000244,0,16,0.512681,0.012536
27069,Kittson County,,MN,250,5646,5896,1,2,3,121,170,291,6,0.278836,0.287741,0,0.000001,0.000034,60,0.000073,0,16,1,0.000076
27071,Koochiching County,,MN,701,15451,16152,3,4,7,468,616,1084,6,0.322543,0.335534,0,0.00052,0.000501,60,0.000083,0,16,1,0.004492
27073,Lac qui Parle County,,MN,441,9152,9593,2,2,4,380,297,677,7,0.244077,0.249874,0,0.000006,0.000006,60,0.000091,0,16,1,0.000188
27075,Lake County,,MN,639,12936,13575,3,2,5,1138,1176,2314,6,0.32244,0.335149,0,0.000512,0.000486,60,0.000089,0,16,1,0.004432
27077,Lake of the Woods County,,MN,278,4955,5233,1,1,2,182,173,355,7,0.244926,0.250782,0,0.000004,0.000003,60,0.000067,0,16,0,0.000099
27079,Le Sueur County,,MN,2206,34310,36516,11,11,22,6615,6215,12830,6,0.323024,0.336992,3.784401,0.001054,0.000966,60,0.00017,0,16,0.827273,0.009192
27081,Lincoln County,,MN,411,7268,7679,3,3,6,585,561,1146,6,0.264172,0.272351,0.972222,0.000017,0.000018,60,0.000103,0,16,0.666667,0.000386
27083,Lyon County,,MN,2199,30130,32329,13,19,32,2932,3832,6764,6,0.326085,0.342165,3619.324507,0.001088,0.001111,60,0.000241,0,16,0.374269,0.009722
27085,McLeod County,,MN,2879,46928,49807,14,15,29,5504,6520,12024,6,0.324895,0.339689,60.484538,0.00129,0.001213,60,0.000198,0,16,0.604167,0.011071
27087,Mahnomen County,,MN,406,6050,6456,1,4,5,591,705,1296,6,0.283907,0.294019,0.233766,0.000009,0.000069,60,0.000063,0,16,0.833333,0.000126
27089,Marshall County,,MN,684,11974,12658,6,6,12,1231,1374,2605,6,0.286837,0.297507,3059.773675,0.000136,0.000095,60,0.000172,0,16,0.666667,0.001367
27091,Martin County,,MN,1422,26183,27605,7,7,14,1457,1657,3114,6,0.322921,0.336415,2115.349149,0.00048,0.000631,60,0.000156,0,16,0.410714,0.00451
27093,Meeker County,,MN,1730,28375,30105,7,9,16,3552,3520,7072,6,0.322956,0.336662,1.263632,0.000525,0.000937,60,0.00012,0,16,0.833333,0.004983
27095,Mille Lacs County,,MN,2137,30086,32223,14,14,28,6117,6288,12405,6,0.323093,0.337433,4.519767,0.001147,0.000947,60,0.00019,0,16,0.8125,0.010009
27097,Morrison County,,MN,2081,40815,42896,14,13,27,4789,4970,9759,6,0.323059,0.337268,4.999666,0.001193,0.00088,60,0.000194,0,16,0.818681,0.010281
27099,Mower County,,MN,2306,48320,50626,14,15,29,4262,5767,10029,6,0.323715,0.338533,796.466633,0.001109,0.001014,60,0.000221,0,16,0.441667,0.009743
27101,Murray County,,MN,508,10937,11445,3,6,9,679,897,1576,6,0.324304,0.338148,40.925935,0.000012,0.000557,60,0.000094,0,16,0.7,0.000316
27103,Nicollet County,,MN,3468,36430,39898,16,17,33,8703,9085,17788,6,0.323404,0.338258,1307.51925,0.001241,0.001079,60,0.000244,0,16,0.525735,0.010559
27105,Nobles County,,MN,1619,25214,26833,9,10,19,1977,2564,4541,6,0.324652,0.339111,2435.69368,0.000837,0.00081,60,0.000179,0,16,0.390909,0.00753
27107,Norman County,,MN,539,8148,8687,3,3,6,636,845,1481,6,0.283827,0.293744,0,0.000085,0.000063,60,0.000106,0,16,1,0.000871
27109,Olmsted County,,MN,9702,178951,188653,50,56,106,21704,23248,44952,5,0.396934,0.42295,9552.696674,0.007927,0.013218,60,0.000589,0,16,0.364993,0.070604
27111,Otter Tail County,,MN,3454,69072,72526,22,21,43,7490,7623,15113,5,0.3556,0.375201,4012.134208,0.002014,0.00188,60,0.000341,0,16,0.559289,0.017946
27113,Pennington County,,MN,990,16416,17406,8,9,17,2073,2160,4233,6,0.324269,0.338423,2604.54488,0.000595,0.000558,60,0.000205,0,16,0.694444,0.005403
27115,Pine County,,MN,1906,31416,33322,13,13,26,5292,5149,10441,6,0.323059,0.337268,4.839572,0.00126,0.001087,60,0.000179,0,16,0.763736,0.010541
27117,Pipestone County,,MN,760,11762,12522,5,6,11,773,1072,1845,6,0.286756,0.297491,300.094894,0.000115,0.000111,18,0.000136,0,16,0.466667,0.001282
27119,Polk County,,MN,2173,36513,38686,13,13,26,4841,4783,9624,6,0.324652,0.339386,5732.218216,0.000871,0.000843,60,0.000314,0,16,0.452381,0.007918
27121,Pope County,,MN,897,13568,14465,5,4,9,1462,1343,2805,6,0.322543,0.335534,0.67619,0.000497,0.000486,60,0.000119,0,16,0.75,0.004559
27123,Ramsey County,,MN,49621,563251,612872,176,171,347,162306,175114,337420,5,0.441738,0.476197,78575.757223,0.04098,0.04489,60,0.00175,0,16,0.324795,0.358591
27125,Red Lake County,,MN,252,4988,5240,2,2,4,571,539,1110,7,0.245164,0.251327,0,0.000008,0.000009,60,0.000089,0,16,1,0.00022
27127,Redwood County,,MN,1133,19746,20879,6,11,17,1440,2081,3521,6,0.324686,0.339276,36.650341,0.000735,0.000992,60,0.000127,0,16,0.554545,0.006517
27129,Renville County,,MN,1183,19974,21157,7,11,18,1618,2298,3916,6,0.326225,0.340684,57.789848,0.000653,0.00091,60,0.000131,0,16,0.518182,0.006582
27131,Rice County,,MN,4277,69417,73694,20,20,40,9816,10650,20466,5,0.361068,0.38067,485.718807,0.002711,0.002508,60,0.000259,0,16,0.65,0.023654
27133,Rock County,,MN,610,11884,12494,3,5,8,965,1174,2139,6,0.324235,0.337928,40.616411,0.000107,0.000566,18,0.0001,0,16,0.6,0.001134
27135,Roseau County,,MN,891,20199,21090,7,10,17,813,1587,2400,6,0.324339,0.338643,6218.902082,0.00059,0.000594,60,0.000205,0,16,0.666667,0.005284
27137,St. Louis County,,MN,9456,225187,234643,56,53,109,23654,24345,47999,5,0.38048,0.406152,7651.194421,0.006184,0.009948,60,0.000719,0,16,0.298611,0.056185
27139,Scott County,,MN,10371,153419,163790,29,34,63,37288,32750,70038,5,0.376976,0.400182,1272.218371,0.00537,0.00793,60,0.000345,0,16,0.529412,0.047703
27141,Sherburne County,,MN,8011,101016,109027,23,26,49,26192,24917,51109,5,0.355725,0.375916,325.043958,0.002188,0.002004,60,0.000287,0,16,0.588624,0.01921
27143,Sibley County,,MN,1163,18979,20142,9,10,19,2268,2562,4830,6,0.322818,0.336635,5.834441,0.000565,0.000716,60,0.000156,0,16,0.733333,0.005354
27145,Stearns County,,MN,10946,168931,179877,51,47,98,30137,33241,63378,5,0.370928,0.394729,4495.151766,0.004446,0.005092,60,0.000674,0,16,0.323295,0.040765
27147,Steele County,,MN,2755,46575,49330,13,15,28,5377,5888,11265,5,0.3551,0.373853,127.70631,0.001116,0.001948,60,0.000195,0,16,0.641667,0.009683
27149,Stevens County,,MN,715,10444,11159,5,5,10,687,636,1323,6,0.322577,0.335699,615.475378,0.00047,0.000486,60,0.000127,0,16,0.6,0.004282
27151,Swift County,,MN,661,12186,12847,3,6,9,835,1169,2004,6,0.322612,0.335864,2.833333,0.000015,0.000492,60,0.000098,0,16,0.7,0.000336
27153,Todd County,,MN,1734,28204,29938,11,12,23,3628,4127,7755,6,0.324061,0.338561,4.714542,0.000662,0.000883,60,0.000173,0,16,0.820513,0.006122
27155,Traverse County,,MN,260,4290,4550,1,0,1,65,0,65,0,0,0,0,0,0,60,0.00007,0,1,0,0.000072
27157,Wabasha County,,MN,1442,27413,28855,7,7,14,3148,3469,6617,6,0.322887,0.336332,128.409432,0.001027,0.000937,60,0.000117,0,16,0.732143,0.008594
27159,Wadena County,,MN,1100,15964,17064,10,11,21,2312,2703,5015,6,0.323888,0.338258,5.446676,0.000646,0.000587,60,0.000164,0,16,0.772727,0.005885
27161,Waseca County,,MN,1444,22792,24236,9,10,19,2909,3543,6452,6,0.323059,0.336937,2.735273,0.000725,0.00096,60,0.000156,0,16,0.827273,0.00648
27163,Washington County,,MN,19684,284104,303788,56,59,115,68519,63207,131726,5,0.392104,0.418725,5048.770311,0.010498,0.015575,60,0.000601,0,16,0.409543,0.093434
27165,Watonwan County,,MN,730,13400,14130,5,5,10,1253,1082,2335,6,0.266708,0.275019,3.9,0.000034,0.000027,60,0.000132,0,16,0.55,0.000611
27167,Wilkin County,,MN,601,8241,8842,4,5,9,1120,1290,2410,6,0.283933,0.294184,3043,0.000092,0.00007,60,0.000125,0,16,0.6,0.001017
27169,Winona County,,MN,3065,55123,58188,18,20,38,5490,6681,12171,5,0.350416,0.368191,1504.034017,0.002232,0.002444,60,0.000248,0,16,0.509524,0.019205
27171,Wright County,,MN,9037,148935,157972,24,30,54,30248,26900,57148,5,0.359355,0.380291,468.001849,0.002197,0.002705,60,0.000303,0,16,0.535484,0.019416
27173,Yellow Medicine County,,MN,713,12850,13563,5,5,10,953,1102,2055,6,0.32268,0.335864,2917.574707,0.000466,0.000463,60,0.000136,0,16,0.6,0.004306
28001,Adams County,,MS,2067,31967,34034,12,15,27,3014,3794,6808,5,0.345421,0.363332,3459.894349,0.001891,0.002518,30,0.000216,0,16,0.538095,0.018787
28003,Alcorn County,,MS,2083,36849,38932,9,11,20,4221,4614,8835,6,0.320665,0.334346,515.277643,0.000535,0.000587,3,0.000186,0,16,0.5,0.005314
28005,Amite County,,MS,986,13343,14329,5,6,11,1717,1961,3678,6,0.302477,0.314686,130.990028,0.000385,0.000346,30,0.000119,0,16,0.566667,0.003467
28007,Attala County,,MS,1058,20108,21166,8,9,17,2040,2026,4066,6,0.291222,0.302713,282.41004,0.000281,0.000219,30,0.000159,0,16,0.486111,0.002635
28009,Benton County,,MS,692,8665,9357,6,6,12,1998,2043,4041,6,0.320123,0.332915,1.384499,0.000519,0.000517,3,0.000124,0,16,0.833333,0.004901
28011,Bolivar County,,MS,2277,36503,38780,10,13,23,3965,4746,8711,5,0.348722,0.365671,128.590547,0.001374,0.001392,3,0.000152,0,16,0.647436,0.012242
28013,Calhoun County,,MS,715,15804,16519,8,8,16,1502,1447,2949,6,0.280957,0.291658,80.202869,0.00005,0.000103,3,0.000176,0,16,0.444444,0.000975
28015,Carroll County,,MS,845,11130,11975,5,5,10,1828,1762,3590,6,0.277483,0.287675,4.898067,0.000023,0.000071,3,0.000118,0,16,0.533333,0.000522
28017,Chickasaw County,,MS,1190,20065,21255,7,7,14,2809,3304,6113,6,0.261843,0.271129,15.121777,0.000047,0.000034,3,0.000162,0,16,0.589286,0.000833
28019,Choctaw County,,MS,631,8728,9359,5,4,9,1165,1272,2437,6,0.261617,0.270249,92.526504,0.000066,0.000016,3,0.000119,0,16,0.4,0.000905
28021,Claiborne County,,MS,873,10730,11603,4,4,8,1824,2653,4477,6,0.290691,0.301144,1.616667,0.00015,0.000105,30,0.000097,0,16,0.6,0.00126
28023,Clarke County,,MS,1117,18725,19842,5,8,13,2688,3439,6127,6,0.294135,0.306647,21.656696,0.000047,0.000327,30,0.000113,0,16,0.732143,0.000751
28025,Clay County,,MS,1257,22007,23264,6,6,12,2492,2659,5151,6,0.273647,0.283619,34.889438,0.000084,0.000053,3,0.000137,0,16,0.7,0.000932
28027,Coahoma County,,MS,1707,28537,30244,10,11,21,2798,3560,6358,5,0.348401,0.365038,323.520245,0.001278,0.00127,3,0.000173,0,16,0.554545,0.011593
28029,Copiah County,,MS,1774,31711,33485,6,9,15,3633,4553,8186,6,0.291278,0.302795,5.546248,0.00026,0.000245,30,0.00012,0,16,0.694444,0.002357
28031,Covington County,,MS,1219,20826,22045,7,10,17,3376,3791,7167,6,0.301093,0.313701,6.453638,0.000135,0.000493,30,0.000134,0,16,0.822222,0.00162
28033,DeSoto County,,MS,13551,179255,192806,62,56,118,45338,36461,81799,5,0.386845,0.413497,15439.504692,0.011315,0.011339,3,0.000744,0,16,0.306534,0.102774
28035,Forrest County,,MS,7504,72133,79637,50,43,93,22035,22668,44703,5,0.358759,0.382051,11697.480142,0.005179,0.005903,30,0.00061,0,16,0.291591,0.048963
28037,Franklin County,,MS,499,8850,9349,4,3,7,731,865,1596,6,0.257065,0.264675,0.94049,0.000035,0.000028,30,0.000106,0,16,0.5,0.000578
28039,George County,,MS,1308,22880,24188,6,6,12,3475,2805,6280,6,0.304178,0.316639,14.245322,0.000524,0.000517,30,0.000118,0,16,0.714286,0.004687
28041,Greene County,,MS,684,12177,12861,6,7,13,1830,1673,3503,6,0.299545,0.311676,46.347356,0.000352,0.000317,30,0.000127,0,16,0.547619,0.003228
28043,Grenada County,,MS,1583,24532,26115,13,15,28,2922,3135,6057,6,0.32155,0.336189,2808.813747,0.000755,0.000747,3,0.000231,0,16,0.454167,0.00706
28045,Hancock County,,MS,3172,39267,42439,14,12,26,7967,6985,14952,6,0.311754,0.325834,32.765766,0.001512,0.00135,30,0.000201,0,16,0.757143,0.014798
28047,Harrison County,,MS,17816,186657,204473,122,122,244,45875,45707,91582,5,0.414194,0.44759,29217.024465,0.033976,0.035205,30,0.00111,0,16,0.415305,0.302675
28049,Hinds County,,MS,17047,265309,282356,84,91,175,48719,56280,104999,5,0.40938,0.439579,69186.452356,0.015864,0.021915,30,0.000957,0,16,0.299942,0.14586
28051,Holmes County,,MS,1279,21188,22467,7,8,15,2417,3291,5708,6,0.321141,0.334758,1111.479447,0.000832,0.000655,30,0.000135,0,16,0.680556,0.00745
28053,Humphreys County,,MS,673,9985,10658,5,6,11,965,1265,2230,6,0.29153,0.302493,1.693054,0.000187,0.000183,30,0.000102,0,16,0.7,0.001538
28055,Issaquena County,,MS,96,1077,1173,1,0,1,96,0,96,0,0,0,0,0.000001,0,30,0.000063,0,4,0,0.000066
28057,Itawamba County,,MS,1727,25014,26741,8,8,16,4183,4510,8693,6,0.260089,0.269203,25.206181,0.00003,0.000035,3,0.00018,0,16,0.472222,0.000894
28059,Jackson County,,MS,10730,148180,158910,51,54,105,25187,27610,52797,5,0.390234,0.416689,5995.120139,0.014501,0.015362,30,0.00052,0,16,0.539662,0.131973
28061,Jasper County,,MS,1347,19261,20608,6,8,14,2956,3919,6875,6,0.271952,0.28253,9.897218,0.000083,0.00009,30,0.000121,0,16,0.625,0.001115
28063,Jefferson County,,MS,481,8494,8975,4,5,9,1225,1299,2524,6,0.290747,0.301365,2.761429,0.000164,0.000117,30,0.000102,0,16,0.6,0.001356
28065,Jefferson Davis County,,MS,839,13514,14353,9,10,19,2377,2593,4970,6,0.300974,0.313508,11.390131,0.000268,0.000411,30,0.000155,0,16,0.766667,0.002665
28067,Jones County,,MS,3935,68741,72676,18,18,36,10018,9420,19438,5,0.342376,0.360306,2322.85464,0.001423,0.001468,30,0.000252,0,16,0.440476,0.013506
28069,Kemper County,,MS,536,9507,10043,4,2,6,1322,1125,2447,6,0.270446,0.279295,0.388889,0.000037,0.000032,30,0.000102,0,16,0.75,0.000574
28071,Lafayette County,,MS,3651,37913,41564,28,22,50,7223,6491,13714,5,0.355058,0.375542,2391.043491,0.002158,0.003372,3,0.000387,0,16,0.378495,0.020066
28073,Lamar County,,MS,5811,51759,57570,31,29,60,18388,15386,33774,5,0.351433,0.372455,3147.618651,0.002825,0.003928,30,0.0004,0,16,0.411111,0.027017
28075,Lauderdale County,,MS,4500,83770,88270,32,37,69,9521,9729,19250,5,0.370565,0.394547,18097.027611,0.005149,0.005761,30,0.000418,0,16,0.355488,0.046641
28077,Lawrence County,,MS,791,14145,14936,9,10,19,1448,2355,3803,6,0.29125,0.302878,10.466435,0.000251,0.000218,30,0.000157,0,16,0.7,0.00257
28079,Leake County,,MS,1113,22750,23863,7,8,15,3150,3575,6725,6,0.291138,0.302438,27.252434,0.000257,0.000205,30,0.000135,0,16,0.696429,0.002426
28081,Lee County,,MS,5630,90814,96444,28,25,53,15595,14456,30051,5,0.350416,0.370601,11428.720123,0.002094,0.00246,3,0.000418,0,16,0.347312,0.019852
28083,Leflore County,,MS,2155,32844,34999,14,17,31,3652,4835,8487,5,0.356311,0.375245,4822.855424,0.00137,0.002093,3,0.000216,0,16,0.474265,0.012503
28085,Lincoln County,,MS,1843,37273,39116,11,11,22,3922,3833,7755,5,0.341527,0.35838,935.452692,0.000304,0.00094,30,0.000204,0,16,0.487179,0.003173
28087,Lowndes County,,MS,4509,63276,67785,22,32,54,7261,7652,14913,5,0.373582,0.39726,9313.864834,0.003903,0.006953,3,0.000291,0,16,0.472269,0.035478
28089,Madison County,,MS,8528,98910,107438,49,46,95,28757,23988,52745,5,0.384488,0.409838,10367.84738,0.008709,0.010021,30,0.000565,0,16,0.384696,0.081326
28091,Marion County,,MS,1566,27827,29393,10,10,20,2752,3418,6170,6,0.303052,0.315698,29.687806,0.000569,0.000521,30,0.000163,0,16,0.644444,0.005428
28093,Marshall County,,MS,2889,39207,42096,8,10,18,7986,8831,16817,6,0.321141,0.334979,19.674365,0.000541,0.000643,3,0.000164,0,16,0.6,0.005233
28095,Monroe County,,MS,2141,41177,43318,11,11,22,4771,5391,10162,6,0.321584,0.335749,1444.000239,0.000649,0.000652,3,0.000205,0,16,0.515152,0.005944
28097,Montgomery County,,MS,821,11985,12806,3,5,8,1107,1144,2251,6,0.290942,0.301722,10.331395,0.000017,0.000157,3,0.000093,0,16,0.75,0.00033
28099,Neshoba County,,MS,1664,31927,33591,8,10,18,3492,3770,7262,6,0.292008,0.303819,131.240138,0.000231,0.000248,30,0.000176,0,16,0.622222,0.002277
28101,Newton County,,MS,1361,24483,25844,8,10,18,3059,3215,6274,6,0.301123,0.313783,94.507419,0.000232,0.000414,30,0.000146,0,16,0.6,0.002279
28103,Noxubee County,,MS,635,13634,14269,3,5,8,753,1202,1955,6,0.27761,0.287691,12.02408,0.000066,0.000067,3,0.000083,0,16,0.65,0.000557
28105,Oktibbeha County,,MS,4017,39221,43238,28,30,58,7028,7562,14590,5,0.353896,0.375415,16507.65507,0.002264,0.004136,3,0.000401,0,16,0.366387,0.020716
28107,Panola County,,MS,2322,38431,40753,10,10,20,5434,5929,11363,6,0.321005,0.334758,22.85042,0.000546,0.000635,3,0.000199,0,16,0.590909,0.005441
28109,Pearl River County,,MS,3413,55374,58787,15,14,29,7427,7909,15336,5,0.34118,0.358215,101.902439,0.001243,0.001776,30,0.000222,0,16,0.641667,0.012556
28111,Perry County,,MS,962,13018,13980,6,7,13,1902,2598,4500,6,0.293508,0.305436,6.327366,0.000072,0.000263,30,0.000132,0,16,0.642857,0.001074
28113,Pike County,,MS,2676,43487,46163,20,21,41,5770,6415,12185,5,0.342763,0.361131,3752.365248,0.002633,0.002121,30,0.00029,0,16,0.484848,0.025578
28115,Pontotoc County,,MS,1924,31709,33633,11,13,24,6333,5773,12106,6,0.320733,0.334676,1473.016482,0.000548,0.000593,3,0.000219,0,16,0.50641,0.005533
28117,Prentiss County,,MS,1357,25939,27296,8,7,15,3534,3598,7132,6,0.261166,0.270012,239.915377,0.000464,0.000028,3,0.000166,0,16,0.732143,0.004594
28119,Quitman County,,MS,625,8144,8769,4,5,9,1130,1485,2615,6,0.320055,0.332695,0,0.000447,0.000519,3,0.000107,0,16,1,0.00415
28121,Rankin County,,MS,10750,147850,158600,60,57,117,35425,30212,65637,5,0.382981,0.409591,23576.118451,0.009156,0.010502,30,0.000697,0,16,0.324169,0.085426
28123,Scott County,,MS,1786,30015,31801,8,9,17,4017,4451,8468,6,0.292008,0.303709,12.122615,0.00029,0.000264,30,0.000144,0,16,0.708333,0.002764
28125,Sharkey County,,MS,395,5428,5823,2,4,6,338,391,729,6,0.291138,0.301612,3043,0.000046,0.000118,30,0.000068,0,16,0.5,0.000375
28127,Simpson County,,MS,1781,27370,29151,10,12,22,4716,4873,9589,6,0.301034,0.313838,27.599661,0.000317,0.00046,30,0.000166,0,16,0.689394,0.00312
28129,Smith County,,MS,952,15916,16868,7,8,15,2777,2810,5587,6,0.291138,0.302438,22.499896,0.000113,0.000191,30,0.000133,0,16,0.660714,0.001454
28131,Stone County,,MS,1205,16452,17657,8,8,16,3677,3230,6907,6,0.293764,0.305893,415.73171,0.00103,0.000353,30,0.00014,0,16,0.638889,0.009489
28133,Sunflower County,,MS,1751,27758,29509,8,10,18,3317,4348,7665,5,0.354559,0.372411,221.948401,0.00068,0.001879,3,0.000135,0,16,0.733333,0.006111
28135,Tallahatchie County,,MS,934,13831,14765,8,9,17,2054,2168,4222,6,0.320393,0.333685,7.575353,0.000483,0.000543,3,0.000151,0,16,0.652778,0.004651
28137,Tate County,,MS,1997,30206,32203,7,6,13,6311,5805,12116,6,0.320123,0.332915,11.137465,0.000799,0.000527,3,0.000142,0,16,0.666667,0.00764
28139,Tippah County,,MS,1217,24030,25247,10,12,22,3392,3455,6847,6,0.325559,0.340866,577.886653,0.000537,0.001073,3,0.000191,0,16,0.522727,0.005393
28141,Tishomingo County,,MS,1178,20400,21578,8,7,15,2662,2445,5107,6,0.260246,0.269286,272.654623,0.000479,0.000034,3,0.000164,0,16,0.458333,0.004742
28143,Tunica County,,MS,1415,13267,14682,8,7,15,3228,3905,7133,6,0.32019,0.333135,5.589123,0.00053,0.000528,3,0.000157,0,16,0.660714,0.005188
28145,Union County,,MS,1607,29713,31320,11,13,24,5193,5507,10700,6,0.320563,0.334401,787.248127,0.000554,0.000588,3,0.000211,0,16,0.538462,0.00557
28147,Walthall County,,MS,987,15691,16678,6,8,14,1989,2190,4179,6,0.29111,0.302438,16.398354,0.000281,0.000172,30,0.000122,0,16,0.680556,0.002952
28149,Warren County,,MS,3339,56474,59813,16,20,36,5372,6263,11635,5,0.35127,0.370777,4189.167364,0.001608,0.003231,30,0.000251,0,16,0.454762,0.015197
28151,Washington County,,MS,3407,57947,61354,15,23,38,4718,6542,11260,5,0.367374,0.388869,5941.865114,0.002579,0.00463,3,0.000212,0,16,0.488142,0.024211
28153,Wayne County,,MS,1040,22449,23489,10,9,19,2039,2443,4482,6,0.293735,0.306042,117.847207,0.000329,0.000263,30,0.000183,0,16,0.477273,0.003274
28155,Webster County,,MS,788,11093,11881,5,6,11,1326,1349,2675,6,0.26173,0.270744,18.506099,0.00003,0.000019,3,0.000137,0,16,0.433333,0.000541
28157,Wilkinson County,,MS,551,9901,10452,6,5,11,890,1119,2009,6,0.299486,0.31084,9.804666,0.000269,0.00025,30,0.000146,0,16,0.466667,0.002775
28159,Winston County,,MS,958,20710,21668,7,9,16,1650,1966,3616,6,0.291952,0.303599,122.147406,0.000063,0.000195,30,0.000154,0,16,0.5,0.000944
28161,Yalobusha County,,MS,793,13924,14717,7,7,14,2089,2677,4766,6,0.320292,0.3333,262.968702,0.000531,0.000528,3,0.000146,0,16,0.738095,0.005089
28163,Yazoo County,,MS,1459,25447,26906,8,8,16,2719,3707,6426,5,0.348401,0.36468,270.677273,0.001329,0.001287,30,0.000133,0,16,0.678571,0.011767
29001,Adair County,,MO,1980,23556,25536,11,12,23,2320,2685,5005,5,0.355391,0.373721,21540.756582,0.001799,0.001782,32,0.0003,0,16,0.324176,0.014472
29003,Andrew County,,MO,1828,20770,22598,10,7,17,5594,5380,10974,6,0.311241,0.322708,530.552021,0.000544,0.000507,32,0.000228,0,16,0.522222,0.005144
29005,Atchison County,,MO,307,6897,7204,1,2,3,67,240,307,7,0.242747,0.248507,0,0.000006,0.000003,32,0.000069,0,16,1,0.000101
29007,Audrain County,,MO,1789,28069,29858,10,13,23,3122,3811,6933,6,0.31901,0.332282,491.094385,0.000619,0.00071,32,0.000212,0,16,0.448718,0.005347
29009,Barry County,,MO,2971,36753,39724,12,12,24,6879,7638,14517,6,0.313984,0.326945,31.5536,0.000878,0.000874,32,0.000224,0,16,0.742424,0.008622
29011,Barton County,,MO,973,14228,15201,5,6,11,1628,2117,3745,6,0.295801,0.306724,2.51912,0.000216,0.000217,32,0.00012,0,16,0.733333,0.00224
29013,Bates County,,MO,1319,18864,20183,9,10,19,2347,2708,5055,6,0.31618,0.329218,37.006491,0.000871,0.000832,32,0.000168,0,16,0.611111,0.007468
29015,Benton County,,MO,1428,19520,20948,11,8,19,3091,2617,5708,6,0.312204,0.323974,5.348854,0.001044,0.00063,32,0.000173,0,16,0.809091,0.009147
29017,Bollinger County,,MO,795,13060,13855,6,6,12,1780,2067,3847,6,0.266309,0.274942,5.158333,0.000044,0.000028,32,0.000146,0,16,0.571429,0.000744
29019,Boone County,,MO,12548,162130,174678,89,100,189,30247,30335,60582,5,0.418833,0.448679,63050.413249,0.017414,0.026457,32,0.001101,0,16,0.353223,0.154686
29021,Buchanan County,,MO,5722,96007,101729,30,27,57,14133,14068,28201,5,0.369345,0.391163,21193.677196,0.004099,0.004065,32,0.000497,0,16,0.338095,0.036282
29023,Butler County,,MO,2815,44405,47220,15,17,32,5786,5773,11559,6,0.320937,0.335666,13604.808156,0.000896,0.001126,32,0.000331,0,16,0.356725,0.00817
29025,Caldwell County,,MO,769,10202,10971,8,8,16,1661,1926,3587,6,0.311145,0.322653,5.433812,0.000477,0.000452,32,0.000171,0,16,0.75,0.004493
29027,Callaway County,,MO,3605,47051,50656,13,13,26,8153,8073,16226,6,0.322303,0.336112,237.081268,0.001546,0.00136,32,0.000203,0,16,0.583333,0.012627
29029,Camden County,,MO,3820,44753,48573,24,24,48,8050,7743,15793,5,0.3577,0.377809,636.065287,0.002849,0.003041,32,0.000308,0,16,0.473545,0.023573
29031,Cape Girardeau County,,MO,4834,82461,87295,30,30,60,12562,10490,23052,5,0.362624,0.38406,30321.056329,0.002714,0.003402,32,0.000517,0,16,0.301411,0.023307
29033,Carroll County,,MO,690,11122,11812,5,6,11,715,1038,1753,6,0.310922,0.322048,3.088889,0.000341,0.000426,32,0.00011,0,16,0.733333,0.002988
29035,Carter County,,MO,464,6344,6808,2,3,5,571,731,1302,7,0.243039,0.249315,0.833333,0.000007,0.000008,32,0.000115,0,16,0.666667,0.000188
29037,Cass County,,MO,8027,114331,122358,23,28,51,24164,21402,45566,5,0.369932,0.39222,1156.996538,0.00346,0.005666,32,0.000304,0,16,0.505747,0.030523
29039,Cedar County,,MO,1188,14493,15681,7,6,13,1614,2031,3645,6,0.312268,0.323864,13.896742,0.000531,0.000491,32,0.000145,0,16,0.666667,0.004847
29041,Chariton County,,MO,500,9300,9800,3,3,6,597,699,1296,6,0.295426,0.305403,1.86787,0.000009,0.000111,32,0.000108,0,16,0.666667,0.000279
29043,Christian County,,MO,8001,82046,90047,33,27,60,24587,21196,45783,5,0.364852,0.386448,3478.180627,0.004583,0.003777,32,0.000476,0,16,0.399287,0.041341
29045,Clark County,,MO,454,8262,8716,1,2,3,291,506,797,7,0.23605,0.241621,4.920197,0.000004,0.000002,18,0.000065,0,16,0,0.000084
29047,Clay County,,MO,19348,256116,275464,82,75,157,65948,59315,125263,5,0.40576,0.433267,28690.286279,0.020333,0.019929,32,0.000916,0,16,0.407018,0.17962
29049,Clinton County,,MO,2080,23944,26024,10,10,20,5459,5529,10988,6,0.315094,0.327869,40.645338,0.000886,0.000824,32,0.000185,0,16,0.636364,0.007826
29051,Cole County,,MO,5470,86508,91978,26,22,48,13368,13271,26639,5,0.350985,0.369132,1803.534097,0.002861,0.00255,32,0.000357,0,16,0.433048,0.024608
29053,Cooper County,,MO,1375,18591,19966,7,8,15,2751,2593,5344,6,0.31301,0.324992,85.439915,0.000505,0.000555,32,0.000141,0,16,0.625,0.004183
29055,Crawford County,,MO,1695,26537,28232,12,11,23,4501,4171,8672,6,0.319212,0.332365,208.098224,0.001121,0.000989,32,0.000203,0,16,0.621212,0.009373
29057,Dade County,,MO,676,8496,9172,4,6,10,937,1301,2238,6,0.295743,0.306614,2.384317,0.000207,0.000202,32,0.000104,0,16,0.6,0.002079
29059,Dallas County,,MO,1608,17747,19355,7,7,14,2940,3734,6674,6,0.29557,0.306421,4.108725,0.000217,0.000202,32,0.000156,0,16,0.642857,0.00233
29061,Daviess County,,MO,669,9531,10200,8,9,17,1162,1828,2990,6,0.311209,0.322873,2225.619367,0.000452,0.000449,32,0.000177,0,16,0.666667,0.004242
29063,DeKalb County,,MO,845,10643,11488,9,7,16,2136,2188,4324,6,0.311113,0.322488,104.563249,0.000475,0.000447,32,0.000188,0,16,0.666667,0.004537
29065,Dent County,,MO,935,15365,16300,6,5,11,1497,1294,2791,6,0.295714,0.306476,952.595819,0.00045,0.000163,32,0.000154,0,16,0.5,0.003951
29067,Douglas County,,MO,870,13299,14169,6,7,13,1378,2083,3461,6,0.295656,0.306559,3.871919,0.000213,0.000214,32,0.000147,0,16,0.714286,0.002366
29069,Dunklin County,,MO,2249,31403,33652,10,12,22,4361,5005,9366,6,0.324131,0.339045,694.938195,0.000085,0.000652,3,0.000205,0,16,0.454545,0.001394
29071,Franklin County,,MO,6054,125222,131276,19,23,42,15503,15654,31157,5,0.36081,0.381039,1310.206178,0.002519,0.003037,32,0.000266,0,16,0.476667,0.020808
29073,Gasconade County,,MO,1183,17968,19151,7,10,17,2399,2791,5190,6,0.318339,0.330907,148.776876,0.000664,0.000616,32,0.000143,0,16,0.577778,0.005399
29075,Gentry County,,MO,463,7541,8004,3,5,8,550,816,1366,6,0.270109,0.278887,7.194877,0.000033,0.000035,32,0.000094,0,16,0.6,0.000472
29077,Greene County,,MO,21727,294292,316019,118,112,230,60679,60477,121156,5,0.419123,0.450385,85785.091768,0.024149,0.026786,32,0.001454,0,16,0.302087,0.21898
29079,Grundy County,,MO,712,11238,11950,5,6,11,968,859,1827,6,0.289248,0.299422,6169.096254,0.000009,0.000149,32,0.00019,0,16,0.357143,0.000398
29081,Harrison County,,MO,620,9993,10613,3,8,11,446,866,1312,6,0.311177,0.322708,1771.867312,0.00032,0.000444,32,0.000091,0,16,0.642857,0.002735
29083,Henry County,,MO,1669,24895,26564,11,10,21,3973,3854,7827,6,0.316147,0.329163,16.220267,0.001024,0.000939,32,0.000179,0,16,0.754545,0.009025
29085,Hickory County,,MO,723,9177,9900,5,5,10,1103,1264,2367,6,0.311979,0.323286,20.472329,0.000484,0.000439,32,0.00012,0,16,0.8,0.004221
29087,Holt County,,MO,359,5977,6336,3,3,6,486,695,1181,6,0.269964,0.278365,52.798956,0.00003,0.000031,32,0.000114,0,16,0.666667,0.000455
29089,Howard County,,MO,750,10978,11728,3,4,7,1547,1609,3156,6,0.295339,0.305414,199.498285,0.000164,0.000111,32,0.000093,0,16,0.583333,0.001199
29091,Howell County,,MO,2570,42255,44825,11,13,24,3646,3957,7603,6,0.313788,0.32678,1104.785349,0.000218,0.000721,32,0.000262,0,16,0.361905,0.00261
29093,Iron County,,MO,835,10702,11537,7,7,14,1865,1919,3784,6,0.275715,0.285215,84.129046,0.000482,0.000062,32,0.000164,0,16,0.527778,0.004304
29095,Jackson County,,MO,44300,745191,789491,198,197,395,135699,146515,282214,5,0.450342,0.486007,141569.171386,0.04914,0.05385,32,0.002046,0,16,0.341873,0.430184
29097,Jasper County,,MO,8339,124185,132524,43,39,82,21860,21574,43434,5,0.374367,0.398327,11811.19137,0.008464,0.007445,32,0.000571,0,16,0.360606,0.077051
29099,Jefferson County,,MO,13638,263709,277347,30,39,69,43015,40796,83811,5,0.38005,0.403956,7093.773709,0.005803,0.007436,32,0.000394,0,16,0.371795,0.050204
29101,Johnson County,,MO,5867,52378,58245,27,25,52,9773,10661,20434,5,0.367999,0.389826,1027.132499,0.006447,0.00557,32,0.000301,0,16,0.527957,0.056744
29103,Knox County,,MO,334,4636,4970,2,3,5,396,379,775,6,0.262638,0.270089,89.191497,0.000011,0.000011,32,0.000111,0,16,0,0.000219
29105,Laclede County,,MO,2486,39207,41693,12,12,24,4487,4810,9297,6,0.323059,0.336827,115.320434,0.000503,0.001015,32,0.000215,0,16,0.571429,0.004775
29107,Lafayette County,,MO,2656,38444,41100,9,12,21,5859,6786,12645,6,0.317106,0.330593,31.03652,0.000865,0.001044,32,0.00015,0,16,0.712121,0.007506
29109,Lawrence County,,MO,3146,41438,44584,9,11,20,7786,8279,16065,6,0.313529,0.32623,28.018754,0.000436,0.00077,32,0.000182,0,16,0.690909,0.004876
29111,Lewis County,,MO,650,11079,11729,4,3,7,1044,1155,2199,6,0.259732,0.267074,144.74544,0.000019,0.000023,32,0.000143,0,16,0.166667,0.000456
29113,Lincoln County,,MO,3943,60487,64430,11,10,21,11916,9996,21912,6,0.319178,0.332117,12.744419,0.00122,0.00102,32,0.000169,0,16,0.718182,0.009496
29115,Linn County,,MO,910,14923,15833,7,8,15,1074,1306,2380,6,0.312494,0.324331,1758.245241,0.000595,0.00054,32,0.000182,0,16,0.392857,0.004997
29117,Livingston County,,MO,969,16024,16993,7,9,16,1660,1804,3464,6,0.312494,0.324442,2252.311594,0.000447,0.000547,32,0.000165,0,16,0.541667,0.004133
29119,McDonald County,,MO,1934,22309,24243,9,9,18,5532,5390,10922,6,0.316609,0.329729,37.100438,0.000689,0.000903,32,0.000164,0,16,0.588889,0.006684
29121,Macon County,,MO,1043,18264,19307,5,5,10,1553,1732,3285,6,0.295599,0.305954,1514.190027,0.000175,0.000122,32,0.00014,0,16,0.4,0.00142
29123,Madison County,,MO,869,13137,14006,6,8,14,1613,1992,3605,6,0.318172,0.330494,376.329784,0.000492,0.000464,32,0.000135,0,16,0.660714,0.004304
29125,Maries County,,MO,702,9456,10158,6,5,11,1389,1401,2790,6,0.28161,0.291757,9.88805,0.000145,0.000117,32,0.000121,0,16,0.666667,0.00156
29127,Marion County,,MO,2003,32790,34793,12,11,23,3907,4020,7927,6,0.322165,0.335617,1890.301852,0.000825,0.000974,32,0.000279,0,16,0.384615,0.006745
29129,Mercer County,,MO,311,4092,4403,1,1,2,133,120,253,7,0.22437,0.228979,0,0.000001,0,32,0.000076,0,16,0,0.000069
29131,Miller County,,MO,2018,25731,27749,10,11,21,4517,4333,8850,6,0.323162,0.336855,107.729564,0.001185,0.00107,32,0.000165,0,16,0.718182,0.009945
29133,Mississippi County,,MO,778,13425,14203,3,3,6,1375,1544,2919,6,0.266192,0.274337,0,0.000029,0.000019,32,0.000098,0,16,1,0.000391
29135,Moniteau County,,MO,1123,17176,18299,7,7,14,2409,2461,4870,6,0.295512,0.306075,2.307738,0.0002,0.000153,32,0.000143,0,16,0.714286,0.001846
29137,Monroe County,,MO,695,10508,11203,6,6,12,1071,1600,2671,6,0.295599,0.306075,1512.530311,0.000172,0.000117,32,0.000159,0,16,0.6,0.001456
29139,Montgomery County,,MO,1055,14022,15077,8,9,17,2093,2337,4430,6,0.31854,0.331099,7.365487,0.000818,0.000702,32,0.000142,0,16,0.708333,0.006404
29141,Morgan County,,MO,1789,21817,23606,12,10,22,3333,3793,7126,6,0.316213,0.329135,95.950782,0.0012,0.000874,32,0.000194,0,16,0.651515,0.009825
29143,New Madrid County,,MO,1316,19323,20639,7,7,14,3071,3453,6524,6,0.266661,0.27563,13.874689,0.000037,0.000028,32,0.000173,0,16,0.642857,0.000708
29145,Newton County,,MO,5010,61006,66016,18,15,33,13927,14215,28142,6,0.319515,0.333829,689.78057,0.00185,0.00125,32,0.000296,0,16,0.508772,0.017533
29147,Nodaway County,,MO,1521,21866,23387,11,13,24,2025,2582,4607,6,0.320495,0.33423,16262.176006,0.000536,0.001081,32,0.000301,0,16,0.314103,0.005144
29149,Oregon County,,MO,698,9891,10589,4,3,7,966,1132,2098,6,0.295656,0.306064,88.456091,0.000164,0.000144,32,0.000126,0,16,0.5,0.001611
29151,Osage County,,MO,675,16232,16907,7,6,13,1649,1656,3305,6,0.29557,0.306047,27.849767,0.000223,0.000148,32,0.000138,0,16,0.619048,0.001887
29153,Ozark County,,MO,664,9520,10184,5,6,11,831,1241,2072,6,0.295772,0.306614,96.989898,0.000197,0.000192,32,0.000128,0,16,0.566667,0.002117
29155,Pemiscot County,,MO,1298,18305,19603,6,8,14,2101,2598,4699,6,0.271197,0.281881,121.550628,0.000071,0.000073,3,0.000138,0,16,0.5,0.001058
29157,Perry County,,MO,1009,22078,23087,9,7,16,2650,2136,4786,6,0.318206,0.330439,316.031315,0.000512,0.000466,32,0.000173,0,16,0.583333,0.004613
29159,Pettis County,,MO,2923,47671,50594,16,16,32,6019,6297,12316,6,0.317272,0.331308,153.061331,0.001259,0.001086,32,0.000242,0,16,0.580882,0.01108
29161,Phelps County,,MO,3537,44241,47778,17,23,40,5887,6814,12701,5,0.363233,0.38357,1567.551926,0.001696,0.003688,32,0.00026,0,16,0.476449,0.014103
29163,Pike County,,MO,1077,19082,20159,8,8,16,1943,2007,3950,6,0.318607,0.331072,462.097102,0.000808,0.000673,32,0.000176,0,16,0.589286,0.006298
29165,Platte County,,MO,11652,97932,109584,42,40,82,34246,32860,67106,5,0.389032,0.413134,4181.947861,0.01142,0.012039,32,0.000464,0,16,0.579082,0.098104
29167,Polk County,,MO,2484,31121,33605,9,10,19,5649,5407,11056,6,0.316048,0.328997,82.926281,0.000513,0.000817,32,0.000193,0,16,0.481818,0.004843
29169,Pulaski County,,MO,8279,42020,50299,52,56,108,19426,19258,38684,5,0.390234,0.416469,7971.290872,0.014479,0.014652,32,0.000492,0,16,0.581356,0.128633
29171,Putnam County,,MO,389,5524,5913,2,3,5,285,239,524,6,0.262365,0.269731,2.357999,0.000011,0.000011,32,0.000105,0,16,0.666667,0.000221
29173,Ralls County,,MO,791,11910,12701,5,5,10,1891,1688,3579,6,0.295541,0.305855,5.792832,0.000027,0.000117,32,0.000139,0,16,0.733333,0.000609
29175,Randolph County,,MO,1883,26906,28789,9,9,18,3132,3151,6283,6,0.32155,0.334654,2190.905657,0.000901,0.000812,32,0.000207,0,16,0.366667,0.007434
29177,Ray County,,MO,1799,27483,29282,8,8,16,4516,4877,9393,6,0.314799,0.327182,22.263471,0.000863,0.000799,32,0.000147,0,16,0.660714,0.007466
29179,Reynolds County,,MO,368,6637,7005,3,3,6,177,357,534,7,0.24265,0.248892,4.62263,0.000008,0.000014,32,0.000123,0,16,0.5,0.000329
29181,Ripley County,,MO,806,13912,14718,3,2,5,1397,1313,2710,7,0.243,0.249095,3.77358,0.000007,0.000005,32,0.000117,0,16,0.666667,0.000258
29183,St. Charles County,,MO,22354,433070,455424,94,113,207,78369,67354,145723,5,0.430929,0.460735,23693.46683,0.026592,0.036386,32,0.000932,0,16,0.472868,0.231552
29185,St. Clair County,,MO,719,9242,9961,8,9,17,1640,1514,3154,6,0.312139,0.324001,6.944318,0.000529,0.000476,32,0.000165,0,16,0.625,0.004716
29186,Ste. Genevieve County,,MO,1410,22188,23598,7,6,13,3002,3659,6661,6,0.318105,0.330164,0.859406,0.000938,0.000679,32,0.000131,0,16,0.904762,0.007586
29187,St. Francois County,,MO,3507,65030,68537,17,18,35,10692,9828,20520,6,0.320156,0.334621,5578.007551,0.001424,0.001118,32,0.00031,0,16,0.45,0.011858
29189,St. Louis County,,MO,70746,1194159,1264905,251,265,516,225447,242308,467755,5,0.465356,0.505431,157092.257889,0.067345,0.071385,32,0.002275,0,16,0.335211,0.578875
29195,Saline County,,MO,1532,24796,26328,8,12,20,2250,2622,4872,5,0.332894,0.348806,50.730255,0.000642,0.001567,32,0.000142,0,16,0.636364,0.005517
29197,Schuyler County,,MO,275,4387,4662,2,1,3,326,350,676,6,0.262228,0.269236,0,0.000011,0.000011,32,0.0001,0,16,1,0.000216
29199,Scotland County,,MO,250,5527,5777,0,0,0,0,0,0,0,0,0,0,0,0,31,0.000049,24,52,0,0
29201,Scott County,,MO,2885,44252,47137,10,14,24,6652,7235,13887,6,0.327707,0.343557,2765.516252,0.000499,0.001485,32,0.000214,0,16,0.470833,0.004581
29203,Shannon County,,MO,473,8305,8778,2,3,5,584,728,1312,6,0.295541,0.305899,0,0.000006,0.000148,32,0.000084,0,16,1,0.000192
29205,Shelby County,,MO,433,7732,8165,3,5,8,468,592,1060,6,0.295483,0.305799,140.082007,0.000001,0.000115,32,0.000127,0,16,0.466667,0.000216
29207,Stoddard County,,MO,2009,32504,34513,9,9,18,4086,4232,8318,6,0.319515,0.332613,1024.826121,0.000504,0.000567,32,0.000199,0,16,0.588889,0.004537
29209,Stone County,,MO,3101,33328,36429,11,8,19,6393,7150,13543,5,0.353483,0.370887,202.673912,0.001268,0.001191,32,0.000196,0,16,0.674242,0.011101
29211,Sullivan County,,MO,696,7405,8101,5,4,9,582,727,1309,6,0.262615,0.270337,229.496027,0.000039,0.000014,32,0.000162,0,16,0.2,0.000672
29213,Taney County,,MO,4938,49832,54770,29,23,52,9586,8933,18519,5,0.367954,0.389551,3394.291007,0.005734,0.004324,32,0.000417,0,16,0.46371,0.051775
29215,Texas County,,MO,1661,24732,26393,9,9,18,2924,3102,6026,6,0.300347,0.311858,2477.735517,0.0007,0.000273,32,0.000187,0,16,0.522222,0.006168
29217,Vernon County,,MO,1402,22003,23405,9,9,18,2397,2280,4677,6,0.312461,0.324497,52.404328,0.000566,0.000514,32,0.000178,0,16,0.536364,0.0052
29219,Warren County,,MO,2595,37345,39940,10,8,18,8624,7474,16098,6,0.31844,0.330824,2.911993,0.001216,0.000938,32,0.000147,0,16,0.811111,0.009391
29221,Washington County,,MO,1465,23967,25432,7,6,13,4142,3860,8002,6,0.317905,0.329861,65.874275,0.000725,0.000464,32,0.000134,0,16,0.857143,0.00627
29223,Wayne County,,MO,903,12284,13187,9,5,14,1681,1432,3113,6,0.266708,0.27552,674.776016,0.000504,0.000033,32,0.000197,0,16,0.522222,0.004605
29225,Webster County,,MO,3081,39156,42237,10,9,19,7424,7887,15311,5,0.351964,0.369341,761.086944,0.00118,0.0009,32,0.000194,0,16,0.572727,0.010986
29227,Worth County,,MO,93,2532,2625,1,1,2,106,82,188,7,0.242728,0.248341,0,0.000006,0.000003,32,0.000069,0,16,0,0.000101
29229,Wright County,,MO,1503,18944,20447,7,7,14,2465,3369,5834,6,0.295656,0.306559,4.041703,0.000198,0.000186,32,0.000161,0,16,0.714286,0.002202
29510,St. Louis city,,MO,36551,311146,347697,121,108,229,114005,127640,241645,5,0.436078,0.464697,26229.314799,0.037426,0.039091,32,0.001108,0,16,0.522783,0.326125
30001,Beaverhead County,,MT,885,9376,10261,5,6,11,772,963,1735,6,0.280074,0.291174,14.221888,0.000192,0.00028,17,0.000138,0,16,0.766667,0.002152
30003,Big Horn County,,MT,759,12954,13713,4,3,7,1236,1261,2497,6,0.279557,0.289854,4.20527,0.00017,0.000165,17,0.000143,0,16,0.75,0.001987
30005,Blaine County,,MT,479,7065,7544,3,2,5,593,675,1268,6,0.276495,0.28609,0.833333,0.000082,0.000087,17,0.000107,0,16,0.5,0.001031
30007,Broadwater County,,MT,363,5505,5868,2,2,4,1087,636,1723,6,0.274565,0.28406,0,0.000105,0.000107,17,0.000075,0,16,1,0.001134
30009,Carbon County,,MT,884,10507,11391,4,5,9,1455,1680,3135,6,0.2801,0.291119,3.62854,0.000166,0.000258,17,0.000122,0,16,0.7,0.001955
30011,Carter County,,MT,56,1332,1388,0,0,0,0,0,0,0,0,0,0,0,0,33,0.000049,25,53,0,0
30013,Cascade County,,MT,6856,93633,100489,39,42,81,11359,11975,23334,5,0.368626,0.392412,25435.928529,0.009648,0.009876,17,0.000613,0,16,0.466698,0.087976
30015,Chouteau County,,MT,354,5341,5695,2,1,3,433,392,825,6,0.269364,0.277902,0,0.00006,0.000057,17,0.00008,0,16,1,0.000671
30017,Custer County,,MT,812,13026,13838,5,5,10,785,910,1695,6,0.280645,0.29173,3039.19992,0.000243,0.000268,17,0.000199,0,16,0.433333,0.002616
30019,Daniels County,,MT,95,2204,2299,0,0,0,0,0,0,0,0,0,0,0,0,34,0.000049,26,54,0,0
30021,Dawson County,,MT,574,10161,10735,2,4,6,318,420,738,6,0.279609,0.290074,3045.779159,0.00008,0.000165,17,0.000111,0,16,0.416667,0.000962
30023,Deer Lodge County,,MT,686,9761,10447,4,4,8,807,1029,1836,6,0.275639,0.285386,1.789441,0.000166,0.000117,17,0.000121,0,16,0.9,0.001825
30025,Fallon County,,MT,227,3360,3587,1,0,1,79,0,79,0,0,0,0,0.000079,0,17,0.000068,0,14,0,0.000879
30027,Fergus County,,MT,760,13358,14118,4,6,10,881,1075,1956,6,0.281323,0.292676,3042,0.0003,0.000328,17,0.000103,0,16,0.7,0.003051
30029,Flathead County,,MT,6181,102567,108748,35,37,72,10695,11000,21695,5,0.369571,0.393106,6039.261935,0.009315,0.009159,17,0.000449,0,16,0.566202,0.084552
30031,Gallatin County,,MT,9149,95472,104621,59,63,122,15373,17049,32422,5,0.378294,0.405101,40389.861447,0.013477,0.013341,17,0.000829,0,16,0.362088,0.125915
30033,Garfield County,,MT,57,1396,1453,0,0,0,0,0,0,0,0,0,0,0,0,35,0.000049,27,55,0,0
30035,Glacier County,,MT,782,13906,14688,7,7,14,1183,1209,2392,6,0.281349,0.292841,25.089551,0.000288,0.000363,17,0.000166,0,16,0.696429,0.003092
30037,Golden Valley County,,MT,79,1151,1230,0,1,1,0,51,51,6,0.276485,0.285941,0,0,0.000085,17,0.000049,0,56,0,0
30039,Granite County,,MT,198,3076,3274,1,1,2,202,217,419,6,0.275514,0.28478,0,0.000084,0.000079,17,0.000061,0,16,0,0.000789
30041,Hill County,,MT,1234,19097,20331,7,8,15,1704,2172,3876,6,0.281375,0.293006,67.154296,0.000381,0.000383,17,0.000174,0,16,0.607143,0.004008
30043,Jefferson County,,MT,978,12471,13449,5,6,11,2162,2212,4374,6,0.280074,0.291174,8.118403,0.00025,0.00028,17,0.000122,0,16,0.785714,0.002662
30045,Judith Basin County,,MT,142,2269,2411,1,1,2,89,80,169,6,0.269388,0.277958,0,0.000002,0.000057,17,0.000064,0,16,1,0.000083
30047,Lake County,,MT,1858,28866,30724,11,11,22,3115,3097,6212,5,0.352619,0.370689,553.754669,0.00128,0.001845,17,0.0002,0,16,0.780303,0.012413
30049,Lewis and Clark County,,MT,4218,73050,77268,25,23,48,10017,8792,18809,5,0.35825,0.378557,6923.864719,0.00473,0.004497,17,0.000408,0,16,0.455026,0.044195
30051,Liberty County,,MT,115,2086,2201,0,0,0,0,0,0,0,0,0,0,0,0,36,0.000049,28,57,0,0
30053,Lincoln County,,MT,1326,20240,21566,4,6,10,1306,1560,2866,6,0.295311,0.308353,0.40024,0.000429,0.000516,17,0.000088,0,16,0.833333,0.004002
30055,McCone County,,MT,135,2005,2140,0,1,1,0,53,53,6,0.276485,0.285941,0,0,0.000085,17,0.000049,0,58,0,0
30057,Madison County,,MT,615,7914,8529,3,3,6,587,600,1187,6,0.274565,0.28417,0.2,0.000082,0.00009,17,0.000097,0,16,0.833333,0.000963
30059,Meagher County,,MT,142,2018,2160,0,0,0,0,0,0,0,0,0,0,0,0,37,0.000049,29,59,0,0
30061,Mineral County,,MT,397,4373,4770,1,1,2,451,510,961,6,0.275514,0.28478,0,0.000084,0.000079,17,0.000061,0,16,0,0.000789
30063,Missoula County,,MT,9304,115244,124548,58,61,119,20905,21521,42426,5,0.380241,0.406949,46667.423026,0.013414,0.014293,17,0.000831,0,16,0.41972,0.123188
30065,Musselshell County,,MT,383,4485,4868,1,1,2,541,618,1159,6,0.276444,0.28587,0,0.000079,0.000085,17,0.000068,0,16,0,0.000879
30067,Park County,,MT,1530,17689,19219,4,4,8,1570,1929,3499,6,0.280022,0.290844,1.376166,0.000249,0.000271,17,0.000105,0,16,0.8,0.002669
30069,Petroleum County,,MT,-2,-2,-4,0,0,0,0,0,0,0,0,0,0,0,0,38,0.000049,30,60,0,0
30071,Phillips County,,MT,203,4853,5056,0,2,2,0,101,101,6,0.27651,0.286106,0,0,0.000085,17,0.000049,0,61,1,0
30073,Pondera County,,MT,494,7135,7629,6,4,10,622,558,1180,6,0.277356,0.287383,17.132999,0.0002,0.000138,17,0.000164,0,16,0.6,0.002147
30075,Powder River County,,MT,134,1675,1809,0,0,0,0,0,0,0,0,0,0,0,0,39,0.000049,31,62,0,0
30077,Powell County,,MT,466,6320,6786,4,4,8,659,744,1403,6,0.275639,0.285386,0.25,0.000114,0.000117,17,0.000125,0,16,0.916667,0.001355
30079,Prairie County,,MT,78,1320,1398,1,1,2,40,44,84,7,0.219191,0.22432,0.333333,0.000001,0.000001,17,0.000073,0,16,0,0.000069
30081,Ravalli County,,MT,3175,43839,47014,15,15,30,5288,5029,10317,5,0.356983,0.376026,20.544786,0.0048,0.003053,17,0.000195,0,16,0.807895,0.044187
30083,Richland County,,MT,720,11684,12404,6,4,10,815,642,1457,6,0.277483,0.287499,16.132617,0.00022,0.000109,17,0.000201,0,16,0.6,0.002688
30085,Roosevelt County,,MT,639,10636,11275,4,4,8,522,569,1091,6,0.277457,0.287444,6.34695,0.000087,0.00011,17,0.000203,0,16,0.666667,0.001338
30087,Rosebud County,,MT,849,10548,11397,5,3,8,1008,959,1967,6,0.276495,0.2862,2.871135,0.000245,0.000087,17,0.000165,0,16,0.8,0.002629
30089,Sanders County,,MT,824,11531,12355,3,3,6,679,789,1468,6,0.27579,0.285496,0,0.000149,0.000141,17,0.000086,0,16,1,0.001487
30091,Sheridan County,,MT,192,4349,4541,0,1,1,0,61,61,6,0.276485,0.285941,0,0,0.000085,17,0.000049,0,63,0,0
30093,Silver Bow County,,MT,2145,37151,39296,14,10,24,4015,3592,7607,6,0.281427,0.293337,533.943289,0.001552,0.000387,17,0.000271,0,16,0.554945,0.015142
30095,Stillwater County,,MT,855,10141,10996,3,3,6,1457,1456,2913,6,0.279557,0.289854,0,0.00016,0.000165,17,0.0001,0,16,1,0.001758
30097,Sweet Grass County,,MT,334,4080,4414,2,2,4,221,328,549,6,0.279531,0.289689,0,0.000158,0.000164,17,0.000079,0,16,1,0.001682
30099,Teton County,,MT,500,7472,7972,3,2,5,527,771,1298,6,0.269388,0.278068,0.392857,0.000085,0.000058,17,0.000111,0,16,0.666667,0.00099
30101,Toole County,,MT,366,5529,5895,1,4,5,154,450,604,6,0.277356,0.287383,0,0.000058,0.000139,17,0.000062,0,16,1,0.00058
30103,Treasure County,,MT,-2,-2,-4,0,0,0,0,0,0,0,0,0,0,0,0,40,0.000049,32,64,0,0
30105,Valley County,,MT,561,8521,9082,2,2,4,272,242,514,6,0.27647,0.286035,0,0.00008,0.000085,17,0.000111,0,16,1,0.000952
30107,Wheatland County,,MT,149,2398,2547,0,1,1,0,137,137,6,0.276485,0.285941,0,0,0.000085,17,0.000049,0,65,0,0
30109,Wibaux County,,MT,59,1066,1125,0,0,0,0,0,0,0,0,0,0,0,0,41,0.000049,33,66,0,0
30111,Yellowstone County,,MT,8888,169915,178803,83,68,151,24209,20649,44858,5,0.382015,0.409453,89823.891957,0.014344,0.013488,17,0.001518,0,16,0.280674,0.134692
31001,Adams County,,NE,2159,35496,37655,11,13,24,3549,4143,7692,6,0.314996,0.327105,15820.107761,0.000503,0.000562,18,0.000283,0,16,0.384615,0.004791
31003,Antelope County,,NE,412,8138,8550,2,4,6,552,749,1301,6,0.29919,0.309464,4.947838,0.000009,0.000131,18,0.000086,0,16,0.666667,0.000242
31005,Arthur County,,NE,-2,-2,-4,0,0,0,0,0,0,0,0,0,0,0,0,42,0.000049,34,67,0,0
31007,Banner County,,NE,53,720,773,1,1,2,41,115,156,7,0.208222,0.211859,0,0.000016,0,2,0.000069,0,16,1,0.000236
31009,Blaine County,,NE,-2,-2,-4,0,0,0,0,0,0,0,0,0,0,0,0,43,0.000049,35,68,0,0
31011,Boone County,,NE,358,7036,7394,2,4,6,262,458,720,6,0.311914,0.322686,8.949876,0.000008,0.000407,18,0.00009,0,16,0.75,0.00024
31013,Box Butte County,,NE,985,14070,15055,4,5,9,620,803,1423,6,0.302537,0.313833,895.192101,0.000186,0.000256,2,0.00013,0,16,0.466667,0.001561
31015,Boyd County,,NE,127,2471,2598,0,0,0,0,0,0,0,0,0,0,0,0,44,0.000049,36,69,0,0
31017,Brown County,,NE,244,3624,3868,0,1,1,0,43,43,1,1,1,0,0,0,18,0.000049,0,70,0,0
31019,Buffalo County,,NE,3667,50662,54329,20,19,39,7429,7742,15171,5,0.354933,0.373897,19581.250923,0.000657,0.001567,18,0.0005,0,16,0.262846,0.006823
31021,Burt County,,NE,483,8331,8814,4,6,10,865,1048,1913,6,0.314309,0.325206,1.677424,0.000292,0.000528,18,0.000119,0,16,0.866667,0.002723
31023,Butler County,,NE,626,10422,11048,6,6,12,1183,1370,2553,6,0.31185,0.322796,38.980659,0.000462,0.000407,18,0.000182,0,16,0.633333,0.004063
31025,Cass County,,NE,2420,30461,32881,6,7,13,6003,5734,11737,6,0.314309,0.325316,5.341865,0.000596,0.000544,18,0.000143,0,16,0.714286,0.005245
31027,Cedar County,,NE,542,11177,11719,5,7,12,692,982,1674,6,0.312171,0.323402,88.112233,0.000016,0.000403,18,0.000151,0,16,0.571429,0.000485
31029,Chase County,,NE,232,4470,4702,0,0,0,0,0,0,0,0,0,0,0,0,45,0.000049,37,71,0,0
31031,Cherry County,,NE,486,6518,7004,2,1,3,254,52,306,6,0.298954,0.308666,3064.033315,0.000001,0.00012,18,0.000123,0,16,0,0.000137
31033,Cheyenne County,,NE,1012,12001,13013,6,7,13,512,748,1260,6,0.314114,0.325636,6239.794835,0.00043,0.000518,2,0.00019,0,16,0.392857,0.004205
31035,Clay County,,NE,527,7691,8218,1,4,5,487,951,1438,6,0.29919,0.309464,0.366667,0.000003,0.000149,18,0.000068,0,16,0.833333,0.0001
31037,Colfax County,,NE,807,11918,12725,10,7,17,1865,2181,4046,6,0.312075,0.323292,57.014143,0.001095,0.000437,18,0.000217,0,16,0.6,0.009822
31039,Cuming County,,NE,655,11385,12040,6,7,13,774,1171,1945,6,0.311979,0.323126,136.321801,0.000464,0.000408,18,0.000152,0,16,0.619048,0.004027
31041,Custer County,,NE,692,13246,13938,5,7,12,855,1026,1881,6,0.312332,0.323594,3043.867894,0.000196,0.000435,18,0.000139,0,16,0.732143,0.001738
31043,Dakota County,,NE,2280,24670,26950,9,8,17,4333,5740,10073,6,0.326788,0.34135,928.936101,0.000965,0.00088,18,0.000186,0,16,0.388889,0.008426
31045,Dawes County,,NE,890,8658,9548,4,7,11,544,802,1346,6,0.314669,0.326202,3686.829394,0.000107,0.000488,2,0.000139,0,16,0.452381,0.001214
31047,Dawson County,,NE,2131,28707,30838,16,16,32,3002,3764,6766,6,0.33326,0.349714,11731.746804,0.002711,0.001482,18,0.000324,0,16,0.338095,0.024887
31049,Deuel County,,NE,197,2184,2381,1,1,2,94,69,163,7,0.23905,0.243951,0,0.000003,0.000003,2,0.000072,0,16,0,0.000091
31051,Dixon County,,NE,428,7389,7817,3,4,7,673,766,1439,6,0.278631,0.287686,44.502035,0.000048,0.000041,18,0.0001,0,16,0.333333,0.000574
31053,Dodge County,,NE,2569,43261,45830,13,11,24,5487,6109,11596,6,0.314734,0.326472,96.555446,0.00066,0.000579,18,0.000269,0,16,0.445055,0.006333
31055,Douglas County,,NE,32923,594245,627168,186,178,364,106353,104318,210671,5,0.450543,0.484027,194230.442046,0.045405,0.048027,18,0.002299,0,16,0.335512,0.404176
31057,Dundy County,,NE,106,2167,2273,0,0,0,0,0,0,0,0,0,0,0,0,46,0.000049,38,72,0,0
31059,Fillmore County,,NE,425,7313,7738,2,3,5,406,562,968,6,0.298954,0.308914,0.5,0.000169,0.000124,18,0.000089,0,16,0.666667,0.00128
31061,Franklin County,,NE,251,3761,4012,2,2,4,236,173,409,6,0.262002,0.269297,0,0.00001,0.000004,18,0.000094,0,16,1,0.000188
31063,Frontier County,,NE,273,2958,3231,2,2,4,166,215,381,6,0.254988,0.262226,0,0.000017,0.00002,18,0.000084,0,16,1,0.00033
31065,Furnas County,,NE,405,5664,6069,2,4,6,282,452,734,6,0.262115,0.269792,3042.952381,0.000012,0.000006,18,0.000098,0,16,0.5,0.000196
31067,Gage County,,NE,1659,26748,28407,7,8,15,2571,3201,5772,6,0.314734,0.3259,2562.304705,0.000457,0.000526,18,0.000215,0,16,0.347222,0.004025
31069,Garden County,,NE,192,2238,2430,0,0,0,0,0,0,0,0,0,0,0,0,47,0.000049,39,73,0,0
31071,Garfield County,,NE,123,2103,2226,2,0,2,131,0,131,0,0,0,0,0.000003,0,18,0.000124,0,6,0,0.000163
31073,Gosper County,,NE,245,2380,2625,2,2,4,295,305,600,7,0.250021,0.2567,0,0.000011,0.000017,18,0.000097,0,16,1,0.000294
31075,Grant County,,NE,-2,-2,-4,0,0,0,0,0,0,0,0,0,0,0,0,48,0.000049,40,74,0,0
31077,Greeley County,,NE,262,2903,3165,0,2,2,0,112,112,6,0.268903,0.276579,0,0,0.000024,18,0.000049,0,75,1,0
31079,Hall County,,NE,4229,66566,70795,27,21,48,9487,9260,18747,5,0.367642,0.38795,15325.724672,0.003987,0.003106,18,0.000527,0,16,0.28202,0.036972
31081,Hamilton County,,NE,770,11595,12365,7,5,12,1560,1559,3119,6,0.311818,0.322631,21.832746,0.000483,0.000415,18,0.000181,0,16,0.595238,0.00426
31083,Harlan County,,NE,254,3797,4051,1,2,3,44,138,182,6,0.262047,0.269407,0,0,0.000005,18,0.00007,0,16,0.833333,0.000065
31085,Hayes County,,NE,52,1159,1211,0,0,0,0,0,0,0,0,0,0,0,0,49,0.000049,41,76,0,0
31087,Hitchcock County,,NE,291,3412,3703,1,1,2,278,291,569,7,0.237867,0.24263,0,0.000002,0.000001,18,0.000076,0,16,0,0.000076
31089,Holt County,,NE,634,12460,13094,4,5,9,591,990,1581,6,0.311946,0.322851,3622.814591,0.000458,0.000396,18,0.000111,0,16,0.45,0.003833
31091,Hooker County,,NE,-2,-2,-4,0,0,0,0,0,0,0,0,0,0,0,0,50,0.000049,42,77,0,0
31093,Howard County,,NE,545,7616,8161,2,4,6,880,932,1812,6,0.29916,0.309382,101.199215,0.000018,0.000148,18,0.000091,0,16,0.55,0.000356
31095,Jefferson County,,NE,584,9004,9588,4,4,8,910,994,1904,6,0.299042,0.309189,2.833333,0.000173,0.000126,18,0.000166,0,16,0.666667,0.001439
31097,Johnson County,,NE,453,5328,5781,3,2,5,547,518,1065,6,0.298954,0.308804,0.375,0.000173,0.000123,18,0.000107,0,16,0.833333,0.001376
31099,Kearney County,,NE,757,7521,8278,4,6,10,1209,1291,2500,6,0.299367,0.309987,218.444457,0.000015,0.000151,18,0.000161,0,16,0.6,0.000364
31101,Keith County,,NE,760,9482,10242,3,4,7,581,734,1315,6,0.29922,0.309492,6070,0.000175,0.000128,18,0.00015,0,16,0.5,0.001366
31103,Keya Paha County,,NE,74,1053,1127,0,1,1,0,41,41,1,1,1,0,0,0,18,0.000049,0,78,0,0
31105,Kimball County,,NE,327,4159,4486,2,3,5,295,346,641,6,0.279196,0.288995,2.42531,0.000108,0.00012,2,0.000082,0,16,0.833333,0.001066
31107,Knox County,,NE,476,10379,10855,4,5,9,387,559,946,6,0.312075,0.323016,1.48228,0.000015,0.000399,18,0.000132,0,16,0.766667,0.000404
31109,Lancaster County,,NE,17178,320504,337682,115,117,232,42192,43338,85530,5,0.426259,0.456949,165022.594929,0.020339,0.028288,18,0.001989,0,16,0.269315,0.185649
31111,Lincoln County,,NE,2426,43247,45673,13,15,28,2895,3701,6596,5,0.333774,0.349169,5430.64064,0.000755,0.00136,18,0.000307,0,16,0.379167,0.007315
31113,Logan County,,NE,-2,-2,-4,1,0,1,146,0,146,0,0,0,0,0.000008,0,18,0.000066,0,8,0,0.000115
31115,Loup County,,NE,-2,-2,-4,0,0,0,0,0,0,0,0,0,0,0,0,51,0.000049,43,79,0,0
31117,McPherson County,,NE,-2,-2,-4,0,0,0,0,0,0,0,0,0,0,0,0,52,0.000049,44,80,0,0
31119,Madison County,,NE,2663,41534,44197,19,19,38,5776,6658,12434,5,0.341411,0.357846,10584.135175,0.001391,0.001215,18,0.000404,0,16,0.27381,0.013525
31121,Merrick County,,NE,572,9063,9635,5,6,11,1194,1238,2432,6,0.311914,0.322906,11.545069,0.000195,0.000426,18,0.000158,0,16,0.595238,0.001814
31123,Morrill County,,NE,514,5577,6091,2,1,3,644,707,1351,6,0.262934,0.270166,3028,0.000016,0.000017,2,0.000127,0,16,0.5,0.0003
31125,Nance County,,NE,254,4228,4482,1,1,2,246,224,470,6,0.254175,0.260322,0,0.000007,0.000011,18,0.000072,0,16,0,0.000174
31127,Nemaha County,,NE,735,7856,8591,4,4,8,717,847,1564,6,0.311786,0.322466,16.104343,0.000455,0.000392,18,0.000114,0,16,0.75,0.003783
31129,Nuckolls County,,NE,313,5598,5911,2,2,4,201,197,398,6,0.299072,0.309024,594.284041,0.000003,0.000123,18,0.000096,0,16,0.666667,0.000163
31131,Otoe County,,NE,1392,18723,20115,7,8,15,2787,2912,5699,6,0.314407,0.325592,58.772051,0.00059,0.00053,18,0.000193,0,16,0.464286,0.005175
31133,Pawnee County,,NE,172,3129,3301,2,2,4,166,155,321,6,0.298983,0.308859,0.555556,0.000005,0.000123,18,0.00009,0,16,0.666667,0.000164
31135,Perkins County,,NE,271,3448,3719,1,1,2,124,162,286,7,0.230325,0.234933,0,0.000001,0.000001,18,0.000081,0,16,0,0.000073
31137,Phelps County,,NE,755,11109,11864,7,6,13,927,1084,2011,6,0.312171,0.323209,1905.567196,0.000186,0.000407,18,0.000218,0,16,0.375,0.001785
31139,Pierce County,,NE,625,8781,9406,4,4,8,865,1009,1874,6,0.31185,0.322576,146.006534,0.000179,0.000396,18,0.000119,0,16,0.8,0.001501
31141,Platte County,,NE,2251,39905,42156,17,15,32,5367,5266,10633,5,0.340758,0.356581,10155.808233,0.001879,0.001175,18,0.000407,0,16,0.393382,0.017284
31143,Polk County,,NE,407,6618,7025,5,4,9,692,778,1470,6,0.299042,0.309189,2.2,0.000181,0.000136,18,0.00016,0,16,0.6,0.001622
31145,Red Willow County,,NE,870,12840,13710,5,6,11,907,1181,2088,6,0.312075,0.323154,7330.148502,0.000184,0.000396,18,0.000189,0,16,0.466667,0.001552
31147,Richardson County,,NE,524,9982,10506,3,5,8,514,693,1207,6,0.311946,0.322851,677.01587,0.000171,0.000393,18,0.000108,0,16,0.35,0.001364
31149,Rock County,,NE,79,1523,1602,3,0,3,354,0,354,0,0,0,0,0.000002,0,18,0.000151,0,5,0,0.00021
31151,Saline County,,NE,1169,16004,17173,5,5,10,1970,2235,4205,6,0.311818,0.322631,39.232567,0.000456,0.000392,18,0.000157,0,16,0.65,0.003852
31153,Sarpy County,,NE,19027,184691,203718,83,71,154,57908,52410,110318,5,0.409989,0.437031,22874.739132,0.022211,0.021814,18,0.000965,0,16,0.47326,0.199156
31155,Saunders County,,NE,1650,24537,26187,5,5,10,4388,3935,8323,6,0.314244,0.324986,0.504054,0.000585,0.000526,18,0.000124,0,16,0.9,0.005043
31157,Scotts Bluff County,,NE,2321,41611,43932,20,21,41,3918,3998,7916,5,0.356689,0.375988,20575.024665,0.002862,0.002728,2,0.000483,0,16,0.339921,0.028275
31159,Seward County,,NE,1426,19036,20462,4,5,9,2317,2722,5039,6,0.311754,0.322521,1.833333,0.000174,0.000396,18,0.000142,0,16,0.7,0.001458
31161,Sheridan County,,NE,460,6251,6711,2,3,5,352,392,744,7,0.239598,0.24493,2.961538,0.000003,0.000002,2,0.000107,0,16,0.333333,0.000141
31163,Sherman County,,NE,235,3590,3825,2,2,4,317,349,666,6,0.269436,0.277363,0,0.000028,0.000027,18,0.000093,0,16,1,0.000414
31165,Sioux County,,NE,106,1287,1393,2,1,3,87,81,168,6,0.262934,0.270166,0,0.000019,0.000017,2,0.000086,0,16,1,0.000308
31167,Stanton County,,NE,441,7267,7708,1,2,3,962,805,1767,6,0.299072,0.309024,0,0.000007,0.000128,18,0.000067,0,16,1,0.000155
31169,Thayer County,,NE,430,6329,6759,3,2,5,351,284,635,6,0.298924,0.308749,0.5,0.000168,0.000121,18,0.000124,0,16,0.666667,0.001333
31171,Thomas County,,NE,72,757,829,0,1,1,0,105,105,7,0.230208,0.23469,0,0,0,18,0.000049,0,81,0,0
31173,Thurston County,,NE,481,7403,7884,3,4,7,668,828,1496,6,0.300228,0.310746,3.911255,0.000048,0.000161,18,0.0001,0,16,0.666667,0.000575
31175,Valley County,,NE,312,4929,5241,1,1,2,59,40,99,1,1,1,1,0.000003,0,18,0.000066,0,7,0,0.000077
31177,Washington County,,NE,1660,23739,25399,7,7,14,4008,3891,7899,6,0.314342,0.325371,14.245515,0.000599,0.000542,18,0.000161,0,16,0.738095,0.005336
31179,Wayne County,,NE,820,9399,10219,5,6,11,909,1250,2159,6,0.311946,0.322961,621.888078,0.000459,0.000397,18,0.000132,0,16,0.566667,0.003906
31181,Webster County,,NE,282,4277,4559,1,2,3,292,361,653,7,0.239579,0.244754,0,0.000003,0.000003,18,0.000068,0,16,1,0.0001
31183,Wheeler County,,NE,-2,-2,-4,0,0,0,0,0,0,0,0,0,0,0,0,53,0.000049,45,82,0,0
31185,York County,,NE,1289,16008,17297,7,7,14,1866,2034,3900,6,0.311882,0.322961,71.499416,0.000474,0.000417,18,0.00021,0,16,0.452381,0.004221
32001,Churchill County,,NV,2813,27346,30159,14,12,26,4149,4787,8936,5,0.35606,0.374326,382.275708,0.003686,0.003378,4,0.000178,0,16,0.664835,0.032741
32003,Clark County,,NV,117346,2157497,2274843,559,565,1124,401929,396987,798916,5,0.51131,0.570194,253662.113172,0.108498,0.10491,4,0.004595,0,16,0.146822,0.922639
32005,Douglas County,,NV,4936,54640,59576,30,20,50,13241,11973,25214,5,0.3577,0.377209,6087.722785,0.009845,0.007195,4,0.000297,0,16,0.831183,0.086057
32007,Elko County,,NV,4099,54690,58789,28,25,53,8515,7417,15932,5,0.357236,0.377319,7096.393052,0.006773,0.004568,4,0.000359,0,16,0.517204,0.060211
32009,Esmeralda County,,NV,115,798,913,1,1,2,79,54,133,6,0.262911,0.269985,0,0.000618,0.000038,4,0.000056,0,16,1,0.005538
32011,Eureka County,,NV,203,1696,1899,1,1,2,125,185,310,6,0.263231,0.270705,0,0.000027,0.00004,4,0.000061,0,16,0,0.000418
32013,Humboldt County,,NV,1533,19130,20663,7,6,13,2235,1941,4176,6,0.339004,0.354473,166.473697,0.000972,0.000983,4,0.000149,0,16,0.642857,0.009266
32015,Lander County,,NV,647,6304,6951,3,3,6,541,671,1212,6,0.295714,0.307461,0,0.000289,0.000297,4,0.00009,0,16,1,0.002814
32017,Lincoln County,,NV,362,4659,5021,2,1,3,691,337,1028,6,0.33836,0.352988,0,0.000687,0.000639,4,0.000064,0,16,1,0.006209
32019,Lyon County,,NV,6440,56510,62950,30,25,55,16968,16211,33179,5,0.358377,0.378612,1648.446453,0.008323,0.006901,4,0.000331,0,16,0.622984,0.073214
32021,Mineral County,,NV,382,5032,5414,3,3,6,411,541,952,6,0.295685,0.307406,0,0.000317,0.000323,4,0.00008,0,16,1,0.003019
32023,Nye County,,NV,4382,45270,49652,18,13,31,9652,8662,18314,5,0.356605,0.375091,3076.230335,0.006444,0.004581,4,0.000224,0,16,0.678947,0.056706
32027,Pershing County,,NV,475,5137,5612,2,3,5,440,694,1134,6,0.295656,0.307351,0,0.000262,0.000307,4,0.000077,0,16,1,0.002396
32029,Storey County,,NV,438,4109,4547,3,3,6,1015,1057,2072,6,0.295656,0.307351,0,0.000336,0.000346,4,0.000077,0,16,1,0.003216
32031,Washoe County,,NV,28187,470596,498783,161,161,322,78895,78975,157870,5,0.419587,0.456405,36289.649861,0.042731,0.043447,4,0.001381,0,16,0.41904,0.383002
32033,White Pine County,,NV,773,9870,10643,3,5,8,999,1035,2034,6,0.339993,0.355574,0,0.000901,0.001415,4,0.000076,0,16,0.95,0.008233
32510,Carson City,,NV,6012,61289,67301,22,21,43,15094,15754,30848,5,0.357067,0.376576,590.030516,0.007696,0.006656,4,0.000228,0,16,0.788043,0.067636
33001,Belknap County,,NH,4999,74048,79047,17,20,37,13932,13139,27071,5,0.357404,0.376741,52.229861,0.004164,0.005077,54,0.000147,0,16,0.844156,0.032824
33003,Carroll County,,NH,3335,57170,60505,19,20,39,8594,7953,16547,5,0.338511,0.35597,16.823883,0.003886,0.004532,54,0.000159,0,16,0.84632,0.029808
33005,Cheshire County,,NH,4972,89464,94436,24,26,50,9590,10892,20482,5,0.359056,0.379465,72.17958,0.005274,0.006713,54,0.000189,0,16,0.805556,0.040128
33007,Coos County,,NH,2208,39128,41336,10,13,23,2868,4088,6956,6,0.312075,0.327039,242.305092,0.001263,0.001466,54,0.000124,0,16,0.692308,0.00992
33009,Grafton County,,NH,7654,97238,104892,42,44,86,18615,19165,37780,5,0.372067,0.39556,7203.801545,0.010964,0.013143,54,0.000338,0,16,0.637373,0.090462
33011,Hillsborough County,,NH,25645,486924,512569,115,137,252,77304,83336,160640,5,0.41127,0.446049,4923.253947,0.040577,0.047315,54,0.000789,0,16,0.595751,0.345371
33013,Merrimack County,,NH,11297,171900,183197,39,47,86,31739,32047,63786,5,0.382933,0.407912,1649.307503,0.012205,0.016679,54,0.000299,0,16,0.720211,0.102503
33015,Rockingham County,,NH,21645,367127,388772,75,91,166,71033,70130,141163,5,0.392154,0.422521,1749.788836,0.026612,0.033695,54,0.000513,0,16,0.689239,0.223812
33017,Strafford County,,NH,9274,138675,147949,32,35,67,26088,25287,51375,5,0.373397,0.39622,401.040723,0.008913,0.011633,54,0.000242,0,16,0.770122,0.073138
33019,Sullivan County,,NH,3038,50895,53933,12,11,23,6955,6678,13633,6,0.312913,0.327347,17.411666,0.001973,0.001482,54,0.000129,0,16,0.78022,0.015508
34001,Atlantic County,,NJ,13685,341291,354976,61,94,155,36247,41816,78063,5,0.395018,0.42596,530.728011,0.02261,0.034539,69,0.000378,0,16,0.779934,0.179462
34003,Bergen County,,NJ,50344,1057215,1107559,143,189,332,186453,187683,374136,5,0.427282,0.466507,2019.332739,0.052334,0.063887,69,0.000901,0,16,0.575196,0.43168
34005,Burlington County,,NJ,27850,545627,573477,129,148,277,85755,87298,173053,5,0.408937,0.44573,1582.961395,0.046611,0.053245,69,0.000827,0,16,0.633387,0.38568
34007,Camden County,,NJ,29040,611356,640396,100,124,224,90437,101591,192028,5,0.403168,0.437405,730.543347,0.038316,0.046823,69,0.000628,0,16,0.749092,0.31437
34009,Cape May County,,NJ,5930,116327,122257,36,35,71,15658,15102,30760,5,0.366618,0.38839,95.5035,0.013113,0.013099,69,0.000232,0,16,0.912892,0.101388
34011,Cumberland County,,NJ,6860,177316,184176,28,32,60,16944,18347,35291,5,0.359653,0.380747,61.350505,0.010426,0.011584,69,0.000194,0,16,0.931373,0.082065
34013,Essex County,,NJ,49292,851007,900299,137,174,311,153789,183142,336931,5,0.423992,0.461913,1850.388909,0.050078,0.058992,69,0.000874,0,16,0.611915,0.414976
34015,Gloucester County,,NJ,15343,349414,364757,41,63,104,50793,49084,99877,5,0.388333,0.415451,255.367962,0.015513,0.024328,69,0.000271,0,16,0.854071,0.12395
34017,Hudson County,,NJ,58180,686632,744812,174,175,349,197767,217133,414900,5,0.429037,0.466535,2176.521487,0.060313,0.061432,69,0.001093,0,16,0.580311,0.49508
34019,Hunterdon County,,NJ,7315,154030,161345,30,44,74,21667,19686,41353,5,0.378436,0.403125,13.065296,0.010233,0.016356,69,0.000188,0,16,0.894949,0.076166
34021,Mercer County,,NJ,22345,410237,432582,96,114,210,66394,72807,139201,5,0.407288,0.440074,381.736136,0.037437,0.042448,69,0.000609,0,16,0.759044,0.308077
34023,Middlesex County,,NJ,58995,961050,1020045,171,203,374,191648,214589,406237,5,0.441352,0.479801,3881.497005,0.060376,0.067162,69,0.001095,0,16,0.536571,0.497592
34025,Monmouth County,,NJ,30152,746466,776618,105,149,254,101712,107032,208744,5,0.407288,0.444256,532.3873,0.039901,0.052853,69,0.000662,0,16,0.670138,0.330511
34027,Morris County,,NJ,30978,591310,622288,112,164,276,99229,104446,203675,5,0.420811,0.458149,900.20927,0.04278,0.057035,69,0.000701,0,16,0.641183,0.350868
34029,Ocean County,,NJ,23806,682846,706652,98,127,225,87975,78597,166572,5,0.401192,0.435644,501.44004,0.034617,0.043951,69,0.000609,0,16,0.672689,0.28323
34031,Passaic County,,NJ,30217,597635,627852,83,119,202,90573,107570,198143,5,0.400767,0.434571,388.083148,0.0318,0.042968,69,0.0005,0,16,0.750566,0.255618
34033,Salem County,,NJ,3814,80939,84753,10,12,22,10811,10639,21450,6,0.314081,0.328574,0.095529,0.002454,0.00265,69,0.000096,0,16,0.962121,0.017567
34035,Somerset County,,NJ,23729,383423,407152,80,110,190,85385,83004,168389,5,0.403114,0.435534,375.821041,0.031282,0.041999,69,0.000497,0,16,0.769565,0.254328
34037,Sussex County,,NJ,8694,183388,192082,29,50,79,22752,23829,46581,5,0.371201,0.395868,39.836732,0.009634,0.017044,69,0.00018,0,16,0.846154,0.070889
34039,Union County,,NJ,35830,624006,659836,93,128,221,124415,128091,252506,5,0.405272,0.439661,412.059002,0.036084,0.047213,69,0.000581,0,16,0.733059,0.296298
34041,Warren County,,NJ,7129,132490,139619,24,36,60,20706,19952,40658,5,0.366796,0.389237,11.041023,0.007371,0.012474,69,0.000154,0,16,0.939683,0.052508
35001,Bernalillo County,,NM,41060,708661,749721,227,220,447,127731,127816,255547,5,0.453783,0.491658,59120.115949,0.062286,0.062203,2,0.002018,0,16,0.382885,0.546546
35003,Catron County,,NM,250,3178,3428,0,0,0,0,0,0,0,0,0,0,0,0,55,0.000049,46,83,0,0
35005,Chaves County,,NM,3819,66371,70190,25,23,48,7750,7656,15406,5,0.366663,0.388071,159.079793,0.006587,0.006628,91,0.000285,0,16,0.739316,0.061008
35006,Cibola County,,NM,1787,24258,26045,7,7,14,3607,4193,7800,5,0.350173,0.367085,0,0.001373,0.001372,2,0.000112,0,16,1,0.012597
35007,Colfax County,,NM,1171,14232,15403,4,8,12,623,1265,1888,6,0.31301,0.325228,3047.274919,0.000473,0.000802,2,0.000091,0,16,0.428571,0.004328
35009,Curry County,,NM,5855,48011,53866,37,38,75,10816,11197,22013,5,0.377163,0.401376,9880.83603,0.008641,0.009964,91,0.00046,0,16,0.500886,0.080264
35011,De Baca County,,NM,163,2221,2384,1,1,2,130,80,210,6,0.273895,0.282574,0,0.000059,0.000051,91,0.000059,0,16,0,0.000535
35013,Dona Ana County,,NM,12571,212030,224601,69,61,130,38205,35772,73977,5,0.386697,0.41347,6735.072941,0.019242,0.019554,91,0.000745,0,16,0.518512,0.179096
35015,Eddy County,,NM,3116,57743,60859,20,19,39,6722,6250,12972,5,0.362537,0.383119,117.193166,0.004584,0.004568,91,0.00025,0,16,0.742424,0.043428
35017,Grant County,,NM,2122,32985,35107,11,9,20,2537,3306,5843,5,0.351229,0.36857,376.374932,0.002923,0.002326,91,0.000176,0,16,0.659091,0.027413
35019,Guadalupe County,,NM,349,4660,5009,1,2,3,246,377,623,6,0.312204,0.323303,0,0.000366,0.000374,2,0.000057,0,16,1,0.00321
35021,Harding County,,NM,38,733,771,0,0,0,0,0,0,0,0,0,0,0,0,56,0.000049,47,84,0,0
35023,Hidalgo County,,NM,456,5299,5755,3,2,5,332,415,747,6,0.278939,0.28834,0,0.000512,0.000131,91,0.000084,0,16,1,0.00483
35025,Lea County,,NM,4260,67305,71565,32,26,58,8673,8512,17185,5,0.365468,0.387438,2880.408787,0.008282,0.005181,91,0.000379,0,16,0.539683,0.078313
35027,Lincoln County,,NM,1651,20957,22608,8,9,17,2455,2722,5177,5,0.352373,0.370084,0,0.001692,0.001859,91,0.000124,0,16,0.986111,0.015808
35028,Los Alamos County,,NM,1773,22391,24164,6,6,12,1908,2135,4043,5,0.350052,0.36681,25.286774,0.001869,0.001398,2,0.000108,0,16,0.928571,0.01717
35029,Luna County,,NM,2061,27935,29996,9,7,16,2890,3126,6016,5,0.35127,0.368405,1.1775,0.003338,0.002122,91,0.000127,0,16,0.888889,0.03025
35031,McKinley County,,NM,8140,88542,96682,15,17,32,23408,25060,48468,5,0.357488,0.376521,19.895591,0.003782,0.004564,2,0.00018,0,16,0.794118,0.034218
35033,Mora County,,NM,331,5109,5440,2,2,4,357,619,976,6,0.312204,0.323303,0,0.000374,0.000374,2,0.000078,0,16,1,0.003341
35035,Otero County,,NM,6634,63318,69952,28,35,63,11817,10576,22393,5,0.37632,0.400094,205.037349,0.00922,0.011288,91,0.000282,0,16,0.639744,0.084546
35037,Quay County,,NM,754,9046,9800,2,5,7,641,777,1418,6,0.313431,0.325531,0,0.000425,0.000568,91,0.000067,0,16,0.8,0.003745
35039,Rio Arriba County,,NM,2194,42804,44998,9,7,16,5213,6690,11903,6,0.312494,0.324348,2.455149,0.001466,0.000784,2,0.000149,0,16,0.791667,0.01367
35041,Roosevelt County,,NM,1942,18478,20420,11,9,20,3652,3415,7067,6,0.314734,0.328145,35.978513,0.001797,0.000934,91,0.000165,0,16,0.593407,0.01679
35043,Sandoval County,,NM,12035,138832,150867,53,49,102,41265,33678,74943,5,0.375294,0.400506,2144.42918,0.016317,0.01706,2,0.000541,0,16,0.596727,0.151223
35045,San Juan County,,NM,10212,148657,158869,41,48,89,29547,30780,60327,5,0.372846,0.398058,1307.756673,0.009205,0.01198,2,0.000444,0,16,0.518868,0.085664
35047,San Miguel County,,NM,1743,27896,29639,7,6,13,2945,3697,6642,5,0.350012,0.366755,160.277986,0.001258,0.001286,2,0.000151,0,16,0.597222,0.011523
35049,Santa Fe County,,NM,9111,152265,161376,61,52,113,25280,24496,49776,5,0.383466,0.408985,2283.990553,0.021232,0.019569,2,0.000564,0,16,0.684149,0.19362
35051,Sierra County,,NM,763,11427,12190,4,2,6,1001,996,1997,6,0.312236,0.323358,0,0.001529,0.00048,91,0.000083,0,16,1,0.013994
35053,Socorro County,,NM,1324,18066,19390,4,5,9,1718,2346,4064,6,0.312397,0.323963,0,0.001175,0.000662,2,0.000086,0,16,1,0.010832
35055,Taos County,,NM,2062,34409,36471,10,11,21,2628,3193,5821,5,0.355934,0.374045,290.160425,0.002918,0.003097,2,0.000145,0,16,0.718182,0.027387
35057,Torrance County,,NM,1187,15064,16251,4,4,8,2776,2819,5595,6,0.3123,0.323688,0,0.000611,0.00062,2,0.000087,0,16,1,0.005655
35059,Union County,,NM,331,4258,4589,1,1,2,46,158,204,7,0.215956,0.220687,1.932556,0.000005,0.000001,91,0.000059,0,16,0,0.000089
35061,Valencia County,,NM,5050,77843,82893,19,17,36,13871,12889,26760,5,0.358929,0.378227,345.407893,0.005356,0.004912,2,0.000223,0,16,0.673684,0.048326
36001,Albany County,,NY,21651,343520,365171,99,130,229,65548,72223,137771,5,0.406741,0.441284,12847.731058,0.031048,0.042779,57,0.000678,0,16,0.562078,0.256102
36003,Allegany County,,NY,2666,50394,53060,11,10,21,4864,5135,9999,6,0.30817,0.321762,44.075578,0.00099,0.000838,57,0.000152,0,16,0.590909,0.007551
36005,Bronx County,,NY,99741,1398879,1498620,177,226,403,297947,353161,651108,5,0.438604,0.480555,5754.989202,0.060614,0.069077,69,0.001133,0,16,0.481882,0.501145
36007,Broome County,,NY,9519,227539,237058,52,79,131,19076,24135,43211,5,0.392307,0.421366,4107.841629,0.014945,0.027474,57,0.000383,0,16,0.627241,0.120948
36009,Cattaraugus County,,NY,4420,90550,94970,11,12,23,9124,9986,19110,5,0.339498,0.355755,469.971567,0.001793,0.002085,57,0.000149,0,16,0.615385,0.014598
36011,Cayuga County,,NY,4007,89828,93835,12,14,26,9946,9193,19139,5,0.322131,0.338115,12.154072,0.001637,0.002101,57,0.000133,0,16,0.736264,0.011573
36013,Chautauqua County,,NY,5084,150389,155473,17,20,37,7553,9260,16813,5,0.36472,0.385221,742.807329,0.006052,0.007119,57,0.000184,0,16,0.720779,0.051654
36015,Chemung County,,NY,4044,101035,105079,16,19,35,8881,8606,17487,5,0.362364,0.382359,733.970265,0.00356,0.004745,57,0.000172,0,16,0.577899,0.027297
36017,Chenango County,,NY,2936,58939,61875,10,12,22,6577,7026,13603,6,0.309619,0.325641,19.550924,0.00162,0.001659,57,0.000116,0,16,0.653846,0.011804
36019,Clinton County,,NY,3381,92338,95719,20,23,43,5229,5783,11012,5,0.341219,0.359783,905.188178,0.003525,0.004722,57,0.000207,0,16,0.553333,0.025869
36021,Columbia County,,NY,3408,71138,74546,16,15,31,8358,7691,16049,6,0.324513,0.341009,1.596828,0.004541,0.003635,69,0.000126,0,16,0.898693,0.032795
36023,Cortland County,,NY,2803,51954,54757,13,10,23,6148,5915,12063,6,0.308609,0.322532,18.210049,0.001644,0.001293,57,0.000138,0,16,0.653846,0.011647
36025,Delaware County,,NY,2915,49915,52830,16,16,32,7486,6084,13570,5,0.324513,0.340866,26.65616,0.004006,0.00331,57,0.000138,0,16,0.772059,0.02946
36027,Dutchess County,,NY,14542,335791,350333,62,95,157,42980,43180,86160,5,0.394401,0.425382,767.111083,0.022384,0.03392,69,0.000401,0,16,0.684386,0.18166
36029,Erie County,,NY,29952,1074176,1104128,182,211,393,80098,92340,172438,5,0.438414,0.478326,29943.840791,0.059699,0.067591,57,0.001257,0,16,0.484639,0.499071
36031,Essex County,,NY,2163,42998,45161,10,10,20,4637,4559,9196,6,0.305404,0.319687,21.472839,0.001101,0.000913,57,0.000129,0,16,0.644444,0.007956
36033,Franklin County,,NY,2161,52529,54690,7,8,15,3819,4460,8279,6,0.308358,0.322851,1.445213,0.00123,0.001189,57,0.000094,0,16,0.902778,0.008501
36035,Fulton County,,NY,2983,64652,67635,10,10,20,7542,7158,14700,6,0.290468,0.303384,298.672289,0.000837,0.000637,57,0.000142,0,16,0.672727,0.005722
36037,Genesee County,,NY,3283,71663,74946,7,9,16,7874,8200,16074,5,0.336481,0.351761,39.454971,0.000934,0.00145,57,0.000106,0,16,0.736111,0.006924
36039,Greene County,,NY,2755,53032,55787,18,16,34,7781,6766,14547,5,0.324165,0.340343,14.562236,0.004681,0.003565,69,0.000141,0,16,0.843137,0.033729
36041,Hamilton County,,NY,368,5841,6209,3,2,5,299,180,479,7,0.247954,0.255269,0.2,0.000218,0.000029,57,0.000077,0,16,0.833333,0.001679
36043,Herkimer County,,NY,3176,73468,76644,10,11,21,7892,7664,15556,6,0.30525,0.319522,20.164369,0.001191,0.001126,57,0.000118,0,16,0.628205,0.008621
36045,Jefferson County,,NY,15348,124197,139545,107,111,218,32433,37251,69684,5,0.411493,0.443568,6925.542182,0.034735,0.037196,57,0.000796,0,16,0.544839,0.296799
36047,Kings County,,NY,145306,2541329,2686635,338,343,681,508777,575943,1084720,5,0.469249,0.517123,42919.469759,0.090322,0.088304,69,0.002307,0,16,0.296956,0.751292
36049,Lewis County,,NY,1353,29014,30367,6,4,10,5116,3170,8286,6,0.302779,0.315379,0.978294,0.000734,0.000592,57,0.000086,0,16,0.866667,0.005387
36051,Livingston County,,NY,3854,71278,75132,9,12,21,9036,9894,18930,6,0.320665,0.336029,20.844133,0.000889,0.001657,57,0.00013,0,16,0.643939,0.006816
36053,Madison County,,NY,4546,77616,82162,14,14,28,11894,11509,23403,6,0.320903,0.336635,18.214233,0.002,0.00208,57,0.00014,0,16,0.7125,0.01413
36055,Monroe County,,NY,29396,875466,904862,185,212,397,80157,94172,174329,5,0.436204,0.476769,39175.729197,0.058394,0.067227,57,0.001299,0,16,0.472633,0.490477
36057,Montgomery County,,NY,3317,58805,62122,11,10,21,8322,9214,17536,6,0.290468,0.303384,24.618601,0.001847,0.000661,57,0.000122,0,16,0.742424,0.013832
36059,Nassau County,,NY,58950,1605722,1664672,154,211,365,219143,221381,440524,5,0.429158,0.470744,3239.614574,0.0557,0.067008,69,0.001004,0,16,0.521339,0.467258
36061,New York County,,NY,180177,1578940,1759117,367,338,705,603466,671596,1275062,5,0.46751,0.515335,51792.366111,0.093882,0.088583,69,0.002557,0,16,0.286154,0.78136
36063,Niagara County,,NY,9654,258721,268375,29,37,66,24908,24781,49689,5,0.372204,0.39529,1865.153657,0.010436,0.014399,57,0.000257,0,16,0.671096,0.088048
36065,Oneida County,,NY,9255,265871,275126,53,66,119,20296,24395,44691,5,0.381438,0.409282,4142.257597,0.016573,0.020632,57,0.000395,0,16,0.596842,0.135364
36067,Onondaga County,,NY,21231,539316,560547,137,168,305,55336,63124,118460,5,0.423992,0.461346,17613.056088,0.045951,0.055622,57,0.000937,0,16,0.54323,0.382707
36069,Ontario County,,NY,6542,126607,133149,22,23,45,19153,16970,36123,5,0.36516,0.386046,1067.137301,0.00458,0.00609,57,0.000212,0,16,0.496032,0.037684
36071,Orange County,,NY,21327,433403,454730,97,145,242,61944,66663,128607,5,0.406141,0.442286,2067.008752,0.035761,0.048042,69,0.000626,0,16,0.588995,0.296404
36073,Orleans County,,NY,2454,48194,50648,5,6,11,5728,6048,11776,6,0.307731,0.320606,0.142857,0.000897,0.000773,57,0.000084,0,16,0.966667,0.006535
36075,Oswego County,,NY,6779,138509,145288,16,23,39,14500,15871,30371,5,0.358929,0.378997,304.28556,0.00361,0.00517,57,0.000149,0,16,0.594203,0.028022
36077,Otsego County,,NY,3728,67077,70805,23,23,46,8039,8358,16397,5,0.326155,0.344151,162.204539,0.005301,0.004785,57,0.000184,0,16,0.651478,0.038489
36079,Putnam County,,NY,6109,116176,122285,15,24,39,18905,17712,36617,5,0.356185,0.375944,0.130304,0.005966,0.008512,69,0.000119,0,16,0.958333,0.045412
36081,Queens County,,NY,132549,2457856,2590405,262,300,562,453100,522599,975699,5,0.455283,0.501937,19944.690796,0.079388,0.083318,69,0.001747,0,16,0.371756,0.662034
36083,Rensselaer County,,NY,11818,183291,195109,39,56,95,32965,35898,68863,5,0.376929,0.40334,2209.327936,0.011093,0.018708,57,0.000293,0,16,0.685564,0.087766
36085,Richmond County,,NY,19504,531156,550660,63,93,156,67034,68196,135230,5,0.394298,0.425025,313.331786,0.024738,0.033531,69,0.00039,0,16,0.783987,0.198784
36087,Rockland County,,NY,13380,351064,364444,47,79,126,37877,42055,79932,5,0.389833,0.418972,160.971637,0.018703,0.028733,69,0.000293,0,16,0.811263,0.147789
36089,St. Lawrence County,,NY,4631,116689,121320,17,22,39,5931,7441,13372,5,0.358377,0.378948,276.849287,0.003176,0.004878,57,0.000169,0,16,0.566667,0.023448
36091,Saratoga County,,NY,15406,263251,278657,86,100,186,52745,47224,99969,5,0.393377,0.424887,11025.310675,0.026789,0.032647,57,0.000607,0,16,0.549199,0.222361
36093,Schenectady County,,NY,9947,181411,191358,42,56,98,29074,29330,58404,5,0.383758,0.409948,2597.3031,0.01348,0.019656,57,0.000309,0,16,0.703569,0.107891
36095,Schoharie County,,NY,1870,35662,37532,11,10,21,4355,3900,8255,6,0.305867,0.320777,16.122856,0.001681,0.000968,57,0.000121,0,16,0.763636,0.012181
36097,Schuyler County,,NY,1322,21569,22891,5,7,12,2848,3189,6037,6,0.304147,0.317156,1.941715,0.000189,0.000501,57,0.000095,0,16,0.738095,0.001533
36099,Seneca County,,NY,2052,39017,41069,9,9,18,4718,4953,9671,6,0.308295,0.321899,41.054943,0.001315,0.001121,57,0.000119,0,16,0.708333,0.009634
36101,Steuben County,,NY,4964,114073,119037,19,25,44,10201,10727,20928,5,0.333958,0.353863,1027.862266,0.002679,0.004167,57,0.000221,0,16,0.403439,0.021603
36103,Suffolk County,,NY,53992,1822708,1876700,208,262,470,176306,196362,372668,5,0.439049,0.484791,14600.810352,0.065278,0.075266,69,0.001408,0,16,0.404805,0.551784
36105,Sullivan County,,NY,4860,83569,88429,19,23,42,12012,11309,23321,5,0.342453,0.360394,17.129484,0.005758,0.006807,69,0.000142,0,16,0.856884,0.042342
36107,Tioga County,,NY,3416,62181,65597,10,10,20,8236,8127,16363,6,0.308704,0.32267,33.356073,0.001087,0.001225,57,0.000135,0,16,0.645455,0.007732
36109,Tompkins County,,NY,7943,92778,100721,53,58,111,15070,19160,34230,5,0.390637,0.417542,5944.843322,0.01747,0.021648,57,0.000411,0,16,0.658592,0.146657
36111,Ulster County,,NY,9902,203563,213465,42,60,102,25891,26252,52143,5,0.374459,0.40071,480.248235,0.013947,0.020485,69,0.000272,0,16,0.731359,0.108177
36113,Warren County,,NY,5211,78951,84162,21,17,38,13238,12892,26130,6,0.329418,0.347018,2990.677618,0.004157,0.003797,57,0.000209,0,16,0.613846,0.02981
36115,Washington County,,NY,4044,69611,73655,12,9,21,12828,11218,24046,6,0.290468,0.303274,13.124794,0.00205,0.000559,57,0.000129,0,16,0.69697,0.015017
36117,Wayne County,,NY,5481,114478,119959,11,13,24,14804,15010,29814,5,0.351555,0.369561,155.596089,0.001845,0.001967,57,0.000132,0,16,0.615385,0.014297
36119,Westchester County,,NY,47922,1052501,1100423,159,205,364,172454,180732,353186,5,0.428976,0.469836,3634.452861,0.055829,0.065289,69,0.001006,0,16,0.527308,0.462551
36121,Wyoming County,,NY,2350,47381,49731,8,9,17,6281,6721,13002,6,0.308013,0.321377,3.498606,0.000919,0.000827,57,0.00012,0,16,0.755556,0.006902
36123,Yates County,,NY,1528,28682,30210,7,7,14,3046,3499,6545,6,0.304178,0.317184,15.173424,0.000506,0.000428,57,0.000109,0,16,0.690476,0.00391
37001,Alamance County,,NC,8010,166322,174332,35,31,66,22797,21059,43856,5,0.367374,0.390008,648.14075,0.007562,0.008785,58,0.000365,0,16,0.594512,0.07134
37003,Alexander County,,NC,2141,41220,43361,7,7,14,5387,5503,10890,6,0.320055,0.334115,0.125,0.000738,0.001047,58,0.000117,0,16,0.946429,0.007364
37005,Alleghany County,,NC,576,11731,12307,5,4,9,768,762,1530,7,0.244531,0.251797,366.897922,0.000249,0.000027,58,0.000126,0,16,0.5,0.002728
37007,Anson County,,NC,1270,26266,27536,5,6,11,2655,3001,5656,6,0.320326,0.334445,1.295333,0.000651,0.001067,58,0.000098,0,16,0.866667,0.006422
37009,Ashe County,,NC,1024,28088,29112,6,7,13,1744,1605,3349,6,0.319414,0.333564,3299.84631,0.001349,0.001191,58,0.000125,0,16,0.607143,0.012866
37011,Avery County,,NC,1011,17228,18239,7,8,15,1686,1716,3402,6,0.322749,0.337774,99.583157,0.000784,0.001423,58,0.000144,0,16,0.571429,0.007852
37013,Beaufort County,,NC,2606,52230,54836,9,10,19,5265,5830,11095,6,0.322887,0.338186,354.048984,0.001533,0.001957,58,0.000163,0,16,0.536364,0.014152
37015,Bertie County,,NC,1129,21769,22898,8,6,14,2062,2655,4717,6,0.318507,0.332244,11.843503,0.000634,0.000687,58,0.00016,0,16,0.517857,0.006358
37017,Bladen County,,NC,1912,32794,34706,11,10,21,4572,4676,9248,5,0.32605,0.341735,1.159865,0.002164,0.002345,58,0.000158,0,16,0.9,0.02138
37019,Brunswick County,,NC,7319,108271,115590,66,33,99,24420,16971,41391,5,0.344087,0.364141,231.262729,0.016396,0.007437,58,0.00054,0,16,0.507024,0.138294
37021,Buncombe County,,NC,15928,255558,271486,149,120,269,47969,42012,89981,5,0.414648,0.447645,41820.657455,0.044181,0.036859,58,0.00137,0,16,0.47072,0.394613
37023,Burke County,,NC,4909,98553,103462,19,21,40,12978,13647,26625,6,0.325209,0.342616,84.013868,0.002338,0.003127,58,0.000245,0,16,0.599567,0.023319
37025,Cabarrus County,,NC,13649,198644,212293,72,53,125,42891,36207,79098,5,0.386401,0.41271,1650.18156,0.02381,0.017277,58,0.000596,0,16,0.643523,0.206512
37027,Caldwell County,,NC,4187,90875,95062,15,16,31,9983,9623,19606,6,0.326577,0.343089,26.861271,0.002277,0.002915,58,0.000197,0,16,0.753676,0.022588
37029,Camden County,,NC,1000,10881,11881,4,5,9,2020,1997,4017,6,0.314342,0.327385,0.25,0.000697,0.000672,98,0.000083,0,16,0.85,0.005791
37031,Carteret County,,NC,4504,70956,75460,25,20,45,11523,8458,19981,5,0.351923,0.371239,123.192416,0.006619,0.005335,4,0.000261,0,16,0.693732,0.061376
37033,Caswell County,,NC,1593,24529,26122,8,9,17,4115,4634,8749,6,0.318909,0.333234,19.7886,0.001049,0.001473,58,0.000129,0,16,0.694444,0.010107
37035,Catawba County,,NC,10353,181628,191981,45,46,91,27021,28231,55252,5,0.374598,0.398311,1056.423648,0.011322,0.012256,58,0.000437,0,16,0.585185,0.103317
37037,Chatham County,,NC,4681,68399,73080,19,14,33,15093,13124,28217,5,0.326542,0.342918,9.264628,0.005218,0.003437,58,0.000206,0,16,0.836257,0.048249
37039,Cherokee County,,NC,1586,27404,28990,12,9,21,1800,1872,3672,6,0.293849,0.305948,6282.947935,0.002682,0.000349,14,0.000269,0,16,0.340659,0.024273
37041,Chowan County,,NC,827,16075,16902,8,6,14,1432,1289,2721,6,0.318641,0.332464,102.003715,0.000842,0.000691,98,0.000161,0,16,0.553571,0.007981
37043,Clay County,,NC,687,10439,11126,3,4,7,1141,1105,2246,7,0.253049,0.260788,9.354663,0.000012,0.00007,14,0.000132,0,16,0.666667,0.000558
37045,Cleveland County,,NC,5358,108406,113764,17,20,37,13011,13787,26798,5,0.341642,0.359387,31.820425,0.00301,0.004559,58,0.000204,0,16,0.794372,0.030076
37047,Columbus County,,NC,2449,56796,59245,10,11,21,5394,6222,11616,5,0.342415,0.359585,19.754818,0.002307,0.003558,58,0.000151,0,16,0.840909,0.022628
37049,Craven County,,NC,12189,110096,122285,75,75,150,23157,25664,48821,5,0.395948,0.424805,3661.050993,0.026109,0.026409,4,0.000622,0,16,0.599512,0.229851
37051,Cumberland County,,NC,46446,326593,373039,302,267,569,127038,136920,263958,5,0.455557,0.498635,36094.178518,0.079648,0.071686,58,0.0023,0,16,0.322342,0.680802
37053,Currituck County,,NC,2047,24993,27040,7,9,16,5184,4234,9418,6,0.322715,0.337807,10.203558,0.001116,0.00172,98,0.000112,0,16,0.788889,0.009449
37055,Dare County,,NC,2746,38448,41194,13,14,27,3285,3278,6563,5,0.331111,0.349296,6035.539733,0.002655,0.003464,98,0.000196,0,16,0.575,0.023802
37057,Davidson County,,NC,9576,185835,195411,27,28,55,27530,26882,54412,5,0.341527,0.361472,260.096777,0.004595,0.005768,58,0.000312,0,16,0.634236,0.044942
37059,Davie County,,NC,2481,46563,49044,9,9,18,6511,5864,12375,6,0.322577,0.337636,8.273831,0.001248,0.001924,58,0.000141,0,16,0.877778,0.012242
37061,Duplin County,,NC,3192,54334,57526,15,18,33,10376,10516,20892,5,0.341604,0.359172,57.320453,0.003252,0.004342,58,0.000185,0,16,0.77451,0.030973
37063,Durham County,,NC,25909,281060,306969,186,151,337,91728,89607,181335,5,0.429463,0.464334,15262.414608,0.057196,0.04972,58,0.001422,0,16,0.489136,0.487278
37065,Edgecombe County,,NC,4792,60052,64844,10,14,24,13039,14708,27747,5,0.331654,0.349004,83.520054,0.002319,0.00333,58,0.000144,0,16,0.690476,0.021649
37067,Forsyth County,,NC,21131,388624,409755,143,116,259,64052,61360,125412,5,0.417333,0.449807,22607.295539,0.04302,0.036844,58,0.001188,0,16,0.478006,0.373243
37069,Franklin County,,NC,4027,59563,63590,12,12,24,13244,11187,24431,6,0.318976,0.333674,13.216774,0.002008,0.001911,58,0.00016,0,16,0.758242,0.019352
37071,Gaston County,,NC,11746,229608,241354,45,47,92,33818,32439,66257,5,0.371019,0.395609,870.952741,0.012248,0.013185,58,0.000446,0,16,0.625189,0.114356
37073,Gates County,,NC,864,12286,13150,7,8,15,1560,1489,3049,6,0.314636,0.328183,13.454702,0.001158,0.000735,98,0.000107,0,16,0.522222,0.009802
37075,Graham County,,NC,394,8756,9150,2,2,4,376,267,643,7,0.227181,0.232744,2.685354,0.000004,0.000017,14,0.000101,0,16,0,0.000289
37077,Granville County,,NC,3704,59244,62948,11,14,25,10487,10076,20563,6,0.323611,0.33932,25.554728,0.001399,0.002427,58,0.000163,0,16,0.637363,0.013809
37079,Greene County,,NC,1389,19113,20502,5,5,10,3558,3961,7519,6,0.319447,0.332965,0,0.00073,0.000797,58,0.000095,0,16,1,0.007073
37081,Guilford County,,NC,31066,528482,559548,224,193,417,101892,98404,200296,5,0.42928,0.468983,56676.919378,0.058033,0.054296,58,0.001862,0,16,0.361705,0.496286
37083,Halifax County,,NC,3025,58157,61182,13,14,27,5943,7085,13028,5,0.328311,0.344987,4305.253593,0.002108,0.002952,58,0.000188,0,16,0.470588,0.019928
37085,Harnett County,,NC,11248,107727,118975,70,61,131,40623,32016,72639,5,0.381246,0.408567,1121.862643,0.019873,0.018149,58,0.000595,0,16,0.557595,0.17962
37087,Haywood County,,NC,2914,63863,66777,18,12,30,5790,4935,10725,6,0.329741,0.346572,533.654654,0.00567,0.002847,58,0.000248,0,16,0.654971,0.05202
37089,Henderson County,,NC,6592,116714,123306,46,31,77,17998,14852,32850,5,0.350944,0.371179,1718.715236,0.014246,0.008305,58,0.000456,0,16,0.595294,0.129504
37091,Hertford County,,NC,1363,22227,23590,7,8,15,2362,2546,4908,6,0.319077,0.333372,32.886508,0.00114,0.00109,58,0.000126,0,16,0.541667,0.01039
37093,Hoke County,,NC,6139,42175,48314,26,28,54,18166,14787,32953,5,0.375993,0.398856,259.054287,0.007197,0.010249,58,0.000255,0,16,0.724599,0.066324
37095,Hyde County,,NC,319,4914,5233,3,3,6,404,347,751,6,0.279531,0.28954,0.621795,0.000147,0.000135,58,0.000084,0,16,0.666667,0.001384
37097,Iredell County,,NC,10925,180096,191021,70,51,121,27721,25136,52857,5,0.384488,0.409948,6862.018335,0.023829,0.016207,58,0.000591,0,16,0.617054,0.207976
37099,Jackson County,,NC,2617,33598,36215,12,10,22,4880,4585,9465,6,0.32299,0.338379,287.690071,0.002988,0.001944,58,0.000212,0,16,0.626374,0.02834
37101,Johnston County,,NC,10197,177844,188041,43,37,80,36699,29646,66345,5,0.371383,0.394481,539.997351,0.012384,0.009215,58,0.000389,0,16,0.590869,0.109822
37103,Jones County,,NC,817,10913,11730,4,4,8,2777,2185,4962,6,0.313107,0.326285,0,0.000644,0.000735,4,0.000081,0,16,1,0.005611
37105,Lee County,,NC,4203,63173,67376,15,17,32,14262,10092,24354,5,0.346845,0.365495,24.775892,0.00281,0.004144,58,0.000184,0,16,0.80117,0.027451
37107,Lenoir County,,NC,3502,64545,68047,16,17,33,8024,9007,17031,5,0.328775,0.345648,151.789276,0.003126,0.003708,58,0.000203,0,16,0.722222,0.029159
37109,Lincoln County,,NC,5869,85388,91257,16,18,34,15987,14451,30438,6,0.324408,0.341515,13.677881,0.003126,0.003401,58,0.000184,0,16,0.765789,0.028963
37111,McDowell County,,NC,2066,48029,50095,10,12,22,4140,4119,8259,6,0.322921,0.338517,178.915636,0.000903,0.001912,58,0.000182,0,16,0.606061,0.009345
37113,Macon County,,NC,1969,36637,38606,16,11,27,2566,2080,4646,6,0.333407,0.349851,2202.70049,0.0047,0.00245,58,0.000258,0,16,0.508772,0.042286
37115,Madison County,,NC,1240,20462,21702,4,5,9,3239,3341,6580,6,0.293451,0.30471,4.361858,0.000284,0.000386,58,0.000113,0,16,0.5,0.003563
37117,Martin County,,NC,1411,27132,28543,7,7,14,2907,3279,6186,6,0.318607,0.332491,64.068291,0.000659,0.000708,58,0.000141,0,16,0.619048,0.006422
37119,Mecklenburg County,,NC,69357,985586,1054943,425,348,773,276092,243748,519840,5,0.469685,0.517976,157703.489362,0.093676,0.085393,58,0.003358,0,16,0.222865,0.787565
37121,Mitchell County,,NC,837,16491,17328,4,4,8,1458,1427,2885,6,0.293224,0.304215,0.791667,0.000238,0.000272,58,0.000111,0,16,0.833333,0.002632
37123,Montgomery County,,NC,1628,29507,31135,10,9,19,3500,3782,7282,6,0.322509,0.337554,2.052507,0.001521,0.001735,58,0.00014,0,16,0.827273,0.014823
37125,Moore County,,NC,5426,95777,101203,38,30,68,12804,11273,24077,5,0.362581,0.383983,535.821227,0.010934,0.008022,58,0.000367,0,16,0.596899,0.100984
37127,Nash County,,NC,7956,108203,116159,22,22,44,21985,23028,45013,5,0.343814,0.363954,122.251067,0.004998,0.005696,58,0.000234,0,16,0.611111,0.045194
37129,New Hanover County,,NC,17074,197137,214211,137,104,241,49841,47528,97369,5,0.401671,0.43346,7533.192887,0.039207,0.032541,58,0.001103,0,16,0.463535,0.335077
37131,Northampton County,,NC,1477,21895,23372,4,8,12,2721,3311,6032,6,0.318943,0.333152,4.133832,0.000516,0.001399,58,0.000105,0,16,0.75,0.005102
37133,Onslow County,,NC,33869,168570,202439,269,268,537,82927,89632,172559,5,0.452495,0.496335,22521.230767,0.076696,0.07489,4,0.001927,0,16,0.354994,0.646747
37135,Orange County,,NC,13403,126267,139670,83,64,147,38390,40910,79300,5,0.400344,0.427748,3316.087318,0.028204,0.024029,58,0.000693,0,16,0.62291,0.249103
37137,Pamlico County,,NC,775,13443,14218,5,5,10,1255,1543,2798,6,0.319077,0.332712,0.309524,0.000801,0.00087,4,0.000099,0,16,0.9,0.007659
37139,Pasquotank County,,NC,3623,42058,45681,15,17,32,6294,6885,13179,5,0.331328,0.349043,236.829147,0.00248,0.002955,98,0.000211,0,16,0.476608,0.021952
37141,Pender County,,NC,4173,51008,55181,20,12,32,13083,11141,24224,5,0.349084,0.366914,57.086394,0.005301,0.003437,58,0.00022,0,16,0.720779,0.04904
37143,Perquimans County,,NC,1052,14138,15190,6,4,10,2237,1736,3973,6,0.289884,0.301838,4.344726,0.000699,0.00032,98,0.000121,0,16,0.714286,0.006002
37145,Person County,,NC,1798,43062,44860,9,8,17,4739,4322,9061,6,0.318876,0.333069,1181.927033,0.001332,0.001461,58,0.000135,0,16,0.666667,0.012862
37147,Pitt County,,NC,10402,158909,169311,78,75,153,29520,27543,57063,5,0.387737,0.41621,16573.884661,0.018806,0.019455,58,0.000792,0,16,0.430108,0.16739
37149,Polk County,,NC,1372,20884,22256,5,5,10,3240,3089,6329,6,0.304025,0.316122,0,0.000717,0.000848,58,0.000098,0,16,1,0.00755
37151,Randolph County,,NC,7914,161952,169866,24,23,47,21504,21001,42505,5,0.341835,0.359965,92.585057,0.004479,0.004806,58,0.000272,0,16,0.676923,0.043389
37153,Richmond County,,NC,2090,48901,50991,16,18,34,4698,5312,10010,5,0.326682,0.343496,62.988564,0.002452,0.00292,58,0.000202,0,16,0.54386,0.023434
37155,Robeson County,,NC,5324,129107,134431,24,26,50,14444,14630,29074,5,0.342144,0.360735,348.335736,0.004612,0.004911,58,0.000272,0,16,0.536946,0.044393
37157,Rockingham County,,NC,4436,106176,110612,14,15,29,10103,10933,21036,6,0.3233,0.339369,162.003179,0.001883,0.002379,58,0.000195,0,16,0.542857,0.018242
37159,Rowan County,,NC,8566,154966,163532,27,29,56,20660,21410,42070,5,0.349971,0.369803,206.553678,0.007081,0.007491,58,0.00028,0,16,0.762923,0.066318
37161,Rutherford County,,NC,2917,68391,71308,14,15,29,5347,6463,11810,6,0.323473,0.339617,65.693115,0.002615,0.002503,58,0.000188,0,16,0.705882,0.025249
37163,Sampson County,,NC,3595,67847,71442,17,18,35,10793,10968,21761,5,0.32792,0.344905,45.878632,0.004291,0.003125,58,0.0002,0,16,0.72619,0.040289
37165,Scotland County,,NC,2331,37840,40171,9,11,20,4417,6244,10661,5,0.32612,0.341956,12.389229,0.0019,0.00251,58,0.000127,0,16,0.790909,0.018026
37167,Stanly County,,NC,3103,67298,70401,13,16,29,6294,6796,13090,5,0.326331,0.342808,19.091806,0.00195,0.003018,58,0.000174,0,16,0.766667,0.019217
37169,Stokes County,,NC,2929,51863,54792,8,9,17,7987,8014,16001,6,0.322612,0.337719,1062.18744,0.00062,0.001768,58,0.000143,0,16,0.722222,0.006152
37171,Surry County,,NC,3734,81024,84758,14,16,30,8109,9362,17471,6,0.323093,0.339232,10193.397352,0.001885,0.002145,58,0.000244,0,16,0.466667,0.018737
37173,Swain County,,NC,1012,18641,19653,5,5,10,1844,2570,4414,6,0.293366,0.304572,1702.004433,0.00026,0.000339,58,0.000157,0,16,0.6,0.003274
37175,Transylvania County,,NC,1840,33081,34921,10,9,19,3074,3102,6176,6,0.325944,0.341851,11.682631,0.002352,0.002244,58,0.000157,0,16,0.8,0.022846
37177,Tyrrell County,,NC,313,4068,4381,2,2,4,322,173,495,6,0.248891,0.25646,1.077606,0.000024,0.000016,58,0.000079,0,16,0,0.000277
37179,Union County,,NC,11904,219429,231333,69,50,119,39104,31661,70765,5,0.38483,0.410223,1775.68034,0.023437,0.017396,58,0.000557,0,16,0.648278,0.202158
37181,Vance County,,NC,2821,48718,51539,7,9,16,5904,6812,12716,6,0.322509,0.337554,8.979366,0.001144,0.00221,58,0.00012,0,16,0.733333,0.011036
37183,Wake County,,NC,57881,977817,1035698,427,332,759,263238,211659,474897,5,0.466646,0.513904,154111.455027,0.094559,0.082775,58,0.003352,0,16,0.223874,0.790588
37185,Warren County,,NC,1319,19689,21008,6,9,15,2814,3512,6326,6,0.31901,0.333372,6.115278,0.000837,0.001312,58,0.00011,0,16,0.708333,0.008168
37187,Washington County,,NC,739,14582,15321,5,7,12,901,1583,2484,6,0.31854,0.332409,531.247952,0.000134,0.00069,58,0.000145,0,16,0.571429,0.001465
37189,Watauga County,,NC,3918,39587,43505,26,23,49,6308,7744,14052,6,0.328953,0.347353,865.971787,0.004975,0.004549,58,0.000315,0,16,0.584046,0.047956
37191,Wayne County,,NC,8715,125604,134319,52,46,98,17241,17269,34510,5,0.376788,0.401909,1749.627564,0.014576,0.013607,58,0.000463,0,16,0.508433,0.130922
37193,Wilkes County,,NC,2970,74459,77429,13,14,27,5625,6240,11865,6,0.322921,0.338737,1211.824858,0.001307,0.002,58,0.000206,0,16,0.648352,0.013098
37195,Wilson County,,NC,4538,89759,94297,21,20,41,11569,11611,23180,5,0.341796,0.359635,114.527112,0.004231,0.004349,58,0.000236,0,16,0.630435,0.039708
37197,Yadkin County,,NC,2386,43215,45601,9,10,19,6271,6595,12866,6,0.322715,0.337966,8.643825,0.001216,0.001902,58,0.000146,0,16,0.855556,0.011942
37199,Yancey County,,NC,826,19070,19896,4,4,8,1426,1689,3115,6,0.293224,0.304215,1.666667,0.000232,0.000269,58,0.000115,0,16,0.666667,0.002605
38001,Adams County,,ND,157,2807,2964,0,0,0,0,0,0,0,0,0,0,0,0,59,0.000049,48,85,0,0
38003,Barnes County,,ND,664,12915,13579,3,3,6,997,1195,2192,6,0.283986,0.294019,0,0.0001,0.000077,60,0.00012,0,16,1,0.001011
38005,Benson County,,ND,384,7116,7500,1,3,4,462,767,1229,6,0.286701,0.296902,0,0.000001,0.000084,60,0.000063,0,16,1,0.000076
38007,Billings County,,ND,96,967,1063,1,1,2,83,49,132,6,0.262752,0.269985,0,0.000008,0.000013,60,0.000084,0,16,0,0.000205
38009,Bottineau County,,ND,420,7705,8125,2,4,6,636,731,1367,6,0.287055,0.297755,0,0.000058,0.000141,60,0.000092,0,16,1,0.000729
38011,Bowman County,,ND,235,3822,4057,0,1,1,0,78,78,6,0.270029,0.278372,0,0,0.000026,60,0.000049,0,86,0,0
38013,Burke County,,ND,132,2423,2555,1,1,2,170,75,245,6,0.276419,0.285188,0,0.000057,0.000064,60,0.000066,0,16,0,0.00065
38015,Burleigh County,,ND,5536,94868,100404,41,30,71,17979,13770,31749,5,0.369796,0.392555,49745.631779,0.004394,0.004212,60,0.001128,0,16,0.198228,0.041661
38017,Cass County,,ND,11038,167368,178406,84,78,162,34735,30330,65065,5,0.396051,0.42459,120116.683191,0.008421,0.011444,60,0.001781,0,16,0.168969,0.080329
38019,Cavalier County,,ND,262,5134,5396,1,2,3,56,265,321,6,0.28662,0.296627,0,0.000057,0.000083,60,0.000064,0,16,1,0.00039
38021,Dickey County,,ND,454,6077,6531,2,2,4,182,338,520,6,0.2842,0.294212,0,0.00008,0.000068,60,0.000099,0,16,1,0.000845
38023,Divide County,,ND,124,2458,2582,0,1,1,0,61,61,6,0.261274,0.268328,0,0,0.000024,60,0.000049,0,87,0,0
38025,Dunn County,,ND,201,3962,4163,1,2,3,251,372,623,6,0.270085,0.278629,0,0.000008,0.000039,60,0.000084,0,16,1,0.000205
38027,Eddy County,,ND,196,2785,2981,0,0,0,0,0,0,0,0,0,0,0,0,61,0.000049,49,88,0,0
38029,Emmons County,,ND,182,4286,4468,1,1,2,216,276,492,6,0.269988,0.278299,0,0.000025,0.000026,60,0.000081,0,16,0,0.000334
38031,Foster County,,ND,292,4112,4404,2,1,3,147,149,296,6,0.28372,0.293304,0,0.000075,0.00005,60,0.000088,0,16,1,0.000677
38033,Golden Valley County,,ND,133,1971,2104,0,1,1,0,61,61,6,0.262793,0.270061,0,0,0.000013,60,0.000049,0,89,0,0
38035,Grand Forks County,,ND,7910,70769,78679,41,48,89,11837,14376,26213,5,0.3865,0.411494,33550.035515,0.005627,0.009626,60,0.000817,0,16,0.309869,0.05177
38037,Grant County,,ND,163,2898,3061,1,1,2,41,172,213,6,0.270012,0.278354,0,0.000008,0.000026,60,0.000075,0,16,1,0.000112
38039,Griggs County,,ND,184,2974,3158,0,1,1,0,148,148,6,0.283761,0.293372,0,0,0.00005,60,0.000049,0,90,0,0
38041,Hettinger County,,ND,163,2922,3085,1,1,2,169,227,396,6,0.262752,0.269985,0,0.000008,0.000013,60,0.000084,0,16,0,0.000205
38043,Kidder County,,ND,219,2939,3158,1,1,2,192,245,437,6,0.269988,0.278299,0,0.000025,0.000026,60,0.000081,0,16,0,0.000334
38045,LaMoure County,,ND,291,5023,5314,2,2,4,229,357,586,6,0.283747,0.293469,0,0.000075,0.000051,60,0.000088,0,16,1,0.000677
38047,Logan County,,ND,128,2400,2528,0,0,0,0,0,0,0,0,0,0,0,0,62,0.000049,50,91,0,0
38049,McHenry County,,ND,440,6503,6943,1,2,3,690,719,1409,6,0.286783,0.29704,0,0.000057,0.000114,60,0.000066,0,16,1,0.00065
38051,McIntosh County,,ND,193,3447,3640,0,2,2,0,140,140,6,0.284,0.293922,0,0,0.000076,60,0.000049,0,92,1,0
38053,McKenzie County,,ND,364,5857,6221,5,3,8,576,445,1021,6,0.270181,0.278876,15.003795,0.000263,0.000051,60,0.00018,0,16,0.35,0.003003
38055,McLean County,,ND,685,10608,11293,5,4,9,1383,1359,2742,6,0.287082,0.29781,3.019532,0.000157,0.000143,60,0.000178,0,16,0.9,0.001765
38057,Mercer County,,ND,567,10552,11119,4,4,8,735,1000,1735,6,0.28404,0.294239,1.036352,0.000108,0.00008,60,0.000161,0,16,0.9,0.001246
38059,Morton County,,ND,2525,32163,34688,12,12,24,7613,7322,14935,6,0.346369,0.36413,4714.312543,0.00068,0.001301,60,0.000367,0,16,0.417582,0.006753
38061,Mountrail County,,ND,582,8157,8739,5,5,10,1056,1203,2259,6,0.287245,0.298168,43.470787,0.000155,0.000165,60,0.000213,0,16,0.8,0.00197
38063,Nelson County,,ND,220,3944,4164,2,2,4,173,214,387,6,0.28662,0.296627,0,0.000058,0.000083,60,0.000078,0,16,1,0.000466
38065,Oliver County,,ND,149,2274,2423,0,2,2,0,304,304,6,0.270078,0.278592,0,0,0.00003,60,0.000049,0,93,1,0
38067,Pembina County,,ND,575,9543,10118,3,3,6,579,923,1502,6,0.286647,0.296792,0,0.000125,0.000085,60,0.000119,0,16,1,0.001068
38069,Pierce County,,ND,292,5165,5457,1,2,3,153,204,357,6,0.286783,0.29704,0,0.000057,0.000114,60,0.000066,0,16,1,0.00065
38071,Ramsey County,,ND,915,13558,14473,4,7,11,1233,1606,2839,6,0.288284,0.299593,6125.814859,0.000182,0.000173,60,0.000118,0,16,0.404762,0.001699
38073,Ransom County,,ND,456,6803,7259,2,2,4,379,619,998,6,0.283747,0.293469,0,0.000068,0.00005,60,0.000108,0,16,1,0.000664
38075,Renville County,,ND,257,2925,3182,1,1,2,482,495,977,6,0.276419,0.285188,0,0.000057,0.000064,60,0.000066,0,16,0,0.00065
38077,Richland County,,ND,1443,19286,20729,7,7,14,2047,2500,4547,6,0.287082,0.298058,34.423997,0.00015,0.00013,60,0.000207,0,16,0.5,0.001549
38079,Rolette County,,ND,667,14562,15229,5,5,10,1193,1170,2363,6,0.288174,0.299153,41.893236,0.000207,0.000173,60,0.000151,0,16,0.8,0.002038
38081,Sargent County,,ND,306,5103,5409,3,3,6,375,439,814,6,0.283774,0.293634,1,0.000068,0.000051,60,0.00014,0,16,0.666667,0.000741
38083,Sheridan County,,ND,65,1686,1751,0,0,0,0,0,0,0,0,0,0,0,0,63,0.000049,51,94,0,0
38085,Sioux County,,ND,224,3667,3891,1,2,3,304,380,684,6,0.270037,0.278519,0,0.000025,0.00003,60,0.000081,0,16,1,0.000334
38087,Slope County,,ND,68,811,879,0,0,0,0,0,0,0,0,0,0,0,0,64,0.000049,52,95,0,0
38089,Stark County,,ND,1754,27909,29663,20,13,33,3196,3078,6274,5,0.356353,0.375311,19594.692444,0.002268,0.001422,60,0.000532,0,16,0.329004,0.021963
38091,Steele County,,ND,158,2390,2548,1,2,3,74,193,267,6,0.283747,0.293469,0,0.000067,0.00005,60,0.000069,0,16,1,0.000595
38093,Stutsman County,,ND,1265,24131,25396,7,10,17,1853,2303,4156,5,0.355225,0.37355,574.037681,0.000214,0.001315,60,0.000229,0,16,0.533333,0.002221
38095,Towner County,,ND,194,2764,2958,1,0,1,64,0,64,0,0,0,0,0.000001,0,60,0.000063,0,2,0,0.000076
38097,Traill County,,ND,663,9451,10114,3,2,5,1017,1131,2148,6,0.28662,0.296627,3.843928,0.000124,0.000083,60,0.000112,0,16,0.666667,0.001052
38099,Walsh County,,ND,731,13631,14362,4,3,7,1075,1280,2355,6,0.286647,0.296792,38.921336,0.000298,0.000084,60,0.000128,0,16,0.583333,0.003138
38101,Ward County,,ND,6134,69514,75648,49,42,91,11165,10843,22008,5,0.381967,0.406685,40780.539356,0.010853,0.009655,60,0.00083,0,16,0.362155,0.098696
38103,Wells County,,ND,261,5394,5655,2,2,4,114,229,343,6,0.28396,0.293854,0,0.000124,0.000076,60,0.000085,0,16,1,0.001245
38105,Williams County,,ND,1374,25089,26463,35,13,48,4522,2885,7407,5,0.353566,0.371899,6585.211648,0.004033,0.001021,60,0.000683,0,16,0.297479,0.038041
39001,Adams County,,OH,1561,31006,32567,12,12,24,3964,3648,7612,6,0.323507,0.338599,71.557652,0.001712,0.001464,65,0.000159,0,16,0.674242,0.012939
39003,Allen County,,OH,5897,123568,129465,20,28,48,10716,13337,24053,5,0.367196,0.388902,717.743683,0.003408,0.00554,65,0.000207,0,16,0.522487,0.026044
39005,Ashland County,,OH,3256,61795,65051,12,15,27,7697,7790,15487,6,0.322612,0.338016,77.784924,0.001747,0.001585,65,0.00013,0,16,0.685714,0.012619
39007,Ashtabula County,,OH,5048,118601,123649,15,17,32,9881,11008,20889,5,0.356185,0.375641,47.246614,0.00328,0.003412,65,0.000138,0,16,0.764706,0.024831
39009,Athens County,,OH,4242,52705,56947,22,23,45,6924,8448,15372,5,0.361025,0.381154,1128.684716,0.002575,0.003838,65,0.000297,0,16,0.426667,0.019363
39011,Auglaize County,,OH,3093,58979,62072,12,14,26,7166,7641,14807,6,0.323819,0.339314,26.934747,0.000951,0.001453,65,0.000157,0,16,0.614286,0.007907
39013,Belmont County,,OH,2934,78673,81607,14,14,28,6948,6963,13911,6,0.325244,0.34151,1783.479541,0.001779,0.001609,69,0.000207,0,16,0.442857,0.014386
39015,Brown County,,OH,3216,50675,53891,12,12,24,9926,10307,20233,6,0.3123,0.325889,46.051434,0.001836,0.001076,65,0.00015,0,16,0.782051,0.01367
39017,Butler County,,OH,24623,414979,439602,82,107,189,75263,77071,152334,5,0.42216,0.45257,18171.88,0.026605,0.036002,65,0.000681,0,16,0.521053,0.224797
39019,Carroll County,,OH,1929,33680,35609,6,8,14,5116,5390,10506,6,0.322371,0.336888,45.613194,0.000507,0.001271,65,0.00011,0,16,0.839286,0.003353
39021,Champaign County,,OH,2799,47523,50322,10,11,21,7259,7753,15012,6,0.3233,0.338186,5.796276,0.001142,0.001348,65,0.000132,0,16,0.818182,0.009008
39023,Clark County,,OH,6825,163347,170172,17,24,41,16233,17884,34117,5,0.367463,0.388186,718.486949,0.00343,0.005287,65,0.000187,0,16,0.566667,0.027541
39025,Clermont County,,OH,13678,232389,246067,28,38,66,42053,40701,82754,5,0.390687,0.414796,1347.715565,0.007786,0.013174,65,0.000276,0,16,0.662805,0.064935
39027,Clinton County,,OH,3539,50142,53681,13,14,27,8924,9229,18153,6,0.32368,0.339067,17.691687,0.001871,0.001664,65,0.000157,0,16,0.714286,0.014019
39029,Columbiana County,,OH,4793,124279,129072,14,14,28,11071,12062,23133,6,0.325105,0.341317,92.311701,0.002288,0.001981,65,0.000156,0,16,0.631868,0.017199
39031,Coshocton County,,OH,1734,42244,43978,9,10,19,4024,3957,7981,6,0.321755,0.336173,45.288901,0.000779,0.00089,65,0.000126,0,16,0.722222,0.006217
39033,Crawford County,,OH,2781,53486,56267,9,13,22,6381,7143,13524,6,0.32268,0.337906,13.905519,0.000678,0.001276,65,0.000134,0,16,0.570513,0.005903
39035,Cuyahoga County,,OH,57938,1484640,1542578,241,274,515,152605,199247,351852,5,0.458176,0.501001,39945.2724,0.071835,0.078721,65,0.001726,0,16,0.382288,0.601417
39037,Darke County,,OH,2861,65842,68703,13,12,25,6176,6560,12736,6,0.323923,0.339259,100.476435,0.001794,0.001278,65,0.000156,0,16,0.56044,0.013545
39039,Defiance County,,OH,2580,48650,51230,11,12,23,5660,5475,11135,6,0.323024,0.338346,117.157082,0.001076,0.000919,66,0.00015,0,16,0.583333,0.008305
39041,Delaware County,,OH,13045,195740,208785,58,55,113,49330,38371,87701,5,0.395689,0.421894,5782.247623,0.013876,0.018123,65,0.000481,0,16,0.49061,0.11497
39043,Erie County,,OH,5221,94379,99600,19,20,39,11459,12315,23774,5,0.366219,0.386783,474.02055,0.004855,0.004556,65,0.000179,0,16,0.63834,0.039336
39045,Fairfield County,,OH,10326,167760,178086,29,33,62,33001,31213,64214,5,0.381294,0.404672,2442.360744,0.005357,0.008668,65,0.000304,0,16,0.459756,0.042972
39047,Fayette County,,OH,2047,33186,35233,10,9,19,5184,5279,10463,6,0.322474,0.336822,5.334052,0.001082,0.000919,65,0.000144,0,16,0.711111,0.008598
39049,Franklin County,,OH,73053,1329835,1402888,356,362,718,250553,257802,508355,5,0.473503,0.522296,268883.692412,0.083293,0.085006,65,0.002946,0,16,0.242565,0.701239
39051,Fulton County,,OH,2932,54098,57030,8,8,16,6736,7016,13752,6,0.321994,0.336338,35.624045,0.000864,0.000762,66,0.000115,0,16,0.708333,0.006613
39053,Gallia County,,OH,1482,32688,34170,7,8,15,2647,2945,5592,6,0.322268,0.336547,122.064002,0.000572,0.000542,65,0.000158,0,16,0.535714,0.004943
39055,Geauga County,,OH,5425,111933,117358,13,17,30,15142,14399,29541,5,0.368581,0.389122,12.058253,0.003154,0.005647,65,0.000121,0,16,0.905229,0.023818
39057,Greene County,,OH,15584,175876,191460,62,66,128,39718,42303,82021,5,0.406196,0.433696,6503.556852,0.017137,0.022874,65,0.00053,0,16,0.494146,0.146245
39059,Guernsey County,,OH,2093,46993,49086,11,12,23,4013,4509,8522,6,0.322543,0.337603,18.171319,0.001527,0.001315,65,0.000152,0,16,0.598485,0.01156
39061,Hamilton County,,OH,46809,923926,970735,201,221,422,136001,161414,297415,5,0.44821,0.487422,68764.443633,0.05908,0.065061,65,0.00161,0,16,0.39388,0.499495
39063,Hancock County,,OH,4883,89837,94720,20,25,45,10647,10648,21295,5,0.371201,0.393062,1291.507605,0.003733,0.005236,66,0.000209,0,16,0.474868,0.028812
39065,Hardin County,,OH,2099,34205,36304,8,10,18,3908,4533,8441,6,0.321755,0.336173,7.00645,0.000592,0.000686,66,0.000124,0,16,0.611111,0.005183
39067,Harrison County,,OH,1008,17528,18536,7,5,12,2170,2326,4496,6,0.289884,0.300385,19.124492,0.00072,0.000138,69,0.000118,0,16,0.761905,0.005767
39069,Henry County,,OH,2031,36553,38584,8,8,16,4140,4588,8728,6,0.321892,0.336173,2.878571,0.000356,0.000734,66,0.000123,0,16,0.75,0.002522
39071,Highland County,,OH,3066,48528,51594,13,13,26,8138,8009,16147,6,0.323438,0.338627,26.974365,0.001844,0.001569,65,0.000166,0,16,0.705128,0.013887
39073,Hocking County,,OH,1961,32392,34353,8,8,16,5392,5346,10738,6,0.321618,0.335732,2.992857,0.000636,0.000595,65,0.000149,0,16,0.767857,0.005493
39075,Holmes County,,OH,1724,44715,46439,7,9,16,4185,4949,9134,6,0.321789,0.33609,2.202536,0.00026,0.000874,65,0.000103,0,16,0.777778,0.001856
39077,Huron County,,OH,4002,74857,78859,16,15,31,9362,10445,19807,6,0.322818,0.338346,19.035282,0.002451,0.001665,65,0.000157,0,16,0.729167,0.017608
39079,Jackson County,,OH,1827,36517,38344,8,9,17,3994,3896,7890,6,0.321755,0.336063,12.204891,0.000552,0.000541,65,0.000164,0,16,0.511111,0.005004
39081,Jefferson County,,OH,3061,80081,83142,15,14,29,6493,6747,13240,6,0.325174,0.341427,209.234809,0.002157,0.001904,69,0.000205,0,16,0.519048,0.016707
39083,Knox County,,OH,3342,67220,70562,13,14,27,7683,7294,14977,6,0.323335,0.338665,86.777878,0.001315,0.0016,65,0.000159,0,16,0.561905,0.010484
39085,Lake County,,OH,11921,289233,301154,32,42,74,34485,32933,67418,5,0.390486,0.415346,256.364519,0.01123,0.015803,65,0.000244,0,16,0.761836,0.091865
39087,Lawrence County,,OH,2878,68607,71485,10,8,18,7180,7119,14299,6,0.322921,0.337372,148.708145,0.000653,0.000596,65,0.000202,0,16,0.544444,0.005781
39089,Licking County,,OH,9945,196388,206333,31,33,64,30170,27340,57510,5,0.370565,0.392698,2158.878532,0.006335,0.00734,65,0.000319,0,16,0.442943,0.05191
39091,Logan County,,OH,3068,56697,59765,13,14,27,6683,6999,13682,6,0.32268,0.337702,17.894078,0.001187,0.001048,65,0.00016,0,16,0.626374,0.009423
39093,Lorain County,,OH,14176,357588,371764,49,71,120,40591,39105,79696,5,0.403705,0.431716,2070.410911,0.016279,0.0251,65,0.000362,0,16,0.640526,0.134641
39095,Lucas County,,OH,22221,497738,519959,90,119,209,49728,64538,114266,5,0.420694,0.452762,14175.61948,0.02616,0.039244,66,0.000682,0,16,0.516387,0.21875
39097,Madison County,,OH,3283,45678,48961,11,12,23,9165,9110,18275,6,0.322577,0.337317,7.045485,0.001218,0.00106,65,0.000151,0,16,0.712121,0.009514
39099,Mahoning County,,OH,11707,274771,286478,47,61,108,27449,31538,58987,5,0.396518,0.423435,1242.632074,0.01509,0.021592,65,0.000356,0,16,0.628223,0.124714
39101,Marion County,,OH,3509,73526,77035,11,11,22,7177,7957,15134,6,0.321857,0.33642,18.297646,0.000724,0.000641,65,0.000153,0,16,0.507576,0.006321
39103,Medina County,,OH,10566,212166,222732,30,42,72,34812,29347,64159,5,0.388433,0.412898,819.443607,0.008049,0.013597,65,0.000239,0,16,0.627273,0.065685
39105,Meigs County,,OH,993,24820,25813,7,8,15,2330,2454,4784,6,0.322028,0.336338,233.187938,0.000544,0.000529,65,0.000166,0,16,0.517857,0.004861
39107,Mercer County,,OH,2171,53466,55637,10,14,24,3882,4653,8535,6,0.324756,0.340745,135.988285,0.000914,0.001607,65,0.000145,0,16,0.587912,0.00752
39109,Miami County,,OH,6898,125581,132479,17,19,36,17766,16315,34081,6,0.328311,0.345769,68.495009,0.002107,0.002641,65,0.00018,0,16,0.626316,0.015551
39111,Monroe County,,OH,787,16920,17707,4,5,9,1077,1680,2757,6,0.321857,0.335732,108.168588,0.000022,0.000513,69,0.00011,0,16,0.4,0.000449
39113,Montgomery County,,OH,32708,625195,657903,153,178,331,87890,99886,187776,5,0.440774,0.476499,32514.269847,0.044994,0.05552,65,0.001219,0,16,0.436759,0.387231
39115,Morgan County,,OH,710,16000,16710,6,5,11,1793,1826,3619,6,0.321584,0.335347,1.453968,0.000548,0.000524,65,0.000123,0,16,0.8,0.00479
39117,Morrow County,,OH,2517,39100,41617,8,8,16,7071,6693,13764,6,0.321721,0.33587,2.147378,0.00071,0.000656,65,0.000119,0,16,0.803571,0.006004
39119,Muskingum County,,OH,4160,100349,104509,15,17,32,9049,9437,18486,6,0.323715,0.339727,64.015453,0.001152,0.001589,65,0.000212,0,16,0.526144,0.008903
39121,Noble County,,OH,641,14029,14670,5,6,11,1507,1623,3130,6,0.321686,0.335595,499.538093,0.00053,0.000518,65,0.00011,0,16,0.7,0.004615
39123,Ottawa County,,OH,2666,51612,54278,12,11,23,6933,6531,13464,6,0.325594,0.341757,5.718342,0.001831,0.001817,66,0.000131,0,16,0.752747,0.013319
39125,Paulding County,,OH,1207,23925,25132,5,8,13,2308,3102,5410,6,0.322887,0.337686,11.486148,0.000235,0.00085,66,0.000101,0,16,0.767857,0.00203
39127,Perry County,,OH,2269,40026,42295,7,7,14,6690,6400,13090,6,0.321584,0.335567,2.016667,0.000634,0.000589,65,0.00013,0,16,0.809524,0.005365
39129,Pickaway County,,OH,4024,59211,63235,12,9,21,12054,10920,22974,6,0.321652,0.335897,11.933092,0.000874,0.00067,65,0.000185,0,16,0.55303,0.007334
39131,Pike County,,OH,1698,30620,32318,7,7,14,4015,4269,8284,6,0.321652,0.335677,4.884413,0.000542,0.000536,65,0.000137,0,16,0.666667,0.004937
39133,Portage County,,OH,10982,177819,188801,25,34,59,31304,32504,63808,5,0.385467,0.409156,469.015382,0.006468,0.010641,65,0.000204,0,16,0.692064,0.051057
39135,Preble County,,OH,2724,50781,53505,9,10,19,6470,6971,13441,6,0.323542,0.338434,28.584327,0.001294,0.001508,65,0.000114,0,16,0.727273,0.009185
39137,Putnam County,,OH,1814,45203,47017,9,10,19,3325,4135,7460,6,0.321994,0.336558,64.450642,0.000885,0.000751,65,0.000127,0,16,0.655556,0.006756
39139,Richland County,,OH,6300,146864,153164,24,32,56,13776,15161,28937,5,0.368581,0.390503,1694.092895,0.004131,0.005565,65,0.000228,0,16,0.467023,0.032673
39141,Ross County,,OH,3733,83447,87180,16,16,32,9229,9407,18636,6,0.323507,0.339067,72.338184,0.001384,0.001344,65,0.000239,0,16,0.496324,0.011453
39143,Sandusky County,,OH,3463,76093,79556,10,11,21,8205,8670,16875,6,0.323542,0.338792,5.91678,0.001498,0.001638,66,0.000121,0,16,0.854545,0.011221
39145,Scioto County,,OH,3039,79469,82508,15,16,31,6006,6787,12793,6,0.324269,0.339991,2022.056194,0.001374,0.0014,65,0.00025,0,16,0.330065,0.011143
39147,Seneca County,,OH,3303,68556,71859,12,12,24,7277,8575,15852,6,0.32268,0.337796,9.132052,0.000965,0.001229,66,0.000144,0,16,0.685897,0.00758
39149,Shelby County,,OH,2950,61919,64869,12,12,24,6610,7227,13837,6,0.323507,0.338599,10.84002,0.001465,0.001293,65,0.000145,0,16,0.772727,0.011534
39151,Stark County,,OH,16479,455828,472307,63,89,152,42324,45125,87449,5,0.407562,0.437328,12027.214451,0.017311,0.028801,65,0.000525,0,16,0.520784,0.148308
39153,Summit County,,OH,28771,638482,667253,113,150,263,81920,90261,172181,5,0.427583,0.46238,12595.236789,0.036402,0.051003,65,0.000838,0,16,0.530541,0.311329
39155,Trumbull County,,OH,9916,255112,265028,33,47,80,22931,25647,48578,5,0.3865,0.411604,820.250426,0.010971,0.016198,65,0.00026,0,16,0.686932,0.090619
39157,Tuscarawas County,,OH,4274,115422,119696,15,17,32,10086,10839,20925,6,0.326225,0.343111,231.434537,0.001654,0.002239,65,0.000183,0,16,0.529412,0.012345
39159,Union County,,OH,3738,58026,61764,11,12,23,10564,9269,19833,6,0.322577,0.337317,15.408062,0.001041,0.001023,65,0.00015,0,16,0.628205,0.008479
39161,Van Wert County,,OH,1720,36717,38437,9,9,18,3293,3478,6771,6,0.322921,0.337851,70.62404,0.000786,0.000867,65,0.000131,0,16,0.6,0.006586
39163,Vinton County,,OH,845,13903,14748,6,5,11,2155,2144,4299,6,0.321516,0.335237,0.7,0.000589,0.000521,65,0.000119,0,16,0.866667,0.005007
39165,Warren County,,OH,16932,243343,260275,57,76,133,55782,50850,106632,5,0.416357,0.443837,4672.42297,0.01894,0.028349,65,0.000479,0,16,0.633821,0.160996
39167,Washington County,,OH,3195,72869,76064,12,14,26,6608,6572,13180,6,0.326225,0.342737,4286.90193,0.001324,0.001543,65,0.000229,0,16,0.390476,0.010513
39169,Wayne County,,OH,6299,139404,145703,12,17,29,13889,14880,28769,5,0.358504,0.378123,178.688819,0.001791,0.003374,65,0.000128,0,16,0.691176,0.012823
39171,Williams County,,OH,2358,47482,49840,12,12,24,4192,4739,8931,6,0.323059,0.338401,157.45077,0.001092,0.00093,66,0.000158,0,16,0.484848,0.00847
39173,Wood County,,OH,10986,139612,150598,38,46,84,28443,28291,56734,5,0.387985,0.4132,3457.469067,0.007528,0.011752,66,0.000327,0,16,0.494898,0.058595
39175,Wyandot County,,OH,1451,28010,29461,7,7,14,3553,3621,7174,6,0.321652,0.335677,3.567232,0.000624,0.000575,66,0.000111,0,16,0.666667,0.005238
40001,Adair County,,OK,1420,23084,24504,6,6,12,3296,3812,7108,6,0.312011,0.323594,0.285714,0.000613,0.000626,3,0.000121,0,16,0.933333,0.005976
40003,Alfalfa County,,OK,373,5084,5457,3,4,7,553,594,1147,6,0.311946,0.323721,1.033333,0.000058,0.000416,3,0.000098,0,16,0.75,0.000672
40005,Atoka County,,OK,1012,13898,14910,7,8,15,1733,2583,4316,5,0.315389,0.327969,735.811717,0.000378,0.000707,91,0.000161,0,16,0.569444,0.004066
40007,Beaver County,,OK,555,5596,6151,3,4,7,731,605,1336,6,0.246481,0.253747,91.844514,0.000019,0.000031,32,0.000116,0,16,0.333333,0.000494
40009,Beckham County,,OK,1798,21264,23062,11,9,20,3242,3518,6760,5,0.314309,0.327099,4133.648556,0.000573,0.000708,3,0.000241,0,16,0.530303,0.006098
40011,Blaine County,,OK,906,10569,11475,7,7,14,1358,1599,2957,6,0.312011,0.324161,103.014134,0.000446,0.000479,3,0.000157,0,16,0.619048,0.004793
40013,Bryan County,,OK,2999,37547,40546,19,18,37,7835,6633,14468,5,0.338134,0.355684,2126.398171,0.002789,0.003065,91,0.000301,0,16,0.45614,0.027922
40015,Caddo County,,OK,2137,28270,30407,9,11,20,4503,5157,9660,5,0.314375,0.327429,15.313619,0.000687,0.000716,3,0.000186,0,16,0.645455,0.006885
40017,Canadian County,,OK,9173,119541,128714,44,28,72,36744,28191,64935,5,0.36903,0.391251,3884.282394,0.008856,0.006722,3,0.000577,0,16,0.379798,0.082912
40019,Carter County,,OK,3009,50516,53525,20,20,40,7009,6769,13778,5,0.338474,0.356372,5032.895515,0.003166,0.00325,91,0.000318,0,16,0.495671,0.031297
40021,Cherokee County,,OK,3305,42291,45596,17,18,35,8023,7980,16003,5,0.316841,0.33105,41.461693,0.001258,0.001258,3,0.000257,0,16,0.630719,0.01249
40023,Choctaw County,,OK,966,14367,15333,6,6,12,1952,2050,4002,6,0.312365,0.324574,10.109739,0.000687,0.000414,91,0.000131,0,16,0.642857,0.006762
40025,Cimarron County,,OK,211,2979,3190,0,1,1,0,84,84,6,0.243569,0.24956,0,0,0.000013,32,0.000049,0,96,0,0
40027,Cleveland County,,OK,23441,251083,274524,96,95,191,81262,72326,153588,5,0.404947,0.43543,26335.253819,0.021275,0.024695,3,0.001101,0,16,0.372645,0.196438
40029,Coal County,,OK,384,5222,5606,2,3,5,748,712,1460,6,0.252944,0.260372,0.2,0.000017,0.00003,3,0.00008,0,16,0.833333,0.000278
40031,Comanche County,,OK,14446,113144,127590,77,82,159,32971,35141,68112,5,0.402953,0.432189,11687.194617,0.022197,0.02453,3,0.000748,0,16,0.530159,0.199993
40033,Cotton County,,OK,479,6248,6727,3,3,6,1107,1089,2196,6,0.294163,0.305447,0,0.000279,0.000237,3,0.000077,0,16,1,0.00235
40035,Craig County,,OK,1082,14318,15400,5,5,10,2269,2436,4705,6,0.310444,0.321613,0,0.000346,0.000336,3,0.000114,0,16,1,0.003362
40037,Creek County,,OK,6197,73428,79625,16,17,33,20258,19317,39575,5,0.342337,0.360141,114.694956,0.001007,0.00163,3,0.000247,0,16,0.591503,0.010065
40039,Custer County,,OK,2509,26070,28579,17,13,30,5250,5525,10775,5,0.335809,0.352135,5163.975684,0.001092,0.001643,3,0.00033,0,16,0.418129,0.010897
40041,Delaware County,,OK,2893,37343,40236,16,15,31,7984,7195,15179,5,0.31694,0.330885,113.093602,0.00133,0.001238,3,0.00026,0,16,0.571895,0.013046
40043,Dewey County,,OK,375,5015,5390,1,2,3,232,422,654,6,0.251683,0.258507,0,0.000006,0.000013,3,0.00007,0,16,1,0.000131
40045,Ellis County,,OK,343,4096,4439,1,1,2,461,426,887,6,0.240073,0.24562,0,0.000006,0.000006,3,0.00007,0,16,0,0.000131
40047,Garfield County,,OK,4891,65581,70472,31,38,69,9007,9961,18968,5,0.375573,0.399807,14922.847911,0.00831,0.009017,3,0.000421,0,16,0.437805,0.077024
40049,Garvin County,,OK,1921,28751,30672,10,9,19,4263,4810,9073,6,0.312139,0.324601,18.593306,0.001097,0.000575,3,0.000186,0,16,0.722222,0.011121
40051,Grady County,,OK,3896,52006,55902,12,12,24,11774,10750,22524,5,0.317239,0.330637,22.22206,0.001605,0.001075,3,0.000204,0,16,0.737179,0.01561
40053,Grant County,,OK,467,4682,5149,2,2,4,700,799,1499,6,0.273203,0.2822,0,0.000066,0.00006,3,0.000072,0,16,1,0.000686
40055,Greer County,,OK,440,5050,5490,2,4,6,489,623,1112,6,0.265678,0.274161,0.166667,0.000034,0.00004,3,0.000084,0,16,0.833333,0.000424
40057,Harmon County,,OK,216,2808,3024,1,1,2,178,224,402,6,0.264657,0.272428,0,0.000029,0.000027,3,0.000061,0,16,0,0.000317
40059,Harper County,,OK,327,3976,4303,2,1,3,227,269,496,6,0.240073,0.24562,0,0.000006,0.000006,3,0.000095,0,16,1,0.000199
40061,Haskell County,,OK,768,12587,13355,8,8,16,1679,1803,3482,5,0.315587,0.328271,4.237479,0.000418,0.000755,3,0.000146,0,16,0.708333,0.004077
40063,Hughes County,,OK,846,12110,12956,9,9,18,2308,2442,4750,5,0.315389,0.328079,3.013034,0.000849,0.000844,3,0.000162,0,16,0.819444,0.008201
40065,Jackson County,,OK,3085,27914,30999,20,22,42,3358,4001,7359,5,0.359867,0.380648,12060.481441,0.004614,0.004986,3,0.00031,0,16,0.449231,0.04321
40067,Jefferson County,,OK,509,5794,6303,2,2,4,811,708,1519,6,0.25759,0.265209,0,0.000037,0.000035,3,0.000075,0,16,1,0.000482
40069,Johnston County,,OK,944,10238,11182,7,8,15,1849,1933,3782,6,0.312107,0.324436,4.956644,0.000209,0.000545,91,0.000151,0,16,0.732143,0.002187
40071,Kay County,,OK,3208,50763,53971,14,15,29,5679,7346,13025,5,0.344361,0.3621,1226.244618,0.001798,0.002222,3,0.000235,0,16,0.496324,0.017079
40073,Kingfisher County,,OK,1005,16580,17585,6,8,14,2194,2641,4835,5,0.315389,0.327969,3.433892,0.00059,0.000943,3,0.000127,0,16,0.857143,0.005881
40075,Kiowa County,,OK,787,9409,10196,8,7,15,1190,1334,2524,5,0.314212,0.326714,123.952392,0.000527,0.000538,3,0.000163,0,16,0.597222,0.005314
40077,Latimer County,,OK,899,12052,12951,3,6,9,1286,1794,3080,5,0.315258,0.327528,3.837242,0.000028,0.000686,3,0.000094,0,16,0.766667,0.000412
40079,Le Flore County,,OK,2945,48536,51481,13,12,25,6103,6207,12310,5,0.316675,0.330114,934.38955,0.001008,0.000978,3,0.000215,0,16,0.512821,0.00975
40081,Lincoln County,,OK,2636,33806,36442,10,10,20,7801,7666,15467,5,0.315357,0.328134,3.912302,0.000928,0.000924,3,0.000178,0,16,0.766667,0.009029
40083,Logan County,,OK,3288,39432,42720,12,14,26,11257,9646,20903,5,0.345697,0.363745,197.354639,0.002035,0.002854,3,0.000194,0,16,0.666667,0.019851
40085,Love County,,OK,855,9464,10319,3,4,7,1463,1462,2925,6,0.311979,0.323776,1.735432,0.000043,0.000404,91,0.000092,0,16,0.75,0.000594
40087,McClain County,,OK,3221,35071,38292,11,8,19,11516,10482,21998,5,0.315324,0.327858,4.328377,0.001436,0.000886,3,0.00019,0,16,0.809091,0.014208
40089,McCurtain County,,OK,1754,32459,34213,13,12,25,2283,2246,4529,5,0.317272,0.330995,816.755639,0.001438,0.000867,91,0.000229,0,16,0.368132,0.014202
40091,McIntosh County,,OK,1489,18637,20126,10,11,21,4067,3339,7406,5,0.315455,0.328409,10.912022,0.000914,0.000923,3,0.000172,0,16,0.690909,0.008961
40093,Major County,,OK,597,8288,8885,3,4,7,807,1036,1843,6,0.311914,0.323666,1.196037,0.000058,0.000416,3,0.000098,0,16,0.75,0.00068
40095,Marshall County,,OK,1162,14449,15611,7,8,15,1987,2273,4260,6,0.317938,0.331512,194.779649,0.000571,0.001017,91,0.000143,0,16,0.696429,0.005709
40097,Mayes County,,OK,2940,42665,45605,12,14,26,6948,7472,14420,5,0.316345,0.329922,27.247278,0.000903,0.001126,3,0.000203,0,16,0.72381,0.008935
40099,Murray County,,OK,1047,12804,13851,6,6,12,2305,2164,4469,6,0.312011,0.324051,18.442481,0.000516,0.000527,3,0.00013,0,16,0.9,0.005179
40101,Muskogee County,,OK,4465,72415,76880,19,21,40,10507,12120,22627,5,0.346488,0.365533,720.802943,0.003461,0.003109,3,0.000263,0,16,0.586957,0.033016
40103,Noble County,,OK,1046,12058,13104,6,7,13,1980,2226,4206,5,0.315357,0.327803,2.022136,0.000471,0.000778,3,0.000121,0,16,0.833333,0.004729
40105,Nowata County,,OK,1019,11066,12085,4,4,8,1835,1973,3808,6,0.310444,0.321503,0.5,0.000351,0.000342,3,0.000097,0,16,0.916667,0.00333
40107,Okfuskee County,,OK,953,10599,11552,8,8,16,1944,2245,4189,5,0.315258,0.327748,2.034524,0.000687,0.000708,3,0.000153,0,16,0.785714,0.006861
40109,Oklahoma County,,OK,48856,735753,784609,278,227,505,169960,164241,334201,5,0.452833,0.491812,161936.124368,0.061776,0.056323,3,0.002801,0,16,0.265834,0.552025
40111,Okmulgee County,,OK,2969,39672,42641,13,14,27,7055,7391,14446,5,0.315521,0.328849,8.958171,0.000948,0.000941,3,0.000208,0,16,0.708791,0.009265
40113,Osage County,,OK,3968,43862,47830,10,10,20,12123,11786,23909,5,0.315422,0.328244,2.410319,0.000923,0.000902,3,0.000169,0,16,0.866667,0.008842
40115,Ottawa County,,OK,2273,33593,35866,14,14,28,5042,5708,10750,5,0.316642,0.330417,344.71401,0.000931,0.001131,3,0.000247,0,16,0.529167,0.009826
40117,Pawnee County,,OK,1502,16321,17823,7,8,15,3946,4134,8080,5,0.315324,0.327858,3.239832,0.000728,0.000745,3,0.000137,0,16,0.821429,0.007059
40119,Payne County,,OK,6886,64091,70977,41,37,78,14515,16647,31162,5,0.374367,0.39808,3656.1291,0.006517,0.008696,3,0.000545,0,16,0.363552,0.063192
40121,Pittsburg County,,OK,2876,45759,48635,19,22,41,5423,6425,11848,5,0.346013,0.365065,2710.973145,0.001998,0.003365,3,0.000297,0,16,0.452569,0.020005
40123,Pontotoc County,,OK,2547,37867,40414,17,18,35,5508,6121,11629,5,0.337983,0.355491,4226.749633,0.001973,0.002188,3,0.000292,0,16,0.488304,0.019614
40125,Pottawatomie County,,OK,4839,69890,74729,22,19,41,14264,13738,28002,5,0.359653,0.379757,844.416555,0.002978,0.002985,3,0.000328,0,16,0.501976,0.028597
40127,Pushmataha County,,OK,768,11325,12093,7,7,14,1218,1595,2813,6,0.312268,0.324546,280.825883,0.000385,0.000407,91,0.00015,0,16,0.619048,0.004139
40129,Roger Mills County,,OK,318,3864,4182,1,2,3,489,479,968,6,0.251536,0.258254,0,0.000004,0.00001,3,0.000072,0,16,1,0.000106
40131,Rogers County,,OK,6947,93504,100451,26,22,48,21842,20889,42731,5,0.363015,0.383878,1315.248275,0.00305,0.003141,3,0.000371,0,16,0.476601,0.029371
40133,Seminole County,,OK,1833,23825,25658,8,9,17,4484,4798,9282,5,0.315357,0.328024,2.296825,0.000829,0.000885,3,0.000154,0,16,0.819444,0.008007
40135,Sequoyah County,,OK,2495,41919,44414,13,13,26,5725,6000,11725,5,0.316708,0.33028,32.050329,0.001191,0.001201,3,0.000207,0,16,0.653846,0.011661
40137,Stephens County,,OK,2874,46547,49421,15,17,32,5562,5927,11489,5,0.346449,0.36501,3669.997144,0.00281,0.003039,3,0.000252,0,16,0.545752,0.027328
40139,Texas County,,OK,2105,24123,26228,12,10,22,2725,2676,5401,5,0.321892,0.336343,6256.176384,0.002181,0.001007,32,0.000254,0,16,0.39011,0.020643
40141,Tillman County,,OK,693,7915,8608,3,5,8,574,984,1558,5,0.316213,0.328662,1.237466,0.00029,0.000615,3,0.000076,0,16,0.9,0.00244
40143,Tulsa County,,OK,40567,650900,691467,209,198,407,134290,131735,266025,5,0.44974,0.485842,95167.768344,0.050864,0.052092,3,0.002107,0,16,0.326629,0.45345
40145,Wagoner County,,OK,7097,73408,80505,20,21,41,25012,21868,46880,5,0.362711,0.383531,479.865528,0.003018,0.0042,3,0.000276,0,16,0.583004,0.03022
40147,Washington County,,OK,3953,57320,61273,20,19,39,8250,8730,16980,5,0.347243,0.365786,566.8799,0.003111,0.002965,3,0.000283,0,16,0.551948,0.030235
40149,Washita County,,OK,1228,11710,12938,5,7,12,2445,2718,5163,6,0.312011,0.324161,0.690476,0.000353,0.000558,3,0.000138,0,16,0.857143,0.003751
40151,Woods County,,OK,687,8240,8927,4,5,9,529,925,1454,6,0.312171,0.324188,121.483685,0.000393,0.000421,3,0.000111,0,16,0.45,0.004015
40153,Woodward County,,OK,1554,21446,23000,10,13,23,2169,2728,4897,5,0.315883,0.329289,17566.272003,0.00108,0.000941,3,0.000323,0,16,0.362637,0.010805
41001,Baker County,,OR,1123,17248,18371,8,9,17,1289,1552,2841,6,0.313302,0.326857,3.13679,0.001252,0.001341,17,0.000125,0,16,0.9,0.011953
41003,Benton County,,OR,8013,82527,90540,45,43,88,18979,23120,42099,5,0.372662,0.396715,423.218987,0.011777,0.012537,17,0.000402,0,16,0.732941,0.1069
41005,Clackamas County,,OR,29370,409814,439184,107,99,206,113383,103720,217103,5,0.393632,0.424915,4912.749317,0.027708,0.028064,17,0.000917,0,16,0.537376,0.252308
41007,Clatsop County,,OR,3231,37780,41011,22,21,43,5928,6216,12144,5,0.355558,0.374871,66.464912,0.005124,0.004815,17,0.000234,0,16,0.836923,0.047795
41009,Columbia County,,OR,3320,54738,58058,16,16,32,8581,8311,16892,5,0.355141,0.37377,0.566101,0.004471,0.004072,17,0.000177,0,16,0.966912,0.041666
41011,Coos County,,OR,3965,64910,68875,30,25,55,8328,8233,16561,5,0.358631,0.37886,12.396573,0.007988,0.005994,17,0.000283,0,16,0.854839,0.072528
41013,Crook County,,OR,1921,22502,24423,9,10,19,3412,4004,7416,6,0.310348,0.323468,0.569891,0.001457,0.001433,17,0.000125,0,16,0.945455,0.014036
41015,Curry County,,OR,1668,23130,24798,17,13,30,3269,2950,6219,5,0.350782,0.368515,13.878637,0.004165,0.002303,17,0.000185,0,16,0.889474,0.038215
41017,Deschutes County,,OR,12820,169933,182753,94,85,179,39646,35085,74731,5,0.372938,0.401772,18605.200039,0.019187,0.018438,17,0.000912,0,16,0.493168,0.175028
41019,Douglas County,,OR,5979,112909,118888,39,33,72,12916,13620,26536,5,0.35991,0.381336,28.285632,0.009738,0.008289,17,0.000349,0,16,0.79939,0.087308
41021,Gilliam County,,OR,222,1982,2204,0,0,0,0,0,0,0,0,0,0,0,0,67,0.000049,53,97,0,0
41023,Grant County,,OR,539,7523,8062,1,1,2,93,168,261,6,0.271659,0.281457,0,0.000109,0.000113,17,0.000058,0,16,0,0.001096
41025,Harney County,,OR,590,7688,8278,2,1,3,300,251,551,6,0.271659,0.281457,0.313131,0.000116,0.000113,17,0.000071,0,16,0.5,0.001246
41027,Hood River County,,OR,1519,25260,26779,10,9,19,3449,3646,7095,6,0.327283,0.341482,30.853089,0.002315,0.001797,17,0.000149,0,16,0.8,0.02196
41029,Jackson County,,OR,11353,222544,233897,80,70,150,33082,29615,62697,5,0.370747,0.39808,393.8518,0.018844,0.018252,17,0.000655,0,16,0.637255,0.17047
41031,Jefferson County,,OR,2034,22418,24452,8,10,18,3341,3929,7270,5,0.346488,0.36287,12.105697,0.001241,0.002203,17,0.000118,0,16,0.963636,0.012072
41033,Josephine County,,OR,4952,86117,91069,37,29,66,12871,11337,24208,5,0.358759,0.379465,37.395287,0.010348,0.007652,17,0.000325,0,16,0.81309,0.09219
41035,Klamath County,,OR,4469,69724,74193,36,32,68,8479,9205,17684,5,0.359824,0.381171,2452.734956,0.008841,0.007794,17,0.000349,0,16,0.710897,0.079507
41037,Lake County,,OR,599,7902,8501,2,3,5,540,453,993,6,0.286647,0.297876,0,0.000155,0.000335,17,0.000067,0,16,1,0.001624
41039,Lane County,,OR,19197,368444,387641,116,111,227,53987,55734,109721,5,0.401192,0.433966,6588.244291,0.028885,0.03054,17,0.000971,0,16,0.51706,0.262493
41041,Lincoln County,,OR,3776,46504,50280,30,24,54,8862,8738,17600,5,0.357996,0.378007,67.889476,0.007695,0.005301,17,0.000289,0,16,0.816532,0.070147
41043,Linn County,,OR,8098,124319,132417,42,32,74,25278,22871,48149,5,0.359739,0.381006,202.01366,0.010933,0.008305,17,0.000379,0,16,0.743632,0.098449
41045,Malheur County,,OR,2271,29066,31337,9,11,20,3526,4603,8129,6,0.313951,0.327958,598.694757,0.001483,0.001184,17,0.000167,0,16,0.544872,0.01429
41047,Marion County,,OR,18342,340096,358438,73,76,149,60391,59637,120028,5,0.380003,0.40849,1836.15605,0.017669,0.019353,17,0.000634,0,16,0.6005,0.160943
41049,Morrow County,,OR,926,12484,13410,2,4,6,1619,2061,3680,6,0.29557,0.307907,0,0.000118,0.000381,17,0.000069,0,16,0.916667,0.001371
41051,Multnomah County,,OR,55399,771470,826869,279,227,506,223284,206866,430150,5,0.447746,0.487614,48056.220453,0.069735,0.06074,17,0.00226,0,16,0.325425,0.599013
41053,Polk County,,OR,6869,77292,84161,26,26,52,21362,21487,42849,5,0.358971,0.37941,61.784389,0.00698,0.006794,17,0.000258,0,16,0.865591,0.06394
41055,Sherman County,,OR,139,1912,2051,1,1,2,106,135,241,7,0.246681,0.252578,0,0.000012,0.000012,17,0.000064,0,16,0,0.000182
41057,Tillamook County,,OR,1869,26717,28586,14,13,27,3624,3412,7036,6,0.310539,0.324128,0.156571,0.00257,0.001754,17,0.000164,0,16,0.97619,0.024466
41059,Umatilla County,,OR,4617,79751,84368,39,34,73,11579,11479,23058,5,0.358801,0.380291,2323.972452,0.007024,0.005986,17,0.000414,0,16,0.537166,0.065725
41061,Union County,,OR,2019,27823,29842,14,15,29,2840,3091,5931,6,0.315324,0.330048,3139.808221,0.001661,0.001989,17,0.000187,0,16,0.704167,0.016072
41063,Wallowa County,,OR,519,7947,8466,1,3,4,109,400,509,6,0.27205,0.282354,0,0.000012,0.000164,17,0.00006,0,16,1,0.000163
41065,Wasco County,,OR,1711,25911,27622,13,12,25,3902,3399,7301,6,0.327424,0.342033,6072.515861,0.002071,0.002109,17,0.000214,0,16,0.737179,0.019952
41067,Washington County,,OR,41191,583038,624229,194,163,357,151997,141544,293541,5,0.427342,0.463464,17863.948731,0.051959,0.046158,17,0.001586,0,16,0.407009,0.458094
41069,Wheeler County,,OR,152,1274,1426,0,0,0,0,0,0,0,0,0,0,0,0,68,0.000049,54,98,0,0
41071,Yamhill County,,OR,6306,102850,109156,30,32,62,18718,18245,36963,5,0.359952,0.381253,81.355548,0.007497,0.007914,17,0.000293,0,16,0.819073,0.068577
42001,Adams County,,PA,5854,124535,130389,20,21,41,16061,16124,32185,5,0.343619,0.361896,142.870188,0.005385,0.005797,69,0.000177,0,16,0.750988,0.043612
42003,Allegheny County,,PA,49375,1454650,1504025,324,300,624,174828,173549,348377,5,0.460404,0.505596,151034.457003,0.08227,0.07982,69,0.002478,0,16,0.295821,0.686369
42005,Armstrong County,,PA,3282,84970,88252,8,9,17,9520,9032,18552,6,0.315652,0.329405,2.555206,0.000745,0.000835,69,0.000125,0,16,0.791667,0.006349
42007,Beaver County,,PA,7493,212644,220137,23,26,49,18743,18015,36758,5,0.36939,0.391411,719.785655,0.006383,0.007815,69,0.000214,0,16,0.634483,0.053433
42009,Bedford County,,PA,2012,62540,64552,10,11,21,3859,4413,8272,6,0.316444,0.330725,189.032132,0.001076,0.000964,69,0.000133,0,16,0.660256,0.008741
42011,Berks County,,PA,17882,503572,521454,78,106,184,51125,53140,104265,5,0.400397,0.432508,1341.72419,0.027559,0.038394,69,0.000486,0,16,0.711289,0.220929
42013,Blair County,,PA,4270,151534,155804,19,19,38,9006,8472,17478,5,0.356395,0.376059,208.821726,0.002618,0.003609,69,0.000185,0,16,0.660173,0.020068
42015,Bradford County,,PA,2941,74931,77872,15,14,29,5905,5863,11768,6,0.313204,0.328942,1681.964974,0.002275,0.001088,57,0.0002,0,16,0.349265,0.01821
42017,Bucks County,,PA,33024,787954,820978,134,167,301,110322,111876,222198,5,0.416129,0.454215,4450.986927,0.048237,0.056102,69,0.000851,0,16,0.587827,0.398656
42019,Butler County,,PA,9550,225364,234914,41,41,82,26873,24467,51340,5,0.385271,0.409976,2418.395165,0.011498,0.012962,69,0.000335,0,16,0.571373,0.095176
42021,Cambria County,,PA,5537,170275,175812,23,25,48,10532,11957,22489,5,0.357869,0.378502,408.119639,0.004573,0.005966,69,0.000222,0,16,0.589947,0.038059
42023,Cameron County,,PA,298,6467,6765,2,2,4,134,249,383,7,0.240817,0.247191,0,0.000011,0.00001,69,0.000078,0,16,1,0.000218
42025,Carbon County,,PA,3755,77093,80848,18,14,32,11918,10136,22054,6,0.321892,0.337785,0.625753,0.005311,0.003484,69,0.000135,0,16,0.965789,0.038631
42027,Centre County,,PA,9112,139283,148395,66,83,149,16170,19619,35789,5,0.397246,0.426868,5664.301525,0.017486,0.026462,69,0.0005,0,16,0.514756,0.144721
42029,Chester County,,PA,28058,593318,621376,138,154,292,96376,91028,187404,5,0.417045,0.453395,3239.98673,0.048419,0.052857,69,0.0009,0,16,0.597246,0.402235
42031,Clarion County,,PA,1943,44951,46894,11,12,23,3874,4538,8412,6,0.315751,0.3299,10.318372,0.000908,0.000835,69,0.000158,0,16,0.643939,0.007563
42033,Clearfield County,,PA,3413,94736,98149,14,15,29,7492,7607,15099,6,0.316708,0.331688,42.613257,0.001491,0.001535,69,0.000174,0,16,0.604167,0.011444
42035,Clinton County,,PA,1900,43211,45111,5,6,11,3710,3728,7438,6,0.316279,0.329982,0,0.000674,0.001172,69,0.000081,0,16,1,0.004717
42037,Columbia County,,PA,3137,73188,76325,16,19,35,7509,7545,15054,6,0.319279,0.335336,82.566184,0.002724,0.003219,69,0.000156,0,16,0.814286,0.019574
42039,Crawford County,,PA,3993,102142,106135,13,13,26,8217,8803,17020,6,0.319481,0.334456,18.422748,0.00159,0.001408,69,0.000151,0,16,0.685897,0.0124
42041,Cumberland County,,PA,15584,284140,299724,87,86,173,48600,44348,92948,5,0.395999,0.425933,8910.378498,0.02712,0.030017,69,0.000637,0,16,0.589983,0.227752
42043,Dauphin County,,PA,18156,328765,346921,97,102,199,49923,54707,104630,5,0.397977,0.429867,9405.399873,0.03107,0.033149,69,0.000667,0,16,0.587465,0.254516
42045,Delaware County,,PA,30138,656936,687074,112,123,235,100396,104965,205361,5,0.411046,0.444531,1604.980788,0.041594,0.04575,69,0.00072,0,16,0.736171,0.342613
42047,Elk County,,PA,1138,42379,43517,6,7,13,1665,1849,3514,6,0.315817,0.32946,2485.941196,0.000655,0.000737,69,0.000135,0,16,0.619048,0.005602
42049,Erie County,,PA,10095,324325,334420,68,83,151,18481,21629,40110,5,0.40082,0.430269,9285.193708,0.021735,0.027946,69,0.000549,0,16,0.534829,0.184253
42051,Fayette County,,PA,5001,158434,163435,13,15,28,11204,12634,23838,5,0.343775,0.361472,1212.279298,0.002123,0.002719,69,0.000182,0,16,0.455882,0.017004
42053,Forest County,,PA,370,5642,6012,4,5,9,649,734,1383,6,0.315422,0.328579,0.658333,0.000484,0.000506,69,0.000095,0,16,0.75,0.00437
42055,Franklin County,,PA,6824,189577,196401,36,36,72,17777,15662,33439,5,0.364808,0.387257,3676.270715,0.008112,0.008418,69,0.000307,0,16,0.542973,0.065916
42057,Fulton County,,PA,767,18852,19619,4,5,9,1663,1789,3452,6,0.270567,0.280015,4.806926,0.000127,0.000111,69,0.000083,0,16,0.55,0.001171
42059,Greene County,,PA,1795,41954,43749,6,7,13,3597,4143,7740,6,0.316477,0.330219,45.322931,0.000762,0.000688,69,0.000107,0,16,0.714286,0.006098
42061,Huntingdon County,,PA,1772,50927,52699,11,14,25,3859,4359,8218,6,0.316874,0.331688,149.933459,0.001089,0.001442,69,0.000136,0,16,0.675824,0.008149
42063,Indiana County,,PA,4077,96065,100142,16,17,33,7494,8801,16295,6,0.319077,0.334924,78.156779,0.002009,0.001851,69,0.000182,0,16,0.509524,0.015902
42065,Jefferson County,,PA,2457,55432,57889,12,8,20,5476,5183,10659,6,0.315685,0.32935,9.955808,0.001066,0.000746,69,0.000161,0,16,0.628788,0.008463
42067,Juniata County,,PA,936,29087,30023,8,6,14,2467,2189,4656,6,0.294049,0.30613,0.656554,0.000869,0.000565,69,0.000111,0,16,0.910714,0.006616
42069,Lackawanna County,,PA,8895,248754,257649,56,65,121,23834,25200,49034,5,0.38444,0.411626,4053.712888,0.01777,0.021997,69,0.000379,0,16,0.732797,0.138626
42071,Lancaster County,,PA,19457,648996,668453,116,139,255,56553,56141,112694,5,0.414024,0.449059,16981.256432,0.034886,0.044448,69,0.000796,0,16,0.530143,0.285431
42073,Lawrence County,,PA,3598,107814,111412,10,13,23,7659,8482,16141,5,0.350985,0.369214,59.927772,0.001159,0.00275,69,0.000119,0,16,0.711538,0.008885
42075,Lebanon County,,PA,6650,168636,175286,28,27,55,19140,17127,36267,5,0.356102,0.37673,172.467275,0.007797,0.007218,69,0.000207,0,16,0.762923,0.05919
42077,Lehigh County,,PA,22821,419725,442546,102,127,229,76141,74618,150759,5,0.409656,0.443722,1728.961805,0.036637,0.045642,69,0.00063,0,16,0.699341,0.296258
42079,Luzerne County,,PA,12086,377526,389612,78,92,170,38034,35022,73056,5,0.392714,0.42317,8960.002134,0.02386,0.030728,69,0.000507,0,16,0.653659,0.185874
42081,Lycoming County,,PA,4518,137547,142065,29,29,58,10006,10278,20284,5,0.360424,0.381308,5871.702194,0.0052,0.005663,69,0.000287,0,16,0.534274,0.040745
42083,McKean County,,PA,1769,49988,51757,10,12,22,2573,2812,5385,6,0.316974,0.331826,3678.577458,0.001104,0.001045,69,0.000182,0,16,0.386364,0.009029
42085,Mercer County,,PA,5236,137766,143002,16,20,36,10992,11266,22258,5,0.363451,0.383735,252.858617,0.002488,0.004095,69,0.000163,0,16,0.640693,0.0196
42087,Mifflin County,,PA,1703,56110,57813,10,11,21,3452,3356,6808,6,0.316444,0.330808,20.097707,0.001041,0.001362,69,0.00013,0,16,0.781818,0.007698
42089,Monroe County,,PA,10868,187999,198867,54,67,121,32748,31180,63928,5,0.378105,0.405486,238.56884,0.017047,0.022347,69,0.000318,0,16,0.7768,0.128124
42091,Montgomery County,,PA,47775,961246,1009021,178,198,376,172727,169191,341918,5,0.431543,0.471173,9459.592851,0.059619,0.064607,69,0.001177,0,16,0.529103,0.498563
42093,Montour County,,PA,1483,22001,23484,10,6,16,3692,3227,6919,6,0.28253,0.293606,8.401303,0.001555,0.000222,69,0.000119,0,16,0.866667,0.011916
42095,Northampton County,,PA,17772,359243,377015,69,97,166,59110,57416,116526,5,0.394196,0.425217,759.220401,0.024248,0.034591,69,0.000421,0,16,0.753131,0.19182
42097,Northumberland County,,PA,4592,110341,114933,20,20,40,12504,12312,24816,6,0.319279,0.335446,127.874256,0.003645,0.00309,69,0.000181,0,16,0.748918,0.026966
42099,Perry County,,PA,2635,57754,60389,10,9,19,7576,7507,15083,6,0.294793,0.307505,5.200793,0.000985,0.000846,69,0.000127,0,16,0.766667,0.007653
42101,Philadelphia County,,PA,75974,1502490,1578464,262,261,523,261238,291842,553080,5,0.450409,0.493898,26606.441604,0.077488,0.076336,69,0.001752,0,16,0.398419,0.639913
42103,Pike County,,PA,4036,65900,69936,31,33,64,13718,11098,24816,5,0.331836,0.351172,8.784669,0.008594,0.008808,69,0.000186,0,16,0.845378,0.059702
42105,Potter County,,PA,1116,20176,21292,5,5,10,1522,1512,3034,6,0.315751,0.32913,11.758891,0.000292,0.000518,69,0.000106,0,16,0.5,0.002224
42107,Schuylkill County,,PA,5746,175757,181503,25,23,48,15606,14502,30108,5,0.353814,0.373413,44.030958,0.005893,0.004646,69,0.000186,0,16,0.858974,0.04378
42109,Snyder County,,PA,2031,44872,46903,11,14,25,5090,4888,9978,6,0.316576,0.331358,63.023362,0.000729,0.001428,69,0.000155,0,16,0.692308,0.005901
42111,Somerset County,,PA,2818,91964,94782,11,11,22,5621,5805,11426,6,0.316378,0.330753,29.076195,0.000992,0.000923,69,0.00015,0,16,0.530303,0.008244
42113,Sullivan County,,PA,382,7215,7597,2,2,4,534,784,1318,6,0.265492,0.273638,0,0.00004,0.000044,57,0.00007,0,16,1,0.000483
42115,Susquehanna County,,PA,2449,50809,53258,9,7,16,6477,5890,12367,6,0.285056,0.297023,36.592255,0.001292,0.0004,69,0.000124,0,16,0.625,0.009533
42117,Tioga County,,PA,1880,47602,49482,12,8,20,3747,3192,6939,6,0.317007,0.331441,49.027052,0.001701,0.001124,57,0.000145,0,16,0.480769,0.012426
42119,Union County,,PA,2534,42813,45347,11,10,21,5261,5728,10989,6,0.316312,0.330505,51.451819,0.001531,0.001218,69,0.000132,0,16,0.856061,0.011675
42121,Venango County,,PA,2464,66740,69204,12,12,24,5083,5294,10377,6,0.315751,0.3299,12.25144,0.000961,0.000881,69,0.000161,0,16,0.653846,0.0079
42123,Warren County,,PA,1687,49853,51540,8,7,15,2882,2953,5835,6,0.315718,0.329295,10.043116,0.000704,0.000673,69,0.000131,0,16,0.642857,0.0061
42125,Washington County,,PA,9178,251267,260445,37,44,81,26750,27334,54084,5,0.386401,0.411423,5959.448861,0.009211,0.013073,69,0.000377,0,16,0.47619,0.08001
42127,Wayne County,,PA,3097,58069,61166,26,16,42,10624,7549,18173,6,0.327849,0.344707,70.265913,0.007636,0.004022,69,0.000177,0,16,0.851852,0.05483
42129,Westmoreland County,,PA,15152,454816,469968,58,71,129,44672,45245,89917,5,0.393326,0.421382,6080.124478,0.016731,0.023421,69,0.000488,0,16,0.561053,0.142846
42131,Wyoming County,,PA,1883,34289,36172,4,4,8,4953,6369,11322,6,0.282688,0.293496,0,0.000319,0.000266,69,0.000086,0,16,1,0.002286
42133,York County,,PA,20005,544021,564026,100,109,209,63420,58760,122180,5,0.399025,0.431545,9388.607283,0.031967,0.034728,69,0.000694,0,16,0.541714,0.266089
44001,Bristol County,,RI,3365,55997,59362,11,12,23,7652,8148,15800,6,0.323611,0.339342,0,0.0033,0.003601,54,0.000107,0,16,1,0.025932
44003,Kent County,,RI,11755,204275,216030,33,50,83,36264,36635,72899,5,0.382064,0.407307,153.463446,0.012925,0.020246,54,0.000239,0,16,0.885882,0.10717
44005,Newport County,,RI,8067,92830,100897,46,43,89,15457,17753,33210,5,0.365865,0.389182,138.978642,0.017832,0.016848,54,0.000327,0,16,0.775421,0.149978
44007,Providence County,,RI,32756,702368,735124,127,165,292,87338,106124,193462,5,0.423399,0.460466,2714.677636,0.046546,0.056292,54,0.000809,0,16,0.60719,0.386025
44009,Washington County,,RI,7599,146435,154034,30,40,70,20128,20992,41120,5,0.373305,0.397122,84.491408,0.010255,0.015042,54,0.000216,0,16,0.853066,0.082891
45001,Abbeville County,,SC,1387,27192,28579,6,6,12,3444,4014,7458,6,0.309619,0.322147,13.714918,0.000535,0.000799,58,0.00012,0,16,0.761905,0.005504
45003,Aiken County,,SC,8694,172971,181665,49,44,93,24141,22381,46522,5,0.378909,0.40367,4903.894541,0.014582,0.013189,58,0.000499,0,16,0.585994,0.131545
45005,Allendale County,,SC,685,9689,10374,4,4,8,959,1372,2331,6,0.30433,0.316403,1.0006,0.000419,0.000431,58,0.000092,0,16,0.75,0.003922
45007,Anderson County,,SC,9622,205849,215471,48,37,85,28350,26194,54544,5,0.35991,0.382057,1554.908168,0.013401,0.010733,58,0.000468,0,16,0.600816,0.123059
45009,Bamberg County,,SC,960,14989,15949,6,6,12,1601,2185,3786,6,0.304422,0.316788,16.446223,0.001141,0.000648,58,0.000106,0,16,0.809524,0.010261
45011,Barnwell County,,SC,1347,23945,25292,7,7,14,2705,3082,5787,6,0.310571,0.323347,5.736298,0.000623,0.00106,58,0.000129,0,16,0.696429,0.006019
45013,Beaufort County,,SC,14726,165052,179778,143,109,252,37910,33534,71444,5,0.414591,0.446506,3994.138134,0.049418,0.039932,4,0.001029,0,16,0.585947,0.415863
45015,Berkeley County,,SC,19668,181535,201203,104,80,184,64079,58827,122906,5,0.400344,0.429482,2734.290592,0.036836,0.028586,58,0.000804,0,16,0.631329,0.320878
45017,Calhoun County,,SC,1024,15883,16907,3,3,6,2477,2613,5090,6,0.304147,0.316017,0,0.000529,0.000547,58,0.000074,0,16,1,0.004854
45019,Charleston County,,SC,30591,351715,382306,243,188,431,106903,100227,207130,5,0.437907,0.475735,21460.466344,0.07103,0.059981,58,0.001856,0,16,0.423167,0.605779
45021,Cherokee County,,SC,2705,59781,62486,11,11,22,6944,6854,13798,5,0.322337,0.337576,26.110453,0.001862,0.002175,58,0.00015,0,16,0.742424,0.018199
45023,Chester County,,SC,2254,37121,39375,7,10,17,4942,5883,10825,5,0.322303,0.337411,29.345764,0.001149,0.002105,58,0.000125,0,16,0.777778,0.011392
45025,Chesterfield County,,SC,2093,47848,49941,12,12,24,4851,5073,9924,5,0.322063,0.337328,20.283141,0.001494,0.001692,58,0.00017,0,16,0.651515,0.014971
45027,Clarendon County,,SC,1997,34968,36965,10,10,20,4059,4634,8693,6,0.313334,0.327077,0.667144,0.001632,0.001689,58,0.000134,0,16,0.909091,0.016031
45029,Colleton County,,SC,2395,42531,44926,12,14,26,4708,5305,10013,5,0.322749,0.338566,38.354605,0.002043,0.00308,58,0.000163,0,16,0.738095,0.020209
45031,Darlington County,,SC,3913,74413,78326,18,17,35,9379,10030,19409,5,0.325839,0.342286,74.979412,0.002478,0.003245,58,0.000222,0,16,0.625731,0.024603
45033,Dillon County,,SC,1561,34339,35900,9,10,19,3272,3833,7105,5,0.325384,0.34091,20.156311,0.00162,0.002132,58,0.000127,0,16,0.763636,0.014944
45035,Dorchester County,,SC,14654,141508,156162,74,58,132,50079,42063,92142,5,0.384488,0.411483,1149.803852,0.02678,0.021255,58,0.000599,0,16,0.67028,0.23664
45037,Edgefield County,,SC,1643,25402,27045,7,7,14,4802,5314,10116,6,0.305867,0.318989,4.680306,0.000948,0.000956,58,0.000119,0,16,0.857143,0.008699
45039,Fairfield County,,SC,1421,25573,26994,7,6,13,3182,4014,7196,6,0.304361,0.316733,4.786791,0.001159,0.000737,58,0.000119,0,16,0.761905,0.01135
45041,Florence County,,SC,7812,147754,155566,42,40,82,20484,20378,40862,5,0.361974,0.385111,1139.287764,0.010225,0.011147,58,0.000415,0,16,0.584541,0.094576
45043,Georgetown County,,SC,3801,69067,72868,15,13,28,7971,8951,16922,5,0.330172,0.346814,9.926195,0.003952,0.003832,58,0.000172,0,16,0.875,0.037422
45045,Greenville County,,SC,27039,486989,514028,204,160,364,93500,81036,174536,5,0.432344,0.467883,23155.915338,0.059853,0.050925,58,0.001582,0,16,0.437962,0.507445
45047,Greenwood County,,SC,3400,76168,79568,21,19,40,9058,9591,18649,5,0.330821,0.348933,303.748671,0.00332,0.003467,58,0.000273,0,16,0.616667,0.032134
45049,Hampton County,,SC,1167,21734,22901,7,10,17,1905,2544,4449,5,0.314571,0.328238,74.396792,0.00135,0.001639,4,0.000124,0,16,0.654545,0.01278
45051,Horry County,,SC,17578,287087,304665,224,163,387,61779,44534,106313,5,0.419065,0.456575,17761.655097,0.054692,0.046749,58,0.001614,0,16,0.342687,0.444845
45053,Jasper County,,SC,1829,21596,23425,7,7,14,5752,4771,10523,5,0.314473,0.327743,7.439056,0.001294,0.001435,4,0.000113,0,16,0.738095,0.012406
45055,Kershaw County,,SC,3789,67822,71611,18,16,34,10216,9760,19976,5,0.322783,0.338786,61.594795,0.003041,0.002863,58,0.000225,0,16,0.730994,0.029989
45057,Lancaster County,,SC,3784,75973,79757,20,15,35,14420,10530,24950,5,0.322646,0.338511,24.63654,0.004891,0.002929,58,0.00022,0,16,0.747619,0.045701
45059,Laurens County,,SC,3994,70583,74577,13,11,24,10820,11498,22318,5,0.322371,0.337741,40.510913,0.001951,0.002102,58,0.000178,0,16,0.685897,0.018703
45061,Lee County,,SC,1384,18993,20377,5,6,11,2670,3609,6279,6,0.304698,0.317063,0,0.000526,0.000695,58,0.000097,0,16,1,0.004862
45063,Lexington County,,SC,16916,282892,299808,98,86,184,61981,53212,115193,5,0.400608,0.430527,12691.07516,0.028999,0.027123,58,0.000889,0,16,0.517681,0.258512
45065,McCormick County,,SC,564,10151,10715,5,5,10,919,1112,2031,6,0.295772,0.30756,9.85904,0.000462,0.000451,58,0.000104,0,16,0.6,0.004281
45067,Marion County,,SC,2151,36170,38321,6,9,15,3970,4857,8827,5,0.325105,0.340387,1.419688,0.000727,0.002207,58,0.000104,0,16,0.847222,0.00681
45069,Marlboro County,,SC,1470,29680,31150,9,12,21,2805,3656,6461,5,0.325454,0.34124,14.974568,0.00126,0.002164,58,0.000133,0,16,0.679487,0.0114
45071,Newberry County,,SC,1896,41957,43853,11,11,22,4355,4876,9231,6,0.312011,0.325691,21.117607,0.001401,0.001535,58,0.00017,0,16,0.674242,0.013732
45073,Oconee County,,SC,3631,80266,83897,19,14,33,7437,7735,15172,5,0.33028,0.347612,49.528914,0.004674,0.003257,58,0.000225,0,16,0.719048,0.044646
45075,Orangeburg County,,SC,5362,96422,101784,28,29,57,11165,14187,25352,5,0.351596,0.371811,683.053135,0.007236,0.007556,58,0.000301,0,16,0.643494,0.066125
45077,Pickens County,,SC,8194,119541,127735,21,29,50,19973,22085,42058,5,0.36124,0.382717,91.680063,0.005056,0.009326,58,0.000238,0,16,0.809195,0.048154
45079,Richland County,,SC,31742,377511,409253,199,194,393,107848,104283,212131,5,0.436833,0.475388,53080.315947,0.056544,0.055157,58,0.001642,0,16,0.415089,0.488776
45081,Saluda County,,SC,1209,20888,22097,8,7,15,3916,3725,7641,6,0.309714,0.322367,12.397404,0.00064,0.000976,58,0.000131,0,16,0.555556,0.006183
45083,Spartanburg County,,SC,13937,313663,327600,77,72,149,40850,38506,79356,5,0.396103,0.424397,5239.7181,0.022987,0.023137,58,0.000688,0,16,0.554648,0.206843
45085,Sumter County,,SC,8416,117388,125804,59,53,112,15253,16866,32119,5,0.383952,0.409943,2488.592494,0.016685,0.016895,58,0.000533,0,16,0.553924,0.152041
45087,Union County,,SC,1284,31036,32320,6,8,14,2055,2957,5012,6,0.309619,0.322367,2.442119,0.000604,0.001058,58,0.000111,0,16,0.714286,0.00641
45089,Williamsburg County,,SC,1925,36061,37986,9,13,22,3847,5246,9093,5,0.32268,0.338291,18.786805,0.001921,0.002584,58,0.000129,0,16,0.818681,0.018447
45091,York County,,SC,13427,250708,264135,107,72,179,47030,35920,82950,5,0.397768,0.426032,5913.867388,0.033879,0.022573,58,0.000878,0,16,0.560228,0.295763
46003,Aurora County,,SD,197,3410,3607,1,1,2,193,193,386,7,0.224553,0.230044,0,0.000001,0.000005,18,0.000084,0,16,0,0.000126
46005,Beadle County,,SD,1086,19425,20511,10,12,22,1242,1721,2963,6,0.311818,0.325025,9603.180925,0.000395,0.00048,18,0.000383,0,16,0.429487,0.004075
46007,Bennett County,,SD,211,3162,3373,1,1,2,63,139,202,6,0.282899,0.292044,0,0.000089,0.000082,18,0.000067,0,16,0,0.000839
46009,Bon Homme County,,SD,404,7144,7548,2,2,4,505,559,1064,6,0.28643,0.296418,0,0.000105,0.000096,18,0.000087,0,16,1,0.001053
46011,Brookings County,,SD,2918,30249,33167,21,18,39,4398,5191,9589,5,0.357953,0.377539,10092.575512,0.001884,0.001662,18,0.0005,0,16,0.291667,0.018094
46013,Brown County,,SD,2283,43205,45488,23,20,43,4215,3926,8141,5,0.359312,0.379383,28227.375281,0.003186,0.002084,18,0.000705,0,16,0.278333,0.029708
46015,Brule County,,SD,437,6059,6496,3,4,7,407,568,975,6,0.286457,0.296748,6350.818795,0.000103,0.000098,18,0.0002,0,16,0.166667,0.001138
46017,Buffalo County,,SD,189,1941,2130,1,0,1,42,0,42,0,0,0,0,0.000001,0,18,0.000092,0,3,0,0.000071
46019,Butte County,,SD,1017,11040,12057,5,5,10,1960,1906,3866,6,0.283296,0.293282,30.75034,0.000134,0.000159,18,0.000177,0,16,0.85,0.001822
46021,Campbell County,,SD,83,1806,1889,0,0,0,0,0,0,0,0,0,0,0,0,70,0.000049,55,99,0,0
46023,Charles Mix County,,SD,502,9549,10051,2,2,4,411,413,824,6,0.286349,0.296308,0,0.000103,0.000098,18,0.0001,0,16,1,0.001073
46025,Clark County,,SD,250,3934,4184,1,1,2,198,246,444,7,0.24632,0.252636,0,0.000004,0.000004,18,0.000075,0,16,0,0.00012
46027,Clay County,,SD,1720,11933,13653,7,10,17,1998,2727,4725,6,0.328775,0.344074,131.291288,0.000253,0.000968,18,0.000189,0,16,0.618182,0.002697
46029,Codington County,,SD,2178,32381,34559,15,15,30,3861,4064,7925,6,0.326788,0.342522,10760.071787,0.000755,0.000728,18,0.000459,0,16,0.341667,0.007603
46031,Corson County,,SD,304,3516,3820,2,2,4,190,352,542,6,0.270133,0.278656,3045.524899,0.000025,0.000026,60,0.000108,0,16,0,0.000398
46033,Custer County,,SD,809,8649,9458,3,3,6,1256,1139,2395,6,0.282952,0.292374,17.788325,0.000192,0.000092,18,0.000127,0,16,0.666667,0.001855
46035,Davison County,,SD,1710,22540,24250,17,14,31,2780,2870,5650,6,0.289552,0.302217,9786.460008,0.000827,0.000236,18,0.000573,0,16,0.253676,0.008451
46037,Day County,,SD,399,6827,7226,3,4,7,475,690,1165,6,0.286566,0.296968,1.067857,0.000118,0.000117,18,0.000121,0,16,0.833333,0.001317
46039,Deuel County,,SD,408,5451,5859,1,3,4,255,518,773,6,0.28643,0.296583,0,0.000004,0.000109,18,0.000075,0,16,1,0.00012
46041,Dewey County,,SD,418,6445,6863,3,2,5,308,298,606,6,0.282952,0.292264,6070,0.000091,0.000082,18,0.000211,0,16,0.333333,0.001022
46043,Douglas County,,SD,177,3670,3847,0,2,2,0,129,129,6,0.286389,0.296375,0,0,0.000098,18,0.000049,0,100,1,0
46045,Edmunds County,,SD,366,4425,4791,1,1,2,442,547,989,6,0.264357,0.271883,0,0.000012,0.000019,18,0.000079,0,16,0,0.00025
46047,Fall River County,,SD,641,7767,8408,2,2,4,506,655,1161,6,0.282925,0.292209,0,0.00009,0.000084,18,0.000103,0,16,1,0.000914
46049,Faulk County,,SD,153,2443,2596,0,1,1,0,45,45,6,0.264398,0.271958,0,0,0.000019,18,0.000049,0,101,0,0
46051,Grant County,,SD,432,9528,9960,4,4,8,572,657,1229,6,0.286512,0.296858,6070,0.000107,0.000099,18,0.000202,0,16,0.5,0.001209
46053,Gregory County,,SD,281,5123,5404,1,1,2,112,68,180,6,0.286295,0.296088,0,0.000001,0.000093,18,0.000068,0,16,1,0.000068
46055,Haakon County,,SD,120,2535,2655,1,1,2,58,71,129,6,0.282899,0.292044,0,0.000089,0.000082,18,0.000067,0,16,0,0.000839
46057,Hamlin County,,SD,406,6511,6917,3,3,6,678,815,1493,6,0.28643,0.296583,0.75,0.000015,0.000109,18,0.000118,0,16,0.833333,0.000373
46059,Hand County,,SD,191,4139,4330,0,0,0,0,0,0,0,0,0,0,0,0,71,0.000049,56,102,0,0
46061,Hanson County,,SD,485,5495,5980,2,2,4,288,296,584,6,0.286349,0.296308,0,0.000103,0.000098,18,0.0001,0,16,1,0.001073
46063,Harding County,,SD,88,1543,1631,0,0,0,0,0,0,0,0,0,0,0,0,72,0.000049,57,103,0,0
46065,Hughes County,,SD,1571,20212,21783,12,13,25,2464,2734,5198,6,0.289413,0.301887,15214.179285,0.000835,0.000272,18,0.000395,0,16,0.345833,0.008175
46067,Hutchinson County,,SD,465,8597,9062,2,2,4,407,504,911,6,0.286349,0.296308,0,0.000103,0.000098,18,0.0001,0,16,1,0.001073
46069,Hyde County,,SD,106,1674,1780,0,0,0,0,0,0,0,0,0,0,0,0,73,0.000049,58,104,0,0
46071,Jackson County,,SD,189,2695,2884,1,1,2,185,157,342,6,0.282899,0.292044,0,0.000089,0.000082,18,0.000067,0,16,0,0.000839
46073,Jerauld County,,SD,136,2198,2334,1,1,2,147,102,249,7,0.237718,0.243244,0,0.000003,0.000002,18,0.000076,0,16,0,0.000095
46075,Jones County,,SD,70,1253,1323,0,0,0,0,0,0,0,0,0,0,0,0,74,0.000049,59,105,0,0
46077,Kingsbury County,,SD,408,6289,6697,2,4,6,429,696,1125,6,0.286457,0.296748,80.292837,0.000112,0.000107,18,0.000089,0,16,0.75,0.001131
46079,Lake County,,SD,1115,13159,14274,3,3,6,1035,1431,2466,6,0.286376,0.296473,0,0.000127,0.000122,18,0.00011,0,16,1,0.001375
46081,Lawrence County,,SD,2398,26243,28641,11,10,21,4484,4383,8867,5,0.358207,0.376142,2550.983754,0.001493,0.001558,18,0.000303,0,16,0.5,0.01444
46083,Lincoln County,,SD,4905,50075,54980,25,22,47,19709,14177,33886,5,0.364019,0.384412,5732.896015,0.003082,0.002629,18,0.000537,0,16,0.323362,0.028257
46085,Lyman County,,SD,272,4217,4489,2,1,3,267,192,459,7,0.222688,0.227403,2,0.000002,0.000001,18,0.000118,0,16,0,0.000191
46087,McCook County,,SD,535,6569,7104,2,3,5,703,843,1546,6,0.28643,0.296583,0,0.000117,0.000109,18,0.000086,0,16,1,0.001191
46089,McPherson County,,SD,142,2731,2873,1,1,2,45,159,204,6,0.264357,0.271883,0,0.000012,0.000019,18,0.000079,0,16,0,0.00025
46091,Marshall County,,SD,332,4906,5238,2,2,4,229,355,584,6,0.264472,0.272241,1.817857,0.000013,0.00002,18,0.000111,0,16,0,0.000329
46093,Meade County,,SD,4293,29198,33491,17,8,25,10191,9408,19599,5,0.359525,0.377787,1377.059371,0.005123,0.002162,18,0.000264,0,16,0.573529,0.046727
46095,Mellette County,,SD,113,1890,2003,1,1,2,83,48,131,7,0.224121,0.229076,0,0.000001,0.000001,18,0.000082,0,16,0,0.000075
46097,Miner County,,SD,170,2766,2936,0,1,1,0,86,86,6,0.286308,0.2961,0,0,0.000093,18,0.000049,0,106,0,0
46099,Minnehaha County,,SD,13987,209132,223119,93,90,183,38664,38633,77297,5,0.401033,0.430604,165294.805958,0.015789,0.017286,18,0.00173,0,16,0.207425,0.144401
46101,Moody County,,SD,587,7716,8303,2,3,5,823,1033,1856,6,0.286376,0.296473,0,0.000112,0.000122,18,0.000089,0,16,1,0.001131
46103,Pennington County,,SD,9059,114857,123916,69,65,134,22690,21452,44142,5,0.394452,0.421327,90349.731262,0.013992,0.015182,18,0.001351,0,16,0.306394,0.130093
46105,Perkins County,,SD,169,3525,3694,0,0,0,0,0,0,0,0,0,0,0,0,75,0.000049,60,107,0,0
46107,Potter County,,SD,172,2970,3142,0,0,0,0,0,0,0,0,0,0,0,0,76,0.000049,61,108,0,0
46109,Roberts County,,SD,720,11563,12283,6,6,12,760,938,1698,6,0.290635,0.302339,348.322838,0.000175,0.000149,18,0.000227,0,16,0.380952,0.001873
46111,Sanborn County,,SD,175,2911,3086,2,2,4,165,278,443,7,0.237961,0.243882,0,0.000004,0.000007,18,0.000111,0,16,1,0.000221
46113,Shannon County,,SD,760,11692,12452,2,2,4,905,1137,2042,6,0.282978,0.292319,1627.368354,0.000089,0.000082,18,0.000097,0,16,0,0.000904
46115,Spink County,,SD,366,7400,7766,4,2,6,455,433,888,6,0.264495,0.272257,0,0.000121,0.000021,18,0.000149,0,16,1,0.001412
46117,Stanley County,,SD,380,3510,3890,1,1,2,814,805,1619,7,0.22447,0.229901,0,0.000002,0.000005,18,0.000075,0,16,0,0.000119
46119,Sully County,,SD,86,1756,1842,1,1,2,54,106,160,7,0.22447,0.229901,0,0.000002,0.000005,18,0.000075,0,16,0,0.000119
46121,Todd County,,SD,544,8709,9253,3,4,7,424,585,1009,6,0.288834,0.299741,9110,0.000191,0.000175,18,0.000152,0,16,0.166667,0.00185
46123,Tripp County,,SD,375,6818,7193,1,3,4,63,367,430,6,0.288779,0.299521,3042,0.000102,0.000175,18,0.000065,0,16,0.5,0.000947
46125,Turner County,,SD,705,9851,10556,3,3,6,1278,1330,2608,6,0.286322,0.296363,0,0.000121,0.000113,18,0.000107,0,16,1,0.001297
46127,Union County,,SD,1343,17384,18727,8,7,15,3846,3040,6886,6,0.313464,0.325096,73.467164,0.001033,0.000422,18,0.000171,0,16,0.660714,0.009282
46129,Walworth County,,SD,438,6451,6889,1,3,4,184,354,538,6,0.283243,0.292924,44.521534,0,0.000101,60,0.000095,0,16,0.333333,0.000066
46135,Yankton County,,SD,1462,25513,26975,12,12,24,2548,2692,5240,6,0.316213,0.329036,1685.474344,0.000559,0.000597,18,0.000298,0,16,0.412088,0.00558
46137,Ziebach County,,SD,113,1231,1344,1,1,2,81,40,121,7,0.220564,0.224939,0,0,0.000001,18,0.000139,0,16,0,0.000071
47001,Anderson County,,TN,5572,82498,88070,17,15,32,14508,14836,29344,6,0.320869,0.335331,269.353636,0.001159,0.001439,77,0.000311,0,16,0.473684,0.012349
47003,Bedford County,,TN,3230,50666,53896,14,10,24,7806,7281,15087,6,0.32792,0.343436,1160.018287,0.001452,0.001407,77,0.000248,0,16,0.442857,0.014408
47005,Benton County,,TN,958,17471,18429,7,6,13,1618,1614,3232,6,0.318373,0.330846,17.295996,0.000898,0.000539,3,0.000145,0,16,0.583333,0.008667
47007,Bledsoe County,,TN,744,11745,12489,5,5,10,1853,1590,3443,6,0.296438,0.307434,361.400366,0.000218,0.000258,77,0.000152,0,16,0.5,0.002592
47009,Blount County,,TN,7264,138883,146147,36,29,65,18357,17320,35677,5,0.367463,0.389749,2963.510548,0.010013,0.006964,77,0.000435,0,16,0.523077,0.091014
47011,Bradley County,,TN,6162,106309,112471,25,22,47,13690,12637,26327,5,0.336107,0.355095,1725.008007,0.005395,0.003195,77,0.000309,0,16,0.396774,0.048107
47013,Campbell County,,TN,1925,39726,41651,7,6,13,3573,3678,7251,6,0.30661,0.318163,63.489707,0.000696,0.00039,77,0.000167,0,16,0.333333,0.006082
47015,Cannon County,,TN,1222,15079,16301,6,7,13,2998,3036,6034,6,0.318339,0.330901,0.600433,0.000657,0.00073,77,0.000129,0,16,0.857143,0.006621
47017,Carroll County,,TN,2000,31602,33602,8,9,17,4438,4736,9174,6,0.324165,0.338203,10.624598,0.000931,0.001159,3,0.000161,0,16,0.777778,0.009044
47019,Carter County,,TN,3494,58816,62310,9,9,18,8773,8987,17760,6,0.320123,0.333515,311.959638,0.00064,0.000912,77,0.000202,0,16,0.544444,0.006654
47021,Cheatham County,,TN,3183,45191,48374,10,9,19,9368,9419,18787,5,0.321516,0.334984,4.014447,0.001172,0.001312,77,0.000173,0,16,0.888889,0.012203
47023,Chester County,,TN,1326,16969,18295,6,7,13,2724,2867,5591,6,0.320156,0.33308,1.716667,0.000498,0.000499,3,0.00013,0,16,0.761905,0.004678
47025,Claiborne County,,TN,1674,33098,34772,9,9,18,3003,3270,6273,6,0.306734,0.318725,1275.717256,0.000333,0.000336,77,0.000233,0,16,0.277778,0.003509
47027,Clay County,,TN,485,7950,8435,3,4,7,526,793,1319,6,0.260447,0.268769,15.185758,0.000027,0.000023,77,0.000105,0,16,0.416667,0.000436
47029,Cocke County,,TN,1900,38063,39963,7,8,15,3861,4086,7947,6,0.306548,0.318405,383.325348,0.000437,0.000469,77,0.000159,0,16,0.75,0.004555
47031,Coffee County,,TN,3898,58866,62764,14,15,29,9190,9054,18244,6,0.327071,0.342935,1448.176506,0.001623,0.00204,77,0.000263,0,16,0.5125,0.015738
47033,Crockett County,,TN,1062,16199,17261,6,6,12,2689,2827,5516,6,0.320156,0.33297,0.644023,0.000498,0.000501,3,0.000131,0,16,0.9,0.004748
47035,Cumberland County,,TN,2838,62539,65377,22,13,35,5123,4731,9854,6,0.320767,0.334907,4799.614583,0.005168,0.001275,77,0.000332,0,16,0.44664,0.045357
47037,Davidson County,,TN,54244,662241,716485,348,284,632,184167,184836,369003,5,0.466215,0.508237,232574.250598,0.081293,0.072462,77,0.003318,0,16,0.258788,0.701414
47039,Decatur County,,TN,737,12293,13030,5,4,9,1278,1268,2546,6,0.320123,0.332695,33.832051,0.000483,0.000484,3,0.000138,0,16,0.4,0.004554
47041,DeKalb County,,TN,1441,19919,21360,8,9,17,3660,3714,7374,6,0.318741,0.331661,6.379451,0.000674,0.000747,77,0.000167,0,16,0.722222,0.006918
47043,Dickson County,,TN,3397,54888,58285,13,14,27,8592,8335,16927,5,0.326366,0.341653,119.315771,0.001608,0.001791,77,0.000231,0,16,0.615385,0.01621
47045,Dyer County,,TN,2533,42933,45466,14,14,28,5381,5406,10787,6,0.324756,0.339606,4383.833911,0.001581,0.001174,3,0.000256,0,16,0.429167,0.014989
47047,Fayette County,,TN,2826,43304,46130,8,8,16,10582,8759,19341,6,0.323992,0.337818,23.124817,0.00099,0.00104,3,0.000148,0,16,0.714286,0.00951
47049,Fentress County,,TN,746,18111,18857,5,5,10,996,1381,2377,6,0.260268,0.268686,16.697501,0.000033,0.000051,77,0.000154,0,16,0.6,0.000805
47051,Franklin County,,TN,2441,45135,47576,12,10,22,5185,5534,10719,6,0.320258,0.334148,703.493264,0.001115,0.001201,77,0.000236,0,16,0.515152,0.011305
47053,Gibson County,,TN,3068,55673,58741,14,16,30,8784,8024,16808,6,0.325244,0.340651,87.690819,0.001191,0.001473,3,0.000245,0,16,0.479167,0.011718
47055,Giles County,,TN,1825,33199,35024,8,10,18,3658,4347,8005,6,0.319717,0.333267,8.820323,0.000929,0.001236,77,0.000147,0,16,0.677778,0.009233
47057,Grainger County,,TN,1511,23155,24666,8,7,15,4250,4072,8322,6,0.306269,0.317883,416.734616,0.000383,0.000405,77,0.000192,0,16,0.660714,0.004072
47059,Greene County,,TN,3060,75324,78384,13,12,25,6062,6263,12325,6,0.321892,0.336156,358.291425,0.001248,0.001247,77,0.000255,0,16,0.571429,0.01237
47061,Grundy County,,TN,815,14731,15546,5,5,10,2433,1567,4000,6,0.296496,0.307544,2.473088,0.000231,0.000251,77,0.00013,0,16,0.75,0.002561
47063,Hamblen County,,TN,4336,68378,72714,16,15,31,10386,10740,21126,6,0.320326,0.334505,4195.98399,0.001463,0.001221,77,0.000302,0,16,0.437909,0.013971
47065,Hamilton County,,TN,18102,365040,383142,143,119,262,55485,51339,106824,5,0.420753,0.453092,62165.192203,0.037761,0.034838,77,0.0014,0,16,0.413251,0.336725
47067,Hancock County,,TN,252,6212,6464,3,4,7,690,444,1134,7,0.243039,0.249524,1.086447,0.000012,0.000016,77,0.000111,0,16,0.833333,0.000348
47069,Hardeman County,,TN,1542,28208,29750,8,10,18,2831,3971,6802,6,0.324061,0.338148,24.52195,0.0005,0.001043,3,0.000164,0,16,0.555556,0.004839
47071,Hardin County,,TN,1520,27975,29495,10,8,18,2744,2595,5339,6,0.3242,0.33812,482.596607,0.000936,0.000984,3,0.000187,0,16,0.488889,0.009193
47073,Hawkins County,,TN,3589,61693,65282,13,11,24,9637,9947,19584,6,0.30661,0.318873,1152.997342,0.000484,0.000512,77,0.000288,0,16,0.532051,0.005428
47075,Haywood County,,TN,1419,22202,23621,9,10,19,3129,3781,6910,6,0.324131,0.338258,23.715708,0.000937,0.000995,3,0.000173,0,16,0.7,0.009076
47077,Henderson County,,TN,1801,30788,32589,10,10,20,3913,3898,7811,6,0.324131,0.338258,51.572576,0.001203,0.00115,3,0.000197,0,16,0.536364,0.011593
47079,Henry County,,TN,1827,35483,37310,12,13,25,3680,3580,7260,5,0.326436,0.341691,302.647397,0.001825,0.001434,3,0.000209,0,16,0.490476,0.017125
47081,Hickman County,,TN,1749,24386,26135,9,9,18,4136,4333,8469,6,0.318373,0.331176,12.513686,0.000809,0.000916,77,0.000198,0,16,0.583333,0.008465
47083,Houston County,,TN,547,8495,9042,5,4,9,1387,1254,2641,6,0.302326,0.313404,18.031686,0.000707,0.000286,77,0.00012,0,16,0.75,0.006875
47085,Humphreys County,,TN,1118,20890,22008,7,6,13,2243,1924,4167,5,0.321243,0.33428,26.888996,0.00088,0.000771,77,0.000155,0,16,0.619048,0.008545
47087,Jackson County,,TN,846,11479,12325,4,5,9,1716,2247,3963,6,0.26038,0.268857,13.272513,0.000031,0.000028,77,0.00012,0,16,0.4,0.00053
47089,Jefferson County,,TN,4701,53531,58232,14,12,26,11740,12123,23863,6,0.320089,0.33379,142.896631,0.001495,0.001049,77,0.000263,0,16,0.631868,0.01464
47091,Johnson County,,TN,691,17067,17758,5,5,10,987,1220,2207,6,0.274018,0.283862,13.639465,0.000122,0.000136,77,0.000136,0,16,0.5,0.001604
47093,Knox County,,TN,26986,459835,486821,183,171,354,81841,77771,159612,5,0.44071,0.476054,80568.486338,0.05378,0.053258,77,0.001717,0,16,0.440984,0.473802
47095,Lake County,,TN,453,5577,6030,2,2,4,951,929,1880,7,0.245542,0.251912,0,0.000014,0.000015,3,0.000082,0,16,1,0.000282
47097,Lauderdale County,,TN,1614,26459,28073,7,7,14,3486,3772,7258,6,0.324027,0.337763,11.424999,0.000923,0.000979,3,0.000143,0,16,0.880952,0.00888
47099,Lawrence County,,TN,1802,44507,46309,8,10,18,3542,3898,7440,6,0.324339,0.338561,47.578095,0.000923,0.00136,77,0.00015,0,16,0.572727,0.009175
47101,Lewis County,,TN,725,12382,13107,5,5,10,1241,1102,2343,6,0.318206,0.330461,2.196465,0.000468,0.000521,77,0.000134,0,16,0.7,0.004805
47103,Lincoln County,,TN,1890,37572,39462,10,11,21,4901,4592,9493,6,0.319717,0.333377,514.841585,0.000926,0.00103,77,0.000202,0,16,0.609091,0.009313
47105,Loudon County,,TN,3623,54493,58116,10,9,19,10031,8904,18935,6,0.32019,0.333652,32.038722,0.001608,0.001166,77,0.000166,0,16,0.822222,0.015309
47107,McMinn County,,TN,3179,55840,59019,11,13,24,7354,7472,14826,6,0.326401,0.342423,292.424991,0.001192,0.00156,77,0.0002,0,16,0.571429,0.011525
47109,McNairy County,,TN,1563,27286,28849,7,8,15,3495,3506,7001,6,0.323992,0.337818,12.106174,0.000495,0.000974,3,0.000151,0,16,0.696429,0.004759
47111,Macon County,,TN,1388,23679,25067,9,9,18,3136,2977,6113,6,0.318809,0.331716,1202.838024,0.000715,0.000658,77,0.000205,0,16,0.511111,0.00759
47113,Madison County,,TN,7057,107194,114251,37,34,71,17965,17858,35823,5,0.373259,0.396578,4746.704975,0.006057,0.006479,3,0.00053,0,16,0.31417,0.055234
47115,Marion County,,TN,1472,31581,33053,9,8,17,3692,4742,8434,6,0.296961,0.308452,112.280125,0.000676,0.000263,77,0.000191,0,16,0.430556,0.00702
47117,Marshall County,,TN,2110,34866,36976,7,7,14,5088,4603,9691,6,0.318273,0.330791,1.17619,0.000802,0.000909,77,0.000142,0,16,0.857143,0.008263
47119,Maury County,,TN,5529,91565,97094,27,24,51,17070,15230,32300,5,0.355183,0.375933,979.33193,0.004937,0.004152,77,0.000363,0,16,0.404234,0.044194
47121,Meigs County,,TN,947,12250,13197,6,6,12,3263,3072,6335,6,0.296351,0.307379,0.433333,0.00025,0.000276,77,0.00013,0,16,0.9,0.002846
47123,Monroe County,,TN,2911,47031,49942,8,10,18,6273,6561,12834,6,0.307076,0.319588,13.769883,0.000605,0.000726,77,0.000153,0,16,0.788889,0.006246
47125,Montgomery County,,TN,19123,174867,193990,156,152,308,63763,60391,124154,5,0.432962,0.46742,33705.960918,0.0456,0.044144,77,0.001376,0,16,0.432013,0.400341
47127,Moore County,,TN,473,7048,7521,5,4,9,1281,1111,2392,7,0.251057,0.258746,0,0.000206,0.00003,77,0.000131,0,16,1,0.002106
47129,Morgan County,,TN,1226,20997,22223,6,6,12,2910,3080,5990,6,0.306424,0.317927,219.106037,0.00034,0.000364,77,0.000163,0,16,0.566667,0.00355
47131,Obion County,,TN,2162,36545,38707,11,12,23,4724,4859,9583,6,0.324895,0.339606,6637.972307,0.000934,0.001167,3,0.000238,0,16,0.423077,0.009253
47133,Overton County,,TN,1300,23075,24375,7,8,15,3055,3129,6184,6,0.318909,0.331743,1040.861961,0.000032,0.000531,77,0.000199,0,16,0.446429,0.00095
47135,Perry County,,TN,460,8063,8523,5,4,9,487,432,919,6,0.318139,0.330241,17.142212,0.000441,0.000489,77,0.000142,0,16,0.4,0.004543
47137,Pickett County,,TN,279,5324,5603,3,4,7,365,503,868,6,0.260492,0.268719,107.504678,0.000024,0.000019,77,0.000112,0,16,0.5,0.000395
47139,Polk County,,TN,1407,18042,19449,5,5,10,3273,3390,6663,6,0.29667,0.307819,50.638267,0.000246,0.000293,77,0.000126,0,16,0.4,0.002902
47141,Putnam County,,TN,5268,73296,78564,27,25,52,11738,11571,23309,5,0.351188,0.371388,22191.969517,0.003137,0.003406,77,0.000451,0,16,0.31754,0.029932
47143,Rhea County,,TN,1782,33057,34839,9,9,18,4152,3908,8060,6,0.30717,0.319643,52.801441,0.000567,0.00062,77,0.000201,0,16,0.583333,0.005989
47145,Roane County,,TN,3495,59554,63049,14,16,30,7997,9594,17591,6,0.320835,0.335347,182.093693,0.001252,0.001426,77,0.000254,0,16,0.579167,0.012842
47147,Robertson County,,TN,5078,75924,81002,16,14,30,15825,15361,31186,5,0.328062,0.343881,119.930992,0.003061,0.002221,77,0.000234,0,16,0.675,0.02873
47149,Rutherford County,,TN,20813,283006,303819,108,100,208,71001,61968,132969,5,0.418833,0.449103,28521.964767,0.028891,0.0293,77,0.001149,0,16,0.399668,0.253238
47151,Scott County,,TN,787,22557,23344,5,5,10,988,1201,2189,6,0.3063,0.317624,1050.647117,0.000327,0.00033,77,0.000153,0,16,0.5,0.003179
47153,Sequatchie County,,TN,868,14685,15553,5,4,9,2251,1965,4216,6,0.296293,0.307049,3.005556,0.000231,0.000231,77,0.000136,0,16,0.6,0.002653
47155,Sevier County,,TN,7048,96374,103422,39,32,71,15914,14737,30651,5,0.354518,0.375228,3326.081687,0.010836,0.008174,77,0.000475,0,16,0.509292,0.098839
47157,Shelby County,,TN,49955,1060669,1110624,316,310,626,140235,160680,300915,5,0.470342,0.514383,241984.015727,0.074366,0.073357,3,0.002946,0,16,0.262736,0.643027
47159,Smith County,,TN,1296,21217,22513,9,9,18,3127,3205,6332,6,0.318842,0.331798,826.262021,0.000735,0.000831,77,0.000188,0,16,0.652778,0.007796
47161,Stewart County,,TN,960,14451,15411,4,5,9,1900,2028,3928,5,0.321243,0.33417,20.442495,0.000392,0.000877,77,0.000104,0,16,0.65,0.003691
47163,Sullivan County,,TN,9072,176030,185102,34,30,64,24786,23731,48517,5,0.364544,0.386871,33709.767129,0.00659,0.005977,77,0.000583,0,16,0.365616,0.061404
47165,Sumner County,,TN,11584,177707,189291,51,39,90,37931,31360,69291,5,0.388333,0.413002,7812.308647,0.017022,0.011538,77,0.000561,0,16,0.556229,0.152294
47167,Tipton County,,TN,4407,68282,72689,9,10,19,11807,10157,21964,5,0.349608,0.36709,96.559444,0.00145,0.001721,3,0.000161,0,16,0.545455,0.013386
47169,Trousdale County,,TN,740,8458,9198,6,5,11,1890,1841,3731,6,0.318373,0.33067,0,0.000712,0.000638,77,0.000131,0,16,0.966667,0.007376
47171,Unicoi County,,TN,1139,19216,20355,4,4,8,2732,2819,5551,6,0.272981,0.282101,0,0.000102,0.000111,77,0.000117,0,16,1,0.001301
47173,Union County,,TN,1290,19609,20899,6,7,13,3811,3917,7728,6,0.306238,0.317828,4.463956,0.000416,0.00046,77,0.000146,0,16,0.714286,0.004331
47175,Van Buren County,,TN,372,5853,6225,3,4,7,744,854,1598,6,0.260201,0.268521,4.985989,0.000011,0.000031,77,0.000112,0,16,0.5,0.000321
47177,Warren County,,TN,1999,43664,45663,12,12,24,4347,4598,8945,6,0.319548,0.333284,2472.49123,0.001367,0.000927,77,0.000226,0,16,0.478022,0.012643
47179,Washington County,,TN,8752,127868,136620,41,37,78,24137,22427,46564,5,0.374598,0.398256,36022.365839,0.010345,0.009139,77,0.000617,0,16,0.420773,0.09589
47181,Wayne County,,TN,646,15677,16323,4,7,11,1128,1116,2244,6,0.31854,0.331204,11.314935,0.000457,0.000543,77,0.000103,0,16,0.47619,0.004612
47183,Weakley County,,TN,2157,33942,36099,10,10,20,4223,4408,8631,6,0.324374,0.338616,1616.28126,0.000941,0.001161,3,0.000195,0,16,0.645455,0.009239
47185,White County,,TN,1499,27509,29008,8,8,16,3710,3694,7404,6,0.318809,0.331661,1572.639321,0.000468,0.00071,77,0.000193,0,16,0.527778,0.005188
47187,Williamson County,,TN,13678,195768,209446,103,69,172,51591,41092,92683,5,0.416758,0.443397,7622.655788,0.035791,0.026491,77,0.000918,0,16,0.621149,0.314524
47189,Wilson County,,TN,8468,126906,135374,32,27,59,28396,22199,50595,5,0.375341,0.397942,2701.715693,0.008579,0.005979,77,0.00042,0,16,0.487395,0.07898
48001,Anderson County,,TX,3155,46938,50093,20,20,40,6815,7323,14138,5,0.346449,0.364851,20.62608,0.0033,0.005188,91,0.000252,0,16,0.731884,0.03391
48003,Andrews County,,TX,1164,15940,17104,7,4,11,2025,1822,3847,5,0.331038,0.346121,30.626651,0.001223,0.000892,91,0.000141,0,16,0.904762,0.012411
48005,Angelina County,,TX,5073,90979,96052,35,35,70,12456,13112,25568,5,0.347921,0.368317,341.774283,0.006446,0.006797,91,0.000416,0,16,0.562312,0.065896
48007,Aransas County,,TX,2387,22850,25237,10,11,21,4756,4485,9241,5,0.344714,0.36188,0.028571,0.003287,0.003569,91,0.000146,0,16,0.99359,0.033167
48009,Archer County,,TX,878,9170,10048,3,4,7,1971,2066,4037,5,0.331582,0.346115,0.583333,0.000132,0.00071,91,0.000092,0,16,0.833333,0.001186
48011,Armstrong County,,TX,252,1929,2181,2,2,4,435,431,866,6,0.275289,0.284957,0,0.000142,0.00014,91,0.000079,0,16,1,0.001489
48013,Atascosa County,,TX,3392,46616,50008,13,9,22,10077,9451,19528,5,0.342105,0.358358,92.090966,0.003113,0.002206,91,0.000206,0,16,0.679487,0.031414
48015,Austin County,,TX,2304,30531,32835,12,11,23,5810,6031,11841,5,0.344283,0.361109,6.791271,0.002029,0.003257,91,0.000174,0,16,0.796703,0.021628
48017,Bailey County,,TX,747,7069,7816,4,5,9,1132,1213,2345,6,0.283084,0.294608,4.790121,0.000196,0.000191,91,0.000104,0,16,0.6,0.001976
48019,Bandera County,,TX,1761,19615,21376,6,7,13,3630,3568,7198,5,0.341951,0.357918,0.823413,0.001675,0.001983,91,0.000121,0,16,0.904762,0.016961
48021,Bastrop County,,TX,5818,71735,77553,28,24,52,19714,17247,36961,5,0.362234,0.383064,122.007553,0.008474,0.006838,91,0.000313,0,16,0.790805,0.083783
48023,Baylor County,,TX,310,3718,4028,1,1,2,161,149,310,6,0.282477,0.292654,0,0.000116,0.00009,91,0.000056,0,16,0,0.000903
48025,Bee County,,TX,1895,25561,27456,12,14,26,3972,4119,8091,5,0.342919,0.359844,361.681471,0.002186,0.002776,91,0.000185,0,16,0.619048,0.022408
48027,Bell County,,TX,51875,304229,356104,275,272,547,132683,142681,275364,4,0.460895,0.503081,34687.825317,0.071384,0.069468,91,0.002261,0,16,0.308124,0.620634
48029,Bexar County,,TX,89715,1809293,1899008,481,401,882,365058,310551,675609,4,0.486352,0.535573,157580.280482,0.098933,0.088602,91,0.004216,0,16,0.191148,0.848309
48031,Blanco County,,TX,825,9989,10814,7,7,14,1799,1724,3523,5,0.330316,0.344575,0.211111,0.002033,0.001715,91,0.000121,0,16,0.928571,0.0211
48033,Borden County,,TX,66,578,644,0,0,0,0,0,0,0,0,0,0,0,0,78,0.000049,62,109,0,0
48035,Bosque County,,TX,1631,17747,19378,13,9,22,3930,3631,7561,5,0.336182,0.35186,14.302667,0.00279,0.001598,91,0.00019,0,16,0.763736,0.027879
48037,Bowie County,,TX,6579,96294,102873,33,36,69,17007,16958,33965,5,0.360424,0.383757,10256.19778,0.006367,0.007082,91,0.000434,0,16,0.408962,0.062851
48039,Brazoria County,,TX,21265,320524,341789,85,71,156,79278,68030,147308,5,0.390084,0.418257,2153.587535,0.02418,0.01922,91,0.000806,0,16,0.492637,0.224247
48041,Brazos County,,TX,15538,151866,167404,91,88,179,38894,44551,83445,5,0.392612,0.422879,4130.97691,0.019581,0.02208,91,0.000953,0,16,0.377094,0.185363
48043,Brewster County,,TX,1025,8774,9799,10,9,19,1273,1499,2772,5,0.332419,0.347766,6154.846967,0.002668,0.001834,91,0.000226,0,16,0.672727,0.026903
48045,Briscoe County,,TX,154,1658,1812,0,0,0,0,0,0,0,0,0,0,0,0,79,0.000049,63,110,0,0
48047,Brooks County,,TX,528,8157,8685,4,4,8,904,1289,2193,6,0.298747,0.309904,0,0.000385,0.000427,91,0.000091,0,16,1,0.004115
48049,Brown County,,TX,2672,38692,41364,25,25,50,5210,5521,10731,5,0.348441,0.36807,13820.954191,0.004509,0.005517,91,0.000469,0,16,0.511396,0.045893
48051,Burleson County,,TX,1341,17993,19334,8,7,15,3052,2810,5862,5,0.341912,0.357863,5.18775,0.001473,0.002267,91,0.000139,0,16,0.708333,0.015478
48053,Burnet County,,TX,3505,43787,47292,19,22,41,9205,8702,17907,5,0.348041,0.367189,53.994962,0.004915,0.005645,91,0.000253,0,16,0.769231,0.050754
48055,Caldwell County,,TX,3334,36086,39420,11,12,23,10418,9444,19862,5,0.346251,0.363613,6.94254,0.003236,0.004148,91,0.000165,0,16,0.931818,0.033169
48057,Calhoun County,,TX,1590,22749,24339,11,9,20,3000,3273,6273,5,0.342105,0.358358,9.753169,0.002879,0.00234,91,0.000162,0,16,0.863636,0.029424
48059,Callahan County,,TX,1271,13903,15174,5,5,10,2788,2677,5465,5,0.330857,0.345604,2.434524,0.000686,0.000748,91,0.000128,0,16,0.8,0.006929
48061,Cameron County,,TX,15876,415338,431214,70,60,130,37947,41665,79612,5,0.392459,0.41944,1285.55775,0.022293,0.021746,91,0.000635,0,16,0.576091,0.204369
48063,Camp County,,TX,1126,13191,14317,9,8,17,2692,2517,5209,5,0.332528,0.346935,4.540687,0.001235,0.000826,91,0.000148,0,16,0.844444,0.012389
48065,Carson County,,TX,564,6448,7012,4,4,8,1189,1261,2450,6,0.275364,0.285342,0,0.000165,0.000167,91,0.000123,0,16,1,0.001892
48067,Cass County,,TX,2189,32708,34897,13,14,27,5225,5569,10794,5,0.344283,0.361819,51.851911,0.002111,0.002294,91,0.000191,0,16,0.708791,0.021125
48069,Castro County,,TX,765,7557,8322,7,6,13,1286,1392,2678,6,0.284493,0.296154,2.533628,0.000308,0.000287,91,0.00015,0,16,0.738095,0.003248
48071,Chambers County,,TX,2428,30330,32758,10,11,21,13420,10023,23443,5,0.339879,0.356179,0.200595,0.002068,0.00243,91,0.000143,0,16,0.977273,0.021729
48073,Cherokee County,,TX,3239,50514,53753,16,18,34,7954,8482,16436,5,0.345895,0.363971,11.986317,0.003998,0.00474,91,0.000208,0,16,0.816993,0.040681
48075,Childress County,,TX,523,6089,6612,4,2,6,240,110,350,6,0.275289,0.284957,0,0.000277,0.00014,91,0.000109,0,16,0.75,0.002796
48077,Clay County,,TX,989,11442,12431,5,4,9,2320,2328,4648,5,0.331582,0.346115,119.893182,0.001031,0.000707,91,0.000108,0,16,0.75,0.010237
48079,Cochran County,,TX,314,3428,3742,2,2,4,385,471,856,6,0.282056,0.292792,0,0.000143,0.00013,91,0.000078,0,16,1,0.00139
48081,Coke County,,TX,375,3348,3723,1,1,2,359,423,782,6,0.277483,0.287587,0,0.000108,0.000094,91,0.00006,0,16,0,0.000942
48083,Coleman County,,TX,737,8641,9378,4,3,7,874,907,1781,6,0.282214,0.293282,1.111111,0.000674,0.000225,91,0.000106,0,16,0.8,0.006746
48085,Collin County,,TX,65750,799640,865390,327,259,586,311338,256362,567700,5,0.460684,0.501563,40618.846375,0.084034,0.07138,91,0.002712,0,16,0.307366,0.720485
48087,Collingsworth County,,TX,263,3081,3344,0,0,0,0,0,0,0,0,0,0,0,0,80,0.000049,64,111,0,0
48089,Colorado County,,TX,1324,22495,23819,9,12,21,3001,3268,6269,5,0.34226,0.358826,4.088012,0.002032,0.003114,91,0.000146,0,16,0.80303,0.020908
48091,Comal County,,TX,8607,110964,119571,54,43,97,37815,31334,69149,5,0.372984,0.39726,705.132807,0.012657,0.01163,91,0.000608,0,16,0.593507,0.122458
48093,Comanche County,,TX,991,13910,14901,6,6,12,1500,1626,3126,5,0.330894,0.345769,7.823339,0.001163,0.000776,91,0.000126,0,16,0.809524,0.011554
48095,Concho County,,TX,258,2597,2855,1,1,2,206,70,276,6,0.277483,0.287587,0,0.000108,0.000094,91,0.00006,0,16,0,0.000942
48097,Cooke County,,TX,3109,41449,44558,12,11,23,7328,7568,14896,5,0.344479,0.361654,1544.721963,0.003036,0.003019,91,0.000179,0,16,0.727273,0.030197
48099,Coryell County,,TX,14592,61907,76499,62,65,127,32002,35509,67511,5,0.392002,0.419247,1430.53394,0.018031,0.018563,91,0.000573,0,16,0.579279,0.167823
48101,Cottle County,,TX,135,1589,1724,0,0,0,0,0,0,0,0,0,0,0,0,81,0.000049,65,112,0,0
48103,Crane County,,TX,429,4670,5099,2,2,4,576,694,1270,6,0.272368,0.281996,0,0.000136,0.000166,91,0.000079,0,16,1,0.001773
48105,Crockett County,,TX,338,4240,4578,1,2,3,215,334,549,6,0.278529,0.289518,0,0.000108,0.000188,91,0.00006,0,16,1,0.000942
48107,Crosby County,,TX,713,6281,6994,1,1,2,949,1242,2191,6,0.28203,0.292627,0,0.000134,0.000122,91,0.000061,0,16,0,0.001241
48109,Culberson County,,TX,327,2671,2998,1,1,2,107,92,199,6,0.270737,0.279834,0,0.000384,0.000072,91,0.000057,0,16,1,0.003507
48111,Dallam County,,TX,751,7148,7899,5,4,9,914,950,1864,6,0.275339,0.285287,3029.648809,0.000163,0.00016,91,0.000174,0,16,0.55,0.001879
48113,Dallas County,,TX,168583,2494655,2663238,551,466,1017,624689,638075,1262764,4,0.497536,0.550347,275273.433455,0.10365,0.092928,91,0.004913,0,16,0.152595,0.884793
48115,Dawson County,,TX,995,12936,13931,4,6,10,1144,1532,2676,6,0.282556,0.294223,11.733808,0.000229,0.000314,91,0.000127,0,16,0.666667,0.002598
48117,Deaf Smith County,,TX,1716,21487,23203,6,8,14,2610,3661,6271,5,0.334216,0.349329,62.020214,0.000338,0.000951,91,0.000142,0,16,0.785714,0.003476
48119,Delta County,,TX,535,5032,5567,4,4,8,1071,1000,2071,5,0.332565,0.346495,0,0.000628,0.000689,91,0.000094,0,16,1,0.006312
48121,Denton County,,TX,61516,666970,728486,285,226,511,269415,220477,489892,5,0.454464,0.493062,34122.118005,0.074774,0.061076,91,0.002424,0,16,0.32925,0.647117
48123,DeWitt County,,TX,1144,19742,20886,8,6,14,2802,2695,5497,5,0.341989,0.357863,838.939116,0.001811,0.002029,91,0.000161,0,16,0.678571,0.01831
48125,Dickens County,,TX,176,2053,2229,1,1,2,103,87,190,6,0.28203,0.292627,0,0.000134,0.000122,91,0.000061,0,16,0,0.001241
48127,Dimmit County,,TX,761,9974,10735,6,5,11,1153,1057,2210,5,0.330208,0.344272,31.220772,0.00164,0.001254,91,0.000132,0,16,0.785714,0.016693
48129,Donley County,,TX,291,3476,3767,2,2,4,227,335,562,6,0.275289,0.284957,0,0.000142,0.00014,91,0.000079,0,16,1,0.001489
48131,Duval County,,TX,790,12289,13079,4,4,8,1495,2120,3615,5,0.327707,0.341108,0,0.000871,0.00078,91,0.000092,0,16,1,0.008892
48133,Eastland County,,TX,1390,18035,19425,10,10,20,1828,2322,4150,5,0.33663,0.352333,35.364484,0.001328,0.001457,91,0.000197,0,16,0.611111,0.01349
48135,Ector County,,TX,8211,149821,158032,65,53,118,28459,24087,52546,5,0.371155,0.396792,17903.581522,0.012243,0.010483,91,0.000932,0,16,0.368545,0.120203
48137,Edwards County,,TX,237,2060,2297,0,0,0,0,0,0,0,0,0,0,0,0,82,0.000049,66,113,0,0
48139,Ellis County,,TX,11185,159349,170534,40,42,82,39471,34718,74189,5,0.369841,0.393876,273.688054,0.010298,0.009965,91,0.000426,0,16,0.654589,0.100645
48141,El Paso County,,TX,43932,867618,911550,256,248,504,137117,133413,270530,4,0.459218,0.499037,57946.390616,0.067919,0.065093,91,0.002218,0,16,0.337397,0.597837
48143,Erath County,,TX,3154,32965,36119,23,24,47,6459,6848,13307,5,0.347362,0.366474,187.209545,0.004727,0.005444,91,0.000318,0,16,0.635,0.048138
48145,Falls County,,TX,1305,15750,17055,7,7,14,2534,3046,5580,5,0.343113,0.359453,6.242591,0.002225,0.001959,91,0.00012,0,16,0.833333,0.021811
48147,Fannin County,,TX,2559,32747,35306,8,8,16,6009,6179,12188,5,0.336145,0.351667,1.195154,0.001996,0.00228,91,0.000132,0,16,0.928571,0.02017
48149,Fayette County,,TX,1464,25240,26704,12,16,28,2983,3351,6334,5,0.342492,0.359596,10.160983,0.002077,0.003176,91,0.000177,0,16,0.686275,0.022291
48151,Fisher County,,TX,347,3885,4232,2,2,4,316,190,506,6,0.278682,0.288649,0,0.000112,0.000113,91,0.000073,0,16,1,0.001202
48153,Floyd County,,TX,591,7145,7736,2,2,4,861,1074,1935,6,0.282056,0.292792,0,0.000157,0.000139,91,0.000073,0,16,1,0.001472
48155,Foard County,,TX,100,1273,1373,0,0,0,0,0,0,0,0,0,0,0,0,83,0.000049,67,114,0,0
48157,Fort Bend County,,TX,40277,576593,616870,197,129,326,215164,152900,368064,5,0.425481,0.458072,11125.374737,0.059192,0.040324,91,0.001622,0,16,0.439806,0.514027
48159,Franklin County,,TX,1103,10697,11800,6,10,16,1977,2251,4228,5,0.335921,0.351612,4.438209,0.001029,0.001941,91,0.000121,0,16,0.855556,0.010446
48161,Freestone County,,TX,1364,19241,20605,9,11,20,3389,3577,6966,5,0.343736,0.360719,3.075696,0.001944,0.002488,91,0.000141,0,16,0.810606,0.01939
48163,Frio County,,TX,952,14596,15548,4,5,9,1497,1868,3365,5,0.327424,0.340888,2.583333,0.000556,0.000639,91,0.000119,0,16,0.6,0.005635
48165,Gaines County,,TX,1040,17234,18274,7,7,14,1672,1792,3464,6,0.282688,0.29458,16.090973,0.000305,0.000349,91,0.000169,0,16,0.589286,0.003795
48167,Galveston County,,TX,28456,297937,326393,92,96,188,74358,74238,148596,5,0.401937,0.432844,3762.92209,0.026807,0.027276,91,0.000862,0,16,0.476593,0.247009
48169,Garza County,,TX,398,4542,4940,1,1,2,438,603,1041,6,0.28203,0.292627,0,0.000134,0.000122,91,0.000061,0,16,0,0.001241
48171,Gillespie County,,TX,1352,25869,27221,11,9,20,3012,2607,5619,5,0.345697,0.362622,19.532674,0.003103,0.003543,91,0.000176,0,16,0.818182,0.031752
48173,Glasscock County,,TX,116,1338,1454,1,0,1,113,0,113,0,0,0,0,0.000074,0,91,0.000064,0,15,0,0.000991
48175,Goliad County,,TX,562,6966,7528,3,2,5,947,895,1842,6,0.258029,0.265638,0.142857,0.000212,0.000044,91,0.000082,0,16,0.833333,0.002103
48177,Gonzales County,,TX,1238,20124,21362,10,10,20,2429,2825,5254,5,0.34226,0.358606,2.281775,0.001936,0.002515,91,0.00016,0,16,0.809091,0.01985
48179,Gray County,,TX,1969,23722,25691,13,11,24,2389,2909,5298,5,0.345421,0.362975,7689.010467,0.002644,0.002257,91,0.000311,0,16,0.472527,0.026062
48181,Grayson County,,TX,7676,127231,134907,31,30,61,20809,19346,40155,5,0.368357,0.390877,607.221446,0.008603,0.008561,91,0.000355,0,16,0.66934,0.083242
48183,Gregg County,,TX,10288,133934,144222,46,53,99,32126,34820,66946,5,0.371246,0.396875,1136.323697,0.008792,0.010256,91,0.000513,0,16,0.465584,0.08693
48185,Grimes County,,TX,2096,24424,26520,8,7,15,5880,5494,11374,5,0.339422,0.355134,1.60202,0.001275,0.001156,91,0.000145,0,16,0.821429,0.013827
48187,Guadalupe County,,TX,11638,136809,148447,69,51,120,48099,36071,84170,5,0.380146,0.405998,1073.559357,0.018825,0.016395,91,0.000692,0,16,0.554955,0.17647
48189,Hale County,,TX,2897,37165,40062,13,17,30,5223,6319,11542,5,0.348281,0.366969,1998.910276,0.002887,0.003991,91,0.000238,0,16,0.599265,0.028374
48191,Hall County,,TX,322,3239,3561,1,3,4,60,199,259,6,0.275314,0.285122,0,0.000072,0.000141,91,0.000064,0,16,1,0.000751
48193,Hamilton County,,TX,843,8635,9478,5,6,11,1030,1196,2226,5,0.330569,0.345571,2.187926,0.000787,0.000878,91,0.000105,0,16,0.733333,0.007953
48195,Hansford County,,TX,468,6065,6533,1,3,4,52,431,483,6,0.275364,0.285232,0,0.000002,0.00014,91,0.000075,0,16,1,0.000077
48197,Hardeman County,,TX,408,4122,4530,1,2,3,278,428,706,6,0.28253,0.292874,0,0.000008,0.000097,91,0.000066,0,16,1,0.00013
48199,Hardin County,,TX,4311,57598,61909,19,19,38,13330,12269,25599,5,0.352414,0.371448,85.252324,0.003439,0.004352,91,0.000237,0,16,0.701299,0.034673
48201,Harris County,,TX,199724,4235159,4434883,719,588,1307,811761,768601,1580362,4,0.513216,0.573732,560903.297933,0.114218,0.102823,91,0.006538,0,16,0.107435,0.976488
48203,Harrison County,,TX,5261,70079,75340,24,21,45,15621,15231,30852,5,0.346528,0.365098,65.897918,0.005065,0.005155,91,0.000293,0,16,0.649231,0.050875
48205,Hartley County,,TX,380,4283,4663,3,4,7,427,839,1266,6,0.275339,0.285287,0,0.00009,0.00016,91,0.00012,0,16,1,0.001071
48207,Haskell County,,TX,542,5586,6128,4,3,7,589,635,1224,6,0.278708,0.288814,87.276403,0.000646,0.00011,91,0.000138,0,16,0.666667,0.006515
48209,Hays County,,TX,15127,140084,155211,63,48,111,59561,47554,107115,5,0.381102,0.406317,912.918915,0.015971,0.013497,91,0.000661,0,16,0.577381,0.152924
48211,Hemphill County,,TX,328,4135,4463,2,3,5,87,216,303,6,0.275339,0.285177,0,0.000142,0.000155,91,0.000079,0,16,1,0.001489
48213,Henderson County,,TX,6213,76183,82396,23,25,48,17937,16902,34839,5,0.346885,0.365896,18.906195,0.004763,0.005779,91,0.000272,0,16,0.710826,0.048411
48215,Hidalgo County,,TX,22247,747688,769935,148,105,253,64781,57483,122264,5,0.417908,0.448718,23140.860884,0.039106,0.02945,91,0.001359,0,16,0.370631,0.347571
48217,Hill County,,TX,3083,35245,38328,16,16,32,7766,7604,15370,5,0.352291,0.37087,33.676755,0.005342,0.004688,91,0.000197,0,16,0.75,0.051153
48219,Hockley County,,TX,2089,24383,26472,9,10,19,3629,4613,8242,5,0.33738,0.353786,693.753247,0.001381,0.001619,91,0.000201,0,16,0.533333,0.014109
48221,Hood County,,TX,4410,51793,56203,24,20,44,12327,10861,23188,5,0.347323,0.365979,72.95704,0.005004,0.005366,91,0.000317,0,16,0.751667,0.050975
48223,Hopkins County,,TX,2175,36834,39009,15,14,29,5613,5214,10827,5,0.344009,0.361406,77.301957,0.002762,0.003084,91,0.000218,0,16,0.709524,0.028267
48225,Houston County,,TX,1365,20635,22000,9,10,19,2729,2803,5532,5,0.342337,0.358793,6.606036,0.001637,0.001823,91,0.000146,0,16,0.818182,0.016645
48227,Howard County,,TX,2295,31420,33715,17,14,31,3878,4165,8043,5,0.347283,0.365456,1711.883916,0.003979,0.003545,91,0.00028,0,16,0.647059,0.039312
48229,Hudspeth County,,TX,289,3488,3777,1,1,2,433,522,955,5,0.314734,0.326059,0,0.000384,0.0004,91,0.000057,0,16,0,0.003507
48231,Hunt County,,TX,7135,85696,92831,29,32,61,20813,20263,41076,5,0.364544,0.38686,3081.326284,0.007052,0.006714,91,0.000348,0,16,0.568254,0.069094
48233,Hutchinson County,,TX,1668,24844,26512,9,8,17,2491,2834,5325,5,0.343775,0.360471,362.163649,0.002,0.001582,91,0.000187,0,16,0.819444,0.019893
48235,Irion County,,TX,194,1639,1833,1,1,2,284,89,373,6,0.277483,0.287587,0,0.000108,0.000094,91,0.00006,0,16,0,0.000942
48237,Jack County,,TX,828,7815,8643,5,5,10,1306,1392,2698,5,0.3301,0.3448,0.267857,0.000643,0.000705,91,0.000106,0,16,0.9,0.006538
48239,Jackson County,,TX,1091,15789,16880,5,6,11,2152,2330,4482,5,0.341719,0.357533,0.25,0.000694,0.001337,91,0.000109,0,16,0.933333,0.007096
48241,Jasper County,,TX,2520,36020,38540,12,16,28,6701,7025,13726,5,0.344126,0.361819,33.638563,0.001786,0.003241,91,0.000174,0,16,0.7375,0.018243
48243,Jeff Davis County,,TX,243,2237,2480,1,1,2,67,87,154,6,0.249506,0.255684,0,0.000011,0.000016,91,0.00007,0,16,0,0.00022
48245,Jefferson County,,TX,15564,259036,274600,70,68,138,40652,47380,88032,5,0.387638,0.415396,2437.83732,0.018574,0.01825,91,0.00067,0,16,0.486902,0.172452
48247,Jim Hogg County,,TX,295,5479,5774,2,1,3,260,125,385,6,0.273104,0.281363,0,0.000102,0.000076,91,0.00007,0,16,1,0.001043
48249,Jim Wells County,,TX,2742,44374,47116,14,13,27,7606,7539,15145,5,0.345146,0.36265,274.08095,0.003264,0.003052,91,0.000206,0,16,0.675824,0.032786
48251,Johnson County,,TX,12737,160805,173542,46,44,90,41113,37333,78446,5,0.372846,0.397452,654.51905,0.010964,0.010852,91,0.000519,0,16,0.604314,0.106244
48253,Jones County,,TX,1569,16085,17654,6,5,11,3038,3260,6298,5,0.331437,0.346484,114.367102,0.000788,0.000839,91,0.000155,0,16,0.633333,0.007928
48255,Karnes County,,TX,852,12856,13708,6,7,13,1331,1528,2859,5,0.327778,0.341548,0.896825,0.001788,0.000922,91,0.000112,0,16,0.833333,0.017905
48257,Kaufman County,,TX,9147,109912,119059,29,26,55,35437,29038,64475,5,0.355058,0.375834,139.311457,0.007565,0.006363,91,0.000324,0,16,0.717742,0.073734
48259,Kendall County,,TX,2497,34212,36709,16,13,29,9454,7459,16913,5,0.345974,0.363448,33.447725,0.004981,0.003883,91,0.000218,0,16,0.852941,0.050146
48261,Kenedy County,,TX,-2,-2,-4,0,0,0,0,0,0,0,0,0,0,0,0,84,0.000049,68,115,0,0
48263,Kent County,,TX,83,808,891,0,0,0,0,0,0,0,0,0,0,0,0,85,0.000049,69,116,0,0
48265,Kerr County,,TX,3548,51572,55120,25,25,50,7293,7479,14772,5,0.350295,0.370205,9162.559892,0.005695,0.00655,91,0.000418,0,16,0.682266,0.05776
48267,Kimble County,,TX,341,4780,5121,1,1,2,164,92,256,6,0.259443,0.266936,0,0.000039,0.000034,91,0.000063,0,16,0,0.000401
48269,King County,,TX,-2,-2,-4,0,0,0,0,0,0,0,0,0,0,0,0,86,0.000049,70,117,0,0
48271,Kinney County,,TX,259,3262,3521,1,2,3,201,256,457,5,0.327389,0.340503,0,0.000056,0.000627,91,0.000056,0,16,1,0.000476
48273,Kleberg County,,TX,3263,30940,34203,15,22,37,6017,7970,13987,5,0.3577,0.378161,1048.263711,0.003876,0.006104,91,0.00021,0,16,0.58,0.038126
48275,Knox County,,TX,292,3798,4090,2,2,4,267,235,502,6,0.278682,0.288649,0,0.000104,0.000109,91,0.0001,0,16,1,0.001155
48277,Lamar County,,TX,2896,53147,56043,19,17,36,6004,5831,11835,5,0.36081,0.380753,500.243632,0.003556,0.00385,91,0.00027,0,16,0.545238,0.035664
48279,Lamb County,,TX,1377,14789,16166,4,7,11,1780,2510,4290,6,0.28282,0.2948,6.864143,0.000168,0.000291,91,0.000108,0,16,0.595238,0.001698
48281,Lampasas County,,TX,2022,20440,22462,9,9,18,4493,4063,8556,5,0.344989,0.361935,0.142157,0.003044,0.003448,91,0.000131,0,16,0.972222,0.030484
48283,La Salle County,,TX,375,5649,6024,3,3,6,593,646,1239,5,0.327389,0.340613,1.657697,0.000592,0.000662,91,0.000091,0,16,0.666667,0.005916
48285,Lavaca County,,TX,1061,21486,22547,9,9,18,2479,2379,4858,5,0.342067,0.358303,4.377321,0.001936,0.002258,91,0.000156,0,16,0.763889,0.020131
48287,Lee County,,TX,1148,17408,18556,7,10,17,2341,2424,4765,5,0.340797,0.357197,1.482643,0.001532,0.002231,91,0.00012,0,16,0.788889,0.016055
48289,Leon County,,TX,1547,17708,19255,12,10,22,3165,3084,6249,5,0.342337,0.358793,12.913402,0.002406,0.001886,91,0.000175,0,16,0.75,0.024172
48291,Liberty County,,TX,6575,72877,79452,19,21,40,19841,18897,38738,5,0.346409,0.364988,81.299902,0.003848,0.004413,91,0.000241,0,16,0.671429,0.039421
48293,Limestone County,,TX,1802,22439,24241,10,13,23,3991,4157,8148,5,0.344714,0.362204,16.145428,0.001895,0.003495,91,0.000161,0,16,0.697802,0.019192
48295,Lipscomb County,,TX,337,3250,3587,1,1,2,105,194,299,7,0.221548,0.226854,0,0.000002,0.000001,91,0.000075,0,16,0,0.000077
48297,Live Oak County,,TX,803,9465,10268,6,6,12,1668,1461,3129,5,0.327707,0.341328,0.466667,0.001379,0.000839,91,0.00011,0,16,0.857143,0.013564
48299,Llano County,,TX,1627,17256,18883,8,7,15,3660,3258,6918,5,0.342531,0.358551,0.973675,0.003043,0.00264,91,0.00013,0,16,0.922222,0.030965
48301,Loving County,,TX,-2,-2,-4,0,0,0,0,0,0,0,0,0,0,0,0,87,0.000049,71,118,0,0
48303,Lubbock County,,TX,17371,268307,285678,109,108,217,52694,49325,102019,5,0.392765,0.425014,78354.899555,0.02074,0.022679,91,0.001514,0,16,0.310711,0.197132
48305,Lynn County,,TX,685,6287,6972,2,2,4,1011,1282,2293,6,0.282056,0.292792,0,0.000135,0.000124,91,0.000079,0,16,1,0.001321
48307,McCulloch County,,TX,715,8526,9241,2,2,4,353,481,834,6,0.277686,0.288137,0,0.000141,0.00012,91,0.000076,0,16,1,0.00128
48309,McLennan County,,TX,13407,237617,251024,85,73,158,37392,37038,74430,5,0.390536,0.41889,3535.004009,0.019826,0.017607,91,0.000887,0,16,0.457238,0.187103
48311,McMullen County,,TX,80,831,911,0,0,0,0,0,0,0,0,0,0,0,0,88,0.000049,72,119,0,0
48313,Madison County,,TX,989,11301,12290,6,6,12,2137,2124,4261,5,0.339384,0.354969,0.4,0.001003,0.001132,91,0.000123,0,16,0.933333,0.010512
48315,Marion County,,TX,997,9667,10664,7,7,14,2156,2224,4380,5,0.336257,0.351667,0.593281,0.001334,0.001449,91,0.00012,0,16,0.952381,0.013183
48317,Martin County,,TX,434,4816,5250,3,2,5,1145,463,1608,6,0.272319,0.281914,0,0.000157,0.000118,91,0.000096,0,16,1,0.002068
48319,Mason County,,TX,224,3939,4163,0,0,0,0,0,0,0,0,0,0,0,0,89,0.000049,73,120,0,0
48321,Matagorda County,,TX,2643,39252,41895,13,14,27,5038,6143,11181,5,0.342763,0.359706,16.607934,0.003092,0.003334,91,0.000189,0,16,0.809524,0.03214
48323,Maverick County,,TX,2869,64782,67651,19,13,32,5879,5673,11552,5,0.346568,0.364136,82.122063,0.005354,0.00403,91,0.000244,0,16,0.638528,0.052486
48325,Medina County,,TX,3350,44616,47966,12,11,23,9151,9015,18166,5,0.3444,0.361274,85.130278,0.002725,0.002831,91,0.000202,0,16,0.686813,0.028073
48327,Menard County,,TX,184,2167,2351,1,0,1,63,0,63,0,0,0,0,0.000108,0,91,0.00006,0,12,0,0.000942
48329,Midland County,,TX,10186,142857,153043,85,64,149,34486,30840,65326,5,0.374135,0.401277,28857.018798,0.015964,0.012556,91,0.001156,0,16,0.328083,0.155378
48331,Milam County,,TX,2039,26118,28157,10,11,21,3559,4208,7767,5,0.340873,0.357417,11.484445,0.002543,0.002334,91,0.000155,0,16,0.69697,0.02568
48333,Mills County,,TX,397,4800,5197,1,1,2,134,226,360,6,0.258425,0.26583,0,0.000033,0.000027,91,0.000065,0,16,0,0.000338
48335,Mitchell County,,TX,563,7234,7797,6,6,12,887,855,1742,6,0.289413,0.301931,0.964904,0.000351,0.000362,91,0.000133,0,16,0.928571,0.003889
48337,Montague County,,TX,1608,20635,22243,9,9,18,3158,3204,6362,5,0.33678,0.352465,11.764987,0.002082,0.002343,91,0.00015,0,16,0.819444,0.020803
48339,Montgomery County,,TX,32429,440402,472831,186,130,316,151059,111284,262343,5,0.412389,0.446407,14382.069985,0.048753,0.036037,91,0.001686,0,16,0.388248,0.435983
48341,Moore County,,TX,2053,23049,25102,16,14,30,3659,4159,7818,5,0.362451,0.382431,5911.216214,0.003384,0.003369,91,0.000324,0,16,0.447712,0.032257
48343,Morris County,,TX,1328,14360,15688,8,9,17,2833,3127,5960,5,0.335921,0.35153,5.121866,0.001243,0.001454,91,0.000137,0,16,0.902778,0.01243
48345,Motley County,,TX,100,1073,1173,0,0,0,0,0,0,0,0,0,0,0,0,90,0.000049,74,121,0,0
48347,Nacogdoches County,,TX,4812,58090,62902,32,30,62,10840,12207,23047,5,0.347323,0.367052,396.144257,0.00558,0.006378,91,0.00038,0,16,0.542781,0.057328
48349,Navarro County,,TX,3500,50111,53611,16,18,34,8566,8919,17485,5,0.34633,0.364466,12.302598,0.004257,0.004887,91,0.000201,0,16,0.80719,0.042647
48351,Newton County,,TX,961,12163,13124,6,7,13,2938,2358,5296,5,0.33946,0.355189,1.244201,0.000891,0.000913,91,0.000102,0,16,0.75,0.008746
48353,Nolan County,,TX,1460,16042,17502,8,11,19,1688,2454,4142,5,0.337907,0.354314,498.071747,0.001442,0.001602,91,0.000167,0,16,0.627273,0.014169
48355,Nueces County,,TX,22394,348353,370747,110,103,213,62235,65727,127962,5,0.398081,0.430048,13848.186791,0.026285,0.02671,91,0.001138,0,16,0.390703,0.244572
48357,Ochiltree County,,TX,747,10947,11694,5,6,11,668,636,1304,6,0.284573,0.296319,9125.743009,0.000149,0.000277,91,0.000186,0,16,0.428571,0.001803
48359,Oldham County,,TX,257,2064,2321,2,2,4,350,406,756,6,0.275289,0.284957,0,0.000142,0.00014,91,0.000079,0,16,1,0.001489
48361,Orange County,,TX,7259,89966,97225,23,29,52,14811,16197,31008,5,0.359696,0.38127,214.252897,0.005431,0.007185,91,0.000273,0,16,0.669951,0.053972
48363,Palo Pinto County,,TX,2226,28317,30543,12,12,24,5188,5054,10242,5,0.343814,0.360939,66.145474,0.002281,0.00255,91,0.000189,0,16,0.719697,0.023116
48365,Panola County,,TX,1765,25560,27325,10,11,21,3720,4090,7810,5,0.34397,0.361049,2.478636,0.002069,0.002349,91,0.000152,0,16,0.872727,0.020588
48367,Parker County,,TX,9850,117878,127728,40,35,75,34231,28659,62890,5,0.366929,0.390107,767.207061,0.009256,0.00805,91,0.000476,0,16,0.591438,0.090311
48369,Parmer County,,TX,1115,11050,12165,8,7,15,2354,2391,4745,6,0.285485,0.297639,285.801414,0.001007,0.000318,91,0.000163,0,16,0.714286,0.009692
48371,Pecos County,,TX,1267,14276,15543,10,8,18,1594,1930,3524,5,0.343619,0.360284,313.935545,0.002436,0.001933,91,0.000183,0,16,0.722222,0.023861
48373,Polk County,,TX,5341,54485,59826,27,35,62,10226,10460,20686,5,0.366308,0.388896,485.275332,0.006549,0.009023,91,0.000321,0,16,0.596096,0.066493
48375,Potter County,,TX,13239,119521,132760,57,52,109,37354,40030,77384,5,0.379241,0.405447,45355.600497,0.012023,0.012285,91,0.000935,0,16,0.368588,0.11537
48377,Presidio County,,TX,1111,10560,11671,4,4,8,1481,2376,3857,5,0.315455,0.327545,0,0.00053,0.000582,91,0.000108,0,16,1,0.0055
48379,Rains County,,TX,940,9938,10878,9,8,17,2346,2143,4489,5,0.332747,0.347183,0.290909,0.002002,0.001346,91,0.000141,0,16,0.966667,0.020379
48381,Randall County,,TX,11981,125143,137124,58,56,114,42077,37848,79925,5,0.374459,0.400743,39124.244307,0.011666,0.011831,91,0.000935,0,16,0.373612,0.112961
48383,Reagan County,,TX,374,3867,4241,2,1,3,250,80,330,6,0.277483,0.287587,0,0.000164,0.000094,91,0.000067,0,16,1,0.001418
48385,Real County,,TX,265,3230,3495,2,1,3,201,52,253,6,0.259465,0.266991,0,0.000622,0.000034,91,0.000076,0,16,1,0.00625
48387,Red River County,,TX,1021,13459,14480,6,6,12,1758,2019,3777,5,0.335958,0.351255,17.674255,0.001173,0.001298,91,0.000119,0,16,0.766667,0.01172
48389,Reeves County,,TX,749,11502,12251,4,5,9,1266,1462,2728,5,0.315455,0.327655,20.745003,0.000522,0.000582,91,0.000106,0,16,0.9,0.005367
48391,Refugio County,,TX,611,8404,9015,4,5,9,792,1126,1918,5,0.327707,0.341218,0,0.000271,0.000835,91,0.00009,0,16,1,0.002662
48393,Roberts County,,TX,127,872,999,1,1,2,42,93,135,6,0.25676,0.263607,0,0.000013,0.000016,91,0.000073,0,16,0,0.000221
48395,Robertson County,,TX,1620,16770,18390,8,8,16,3216,3289,6505,5,0.339498,0.355354,5.460284,0.001902,0.00124,91,0.000134,0,16,0.733333,0.019151
48397,Rockwall County,,TX,6735,78058,84793,22,23,45,26924,22015,48939,5,0.361197,0.382304,69.772729,0.007104,0.006929,91,0.000251,0,16,0.799145,0.06866
48399,Runnels County,,TX,926,11337,12263,2,3,5,1054,1429,2483,6,0.282135,0.293117,1.947558,0.000211,0.000202,91,0.000072,0,16,0.833333,0.001996
48401,Rusk County,,TX,3635,51505,55140,16,15,31,10884,10519,21403,5,0.344009,0.361544,6.858401,0.002962,0.003708,91,0.000212,0,16,0.783088,0.02989
48403,Sabine County,,TX,695,10793,11488,8,8,16,1652,1452,3104,5,0.339498,0.355354,3.313394,0.000862,0.00092,91,0.000136,0,16,0.75,0.008708
48405,San Augustine County,,TX,588,8709,9297,5,5,10,1197,1377,2574,5,0.339384,0.354859,0.5,0.000702,0.000759,91,0.000107,0,16,0.9,0.007148
48407,San Jacinto County,,TX,2392,22654,25046,8,7,15,7953,6272,14225,5,0.339993,0.355607,0.428571,0.001445,0.00122,91,0.000126,0,16,0.902778,0.015598
48409,San Patricio County,,TX,8257,74105,82362,32,37,69,16889,20690,37579,5,0.364808,0.387917,962.073785,0.008621,0.010051,91,0.000367,0,16,0.655052,0.085043
48411,San Saba County,,TX,418,5501,5919,1,1,2,77,177,254,6,0.258425,0.26583,0,0.000033,0.000027,91,0.000065,0,16,0,0.000338
48413,Schleicher County,,TX,299,3247,3546,1,2,3,197,271,468,6,0.28468,0.296077,0.578077,0.000108,0.000196,91,0.00006,0,16,0,0.000942
48415,Scurry County,,TX,1288,16739,18027,10,10,20,1737,1963,3700,5,0.33802,0.354369,103.79686,0.001598,0.001735,91,0.00018,0,16,0.855556,0.016153
48417,Shackelford County,,TX,306,3560,3866,1,2,3,281,355,636,6,0.278708,0.288704,0,0.000103,0.000109,91,0.000061,0,16,1,0.001054
48419,Shelby County,,TX,1505,25806,27311,11,11,22,3221,3272,6493,5,0.34397,0.361049,34.652022,0.001676,0.002221,91,0.000174,0,16,0.705128,0.017225
48421,Sherman County,,TX,291,2847,3138,0,1,1,0,153,153,6,0.266093,0.273674,0,0,0.00002,91,0.000049,0,122,0,0
48423,Smith County,,TX,13718,217469,231187,79,65,144,44072,41013,85085,5,0.384001,0.411461,2494.447987,0.016656,0.015137,91,0.000831,0,16,0.436086,0.158757
48425,Somervell County,,TX,836,8282,9118,7,6,13,1749,1611,3360,5,0.33566,0.350814,0.090909,0.001269,0.001353,91,0.000131,0,16,0.952381,0.012836
48427,Starr County,,TX,2695,67075,69770,10,9,19,5299,7219,12518,5,0.344714,0.361357,41.187004,0.003366,0.002606,91,0.000154,0,16,0.863636,0.032871
48429,Stephens County,,TX,762,8938,9700,5,4,9,621,739,1360,5,0.330749,0.345328,94.973026,0.000661,0.000726,91,0.000125,0,16,0.55,0.006709
48431,Sterling County,,TX,124,1148,1272,1,0,1,74,0,74,0,0,0,0,0.000108,0,91,0.00006,0,13,0,0.000942
48433,Stonewall County,,TX,111,1549,1660,0,0,0,0,0,0,0,0,0,0,0,0,92,0.000049,75,123,0,0
48435,Sutton County,,TX,594,4964,5558,2,3,5,418,634,1052,6,0.280541,0.292005,0,0.000164,0.000231,91,0.000067,0,16,0.833333,0.001418
48437,Swisher County,,TX,783,7668,8451,4,4,8,1119,1467,2586,6,0.28444,0.295824,0,0.000299,0.000279,91,0.000102,0,16,1,0.002961
48439,Tarrant County,,TX,114939,1933303,2048242,537,467,1004,470411,422235,892646,4,0.49228,0.547045,271088.279985,0.10249,0.091167,91,0.004804,0,16,0.151192,0.877492
48441,Taylor County,,TX,12453,138130,150583,78,75,153,26982,29900,56882,5,0.386254,0.415076,31908.868833,0.017788,0.017458,91,0.001009,0,16,0.432967,0.168122
48443,Terrell County,,TX,108,900,1008,0,0,0,0,0,0,0,0,0,0,0,0,93,0.000049,76,124,0,0
48445,Terry County,,TX,1053,12016,13069,5,3,8,1451,1687,3138,6,0.282082,0.292957,29.13467,0.000684,0.000132,91,0.000121,0,16,0.6,0.006834
48447,Throckmorton County,,TX,126,1626,1752,0,0,0,0,0,0,0,0,0,0,0,0,94,0.000049,77,125,0,0
48449,Titus County,,TX,2202,33072,35274,18,18,36,5179,5454,10633,5,0.34554,0.363596,106.885076,0.002826,0.00326,91,0.000253,0,16,0.605263,0.028873
48451,Tom Green County,,TX,10209,115360,125569,70,79,149,20752,23210,43962,5,0.384001,0.413635,54333.948971,0.015887,0.018384,91,0.001031,0,16,0.366101,0.149272
48453,Travis County,,TX,83317,980539,1063856,440,327,767,367399,307583,674982,5,0.473651,0.518648,91752.706911,0.097363,0.079577,91,0.003678,0,16,0.223313,0.829304
48455,Trinity County,,TX,1230,13556,14786,8,7,15,3071,2922,5993,5,0.339993,0.355607,1.344045,0.000992,0.001104,91,0.000136,0,16,0.821429,0.010525
48457,Tyler County,,TX,1437,19016,20453,9,8,17,3362,3504,6866,5,0.339993,0.355717,0.590454,0.001092,0.001209,91,0.000131,0,16,0.933333,0.010695
48459,Upshur County,,TX,3508,38537,42045,16,15,31,10513,10059,20572,5,0.343892,0.361379,71.068237,0.002607,0.003092,91,0.000227,0,16,0.661765,0.026185
48461,Upton County,,TX,341,3399,3740,2,2,4,311,353,664,6,0.272368,0.281996,0,0.000136,0.000166,91,0.000079,0,16,1,0.001773
48463,Uvalde County,,TX,1894,29045,30939,14,11,25,3015,3408,6423,5,0.344439,0.361329,185.156024,0.003162,0.002693,91,0.000231,0,16,0.52381,0.031988
48465,Val Verde County,,TX,4568,53658,58226,21,35,56,6022,8406,14428,5,0.371338,0.395075,6196.189906,0.007412,0.00952,91,0.000275,0,16,0.593844,0.071454
48467,Van Zandt County,,TX,3958,52087,56045,16,17,33,10899,10445,21344,5,0.344165,0.361957,19.429917,0.003355,0.003926,91,0.000208,0,16,0.797386,0.034332
48469,Victoria County,,TX,5721,97153,102874,35,33,68,15223,16116,31339,5,0.347681,0.367767,3072.664305,0.005627,0.006493,91,0.000462,0,16,0.505556,0.05859
48471,Walker County,,TX,4882,47399,52281,28,26,54,13674,14619,28293,5,0.346845,0.365979,128.631889,0.005862,0.006191,91,0.000348,0,16,0.636243,0.06003
48473,Waller County,,TX,3479,36326,39805,12,13,25,12677,11008,23685,5,0.346171,0.363668,23.908042,0.003469,0.004223,91,0.000179,0,16,0.826923,0.035434
48475,Ward County,,TX,996,11579,12575,6,7,13,1310,1657,2967,6,0.287654,0.300209,30.201181,0.000285,0.0004,91,0.00016,0,16,0.642857,0.003392
48477,Washington County,,TX,1946,34519,36465,16,13,29,5422,5271,10693,5,0.344048,0.361296,38.744752,0.003364,0.003616,91,0.000224,0,16,0.679167,0.03526
48479,Webb County,,TX,7920,270562,278482,44,35,79,17369,19986,37355,5,0.375667,0.398668,6590.671386,0.012871,0.011273,91,0.000515,0,16,0.522534,0.119855
48481,Wharton County,,TX,2516,46538,49054,11,12,23,5933,6675,12608,5,0.342337,0.358936,10.094386,0.002208,0.002858,91,0.000169,0,16,0.75641,0.022982
48483,Wheeler County,,TX,434,5730,6164,3,3,6,267,371,638,6,0.275339,0.285177,0,0.000155,0.000155,91,0.000103,0,16,1,0.00171
48485,Wichita County,,TX,11792,130794,142586,62,87,149,20124,28052,48176,5,0.393632,0.423985,19176.747837,0.015298,0.019771,91,0.000732,0,16,0.409602,0.143281
48487,Wilbarger County,,TX,1109,14358,15467,4,5,9,1215,1456,2671,5,0.336818,0.35208,3202.202445,0.001202,0.001332,91,0.000102,0,16,0.6,0.011579
48489,Willacy County,,TX,1155,20458,21613,4,5,9,2219,2831,5050,5,0.342183,0.357945,0,0.001429,0.001772,91,0.000087,0,16,1,0.014378
48491,Williamson County,,TX,38780,426327,465107,213,153,366,178502,133276,311778,5,0.42656,0.461869,16067.332534,0.05813,0.043214,91,0.001862,0,16,0.389364,0.514045
48493,Wilson County,,TX,3217,44109,47326,11,10,21,9661,8370,18031,5,0.344361,0.361109,24.715579,0.002903,0.002903,91,0.000173,0,16,0.839744,0.030139
48495,Winkler County,,TX,586,7630,8216,4,3,7,756,1000,1756,6,0.272392,0.282161,0.349889,0.000169,0.000168,91,0.000111,0,16,0.833333,0.002381
48497,Wise County,,TX,4989,60440,65429,16,20,36,14554,13261,27815,5,0.348883,0.36818,173.074183,0.004047,0.005339,91,0.000225,0,16,0.733333,0.040255
48499,Wood County,,TX,3106,42032,45138,20,17,37,8920,7732,16652,5,0.344087,0.361847,69.710979,0.003408,0.00318,91,0.000261,0,16,0.686842,0.035017
48501,Yoakum County,,TX,679,8990,9669,3,6,9,757,1260,2017,6,0.282661,0.294415,0.35989,0.000166,0.000343,91,0.000094,0,16,0.8,0.001852
48503,Young County,,TX,1228,19488,20716,9,11,20,2008,1957,3965,5,0.337418,0.353323,260.303969,0.001636,0.001991,91,0.000172,0,16,0.590909,0.016392
48505,Zapata County,,TX,518,13462,13980,4,4,8,985,1116,2101,5,0.328062,0.341548,0,0.000861,0.000909,91,0.000097,0,16,1,0.009091
48507,Zavala County,,TX,908,11617,12525,3,4,7,1094,1533,2627,5,0.327389,0.340723,0.2,0.000545,0.000643,91,0.000098,0,16,0.916667,0.005474
49001,Beaver County,,UT,443,7355,7798,4,4,8,629,771,1400,6,0.339498,0.354749,0,0.001139,0.001156,2,0.000082,0,16,1,0.010162
49003,Box Elder County,,UT,3639,57927,61566,11,10,21,9772,9433,19205,6,0.340146,0.356317,1078.614826,0.002384,0.001719,2,0.000153,0,16,0.825758,0.021543
49005,Cache County,,UT,8991,116616,125607,40,41,81,21485,22312,43797,5,0.367954,0.39162,9277.76546,0.00707,0.008875,2,0.000476,0,16,0.417092,0.064682
49007,Carbon County,,UT,1459,22639,24098,13,11,24,3245,3209,6454,6,0.31992,0.333504,23.14176,0.001858,0.001171,2,0.000172,0,16,0.769231,0.016771
49009,Daggett County,,UT,62,906,968,0,0,0,0,0,0,0,0,0,0,0,0,95,0.000049,78,126,0,0
49011,Davis County,,UT,27525,338864,366389,91,87,178,83845,82891,166736,5,0.394709,0.424601,5352.376378,0.024035,0.024878,2,0.000839,0,16,0.474394,0.219571
49013,Duchesne County,,UT,1120,19340,20460,10,8,18,3942,3358,7300,6,0.339841,0.355656,0.322222,0.001713,0.001563,2,0.000133,0,16,0.9,0.015265
49015,Emery County,,UT,756,11960,12716,3,5,8,1316,1577,2893,6,0.318574,0.33111,0,0.000697,0.00077,2,0.000077,0,16,0.95,0.005908
49017,Garfield County,,UT,417,5259,5676,4,3,7,357,544,901,6,0.338625,0.353593,0,0.000989,0.000739,2,0.000082,0,16,1,0.008695
49019,Grand County,,UT,846,9915,10761,5,4,9,835,938,1773,6,0.318809,0.331358,0.739601,0.000863,0.000738,2,0.000094,0,16,0.9,0.007389
49021,Iron County,,UT,4030,38215,42245,24,24,48,10840,10866,21706,5,0.357531,0.377402,400.871794,0.005439,0.005381,2,0.000288,0,16,0.556159,0.047948
49023,Juab County,,UT,766,10796,11562,4,3,7,1921,1752,3673,6,0.317905,0.330092,0,0.000768,0.000657,2,0.000084,0,16,1,0.006568
49025,Kane County,,UT,720,6890,7610,6,6,12,1224,1321,2545,6,0.339803,0.355381,0,0.001516,0.001467,2,0.000095,0,16,1,0.013085
49027,Millard County,,UT,907,13740,14647,6,4,10,1365,1489,2854,6,0.317972,0.330313,0,0.001464,0.000747,2,0.0001,0,16,0.933333,0.013082
49029,Morgan County,,UT,804,10541,11345,3,4,7,2026,1872,3898,6,0.318641,0.330973,0,0.000655,0.00088,2,0.000072,0,16,1,0.005819
49031,Piute County,,UT,92,1491,1583,0,0,0,0,0,0,0,0,0,0,0,0,96,0.000049,79,127,0,0
49033,Rich County,,UT,233,2299,2532,1,0,1,82,0,82,0,0,0,0,0.000052,0,2,0.000059,0,10,0,0.000455
49035,Salt Lake County,,UT,60077,1178477,1238554,279,286,565,201941,205749,407690,5,0.464571,0.507093,95533.730954,0.070688,0.071198,2,0.002403,0,16,0.298786,0.61165
49037,San Juan County,,UT,1256,10255,11511,8,9,17,2391,2641,5032,6,0.319346,0.332789,11.889593,0.00091,0.000948,2,0.00014,0,16,0.625,0.008069
49039,Sanpete County,,UT,1836,25649,27485,10,10,20,4513,4951,9464,6,0.339917,0.355987,29.392365,0.001709,0.001598,2,0.000149,0,16,0.818182,0.015214
49041,Sevier County,,UT,1425,22465,23890,7,9,16,2862,3059,5921,6,0.339879,0.355822,0.95345,0.001565,0.001588,2,0.00011,0,16,0.888889,0.013792
49043,Summit County,,UT,3756,41275,45031,21,16,37,9888,9225,19113,5,0.358886,0.378062,26.464554,0.008781,0.006095,2,0.000199,0,16,0.804348,0.078392
49045,Tooele County,,UT,4651,63705,68356,13,15,28,13201,11675,24876,5,0.356395,0.375118,18.703645,0.00366,0.003206,2,0.000153,0,16,0.716912,0.032547
49047,Uintah County,,UT,2228,32039,34267,16,16,32,6820,5388,12208,5,0.353442,0.371982,363.784616,0.002533,0.002715,2,0.000207,0,16,0.581871,0.023223
49049,Utah County,,UT,34752,516680,551432,156,172,328,110363,113945,224308,5,0.430929,0.46758,28141.398105,0.039125,0.045847,2,0.001419,0,16,0.382084,0.357234
49051,Wasatch County,,UT,2293,24119,26412,8,11,19,6753,6093,12846,5,0.351964,0.369643,8.106211,0.002312,0.002393,2,0.000113,0,16,0.927273,0.020852
49053,Washington County,,UT,11180,140260,151440,52,55,107,31126,29580,60706,5,0.369796,0.395306,2345.406406,0.01152,0.011772,2,0.000541,0,16,0.405048,0.102912
49055,Wayne County,,UT,289,2835,3124,1,1,2,78,108,186,6,0.317239,0.329075,0,0.000419,0.000416,2,0.000056,0,16,0,0.003604
49057,Weber County,,UT,16773,259614,276387,54,56,110,52463,49837,102300,5,0.37225,0.398195,1626.00241,0.015568,0.015019,2,0.000499,0,16,0.565228,0.140653
50001,Addison County,,VT,2391,43504,45895,9,10,19,4508,4719,9227,6,0.320767,0.335974,106.465634,0.000723,0.001275,54,0.000145,0,16,0.644444,0.00647
50003,Bennington County,,VT,2043,44299,46342,10,13,23,3180,3561,6741,6,0.321141,0.33691,22.969715,0.001399,0.002198,57,0.000118,0,16,0.673077,0.010762
50005,Caledonia County,,VT,1965,36523,38488,9,10,19,3759,3902,7661,6,0.31185,0.326351,251.996829,0.000756,0.000768,54,0.000151,0,16,0.572727,0.006623
50007,Chittenden County,,VT,10719,181938,192657,85,85,170,27129,28479,55608,5,0.391293,0.420953,22754.56567,0.023848,0.02783,54,0.000644,0,16,0.545247,0.196253
50009,Essex County,,VT,621,7296,7917,4,4,8,1240,1208,2448,6,0.271367,0.280258,2.641248,0.000092,0.000078,54,0.000093,0,16,0.583333,0.000898
50011,Franklin County,,VT,2580,59174,61754,9,8,17,7052,5713,12765,6,0.281715,0.292874,13.662042,0.000252,0.000205,54,0.000161,0,16,0.555556,0.002287
50013,Grand Isle County,,VT,818,8829,9647,3,3,6,1618,1842,3460,6,0.281558,0.291994,0,0.000193,0.000163,54,0.00008,0,16,1,0.001498
50015,Lamoille County,,VT,1863,29477,31340,9,9,18,3992,3847,7839,6,0.31185,0.326241,87.951941,0.000725,0.000716,54,0.000149,0,16,0.777778,0.006432
50017,Orange County,,VT,2366,34934,37300,10,9,19,5610,5550,11160,6,0.282635,0.294041,5.925423,0.000833,0.000363,54,0.000139,0,16,0.7,0.007277
50019,Orleans County,,VT,1452,32803,34255,7,7,14,2232,2492,4724,6,0.281506,0.292379,24.189418,0.000228,0.000203,54,0.000139,0,16,0.666667,0.00212
50021,Rutland County,,VT,3366,76309,79675,16,19,35,4908,5536,10444,6,0.334032,0.35137,354.35787,0.002362,0.003024,54,0.000195,0,16,0.529644,0.018835
50023,Washington County,,VT,3935,72743,76678,19,18,37,8309,8331,16640,5,0.354145,0.373011,1256.786931,0.003178,0.004003,54,0.000222,0,16,0.543478,0.026812
50025,Windham County,,VT,3079,53090,56169,20,20,40,5710,5809,11519,6,0.324269,0.341213,33.692265,0.004435,0.004081,54,0.000177,0,16,0.671937,0.035093
50027,Windsor County,,VT,4661,69783,74444,27,25,52,10282,10447,20729,5,0.340452,0.358793,834.224315,0.005672,0.005148,54,0.00026,0,16,0.578495,0.04636
51001,Accomack County,,VA,1839,37924,39763,12,9,21,2806,3101,5907,5,0.316907,0.330802,75.371007,0.003602,0.001431,98,0.000149,0,16,0.554945,0.031089
51003,Albemarle County,,VA,10300,98608,108908,67,64,131,26690,26304,52994,5,0.400767,0.427754,16932.217435,0.021097,0.021981,98,0.000622,0,16,0.582603,0.186833
51005,Alleghany County,,VA,724,18858,19582,4,6,10,1266,1332,2598,6,0.271927,0.281776,4852.118361,0.000002,0.000068,98,0.000155,0,16,0.333333,0.000309
51007,Amelia County,,VA,891,14696,15587,7,6,13,2623,2173,4796,6,0.301483,0.313602,3.212699,0.00073,0.000726,98,0.000132,0,16,0.785714,0.006657
51009,Amherst County,,VA,2086,35982,38068,5,5,10,5022,5020,10042,6,0.260626,0.269451,13.081397,0.000063,0.000048,98,0.000121,0,16,0.6,0.000764
51011,Appomattox County,,VA,951,17240,18191,7,6,13,2523,2084,4607,6,0.260716,0.269781,19.419657,0.000071,0.000048,98,0.000149,0,16,0.47619,0.000926
51013,Arlington County,,VA,38485,215322,253807,237,164,401,138133,136400,274533,5,0.435264,0.470678,11668.714823,0.072932,0.058291,98,0.001679,0,16,0.462012,0.608248
51015,Augusta County,,VA,4156,86076,90232,9,15,24,11730,11089,22819,5,0.326682,0.343408,1665.759827,0.000817,0.002031,98,0.000173,0,16,0.561905,0.007323
51017,Bath County,,VA,386,5627,6013,1,2,3,125,293,418,7,0.213822,0.218576,0,0,0,98,0.000071,0,16,1,0.000068
51019,Bedford County,,VA,4704,79031,83735,17,19,36,14790,12757,27547,5,0.331691,0.350644,4679.184078,0.002257,0.003009,98,0.000265,0,16,0.505848,0.020043
51021,Bland County,,VA,409,6974,7383,3,3,6,530,701,1231,7,0.245482,0.252892,5.355594,0.000006,0.000005,77,0.000107,0,16,0.666667,0.000265
51023,Botetourt County,,VA,2518,39815,42333,9,8,17,6457,6162,12619,6,0.287218,0.297981,4146.299047,0.000463,0.000136,98,0.000189,0,16,0.583333,0.00392
51025,Brunswick County,,VA,1156,17382,18538,9,9,18,1703,2120,3823,6,0.295368,0.308,2241.414726,0.000493,0.000491,98,0.000191,0,16,0.444444,0.004792
51027,Buchanan County,,VA,1031,23512,24543,6,6,12,1751,2166,3917,6,0.270737,0.280373,960.526025,0.000006,0.000046,77,0.0002,0,16,0.357143,0.000494
51029,Buckingham County,,VA,773,15737,16510,6,8,14,1614,1537,3151,6,0.301513,0.31407,104.17067,0.000479,0.000712,98,0.000117,0,16,0.553571,0.004183
51031,Campbell County,,VA,4208,62253,66461,10,14,24,11569,11918,23487,6,0.322956,0.339083,1110.127694,0.000159,0.001377,98,0.000191,0,16,0.483516,0.001678
51033,Caroline County,,VA,2923,32271,35194,13,12,25,8097,7507,15604,5,0.323819,0.339628,18.170733,0.002337,0.002004,98,0.000162,0,16,0.763736,0.02113
51035,Carroll County,,VA,1322,31774,33096,8,9,17,2991,3034,6025,6,0.29638,0.308661,2506.561536,0.000123,0.000321,58,0.000203,0,16,0.333333,0.001167
51036,Charles City County,,VA,535,8407,8942,5,6,11,1259,1324,2583,6,0.301453,0.313547,0,0.000782,0.000809,98,0.000101,0,16,1,0.006966
51037,Charlotte County,,VA,721,13908,14629,6,7,13,1186,1366,2552,6,0.260716,0.26993,15.624259,0.000033,0.000044,98,0.000141,0,16,0.428571,0.000565
51041,Chesterfield County,,VA,26438,368536,394974,148,138,286,83362,80433,163795,5,0.416586,0.451431,56398.288734,0.041596,0.041762,98,0.001298,0,16,0.424212,0.361187
51043,Clarke County,,VA,1250,15535,16785,9,7,16,3446,3116,6562,5,0.322577,0.337328,0.646822,0.001331,0.001024,98,0.00014,0,16,0.902778,0.012657
51045,Craig County,,VA,357,5643,6000,5,4,9,663,577,1240,6,0.286674,0.296561,0.775,0.000198,0.000118,98,0.000117,0,16,0.75,0.001414
51047,Culpeper County,,VA,4345,50582,54927,17,20,37,10082,9747,19829,5,0.324269,0.3414,312.263933,0.002509,0.003136,98,0.000234,0,16,0.588095,0.023712
51049,Cumberland County,,VA,669,10456,11125,6,6,12,1663,1690,3353,6,0.301483,0.313602,4.654626,0.000725,0.000726,98,0.000118,0,16,0.766667,0.006542
51051,Dickenson County,,VA,591,15257,15848,3,3,6,923,1037,1960,7,0.216868,0.222218,1.629845,0.000002,0.000001,77,0.000124,0,16,0.666667,0.000225
51053,Dinwiddie County,,VA,2192,31017,33209,10,11,21,6545,6176,12721,6,0.302416,0.31539,21.246107,0.000817,0.000809,98,0.000166,0,16,0.654545,0.007491
51057,Essex County,,VA,773,12722,13495,7,10,17,1509,1523,3032,6,0.301723,0.314482,178.585845,0.000318,0.000848,98,0.00016,0,16,0.5,0.003157
51059,Fairfax County,,VA,108523,1198588,1307111,410,392,802,386959,393505,780464,4,0.475063,0.526686,147219.318453,0.096796,0.09195,98,0.003157,0,16,0.23152,0.817834
51061,Fauquier County,,VA,5378,73712,79090,24,22,46,15707,14058,29765,5,0.325419,0.342918,318.965284,0.005455,0.004075,98,0.000276,0,16,0.561538,0.050546
51063,Floyd County,,VA,908,16636,17544,8,7,15,1737,1645,3382,6,0.286946,0.297441,152.48014,0.000205,0.000123,98,0.000161,0,16,0.607143,0.001703
51065,Fluvanna County,,VA,1992,28392,30384,10,10,20,4653,4343,8996,6,0.301844,0.314675,98.721192,0.001257,0.000933,98,0.000155,0,16,0.613636,0.011297
51067,Franklin County,,VA,2930,60822,63752,11,11,22,6796,6253,13049,6,0.287245,0.298459,1077.202977,0.000771,0.000144,98,0.000196,0,16,0.484848,0.006803
51069,Frederick County,,VA,6736,89268,96004,24,23,47,20617,17979,38596,5,0.327389,0.345334,2234.950578,0.003964,0.003391,98,0.0003,0,16,0.462963,0.035469
51071,Giles County,,VA,931,19482,20413,5,7,12,1894,2125,4019,6,0.287846,0.298421,408.246238,0.000117,0.000103,98,0.000134,0,16,0.47619,0.000913
51073,Gloucester County,,VA,2782,43776,46558,17,15,32,6595,5595,12190,5,0.317239,0.332486,214.612318,0.002877,0.002058,98,0.000228,0,16,0.552288,0.024461
51075,Goochland County,,VA,1358,23157,24515,6,7,13,4426,3488,7914,6,0.301723,0.314125,1.285969,0.000756,0.000881,98,0.000111,0,16,0.857143,0.006812
51077,Grayson County,,VA,776,16768,17544,5,5,10,1327,1669,2996,7,0.230377,0.237093,42.629511,0.00001,0.000003,58,0.000164,0,16,0.266667,0.000439
51079,Greene County,,VA,1431,20860,22291,8,7,15,3629,3460,7089,6,0.286566,0.296836,44.821075,0.001149,0.000231,98,0.000134,0,16,0.777778,0.010411
51081,Greensville County,,VA,472,9360,9832,4,3,7,1277,857,2134,7,0.232571,0.238897,17.529373,0.000025,0.000005,98,0.000114,0,16,0.416667,0.000436
51083,Halifax County,,VA,1453,39657,41110,6,11,17,1668,2313,3981,6,0.320563,0.335958,289.558022,0.000053,0.001421,98,0.000125,0,16,0.518182,0.000641
51085,Hanover County,,VA,7246,117763,125009,24,24,48,20857,19031,39888,5,0.331473,0.350946,513.610402,0.004296,0.004629,98,0.000284,0,16,0.475369,0.03836
51087,Henrico County,,VA,28900,349213,378113,160,149,309,96628,94898,191526,5,0.426981,0.461803,62597.305606,0.04562,0.045634,98,0.001426,0,16,0.422165,0.392179
51089,Henry County,,VA,2882,62161,65043,10,10,20,6160,6697,12857,6,0.301964,0.315753,650.582235,0.000669,0.000484,58,0.000167,0,16,0.509091,0.0065
51091,Highland County,,VA,141,2778,2919,0,0,0,0,0,0,0,0,0,0,0,0,97,0.000049,80,128,0,0
51093,Isle of Wight County,,VA,3127,42030,45157,12,14,26,8243,7151,15394,5,0.317239,0.332376,61.276019,0.001755,0.002168,98,0.000154,0,16,0.741758,0.0146
51095,James City County,,VA,5723,74908,80631,39,35,74,17058,13294,30352,5,0.368716,0.391812,2351.815877,0.010383,0.010899,98,0.000387,0,16,0.589323,0.091951
51097,King and Queen County,,VA,566,7254,7820,6,5,11,1238,1104,2342,6,0.299456,0.310889,1.994907,0.000384,0.000354,98,0.000118,0,16,0.8,0.003605
51099,King George County,,VA,2709,26308,29017,15,14,29,6407,5809,12216,5,0.35127,0.369451,53.663409,0.003576,0.004015,98,0.000164,0,16,0.683007,0.030951
51101,King William County,,VA,1350,19306,20656,10,10,20,3990,3479,7469,6,0.306238,0.319456,17.036655,0.00084,0.001058,98,0.000169,0,16,0.690909,0.007824
51103,Lancaster County,,VA,712,13849,14561,6,5,11,854,903,1757,6,0.305035,0.317239,835.374544,0.001064,0.000507,98,0.000136,0,16,0.547619,0.009566
51105,Lee County,,VA,833,22651,23484,5,5,10,1407,1312,2719,6,0.269244,0.278546,85.618071,0.000042,0.000042,77,0.000158,0,16,0.4,0.000747
51107,Loudoun County,,VA,28936,346358,375294,173,151,324,116923,85413,202336,5,0.420928,0.456724,10529.515267,0.057971,0.052509,98,0.001287,0,16,0.53935,0.494763
51109,Louisa County,,VA,2438,36246,38684,15,15,30,6964,5742,12706,5,0.323957,0.340178,91.150703,0.002135,0.002171,98,0.000193,0,16,0.666667,0.01922
51111,Lunenburg County,,VA,677,12109,12786,7,6,13,1406,1272,2678,6,0.294478,0.306388,419.413288,0.000465,0.000262,98,0.000145,0,16,0.690476,0.004427
51113,Madison County,,VA,998,14958,15956,5,4,9,2019,1933,3952,6,0.286403,0.296176,0.111111,0.00025,0.000158,98,0.000102,0,16,0.9,0.00221
51115,Mathews County,,VA,569,10264,10833,3,3,6,805,927,1732,6,0.298042,0.309084,0,0.000272,0.00025,98,0.000089,0,16,1,0.00231
51117,Mecklenburg County,,VA,1692,34773,36465,11,11,22,2827,3089,5916,6,0.324269,0.340299,3522.186659,0.001239,0.001749,98,0.000183,0,16,0.365385,0.011613
51119,Middlesex County,,VA,741,12008,12749,7,6,13,1450,893,2343,6,0.305589,0.318119,31.799524,0.000983,0.000722,98,0.000142,0,16,0.666667,0.008629
51121,Montgomery County,,VA,7828,77538,85366,45,60,105,13470,16760,30230,5,0.39683,0.423886,38327.982622,0.008987,0.018364,98,0.000559,0,16,0.484375,0.082082
51125,Nelson County,,VA,953,17167,18120,6,6,12,1981,2043,4024,6,0.286566,0.296616,394.16155,0.000779,0.000196,98,0.000115,0,16,0.595238,0.006784
51127,New Kent County,,VA,1366,20870,22236,12,8,20,4882,3322,8204,6,0.306145,0.319071,7.836213,0.00138,0.001038,98,0.000165,0,16,0.757576,0.011922
51131,Northampton County,,VA,790,14051,14841,3,3,6,1250,1424,2674,6,0.314342,0.327165,0,0.000785,0.000795,98,0.000076,0,16,1,0.006733
51133,Northumberland County,,VA,686,14462,15148,6,5,11,1420,1112,2532,6,0.299456,0.310889,702.650067,0.000831,0.000289,98,0.000136,0,16,0.633333,0.007581
51135,Nottoway County,,VA,1050,16051,17101,7,9,16,1887,2223,4110,6,0.301723,0.314372,12.675207,0.000461,0.000741,98,0.000151,0,16,0.694444,0.004436
51137,Orange County,,VA,3018,38233,41251,16,16,32,8729,7832,16561,5,0.323646,0.339969,215.163634,0.002112,0.001966,98,0.000212,0,16,0.632353,0.019282
51139,Page County,,VA,1260,27904,29164,6,7,13,2029,2129,4158,5,0.322474,0.337218,1.677671,0.000956,0.001043,98,0.000116,0,16,0.857143,0.008895
51141,Patrick County,,VA,845,19648,20493,6,7,13,1725,1655,3380,7,0.245164,0.253255,28.048815,0.000021,0.000027,58,0.000146,0,16,0.309524,0.000637
51143,Pittsylvania County,,VA,3317,72105,75422,11,15,26,8690,8664,17354,6,0.320631,0.336525,371.688063,0.000437,0.001223,98,0.000178,0,16,0.447619,0.004306
51145,Powhatan County,,VA,1656,30528,32184,7,7,14,5307,4099,9406,6,0.301453,0.313657,2.4,0.000753,0.000753,98,0.000133,0,16,0.761905,0.006839
51147,Prince Edward County,,VA,1403,19049,20452,10,11,21,2571,3021,5592,6,0.301783,0.314702,1064.615701,0.000731,0.000761,98,0.000195,0,16,0.445455,0.006866
51149,Prince George County,,VA,5047,34655,39702,26,29,55,12764,11850,24614,5,0.360595,0.382128,1329.917693,0.006477,0.008046,98,0.00027,0,16,0.633523,0.058512
51153,Prince William County,,VA,47546,433160,480706,225,199,424,182585,148740,331325,5,0.436959,0.476279,26275.569637,0.066555,0.059865,98,0.001698,0,16,0.406213,0.565866
51155,Pulaski County,,VA,1960,37690,39650,8,10,18,4816,4373,9189,6,0.287327,0.298432,210.628775,0.000205,0.000126,98,0.000172,0,16,0.466667,0.00167
51157,Rappahannock County,,VA,690,8412,9102,5,4,9,1257,1264,2521,5,0.322234,0.336503,0,0.000947,0.000633,98,0.000097,0,16,1,0.00889
51159,Richmond County,,VA,635,8540,9175,4,5,9,1228,1417,2645,6,0.299456,0.310889,1.923036,0.00002,0.000294,98,0.000123,0,16,0.75,0.000486
51161,Roanoke County,,VA,8549,108897,117446,25,28,53,23842,23353,47195,5,0.338511,0.359959,8878.135466,0.004131,0.005659,98,0.000363,0,16,0.44254,0.037181
51163,Rockbridge County,,VA,1406,24808,26214,6,6,12,2758,2417,5175,6,0.269125,0.278667,12151.383502,0.000075,0.000053,98,0.000226,0,16,0.2,0.00088
51165,Rockingham County,,VA,4620,90874,95494,14,13,27,12060,11291,23351,5,0.325384,0.341763,4634.748227,0.001847,0.00167,98,0.000223,0,16,0.47619,0.016627
51167,Russell County,,VA,1019,28175,29194,7,9,16,3070,2936,6006,6,0.274366,0.284439,2007.525017,0.000038,0.000105,77,0.000226,0,16,0.541667,0.000894
51169,Scott County,,VA,1033,23586,24619,6,6,12,2426,2877,5303,6,0.273969,0.283625,20.173093,0.000094,0.000106,77,0.000176,0,16,0.666667,0.001383
51171,Shenandoah County,,VA,2964,48969,51933,13,11,24,6689,6021,12710,5,0.322818,0.338153,95.892895,0.001372,0.001457,98,0.000193,0,16,0.583333,0.01311
51173,Smyth County,,VA,1343,35453,36796,6,5,11,2407,2429,4836,6,0.273969,0.283526,495.20867,0.000038,0.000104,77,0.000188,0,16,0.47619,0.000823
51175,Southampton County,,VA,1202,19514,20716,10,10,20,3128,2744,5872,5,0.315751,0.329801,2791.099172,0.001413,0.001351,98,0.000147,0,16,0.622222,0.01189
51177,Spotsylvania County,,VA,13118,138157,151275,49,48,97,36858,34527,71385,5,0.378341,0.403714,1471.549901,0.014184,0.015975,98,0.000445,0,16,0.617481,0.125866
51179,Stafford County,,VA,16770,136686,153456,74,71,145,48354,45179,93533,5,0.393479,0.421305,3035.312544,0.025534,0.024868,98,0.000616,0,16,0.615878,0.225417
51181,Surry County,,VA,530,7718,8248,3,4,7,743,761,1504,6,0.298218,0.309525,4.228074,0.000273,0.000301,98,0.000079,0,16,0.583333,0.002227
51183,Sussex County,,VA,1019,11377,12396,9,11,20,1933,2178,4111,6,0.302537,0.315962,2916.782078,0.00035,0.000766,98,0.000184,0,16,0.418182,0.003467
51185,Tazewell County,,VA,2116,45097,47213,7,11,18,4161,4309,8470,6,0.276041,0.286756,675.639451,0.000007,0.00011,77,0.000213,0,16,0.325758,0.000582
51187,Warren County,,VA,3086,42505,45591,17,15,32,7827,7001,14828,5,0.322921,0.338759,32.170163,0.002728,0.001702,98,0.00023,0,16,0.611111,0.025513
51191,Washington County,,VA,3059,58131,61190,12,10,22,7203,7243,14446,6,0.287873,0.299422,2691.127412,0.000516,0.000155,77,0.000298,0,16,0.378788,0.004973
51193,Westmoreland County,,VA,1372,19523,20895,13,11,24,3567,3210,6777,5,0.323197,0.338786,1517.751843,0.002068,0.00176,98,0.000183,0,16,0.564103,0.018483
51195,Wise County,,VA,1785,39943,41728,9,10,19,3666,4362,8028,6,0.275464,0.285903,9674.954357,0.000093,0.000108,77,0.0003,0,16,0.322222,0.001585
51197,Wythe County,,VA,1581,32906,34487,8,8,16,2667,2501,5168,6,0.288202,0.299164,1417.39464,0.000116,0.000099,98,0.000212,0,16,0.322222,0.001087
51199,York County,,VA,10080,74293,84373,39,43,82,20762,21782,42544,5,0.37754,0.40219,1340.811188,0.012286,0.014359,98,0.000348,0,16,0.63009,0.109026
51510,Alexandria city,,VA,28595,143857,172452,159,120,279,100529,99305,199834,5,0.424467,0.456273,3375.443255,0.056223,0.045664,98,0.001127,0,16,0.619364,0.474646
51515,Bedford city,,VA,642,6851,7493,5,5,10,1417,1598,3015,6,0.270519,0.280037,0,0.00015,0.000106,98,0.000106,0,16,1,0.0013
51520,Bristol city,,VA,1885,17542,19427,6,5,11,5471,5214,10685,6,0.273499,0.282899,17.303813,0.000092,0.000103,77,0.000175,0,16,0.766667,0.001373
51530,Buena Vista city,,VA,641,6848,7489,2,2,4,1305,1140,2445,7,0.212085,0.216719,0,0,0,98,0.000141,0,16,1,0.000138
51540,Charlottesville city,,VA,6236,37756,43992,34,44,78,14275,17891,32166,5,0.385614,0.410543,6011.09964,0.009802,0.015096,98,0.000353,0,16,0.590338,0.088102
51550,Chesapeake city,,VA,25483,246660,272143,100,104,204,80299,75228,155527,5,0.404838,0.436734,10546.76845,0.032251,0.035311,98,0.000804,0,16,0.556818,0.280382
51570,Colonial Heights city,,VA,2478,20372,22850,7,7,14,6622,6534,13156,6,0.302175,0.31451,0,0.000806,0.000797,98,0.000118,0,16,1,0.007217
51580,Covington city,,VA,504,7155,7659,3,3,6,909,990,1899,6,0.270326,0.279553,1600.038196,0.000056,0.000041,98,0.000113,0,16,0.416667,0.000557
51590,Danville city,,VA,3061,46265,49326,10,15,25,6651,7626,14277,6,0.327495,0.344949,655.19753,0.000862,0.003123,98,0.000157,0,16,0.575163,0.008245
51595,Emporia city,,VA,518,6512,7030,4,5,9,1121,1127,2248,6,0.249177,0.257538,41.777121,0.000015,0.000026,98,0.000126,0,16,0.35,0.00039
51600,Fairfax city,,VA,3869,24869,28738,9,12,21,10102,12403,22505,5,0.349608,0.366975,0.228235,0.003143,0.004217,98,0.000118,0,16,0.94697,0.029212
51610,Falls Church city,,VA,2042,11849,13891,8,7,15,5765,5228,10993,5,0.323611,0.338517,0,0.003117,0.003063,98,0.000107,0,16,1,0.028929
51620,Franklin city,,VA,954,9451,10405,6,7,13,1986,2030,4016,6,0.314538,0.327908,0,0.000947,0.001124,98,0.000099,0,16,1,0.008108
51630,Fredericksburg city,,VA,5213,20032,25245,20,18,38,15957,15009,30966,5,0.325594,0.342577,46.58186,0.004969,0.004036,98,0.000221,0,16,0.745238,0.045388
51640,Galax city,,VA,610,7761,8371,3,3,6,1750,1449,3199,7,0.244669,0.251747,16.840047,0.000015,0.000012,58,0.000109,0,16,0.666667,0.000323
51650,Hampton city,,VA,21237,145311,166548,84,96,180,50305,56949,107254,5,0.408386,0.439133,4043.406974,0.029251,0.034013,98,0.00067,0,16,0.58774,0.258036
51660,Harrisonburg city,,VA,4597,33474,38071,21,23,44,9527,10871,20398,5,0.332309,0.35164,3665.29032,0.003792,0.005543,98,0.000275,0,16,0.482804,0.032633
51670,Hopewell city,,VA,3147,24576,27723,13,11,24,7309,8034,15343,5,0.326295,0.342544,119.834618,0.001936,0.002093,98,0.00017,0,16,0.633333,0.016984
51678,Lexington city,,VA,639,5323,5962,2,2,4,744,1020,1764,7,0.212085,0.216719,0,0,0,98,0.000141,0,16,1,0.000138
51680,Lynchburg city,,VA,6580,68731,75311,27,26,53,14777,17275,32052,5,0.351759,0.372829,11484.249945,0.004821,0.006058,98,0.000329,0,16,0.494253,0.042477
51683,Manassas city,,VA,6994,38922,45916,17,16,33,23853,20617,44470,5,0.349809,0.36769,68.359007,0.004121,0.004476,98,0.000196,0,16,0.783088,0.038371
51685,Manassas Park city,,VA,2855,13382,16237,10,8,18,9902,8300,18202,5,0.322956,0.338071,0.083333,0.00276,0.002352,98,0.000129,0,16,0.972727,0.025638
51690,Martinsville city,,VA,1231,15287,16518,6,7,13,2925,3356,6281,6,0.300944,0.314031,374.059659,0.000345,0.000369,58,0.000126,0,16,0.666667,0.00349
51700,Newport News city,,VA,28616,190963,219579,131,137,268,70061,80253,150314,5,0.42417,0.458204,28425.497592,0.038633,0.043322,98,0.001096,0,16,0.477135,0.335532
51710,Norfolk city,,VA,37758,222253,260011,170,163,333,95291,108285,203576,5,0.430806,0.46681,16591.991107,0.053865,0.053558,98,0.001273,0,16,0.4985,0.45898
51720,Norton city,,VA,460,4210,4670,1,1,2,1030,966,1996,7,0.215987,0.220738,0,0.000001,0.000001,77,0.000075,0,16,0,0.00008
51730,Petersburg city,,VA,4843,33670,38513,20,20,40,11074,12703,23777,5,0.344205,0.362534,792.920715,0.004679,0.004994,98,0.000229,0,16,0.608333,0.041248
51735,Poquoson city,,VA,1097,14482,15579,3,6,9,2109,2174,4283,5,0.315488,0.328948,0,0.00054,0.001007,98,0.000069,0,16,1,0.004204
51740,Portsmouth city,,VA,12988,103841,116829,43,44,87,35486,36491,71977,5,0.383078,0.408033,1601.89549,0.014714,0.015148,98,0.00037,0,16,0.692308,0.129846
51750,Radford city,,VA,1820,10776,12596,7,8,15,3261,3990,7251,5,0.323784,0.338808,577.535237,0.000741,0.000691,98,0.000137,0,16,0.642857,0.006312
51760,Richmond city,,VA,23986,184424,208410,127,111,238,79382,83402,162784,5,0.410823,0.442874,34586.032171,0.034102,0.033383,98,0.001165,0,16,0.420501,0.297992
51770,Roanoke city,,VA,9684,103746,113430,37,38,75,26816,28533,55349,5,0.36733,0.390784,42874.082917,0.006676,0.009425,98,0.000536,0,16,0.358081,0.06047
51775,Salem city,,VA,2714,27561,30275,8,7,15,7769,7852,15621,6,0.286946,0.297414,4.622727,0.000218,0.000138,98,0.000167,0,16,0.75,0.001806
51790,Staunton city,,VA,2439,26217,28656,9,9,18,5924,6192,12116,5,0.323542,0.338968,1282.599933,0.00109,0.001061,98,0.000159,0,16,0.708333,0.009523
51800,Suffolk city,,VA,8594,91641,100235,35,35,70,25081,22412,47493,5,0.362277,0.384874,880.3994,0.00924,0.01018,98,0.000321,0,16,0.569231,0.080527
51810,Virginia Beach city,,VA,54472,491303,545775,281,284,565,156885,163578,320463,5,0.457968,0.502157,61136.014587,0.07746,0.078293,98,0.002078,0,16,0.329439,0.654216
51820,Waynesboro city,,VA,2354,24321,26675,8,9,17,6055,5973,12028,5,0.323819,0.339243,46.563634,0.000286,0.001046,98,0.000143,0,16,0.688889,0.00259
51830,Williamsburg city,,VA,1663,9177,10840,9,10,19,3967,4591,8558,5,0.325,0.340883,10.064144,0.002232,0.002216,98,0.000121,0,16,0.863636,0.019487
51840,Winchester city,,VA,4341,26761,31102,11,12,23,11184,11414,22598,5,0.322887,0.338374,94.454712,0.001335,0.00191,98,0.000176,0,16,0.698718,0.012925
53001,Adams County,,WA,1316,21195,22511,8,7,15,2883,3761,6644,6,0.327318,0.341207,0,0.002317,0.001091,17,0.000118,0,16,1,0.021542
53003,Asotin County,,WA,2109,22849,24958,11,9,20,5324,4610,9934,6,0.328596,0.343161,3468.703234,0.001626,0.001212,17,0.000182,0,16,0.613636,0.015207
53005,Benton County,,WA,12349,187539,199888,71,62,133,47817,38952,86769,5,0.378625,0.405271,6771.379885,0.015774,0.014061,17,0.000663,0,16,0.502342,0.143695
53007,Chelan County,,WA,5417,81696,87113,25,25,50,16830,16410,33240,5,0.358419,0.378585,43.238703,0.006383,0.006044,17,0.000241,0,16,0.812169,0.057663
53009,Clallam County,,WA,4014,79294,83308,33,27,60,9243,8153,17396,5,0.358929,0.37941,29.286264,0.009522,0.007387,17,0.000301,0,16,0.819841,0.085695
53011,Clark County,,WA,25172,476974,502146,134,131,265,95581,80012,175593,5,0.403598,0.437999,10263.123863,0.032589,0.033442,17,0.001187,0,16,0.426412,0.297779
53013,Columbia County,,WA,307,4284,4591,2,1,3,465,398,863,6,0.262638,0.269985,0,0.000114,0.000036,17,0.00007,0,16,1,0.001308
53015,Cowlitz County,,WA,6129,112522,118651,35,34,69,15850,16133,31983,5,0.359483,0.380951,5196.764873,0.008529,0.008647,17,0.000357,0,16,0.68691,0.077462
53017,Douglas County,,WA,3477,38982,42459,14,11,25,11919,11123,23042,5,0.330677,0.345411,7.828637,0.003408,0.001929,17,0.00016,0,16,0.972527,0.031291
53019,Ferry County,,WA,541,6715,7256,5,3,8,1013,851,1864,6,0.291952,0.303577,0.166667,0.001086,0.000228,17,0.000099,0,16,0.95,0.009995
53021,Franklin County,,WA,6417,80504,86921,35,22,57,28617,21491,50108,5,0.363975,0.384164,409.518315,0.009351,0.006757,17,0.000332,0,16,0.766517,0.084317
53023,Garfield County,,WA,140,2302,2442,1,0,1,77,0,77,0,0,0,0,0.000007,0,17,0.000066,0,0,0,0.000155
53025,Grant County,,WA,5208,95551,100759,36,34,70,15690,14442,30132,5,0.360509,0.382189,314.231616,0.007754,0.007648,17,0.000366,0,16,0.656707,0.070761
53027,Grays Harbor County,,WA,4155,74188,78343,21,23,44,10500,10785,21285,5,0.356311,0.376081,36.189673,0.005436,0.005415,17,0.000218,0,16,0.873188,0.050148
53029,Island County,,WA,9950,86821,96771,45,47,92,22242,22628,44870,5,0.376273,0.401579,401.241265,0.014513,0.015838,17,0.00039,0,16,0.648485,0.129685
53031,Jefferson County,,WA,2073,32874,34947,14,12,26,4593,4240,8833,5,0.344361,0.361819,0.475204,0.004456,0.003274,17,0.000156,0,16,0.966667,0.041007
53033,King County,,WA,119404,2179798,2299202,450,390,840,468081,439280,907361,5,0.484253,0.532915,147952.399094,0.098441,0.089923,17,0.003715,0,16,0.216771,0.83647
53035,Kitsap County,,WA,21423,276967,298390,111,115,226,58020,59227,117247,5,0.402525,0.435578,2305.576918,0.03391,0.035053,17,0.000876,0,16,0.543032,0.302695
53037,Kittitas County,,WA,3466,37168,40634,18,18,36,8709,8440,17149,5,0.352496,0.371239,12.158114,0.00326,0.00364,17,0.000196,0,16,0.861472,0.030151
53039,Klickitat County,,WA,1481,21833,23314,13,10,23,3791,3187,6978,5,0.331002,0.345714,20.409686,0.002493,0.002021,17,0.000174,0,16,0.785714,0.023778
53041,Lewis County,,WA,4966,81960,86926,22,23,45,13695,13271,26966,5,0.356311,0.376081,30.777259,0.006332,0.005554,17,0.000223,0,16,0.886667,0.057972
53043,Lincoln County,,WA,790,11693,12483,4,3,7,1600,1649,3249,6,0.326823,0.340079,0.125,0.000803,0.000818,17,0.000091,0,16,0.916667,0.007494
53045,Mason County,,WA,4367,63165,67532,17,15,32,13091,11752,24843,5,0.355767,0.374513,6.823563,0.004777,0.004303,17,0.00018,0,16,0.921569,0.043423
53047,Okanogan County,,WA,2363,43937,46300,16,17,33,5362,5380,10742,5,0.352209,0.370771,173.266123,0.003057,0.003093,17,0.000196,0,16,0.804094,0.028175
53049,Pacific County,,WA,1637,22295,23932,14,12,26,3418,3135,6553,5,0.330749,0.345631,1013.11939,0.002804,0.00244,17,0.000184,0,16,0.807692,0.026419
53051,Pend Oreille County,,WA,1179,13600,14779,5,5,10,2261,3028,5289,6,0.327071,0.340602,0.285714,0.000862,0.000911,17,0.000102,0,16,0.9,0.008213
53053,Pierce County,,WA,65733,891433,957166,301,290,591,222306,220177,442483,4,0.464856,0.507951,45617.824594,0.074495,0.072107,17,0.002416,0,16,0.291172,0.649837
53055,San Juan County,,WA,1105,16504,17609,4,6,10,1508,1497,3005,6,0.327424,0.34129,0,0.001011,0.001555,17,0.00008,0,16,1,0.009341
53057,Skagit County,,WA,7806,132450,140256,36,34,70,21427,20682,42109,5,0.366352,0.388374,224.78251,0.009719,0.009682,17,0.000328,0,16,0.725371,0.087636
53059,Skamania County,,WA,825,11065,11890,5,6,11,1947,1806,3753,6,0.327035,0.340767,0.428114,0.000743,0.001261,17,0.000102,0,16,0.880952,0.00726
53061,Snohomish County,,WA,47730,809398,857128,192,191,383,177087,161800,338887,5,0.430133,0.4695,16315.256317,0.05268,0.05246,17,0.001578,0,16,0.395679,0.466842
53063,Spokane County,,WA,25219,521640,546859,150,150,300,78758,78469,157227,5,0.412165,0.448305,33606.361905,0.032709,0.036362,17,0.001435,0,16,0.356351,0.298328
53065,Stevens County,,WA,3115,46481,49596,15,10,25,7206,6985,14191,5,0.3518,0.369451,195.869939,0.002963,0.002422,17,0.000197,0,16,0.709559,0.027307
53067,Thurston County,,WA,21796,282317,304113,121,118,239,73981,66265,140246,5,0.402632,0.435842,3540.765862,0.032932,0.032094,17,0.000994,0,16,0.464523,0.29824
53069,Wahkiakum County,,WA,359,4269,4628,2,2,4,478,427,905,6,0.264472,0.272466,0,0.000065,0.000067,17,0.000071,0,16,1,0.000735
53071,Walla Walla County,,WA,3609,59951,63560,25,22,47,9106,9088,18194,5,0.356143,0.375751,3927.523645,0.006149,0.005348,17,0.000306,0,16,0.798462,0.056813
53073,Whatcom County,,WA,12041,215159,227200,70,72,142,31380,31880,63260,5,0.383952,0.411847,1286.129676,0.018779,0.019548,17,0.000624,0,16,0.599067,0.169993
53075,Whitman County,,WA,4789,35195,39984,26,26,52,8982,10594,19576,5,0.358504,0.378805,165.910464,0.005547,0.00615,17,0.000283,0,16,0.796296,0.051834
53077,Yakima County,,WA,9591,267702,277293,61,63,124,29607,28577,58184,5,0.374182,0.400594,639.07366,0.014079,0.01505,17,0.000531,0,16,0.601035,0.126154
54001,Barbour County,,WV,684,16769,17453,6,5,11,1609,1611,3220,6,0.278759,0.288153,3.757576,0.000065,0.000039,69,0.000183,0,16,0.8,0.000832
54003,Berkeley County,,WV,6941,117926,124867,33,32,65,21212,16002,37214,5,0.366929,0.388539,9070.305953,0.005884,0.007093,98,0.000382,0,16,0.442943,0.051385
54005,Boone County,,WV,983,25703,26686,4,5,9,2221,2605,4826,6,0.284841,0.294311,1.316561,0.000102,0.000084,65,0.000111,0,16,0.8,0.001007
54007,Braxton County,,WV,675,14184,14859,5,6,11,895,992,1887,6,0.28468,0.294388,3552.83475,0.000082,0.000068,65,0.000186,0,16,0.366667,0.000936
54009,Brooke County,,WV,1109,28075,29184,6,7,13,2917,2978,5895,6,0.316642,0.330494,5.709932,0.000579,0.000607,69,0.00012,0,16,0.857143,0.005128
54011,Cabell County,,WV,5783,98152,103935,25,31,56,14422,14622,29044,5,0.371338,0.3931,11747.735872,0.002801,0.00649,65,0.000454,0,16,0.299465,0.025508
54013,Calhoun County,,WV,383,7321,7704,2,5,7,345,633,978,7,0.246521,0.254141,90.939151,0,0.000008,65,0.000111,0,16,0.3,0.000139
54015,Clay County,,WV,514,9686,10200,5,4,9,1068,1164,2232,6,0.284547,0.29392,164.224285,0.000082,0.000067,65,0.000161,0,16,0.5,0.000934
54017,Doddridge County,,WV,343,5276,5619,2,2,4,678,700,1378,7,0.241432,0.248033,0,0.000004,0.000004,69,0.000098,0,16,1,0.00018
54019,Fayette County,,WV,2263,45758,48021,8,9,17,4604,5144,9748,6,0.286946,0.297986,203.559448,0.000144,0.000132,65,0.000204,0,16,0.708333,0.001464
54021,Gilmer County,,WV,451,6425,6876,3,3,6,573,625,1198,7,0.222377,0.227684,12.5787,0.000001,0.000001,65,0.000122,0,16,0.333333,0.00021
54023,Grant County,,WV,666,13705,14371,4,3,7,1089,1206,2295,7,0.219588,0.224939,27.006954,0.000002,0.000001,98,0.000135,0,16,0.5,0.000342
54025,Greenbrier County,,WV,1821,37850,39671,12,11,23,2572,2465,5037,6,0.287136,0.298591,5566.045561,0.000196,0.000131,65,0.000304,0,16,0.363636,0.002028
54027,Hampshire County,,WV,1297,25607,26904,11,10,21,2651,3134,5785,6,0.280853,0.291735,3431.175771,0.001081,0.000124,98,0.000192,0,16,0.384615,0.009945
54029,Hancock County,,WV,1733,37620,39353,8,8,16,4464,4353,8817,6,0.316576,0.330494,21.061019,0.000683,0.000647,69,0.000138,0,16,0.660714,0.0059
54031,Hardy County,,WV,768,15892,16660,6,7,13,1484,1390,2874,6,0.271513,0.281176,928.118017,0.000073,0.000098,98,0.000161,0,16,0.428571,0.001077
54033,Harrison County,,WV,3458,79848,83306,15,16,31,6897,6866,13763,6,0.318139,0.333823,9571.320558,0.000662,0.000649,69,0.000386,0,16,0.3125,0.006335
54035,Jackson County,,WV,1319,32693,34012,7,8,15,2813,2658,5471,6,0.286268,0.297084,369.680581,0.000097,0.000127,65,0.000219,0,16,0.5,0.001182
54037,Jefferson County,,WV,3894,59101,62995,22,16,38,11565,9551,21116,5,0.326647,0.343161,770.031149,0.005187,0.00346,98,0.000232,0,16,0.598814,0.044744
54039,Kanawha County,,WV,9023,220918,229941,49,53,102,22004,23355,45359,5,0.397298,0.422983,84228.758095,0.011015,0.013728,65,0.000751,0,16,0.330226,0.098157
54041,Lewis County,,WV,819,19548,20367,6,6,12,1981,2065,4046,6,0.278862,0.288456,2471.232711,0.000065,0.000042,69,0.000197,0,16,0.5,0.000828
54043,Lincoln County,,WV,1027,22163,23190,6,6,12,2781,3084,5865,6,0.285082,0.294855,5.119682,0.000136,0.000092,65,0.000144,0,16,0.733333,0.001241
54045,Logan County,,WV,1291,36965,38256,8,10,18,2802,3774,6576,6,0.338776,0.354396,2659.819692,0.001286,0.001289,65,0.000166,0,16,0.466667,0.011279
54047,McDowell County,,WV,841,18123,18964,4,4,8,1055,1969,3024,7,0.245542,0.253062,552.215333,0.000101,0.000005,77,0.000115,0,16,0.3,0.001507
54049,Marion County,,WV,2777,63484,66261,13,12,25,5972,6721,12693,6,0.317572,0.332475,1338.78649,0.000666,0.000609,69,0.000296,0,16,0.380952,0.006233
54051,Marshall County,,WV,1623,37179,38802,6,8,14,3551,3681,7232,6,0.316708,0.330714,81.965486,0.000154,0.000607,69,0.000132,0,16,0.625,0.001385
54053,Mason County,,WV,1207,27933,29140,7,6,13,2727,2649,5376,6,0.28519,0.295048,18.07902,0.000138,0.00009,65,0.00017,0,16,0.619048,0.001364
54055,Mercer County,,WV,2599,65128,67727,15,15,30,5434,4903,10337,6,0.323438,0.339612,17458.405767,0.000748,0.000733,77,0.000333,0,16,0.275,0.006982
54057,Mineral County,,WV,1355,32664,34019,7,7,14,3349,2799,6148,6,0.279583,0.289832,2117.306772,0.000122,0.000099,98,0.000177,0,16,0.52381,0.001359
54059,Mingo County,,WV,1127,25616,26743,6,7,13,2229,2775,5004,6,0.285782,0.295923,1164.019419,0.000096,0.000094,77,0.000165,0,16,0.333333,0.001099
54061,Monongalia County,,WV,6289,84105,90394,42,45,87,14744,12738,27482,5,0.386057,0.410873,70406.835814,0.005622,0.009625,69,0.000715,0,16,0.245306,0.051487
54063,Monroe County,,WV,692,13967,14659,4,4,8,1369,1441,2810,7,0.244847,0.252111,7.279816,0.000006,0.000006,65,0.000134,0,16,0.666667,0.000344
54065,Morgan County,,WV,991,19443,20434,6,6,12,2150,1985,4135,6,0.27276,0.282877,13.607203,0.000147,0.000193,98,0.000121,0,16,0.619048,0.001647
54067,Nicholas County,,WV,1040,28098,29138,8,8,16,1987,2074,4061,6,0.286025,0.296622,6116.476472,0.000153,0.000111,65,0.000259,0,16,0.446429,0.001562
54069,Ohio County,,WV,2511,51521,54032,12,10,22,5763,6496,12259,6,0.326295,0.342352,364.507076,0.001224,0.001159,69,0.000204,0,16,0.545455,0.01057
54071,Pendleton County,,WV,536,8842,9378,2,3,5,278,474,752,6,0.24965,0.257648,275.603355,0.00001,0.000033,98,0.000102,0,16,0.333333,0.000233
54073,Pleasants County,,WV,489,8402,8891,4,3,7,1002,936,1938,7,0.246561,0.253976,8.562612,0.000016,0.000015,65,0.000132,0,16,0.416667,0.000401
54075,Pocahontas County,,WV,482,9491,9973,2,3,5,191,433,624,6,0.284013,0.294085,30.142922,0.000001,0.000139,65,0.000093,0,16,0,0.000157
54077,Preston County,,WV,1541,34858,36399,7,7,14,3154,3183,6337,6,0.279222,0.289116,2720.543447,0.000084,0.000063,69,0.000201,0,16,0.404762,0.001055
54079,Putnam County,,WV,3922,63501,67423,12,12,24,11417,9670,21087,6,0.326225,0.342363,407.638379,0.000207,0.000948,65,0.000262,0,16,0.409524,0.002117
54081,Raleigh County,,WV,3390,81434,84824,15,16,31,6652,6160,12812,5,0.344322,0.36265,7931.0034,0.001664,0.002211,65,0.000295,0,16,0.391813,0.014384
54083,Randolph County,,WV,1278,31734,33012,5,8,13,1692,1952,3644,6,0.28562,0.296148,4121.927414,0.000058,0.000107,69,0.000192,0,16,0.464286,0.000671
54085,Ritchie County,,WV,633,12126,12759,4,5,9,867,1756,2623,7,0.246762,0.254554,39.388828,0.000011,0.000011,65,0.000169,0,16,0.4,0.000384
54087,Roane County,,WV,750,15549,16299,5,5,10,1467,1864,3331,6,0.284707,0.294333,3195.840404,0.000089,0.000073,65,0.000158,0,16,0.5,0.000997
54089,Summers County,,WV,474,11607,12081,5,5,10,1207,1296,2503,6,0.256608,0.264581,20.193472,0.000019,0.000016,65,0.000155,0,16,0.8,0.000503
54091,Taylor County,,WV,917,17701,18618,5,5,10,2619,2226,4845,6,0.278734,0.288098,0.783333,0.000065,0.000042,69,0.00016,0,16,0.85,0.000759
54093,Tucker County,,WV,391,8205,8596,2,2,4,420,628,1048,7,0.22241,0.227552,1.283333,0.000001,0.000001,69,0.000094,0,16,0,0.000146
54095,Tyler County,,WV,564,10216,10780,1,3,4,701,987,1688,7,0.24642,0.253673,2.432576,0,0.000008,69,0.000068,0,16,0.333333,0.000073
54097,Upshur County,,WV,1153,25170,26323,8,6,14,2089,2112,4201,6,0.278862,0.288456,58.757936,0.000147,0.000042,69,0.000222,0,16,0.607143,0.001545
54099,Wayne County,,WV,2126,42567,44693,9,10,19,5610,5901,11511,6,0.323231,0.337994,1039.243356,0.000143,0.000591,65,0.000219,0,16,0.477778,0.001521
54101,Webster County,,WV,375,9055,9430,1,1,2,368,518,886,7,0.222426,0.227211,0,0.000001,0.000001,65,0.000077,0,16,0,0.000079
54103,Wetzel County,,WV,832,19010,19842,6,7,13,1486,1709,3195,6,0.278991,0.288841,3265.249441,0.000071,0.000049,69,0.000156,0,16,0.285714,0.000818
54105,Wirt County,,WV,390,5537,5927,3,2,5,1042,715,1757,7,0.24632,0.253316,1.383333,0.000007,0.000008,65,0.000117,0,16,0.416667,0.000271
54107,Wood County,,WV,4052,99366,103418,18,17,35,8165,7267,15432,6,0.326718,0.343782,19333.227815,0.001196,0.001133,65,0.000408,0,16,0.263158,0.010655
54109,Wyoming County,,WV,930,22777,23707,5,6,11,1193,1898,3091,6,0.285351,0.295207,259.817614,0.000026,0.000088,65,0.000142,0,16,0.5,0.00055
55001,Adams County,,WI,1531,21821,23352,13,11,24,3515,3190,6705,6,0.314734,0.327941,32.01301,0.001661,0.000885,99,0.000178,0,16,0.737179,0.014153
55003,Ashland County,,WI,1074,18935,20009,5,7,12,1345,1751,3096,6,0.323197,0.336789,42.744257,0.000104,0.000531,60,0.000113,0,16,0.452381,0.001039
55005,Barron County,,WI,2895,57035,59930,18,19,37,6067,6295,12362,6,0.327176,0.343089,884.069978,0.001825,0.001756,60,0.000256,0,16,0.597368,0.015912
55007,Bayfield County,,WI,992,18313,19305,5,6,11,1619,1624,3243,6,0.324339,0.338247,97.072866,0.000529,0.000813,60,0.000119,0,16,0.666667,0.004711
55009,Brown County,,WI,12892,308348,321240,59,65,124,36654,35629,72283,5,0.384537,0.411489,32873.119551,0.009547,0.013044,99,0.000676,0,16,0.333126,0.085025
55011,Buffalo County,,WI,965,17053,18018,5,8,13,1576,2120,3696,6,0.26891,0.278733,9.404178,0.000055,0.000102,60,0.000117,0,16,0.535714,0.000888
55013,Burnett County,,WI,935,19120,20055,11,11,22,2229,1921,4150,6,0.3233,0.337433,5.757892,0.001179,0.000891,60,0.000161,0,16,0.80303,0.009825
55015,Calumet County,,WI,3880,60970,64850,12,11,23,13477,11963,25440,5,0.345461,0.361434,24.639756,0.001761,0.001614,99,0.000152,0,16,0.94697,0.014879
55017,Chippewa County,,WI,3898,74867,78765,20,18,38,11107,10705,21812,6,0.327141,0.342924,2050.5115,0.001868,0.001575,60,0.000277,0,16,0.513834,0.017661
55019,Clark County,,WI,2206,40648,42854,10,11,21,4390,5374,9764,6,0.324686,0.339347,127.126518,0.00079,0.000891,99,0.00016,0,16,0.75,0.007174
55021,Columbia County,,WI,4664,71692,76356,21,20,41,13412,13364,26776,5,0.361628,0.381441,351.661243,0.002489,0.002825,99,0.000251,0,16,0.626812,0.022242
55023,Crawford County,,WI,1075,20008,21083,7,7,14,2014,2425,4439,6,0.308013,0.320342,74.400703,0.000358,0.000356,99,0.000139,0,16,0.571429,0.003523
55025,Dane County,,WI,30436,591919,622355,210,207,417,99388,96734,196122,5,0.443615,0.481974,85984.746842,0.052383,0.053811,99,0.00184,0,16,0.335025,0.445421
55027,Dodge County,,WI,6337,106750,113087,20,22,42,16791,17497,34288,5,0.361715,0.381771,158.933902,0.00203,0.002931,99,0.000219,0,16,0.708333,0.017224
55029,Door County,,WI,1603,36057,37660,10,9,19,2876,2784,5660,5,0.345382,0.361104,304.938437,0.002083,0.001568,99,0.000131,0,16,0.833333,0.016839
55031,Douglas County,,WI,2424,51191,53615,10,13,23,4630,5152,9782,5,0.355642,0.374364,351.830976,0.001014,0.00228,60,0.000184,0,16,0.580952,0.008812
55033,Dunn County,,WI,3112,45659,48771,19,18,37,7319,7426,14745,6,0.327389,0.343309,1599.345937,0.001908,0.00177,60,0.000251,0,16,0.594737,0.016578
55035,Eau Claire County,,WI,7435,110212,117647,43,42,85,20972,20509,41481,5,0.365292,0.388098,15949.147166,0.00441,0.004254,60,0.000524,0,16,0.338113,0.03847
55037,Florence County,,WI,303,5521,5824,3,3,6,470,518,988,6,0.27789,0.28746,0,0.000083,0.000065,99,0.000089,0,16,1,0.000811
55039,Fond du Lac County,,WI,5702,127203,132905,24,24,48,14464,15230,29694,5,0.361888,0.382211,296.09907,0.002397,0.00292,99,0.000273,0,16,0.624339,0.020376
55041,Forest County,,WI,582,10977,11559,5,6,11,629,762,1391,6,0.311786,0.323946,0.408333,0.000502,0.000448,99,0.000095,0,16,0.866667,0.004146
55043,Grant County,,WI,3062,57530,60592,17,17,34,6281,6703,12984,5,0.346013,0.36281,731.500169,0.001686,0.001574,99,0.000239,0,16,0.409357,0.014672
55045,Green County,,WI,2433,47185,49618,13,12,25,6285,6287,12572,6,0.315521,0.329152,85.483584,0.00162,0.001003,99,0.000169,0,16,0.664835,0.013656
55047,Green Lake County,,WI,1446,23843,25289,9,9,18,3543,3618,7161,6,0.314571,0.327446,0.859921,0.000828,0.000767,99,0.000138,0,16,0.902778,0.007152
55049,Iowa County,,WI,1800,29560,31360,6,7,13,4001,4427,8428,6,0.314636,0.327281,7.056832,0.000354,0.000683,99,0.000122,0,16,0.761905,0.003366
55051,Iron County,,WI,412,7260,7672,1,1,2,424,342,766,7,0.211213,0.215182,0,0,0,99,0.000099,0,16,0,0.000066
55053,Jackson County,,WI,1470,23010,24480,8,8,16,2658,2903,5561,6,0.314898,0.327886,2.367396,0.000768,0.000731,60,0.000135,0,16,0.861111,0.006813
55055,Jefferson County,,WI,6180,100420,106600,20,19,39,18130,17459,35589,5,0.362494,0.382293,100.499189,0.002893,0.003095,99,0.00021,0,16,0.705534,0.025225
55057,Juneau County,,WI,2054,30258,32312,14,11,25,4656,4631,9287,5,0.345303,0.361214,72.43156,0.001778,0.001412,99,0.000179,0,16,0.741758,0.015019
55059,Kenosha County,,WI,10493,195375,205868,27,33,60,28079,26785,54864,5,0.378247,0.40131,201.736351,0.008424,0.00901,99,0.000224,0,16,0.654655,0.068013
55061,Kewaunee County,,WI,1132,25923,27055,3,5,8,2495,2772,5267,6,0.311722,0.323726,0,0.000103,0.000455,99,0.000079,0,16,1,0.000954
55063,La Crosse County,,WI,6600,130585,137185,42,40,82,16979,15666,32645,5,0.364325,0.38686,3615.438589,0.004457,0.004201,99,0.00049,0,16,0.380303,0.039465
55065,Lafayette County,,WI,1178,21606,22784,7,7,14,2954,3018,5972,6,0.308232,0.320672,8.009282,0.000414,0.000397,99,0.000127,0,16,0.619048,0.003829
55067,Langlade County,,WI,1231,24750,25981,10,11,21,2048,2197,4245,6,0.315029,0.328381,7.229442,0.000886,0.000834,99,0.000149,0,16,0.827273,0.007701
55069,Lincoln County,,WI,1681,36759,38440,8,10,18,2884,3481,6365,6,0.315193,0.328546,6.193698,0.000813,0.000828,99,0.000126,0,16,0.827273,0.00697
55071,Manitowoc County,,WI,3747,104709,108456,17,20,37,7695,9262,16957,5,0.361672,0.381496,761.659478,0.002476,0.002853,99,0.000208,0,16,0.707895,0.021777
55073,Marathon County,,WI,6993,169452,176445,35,36,71,17271,17208,34479,5,0.362841,0.384632,3288.955627,0.004076,0.003441,99,0.000384,0,16,0.45614,0.035273
55075,Marinette County,,WI,2667,51137,53804,13,13,26,5535,5722,11257,6,0.315225,0.328876,932.552002,0.001429,0.000955,99,0.0002,0,16,0.584559,0.012153
55077,Marquette County,,WI,1299,18888,20187,10,9,19,3220,3202,6422,6,0.314571,0.327446,1.78688,0.000802,0.000742,99,0.000152,0,16,0.833333,0.007099
55078,Menominee County,,WI,346,4502,4848,2,2,4,553,707,1260,6,0.277788,0.287185,0,0.000082,0.000063,99,0.000072,0,16,1,0.000715
55079,Milwaukee County,,WI,47158,1084894,1132052,210,225,435,138161,162005,300166,5,0.451887,0.490833,68943.052357,0.056708,0.06175,99,0.00173,0,16,0.363622,0.482673
55081,Monroe County,,WI,3336,53448,56784,17,14,31,6165,6139,12304,6,0.330028,0.345351,189.891225,0.002214,0.001378,99,0.000223,0,16,0.565359,0.019353
55083,Oconto County,,WI,2416,47086,49502,8,8,16,6537,6299,12836,6,0.314865,0.327776,3.202483,0.000557,0.000801,99,0.000133,0,16,0.777778,0.004816
55085,Oneida County,,WI,2546,47171,49717,16,17,33,4935,5131,10066,6,0.327212,0.342951,592.515895,0.001781,0.001489,99,0.000201,0,16,0.686275,0.015251
55087,Outagamie County,,WI,13307,221378,234685,45,45,90,40638,40446,81084,5,0.37604,0.400457,3882.187208,0.006483,0.008121,99,0.000481,0,16,0.403486,0.056528
55089,Ozaukee County,,WI,5955,108129,114084,21,18,39,16985,15272,32257,5,0.364764,0.384714,46.711423,0.005147,0.004339,99,0.000204,0,16,0.816017,0.043614
55091,Pepin County,,WI,575,9153,9728,4,4,8,1016,1174,2190,6,0.267721,0.276422,0.666667,0.000044,0.000046,60,0.000095,0,16,0.833333,0.000705
55093,Pierce County,,WI,2987,45412,48399,12,13,25,6700,7631,14331,6,0.325,0.33998,774.479278,0.001412,0.001361,60,0.000174,0,16,0.74359,0.012199
55095,Polk County,,WI,2657,54634,57291,13,16,29,6776,7271,14047,6,0.32507,0.34042,14.5196,0.001214,0.0014,60,0.000186,0,16,0.708333,0.010319
55097,Portage County,,WI,4412,80593,85005,29,26,55,9846,10254,20100,5,0.362277,0.382871,554.9701,0.002498,0.003167,99,0.000331,0,16,0.546371,0.02212
55099,Price County,,WI,912,18245,19157,5,7,12,879,1184,2063,6,0.307856,0.320232,8.797402,0.00006,0.000375,99,0.000107,0,16,0.595238,0.000925
55101,Racine County,,WI,11078,241051,252129,28,42,70,28758,29050,57808,5,0.382256,0.406729,275.745617,0.007107,0.01144,99,0.000247,0,16,0.599366,0.058557
55103,Richland County,,WI,1173,20820,21993,6,7,13,2451,2707,5158,6,0.307731,0.319957,2.270346,0.000352,0.000371,99,0.000128,0,16,0.809524,0.00334
55105,Rock County,,WI,8964,198308,207272,33,47,80,21100,21822,42922,5,0.383904,0.408908,1526.997062,0.005801,0.008556,99,0.000326,0,16,0.442376,0.048486
55107,Rusk County,,WI,832,17515,18347,4,6,10,1115,1445,2560,6,0.267769,0.276753,1.501368,0.000047,0.000065,60,0.000098,0,16,0.733333,0.000745
55109,St. Croix County,,WI,5820,102539,108359,19,21,40,16310,15206,31516,5,0.356018,0.37574,229.448128,0.002636,0.002513,60,0.000231,0,16,0.603896,0.022853
55111,Sauk County,,WI,4678,77925,82603,27,26,53,12213,11798,24011,5,0.362104,0.382651,708.818319,0.002718,0.002905,99,0.000322,0,16,0.517241,0.022925
55113,Sawyer County,,WI,1056,20608,21664,11,6,17,1455,1129,2584,6,0.322887,0.336305,198.741043,0.002077,0.0005,60,0.000169,0,16,0.606061,0.018099
55115,Shawano County,,WI,2497,49959,52456,12,11,23,6694,6918,13612,6,0.315029,0.328381,201.728708,0.00111,0.000825,99,0.000186,0,16,0.727273,0.009163
55117,Sheboygan County,,WI,5776,149174,154950,23,23,46,11995,13374,25369,5,0.363931,0.384439,139.759441,0.004417,0.00401,99,0.000238,0,16,0.678063,0.037881
55119,Taylor County,,WI,1147,23931,25078,7,8,15,2031,2354,4385,6,0.307794,0.320232,67.584802,0.000081,0.000389,99,0.000132,0,16,0.696429,0.001257
55121,Trempealeau County,,WI,1951,38240,40191,13,11,24,5345,4566,9911,6,0.324721,0.339402,426.856844,0.001312,0.000868,60,0.00019,0,16,0.593407,0.01162
55123,Vernon County,,WI,1708,34480,36188,10,8,18,4131,4030,8161,6,0.308076,0.320414,76.170885,0.001062,0.000389,99,0.000162,0,16,0.733333,0.009762
55125,Vilas County,,WI,1362,26621,27983,9,10,19,2757,2336,5093,5,0.345697,0.361599,6136.527678,0.001645,0.001587,99,0.000125,0,16,0.674242,0.013723
55127,Walworth County,,WI,6982,118600,125582,22,28,50,18696,18568,37264,5,0.366042,0.387163,155.299831,0.004781,0.005355,99,0.0002,0,16,0.664368,0.037906
55129,Washburn County,,WI,1166,20003,21169,11,8,19,2167,2179,4346,6,0.322956,0.336635,127.083056,0.000805,0.000529,60,0.000183,0,16,0.681818,0.007587
55131,Washington County,,WI,8217,169206,177423,23,26,49,25413,23329,48742,5,0.364457,0.38521,160.694145,0.003186,0.003718,99,0.000238,0,16,0.690883,0.027783
55133,Waukesha County,,WI,24821,492973,517794,86,115,201,81248,80037,161285,5,0.423163,0.454248,10049.402336,0.025005,0.035795,99,0.000741,0,16,0.494697,0.217187
55135,Waupaca County,,WI,3160,63572,66732,13,12,25,8650,8036,16686,6,0.315094,0.328601,3.626953,0.001149,0.000995,99,0.000176,0,16,0.852564,0.009568
55137,Waushara County,,WI,1654,28721,30375,13,12,25,4335,4580,8915,6,0.314701,0.327996,5.606183,0.00107,0.000796,99,0.000181,0,16,0.74359,0.008959
55139,Winnebago County,,WI,11631,195679,207310,47,42,89,36002,35269,71271,5,0.375155,0.399164,2613.853594,0.005737,0.00657,99,0.000501,0,16,0.402857,0.050418
55141,Wood County,,WI,4559,94815,99374,26,25,51,9710,10797,20507,5,0.362234,0.382706,1052.605772,0.002468,0.003116,99,0.000307,0,16,0.54064,0.021666
56001,Albany County,,WY,4178,31551,35729,32,35,67,7149,8203,15352,5,0.37152,0.394509,5254.351832,0.00694,0.008566,2,0.000418,0,16,0.514845,0.066216
56003,Big Horn County,,WY,889,12350,13239,4,6,10,882,1377,2259,6,0.280126,0.290822,14.679167,0.000138,0.000219,2,0.000111,0,16,0.833333,0.001606
56005,Campbell County,,WY,3573,49995,53568,36,27,63,7350,6304,13654,5,0.356437,0.376604,7820.523569,0.006224,0.003846,2,0.00059,0,16,0.352063,0.058661
56007,Carbon County,,WY,1861,17492,19353,13,10,23,1781,2698,4479,5,0.35127,0.368763,176.181545,0.002096,0.001407,2,0.000192,0,16,0.75641,0.020608
56009,Converse County,,WY,1315,15648,16963,7,5,12,1702,1929,3631,6,0.300317,0.311522,13.025297,0.000251,0.000522,2,0.000144,0,16,0.821429,0.002963
56011,Crook County,,WY,648,7769,8417,5,4,9,1071,1048,2119,6,0.266661,0.274783,1.333333,0.000123,0.000047,2,0.000176,0,16,0.8,0.00156
56013,Fremont County,,WY,2558,44166,46724,20,18,38,3519,3259,6778,5,0.352948,0.371844,2367.787131,0.003993,0.001921,2,0.0003,0,16,0.496047,0.03769
56015,Goshen County,,WY,940,13451,14391,7,8,15,1553,1520,3073,6,0.280489,0.291504,22.679224,0.000355,0.000273,2,0.000142,0,16,0.722222,0.003814
56017,Hot Springs County,,WY,376,5342,5718,3,3,6,371,328,699,6,0.27308,0.281914,0,0.000077,0.000087,2,0.000091,0,16,1,0.001147
56019,Johnson County,,WY,794,9167,9961,3,3,6,924,902,1826,6,0.273326,0.282326,0,0.000092,0.000116,2,0.000098,0,16,1,0.001302
56021,Laramie County,,WY,7958,104973,112931,61,58,119,17088,14886,31974,5,0.383904,0.410317,15112.563853,0.017048,0.017809,2,0.000697,0,16,0.525789,0.157269
56023,Lincoln County,,WY,1501,19786,21287,11,11,22,2114,2154,4268,6,0.319785,0.333317,59.898697,0.001661,0.000999,2,0.000158,0,16,0.615385,0.015152
56025,Natrona County,,WY,5503,85536,91039,47,40,87,12374,10482,22856,5,0.375387,0.399092,17420.747272,0.010774,0.009939,2,0.000606,0,16,0.42911,0.101296
56027,Niobrara County,,WY,228,2634,2862,0,0,0,0,0,0,0,0,0,0,0,0,100,0.000049,81,129,0,0
56029,Park County,,WY,2304,33085,35389,14,14,28,2990,3017,6007,5,0.351596,0.369753,1989.96499,0.002325,0.001137,2,0.000238,0,16,0.479167,0.022059
56031,Platte County,,WY,751,9802,10553,4,6,10,896,1126,2022,6,0.278785,0.289243,0,0.000216,0.000245,2,0.000097,0,16,0.933333,0.002179
56033,Sheridan County,,WY,2270,33106,35376,16,13,29,3243,3090,6333,5,0.352496,0.370716,1354.301799,0.002738,0.001902,2,0.000262,0,16,0.552288,0.026494
56035,Sublette County,,WY,1034,9644,10678,10,6,16,1073,765,1838,6,0.280619,0.291493,23.144601,0.001418,0.000246,2,0.000143,0,16,0.515152,0.013197
56037,Sweetwater County,,WY,4316,50732,55048,36,34,70,7561,7510,15071,5,0.36472,0.387466,1821.904984,0.007485,0.005754,2,0.000421,0,16,0.413636,0.070301
56039,Teton County,,WY,2588,24469,27057,14,17,31,2440,3436,5876,5,0.359483,0.378942,371.700982,0.004699,0.004946,2,0.000176,0,16,0.584795,0.043316
56041,Uinta County,,WY,1956,24611,26567,11,15,26,2464,3121,5585,6,0.341065,0.358077,31.390025,0.002376,0.001994,2,0.000143,0,16,0.621324,0.021131
56043,Washakie County,,WY,652,9768,10420,5,6,11,325,724,1049,6,0.280048,0.290657,16.689621,0.000078,0.000202,2,0.000132,0,16,0.714286,0.001293
56045,Weston County,,WY,641,8187,8828,3,3,6,410,580,990,6,0.283243,0.292951,28.576486,0.000112,0.00012,2,0.000123,0,16,0.833333,0.001333
