id,label,timeset,state,totalMig,totalNonMig,population
1001,Autauga County,,AL,6044,58104,64148
1003,Baldwin County,,AL,10504,188262,198766
1005,Barbour County,,AL,1692,26144,27836
1007,Bibb County,,AL,1547,22324,23871
1009,Blount County,,AL,3627,59387,63014
1011,Bullock County,,AL,551,9755,10306
1013,Butler County,,AL,1244,22691,23935
1015,Calhoun County,,AL,6335,129740,136075
1017,Chambers County,,AL,2127,38337,40464
1019,Cherokee County,,AL,1355,25510,26865
1021,Chilton County,,AL,2466,45657,48123
1023,Choctaw County,,AL,700,15134,15834
1025,Clarke County,,AL,1538,30277,31815
1027,Clay County,,AL,880,16005,16885
1029,Cleburne County,,AL,1008,14970,15978
1031,Coffee County,,AL,5595,49033,54628
1033,Colbert County,,AL,3430,61520,64950
1035,Conecuh County,,AL,803,13525,14328
1037,Coosa County,,AL,1189,11384,12573
1039,Covington County,,AL,2050,39429,41479
1041,Crenshaw County,,AL,907,14851,15758
1043,Cullman County,,AL,3977,87842,91819
1045,Dale County,,AL,8014,49704,57718
1047,Dallas County,,AL,2412,46366,48778
1049,DeKalb County,,AL,3833,73451,77284
1051,Elmore County,,AL,7179,83793,90972
1053,Escambia County,,AL,2146,38691,40837
1055,Etowah County,,AL,5178,112019,117197
1057,Fayette County,,AL,1032,18065,19097
1059,Franklin County,,AL,2009,34549,36558
1061,Geneva County,,AL,1869,26523,28392
1063,Greene County,,AL,681,9680,10361
1065,Hale County,,AL,1112,17964,19076
1067,Henry County,,AL,1332,18011,19343
1069,Houston County,,AL,7224,107446,114670
1071,Jackson County,,AL,2678,58368,61046
1073,Jefferson County,,AL,36934,732168,769102
1075,Lamar County,,AL,710,15820,16530
1077,Lauderdale County,,AL,4986,98347,103333
1079,Lawrence County,,AL,1917,38108,40025
1081,Lee County,,AL,11078,129223,140301
1083,Limestone County,,AL,4479,85590,90069
1085,Lowndes County,,AL,1061,14297,15358
1087,Macon County,,AL,1905,21390,23295
1089,Madison County,,AL,19072,372371,391443
1091,Marengo County,,AL,1247,23711,24958
1093,Marion County,,AL,1703,30193,31896
1095,Marshall County,,AL,5397,98617,104014
1097,Mobile County,,AL,17371,450225,467596
1099,Monroe County,,AL,1228,25074,26302
1101,Montgomery County,,AL,19172,249687,268859
1103,Morgan County,,AL,6919,134809,141728
1105,Perry County,,AL,640,11381,12021
1107,Pickens County,,AL,1068,21522,22590
1109,Pike County,,AL,2147,29586,31733
1111,Randolph County,,AL,1258,23811,25069
1113,Russell County,,AL,6336,52109,58445
1115,St. Clair County,,AL,5279,86117,91396
1117,Shelby County,,AL,15211,208632,223843
1119,Sumter County,,AL,788,13851,14639
1121,Talladega County,,AL,4870,86870,91740
1123,Tallapoosa County,,AL,2927,44721,47648
1125,Tuscaloosa County,,AL,10197,189804,200001
1127,Walker County,,AL,3108,69982,73090
1129,Washington County,,AL,1020,18810,19830
1131,Wilcox County,,AL,818,13500,14318
1133,Winston County,,AL,1446,25462,26908
2013,Aleutians East Borough,,AK,339,1753,2092
2016,Aleutians West Census Area,,AK,694,4350,5044
2020,Anchorage Municipality,,AK,28706,311726,340432
2050,Bethel Census Area,,AK,1042,17127,18169
2060,Bristol Bay Borough,,AK,226,1133,1359
2068,Denali Borough,,AK,263,2316,2579
2070,Dillingham Census Area,,AK,386,4979,5365
2090,Fairbanks North Star Borough,,AK,12822,101261,114083
2100,Haines Borough,,AK,195,2699,2894
2105,Hoonah-Angoon Census Area,,AK,236,2077,2313
2110,Juneau City and Borough,,AK,3075,34187,37262
2122,Kenai Peninsula Borough,,AK,3766,59463,63229
2130,Ketchikan Gateway Borough,,AK,1464,14958,16422
2150,Kodiak Island Borough,,AK,1930,15099,17029
2164,Lake and Peninsula Borough,,AK,165,1526,1691
2170,Matanuska-Susitna Borough,,AK,6236,88852,95088
2180,Nome Census Area,,AK,604,8722,9326
2185,North Slope Borough,,AK,615,6775,7390
2188,Northwest Arctic Borough,,AK,504,6504,7008
2195,Petersburg Census Area,,AK,360,4030,4390
2198,Prince of Wales-Hyder Census Area,,AK,401,4863,5264
2220,Sitka City and Borough,,AK,888,9628,10516
2230,Skagway Municipality,,AK,161,1228,1389
2240,Southeast Fairbanks Census Area,,AK,841,7908,8749
2261,Valdez-Cordova Census Area,,AK,1216,10689,11905
2270,Wade Hampton Census Area,,AK,480,7234,7714
2275,Wrangell City and Borough,,AK,212,2443,2655
2282,Yakutat City and Borough,,AK,47,554,601
2290,Yukon-Koyukuk Census Area,,AK,632,5541,6173
4001,Apache County,,AZ,6803,65128,71931
4003,Cochise County,,AZ,13670,130856,144526
4005,Coconino County,,AZ,12776,132183,144959
4007,Gila County,,AZ,3832,54593,58425
4009,Graham County,,AZ,2308,30595,32903
4011,Greenlee County,,AZ,1084,8401,9485
4012,La Paz County,,AZ,1318,15640,16958
4013,Maricopa County,,AZ,196634,4059391,4256025
4015,Mohave County,,AZ,14927,191351,206278
4017,Navajo County,,AZ,8667,101816,110483
4019,Pima County,,AZ,49046,1028429,1077475
4021,Pinal County,,AZ,35968,300753,336721
4023,Santa Cruz County,,AZ,2707,53983,56690
4025,Yavapai County,,AZ,15843,222474,238317
4027,Yuma County,,AZ,12511,217786,230297
5001,Arkansas County,,AR,1213,21295,22508
5003,Ashley County,,AR,1394,23683,25077
5005,Baxter County,,AR,2711,43783,46494
5007,Benton County,,AR,16415,231494,247909
5009,Boone County,,AR,2557,39288,41845
5011,Bradley County,,AR,850,11677,12527
5013,Calhoun County,,AR,365,5246,5611
5015,Carroll County,,AR,1836,27716,29552
5017,Chicot County,,AR,841,11425,12266
5019,Clark County,,AR,1849,21699,23548
5021,Clay County,,AR,1165,16552,17717
5023,Cleburne County,,AR,1674,26369,28043
5025,Cleveland County,,AR,640,8973,9613
5027,Columbia County,,AR,1637,24463,26100
5029,Conway County,,AR,1518,22239,23757
5031,Craighead County,,AR,6355,94181,100536
5033,Crawford County,,AR,4469,63194,67663
5035,Crittenden County,,AR,3624,55827,59451
5037,Cross County,,AR,1339,19554,20893
5039,Dallas County,,AR,612,8235,8847
5041,Desha County,,AR,981,14035,15016
5043,Drew County,,AR,1389,18655,20044
5045,Faulkner County,,AR,8049,109935,117984
5047,Franklin County,,AR,1333,18312,19645
5049,Fulton County,,AR,874,11196,12070
5051,Garland County,,AR,5855,101535,107390
5053,Grant County,,AR,1286,19169,20455
5055,Greene County,,AR,2397,43211,45608
5057,Hempstead County,,AR,1379,22841,24220
5059,Hot Spring County,,AR,2296,32479,34775
5061,Howard County,,AR,1060,14820,15880
5063,Independence County,,AR,2266,37935,40201
5065,Izard County,,AR,920,12710,13630
5067,Jackson County,,AR,1058,16105,17163
5069,Jefferson County,,AR,5043,82146,87189
5071,Johnson County,,AR,1565,25775,27340
5073,Lafayette County,,AR,536,7151,7687
5075,Lawrence County,,AR,1229,16952,18181
5077,Lee County,,AR,731,8313,9044
5079,Lincoln County,,AR,808,11430,12238
5081,Little River County,,AR,795,13508,14303
5083,Logan County,,AR,1645,23498,25143
5085,Lonoke County,,AR,6340,71251,77591
5087,Madison County,,AR,1233,16209,17442
5089,Marion County,,AR,1409,16172,17581
5091,Miller County,,AR,4082,42512,46594
5093,Mississippi County,,AR,3171,49777,52948
5095,Monroe County,,AR,734,8674,9408
5097,Montgomery County,,AR,608,8680,9288
5099,Nevada County,,AR,682,9398,10080
5101,Newton County,,AR,639,8201,8840
5103,Ouachita County,,AR,1729,26995,28724
5105,Perry County,,AR,852,10359,11211
5107,Phillips County,,AR,1521,21838,23359
5109,Pike County,,AR,797,11266,12063
5111,Poinsett County,,AR,1658,24756,26414
5113,Polk County,,AR,1113,20241,21354
5115,Pope County,,AR,4287,61815,66102
5117,Prairie County,,AR,515,8796,9311
5119,Pulaski County,,AR,27487,421112,448599
5121,Randolph County,,AR,1167,18235,19402
5123,St. Francis County,,AR,1830,24564,26394
5125,Saline County,,AR,7042,111810,118852
5127,Scott County,,AR,840,11339,12179
5129,Searcy County,,AR,579,7785,8364
5131,Sebastian County,,AR,9443,131086,140529
5133,Sevier County,,AR,979,16222,17201
5135,Sharp County,,AR,1419,17224,18643
5137,Stone County,,AR,734,11937,12671
5139,Union County,,AR,2473,47921,50394
5141,Van Buren County,,AR,1239,16601,17840
5143,Washington County,,AR,16178,197214,213392
5145,White County,,AR,4858,77064,81922
5147,Woodruff County,,AR,571,7558,8129
5149,Yell County,,AR,1766,22026,23792
6001,Alameda County,,CA,102648,1635126,1737774
6003,Alpine County,,CA,143,1037,1180
6005,Amador County,,CA,2304,38881,41185
6007,Butte County,,CA,11876,214857,226733
6009,Calaveras County,,CA,3112,47440,50552
6011,Colusa County,,CA,1476,27212,28688
6013,Contra Costa County,,CA,61341,1151408,1212749
6015,Del Norte County,,CA,1527,24348,25875
6017,El Dorado County,,CA,12529,196315,208844
6019,Fresno County,,CA,33525,951290,984815
6021,Glenn County,,CA,1917,30779,32696
6023,Humboldt County,,CA,7099,129559,136658
6025,Imperial County,,CA,8314,207978,216292
6027,Inyo County,,CA,1236,20042,21278
6029,Kern County,,CA,35218,820575,855793
6031,Kings County,,CA,10732,138130,148862
6033,Lake County,,CA,3697,59816,63513
6035,Lassen County,,CA,2005,26345,28350
6037,Los Angeles County,,CA,368527,10532053,10900580
6039,Madera County,,CA,8449,141548,149997
6041,Marin County,,CA,14890,250193,265083
6043,Mariposa County,,CA,1545,18220,19765
6045,Mendocino County,,CA,4245,91664,95909
6047,Merced County,,CA,16897,256931,273828
6049,Modoc County,,CA,576,8855,9431
6051,Mono County,,CA,1497,13117,14614
6053,Monterey County,,CA,27340,462263,489603
6055,Napa County,,CA,8546,151577,160123
6057,Nevada County,,CA,6395,106948,113343
6059,Orange County,,CA,155659,3354199,3509858
6061,Placer County,,CA,26487,371378,397865
6063,Plumas County,,CA,1654,22044,23698
6065,Riverside County,,CA,137145,2183084,2320229
6067,Sacramento County,,CA,80887,1529032,1609919
6069,San Benito County,,CA,4431,61725,66156
6071,San Bernardino County,,CA,148595,2119858,2268453
6073,San Diego County,,CA,174615,3407490,3582105
6075,San Francisco County,,CA,70028,846300,916328
6077,San Joaquin County,,CA,40355,719514,759869
6079,San Luis Obispo County,,CA,14990,273340,288330
6081,San Mateo County,,CA,51675,800581,852256
6083,Santa Barbara County,,CA,23453,433056,456509
6085,Santa Clara County,,CA,96208,2032646,2128854
6087,Santa Cruz County,,CA,14371,282419,296790
6089,Shasta County,,CA,9348,185360,194708
6091,Sierra County,,CA,298,3211,3509
6093,Siskiyou County,,CA,2573,46348,48921
6095,Solano County,,CA,31729,455580,487309
6097,Sonoma County,,CA,21097,531974,553071
6099,Stanislaus County,,CA,29765,549142,578907
6101,Sutter County,,CA,8117,99361,107478
6103,Tehama County,,CA,4001,62406,66407
6105,Trinity County,,CA,848,11449,12297
6107,Tulare County,,CA,16497,447334,463831
6109,Tuolumne County,,CA,3302,57321,60623
6111,Ventura County,,CA,41996,943941,985937
6113,Yolo County,,CA,17239,195815,213054
6115,Yuba County,,CA,9842,69463,79305
8001,Adams County,,CO,45997,466546,512543
8003,Alamosa County,,CO,1561,14812,16373
8005,Arapahoe County,,CO,65169,608120,673289
8007,Archuleta County,,CO,1193,11942,13135
8009,Baca County,,CO,281,4017,4298
8011,Bent County,,CO,314,4409,4723
8013,Boulder County,,CO,26683,305211,331894
8014,Broomfield County,,CO,13407,100850,114257
8015,Chaffee County,,CO,1395,17835,19230
8017,Cheyenne County,,CO,160,2106,2266
8019,Clear Creek County,,CO,1114,9540,10654
8021,Conejos County,,CO,603,8071,8674
8023,Costilla County,,CO,273,3118,3391
8025,Crowley County,,CO,340,2927,3267
8027,Custer County,,CO,340,4035,4375
8029,Delta County,,CO,2022,32345,34367
8031,Denver County,,CO,78599,591065,669664
8033,Dolores County,,CO,156,2134,2290
8035,Douglas County,,CO,27417,305712,333129
8037,Eagle County,,CO,5632,51485,57117
8039,Elbert County,,CO,1860,23657,25517
8041,El Paso County,,CO,53379,663882,717261
8043,Fremont County,,CO,2908,42150,45058
8045,Garfield County,,CO,5695,55660,61355
8047,Gilpin County,,CO,480,4145,4625
8049,Grand County,,CO,1634,14108,15742
8051,Gunnison County,,CO,1606,14318,15924
8053,Hinsdale County,,CO,82,831,913
8055,Huerfano County,,CO,676,6523,7199
8057,Jackson County,,CO,155,1462,1617
8059,Jefferson County,,CO,49010,560646,609656
8061,Kiowa County,,CO,145,1526,1671
8063,Kit Carson County,,CO,542,8295,8837
8065,Lake County,,CO,881,6886,7767
8067,La Plata County,,CO,4191,50473,54664
8069,Larimer County,,CO,23347,320041,343388
8071,Las Animas County,,CO,1117,15868,16985
8073,Lincoln County,,CO,417,4963,5380
8075,Logan County,,CO,1331,20960,22291
8077,Mesa County,,CO,9298,158670,167968
8079,Mineral County,,CO,94,875,969
8081,Moffat County,,CO,1362,14918,16280
8083,Montezuma County,,CO,1824,25608,27432
8085,Montrose County,,CO,2690,43456,46146
8087,Morgan County,,CO,2201,30380,32581
8089,Otero County,,CO,1292,19784,21076
8091,Ouray County,,CO,500,4250,4750
8093,Park County,,CO,1689,15188,16877
8095,Phillips County,,CO,373,4716,5089
8097,Pitkin County,,CO,1742,15228,16970
8099,Prowers County,,CO,950,13079,14029
8101,Pueblo County,,CO,7803,169078,176881
8103,Rio Blanco County,,CO,764,6763,7527
8105,Rio Grande County,,CO,1277,14983,16260
8107,Routt County,,CO,2388,23348,25736
8109,Saguache County,,CO,340,3625,3965
8111,San Juan County,,CO,91,595,686
8113,San Miguel County,,CO,913,6591,7504
8115,Sedgwick County,,CO,222,2575,2797
8117,Summit County,,CO,4060,29636,33696
8119,Teller County,,CO,2429,25274,27703
8121,Washington County,,CO,384,4741,5125
8123,Weld County,,CO,20087,263026,283113
8125,Yuma County,,CO,746,10555,11301
9001,Fairfield County,,CT,41826,994523,1036349
9003,Hartford County,,CT,41768,1063133,1104901
9005,Litchfield County,,CT,9877,228914,238791
9007,Middlesex County,,CT,10730,197243,207973
9009,New Haven County,,CT,41224,985211,1026435
9011,New London County,,CT,18378,322866,341244
9013,Tolland County,,CT,10230,166445,176675
9015,Windham County,,CT,7060,135795,142855
10001,Kent County,,DE,10313,180320,190633
10003,New Castle County,,DE,26602,625755,652357
10005,Sussex County,,DE,9029,214023,223052
11001,District of Columbia,,DC,58001,575642,633643
12001,Alachua County,,FL,22250,231611,253861
12003,Baker County,,FL,1700,26882,28582
12005,Bay County,,FL,15284,183899,199183
12007,Bradford County,,FL,1980,25229,27209
12009,Brevard County,,FL,33113,617994,651107
12011,Broward County,,FL,121299,1915575,2036874
12013,Calhoun County,,FL,923,12289,13212
12015,Charlotte County,,FL,13442,166724,180166
12017,Citrus County,,FL,9485,151401,160886
12019,Clay County,,FL,20890,214450,235340
12021,Collier County,,FL,23567,341377,364944
12023,Columbia County,,FL,4906,65465,70371
12027,DeSoto County,,FL,2185,28473,30658
12029,Dixie County,,FL,1074,13003,14077
12031,Duval County,,FL,69199,973599,1042798
12033,Escambia County,,FL,27190,318206,345396
12035,Flagler County,,FL,8807,102331,111138
12037,Franklin County,,FL,712,9719,10431
12039,Gadsden County,,FL,3451,50186,53637
12041,Gilchrist County,,FL,1565,15135,16700
12043,Glades County,,FL,989,8633,9622
12045,Gulf County,,FL,1110,13231,14341
12047,Hamilton County,,FL,943,12156,13099
12049,Hardee County,,FL,1972,25158,27130
12051,Hendry County,,FL,3544,36728,40272
12053,Hernando County,,FL,13650,180852,194502
12055,Highlands County,,FL,6304,97943,104247
12057,Hillsborough County,,FL,90764,1309952,1400716
12059,Holmes County,,FL,1501,18137,19638
12061,Indian River County,,FL,9462,150685,160147
12063,Jackson County,,FL,2967,47092,50059
12065,Jefferson County,,FL,1086,14212,15298
12067,Lafayette County,,FL,371,6108,6479
12069,Lake County,,FL,25549,321813,347362
12071,Lee County,,FL,47948,647577,695525
12073,Leon County,,FL,23972,261046,285018
12075,Levy County,,FL,3361,40098,43459
12077,Liberty County,,FL,525,6686,7211
12079,Madison County,,FL,1077,18396,19473
12081,Manatee County,,FL,24170,338371,362541
12083,Marion County,,FL,21510,355561,377071
12085,Martin County,,FL,11433,150412,161845
12086,Miami-Dade County,,FL,119866,2685923,2805789
12087,Monroe County,,FL,8902,78808,87710
12089,Nassau County,,FL,5913,81310,87223
12091,Okaloosa County,,FL,23365,209742,233107
12093,Okeechobee County,,FL,2835,37417,40252
12095,Orange County,,FL,113618,1210804,1324422
12097,Osceola County,,FL,36359,283555,319914
12099,Palm Beach County,,FL,73987,1387864,1461851
12101,Pasco County,,FL,39140,484953,524093
12103,Pinellas County,,FL,58761,1001505,1060266
12105,Polk County,,FL,42793,637653,680446
12107,Putnam County,,FL,5140,74083,79223
12109,St. Johns County,,FL,15340,196487,211827
12111,St. Lucie County,,FL,23524,295533,319057
12113,Santa Rosa County,,FL,15987,157256,173243
12115,Sarasota County,,FL,28611,408468,437079
12117,Seminole County,,FL,46548,456336,502884
12119,Sumter County,,FL,4839,86146,90985
12121,Suwannee County,,FL,3010,39445,42455
12123,Taylor County,,FL,1145,20983,22128
12125,Union County,,FL,998,11437,12435
12127,Volusia County,,FL,35741,539654,575395
12129,Wakulla County,,FL,2283,29549,31832
12131,Walton County,,FL,4997,50675,55672
12133,Washington County,,FL,2095,22502,24597
13001,Appling County,,GA,983,18508,19491
13003,Atkinson County,,GA,631,8449,9080
13005,Bacon County,,GA,613,10637,11250
13007,Baker County,,GA,293,3365,3658
13009,Baldwin County,,GA,2797,43356,46153
13011,Banks County,,GA,1738,18091,19829
13013,Barrow County,,GA,6093,73883,79976
13015,Bartow County,,GA,7996,108770,116766
13017,Ben Hill County,,GA,1362,18315,19677
13019,Berrien County,,GA,1622,17653,19275
13021,Bibb County,,GA,10602,165345,175947
13023,Bleckley County,,GA,730,12676,13406
13025,Brantley County,,GA,1216,16299,17515
13027,Brooks County,,GA,1482,16192,17674
13029,Bryan County,,GA,4300,33589,37889
13031,Bulloch County,,GA,4924,55928,60852
13033,Burke County,,GA,1687,25649,27336
13035,Butts County,,GA,2117,23539,25656
13037,Calhoun County,,GA,368,5450,5818
13039,Camden County,,GA,7064,52145,59209
13043,Candler County,,GA,809,10194,11003
13045,Carroll County,,GA,8967,114268,123235
13047,Catoosa County,,GA,5222,65814,71036
13049,Charlton County,,GA,819,9446,10265
13051,Chatham County,,GA,21626,262847,284473
13053,Chattahoochee County,,GA,3769,6740,10509
13055,Chattooga County,,GA,1384,26089,27473
13057,Cherokee County,,GA,15995,228883,244878
13059,Clarke County,,GA,12578,94831,107409
13061,Clay County,,GA,207,3136,3343
13063,Clayton County,,GA,41226,278030,319256
13065,Clinch County,,GA,380,6760,7140
13067,Cobb County,,GA,71001,753097,824098
13069,Coffee County,,GA,2279,40674,42953
13071,Colquitt County,,GA,2243,44306,46549
13073,Columbia County,,GA,11239,129528,140767
13075,Cook County,,GA,1308,16919,18227
13077,Coweta County,,GA,9389,138108,147497
13079,Crawford County,,GA,1196,13105,14301
13081,Crisp County,,GA,1476,22277,23753
13083,Dade County,,GA,1144,16346,17490
13085,Dawson County,,GA,2009,21893,23902
13087,Decatur County,,GA,1672,29153,30825
13089,DeKalb County,,GA,87934,696335,784269
13091,Dodge County,,GA,1096,19605,20701
13093,Dooly County,,GA,829,10793,11622
13095,Dougherty County,,GA,7758,97257,105015
13097,Douglas County,,GA,16228,136795,153023
13099,Early County,,GA,655,11725,12380
13101,Echols County,,GA,206,3186,3392
13103,Effingham County,,GA,4252,55982,60234
13105,Elbert County,,GA,1230,23266,24496
13107,Emanuel County,,GA,1532,23891,25423
13109,Evans County,,GA,890,11046,11936
13111,Fannin County,,GA,1349,23765,25114
13113,Fayette County,,GA,9426,119008,128434
13115,Floyd County,,GA,5170,101934,107104
13117,Forsyth County,,GA,11777,182114,193891
13119,Franklin County,,GA,1834,24474,26308
13121,Fulton County,,GA,107644,869068,976712
13123,Gilmer County,,GA,2019,28841,30860
13125,Glascock County,,GA,183,2983,3166
13127,Glynn County,,GA,5782,82704,88486
13129,Gordon County,,GA,3868,61910,65778
13131,Grady County,,GA,1577,24896,26473
13133,Greene County,,GA,1078,17109,18187
13135,Gwinnett County,,GA,69928,861106,931034
13137,Habersham County,,GA,2798,44816,47614
13139,Hall County,,GA,12901,196155,209056
13141,Hancock County,,GA,563,9245,9808
13143,Haralson County,,GA,2246,29697,31943
13145,Harris County,,GA,2444,33308,35752
13147,Hart County,,GA,1566,26744,28310
13149,Heard County,,GA,1056,10987,12043
13151,Henry County,,GA,20691,214507,235198
13153,Houston County,,GA,12689,154552,167241
13155,Irwin County,,GA,866,9193,10059
13157,Jackson County,,GA,5361,63722,69083
13159,Jasper County,,GA,1189,14989,16178
13161,Jeff Davis County,,GA,911,14428,15339
13163,Jefferson County,,GA,989,20112,21101
13165,Jenkins County,,GA,561,8438,8999
13167,Johnson County,,GA,524,8391,8915
13169,Jones County,,GA,2221,30570,32791
13171,Lamar County,,GA,1389,17464,18853
13173,Lanier County,,GA,1032,7858,8890
13175,Laurens County,,GA,2525,54314,56839
13177,Lee County,,GA,3210,31950,35160
13179,Liberty County,,GA,14015,61188,75203
13181,Lincoln County,,GA,525,8686,9211
13183,Long County,,GA,1568,9179,10747
13185,Lowndes County,,GA,9621,102824,112445
13187,Lumpkin County,,GA,2597,26917,29514
13189,McDuffie County,,GA,1430,25005,26435
13191,McIntosh County,,GA,907,11933,12840
13193,Macon County,,GA,839,12901,13740
13195,Madison County,,GA,2246,30203,32449
13197,Marion County,,GA,562,7257,7819
13199,Meriwether County,,GA,2037,24126,26163
13201,Miller County,,GA,452,5812,6264
13205,Mitchell County,,GA,1503,22888,24391
13207,Monroe County,,GA,2076,26988,29064
13209,Montgomery County,,GA,705,8233,8938
13211,Morgan County,,GA,1246,20316,21562
13213,Murray County,,GA,3414,42841,46255
13215,Muscogee County,,GA,20872,202178,223050
13217,Newton County,,GA,9994,103381,113375
13219,Oconee County,,GA,2548,35040,37588
13221,Oglethorpe County,,GA,1120,14853,15973
13223,Paulding County,,GA,12042,148452,160494
13225,Peach County,,GA,2669,27074,29743
13227,Pickens County,,GA,2320,32355,34675
13229,Pierce County,,GA,1341,18980,20321
13231,Pike County,,GA,1482,19148,20630
13233,Polk County,,GA,2662,43653,46315
13235,Pulaski County,,GA,629,9759,10388
13237,Putnam County,,GA,1681,22648,24329
13239,Quitman County,,GA,225,2319,2544
13241,Rabun County,,GA,1051,17306,18357
13243,Randolph County,,GA,411,7681,8092
13245,Richmond County,,GA,20860,205524,226384
13247,Rockdale County,,GA,10647,86355,97002
13249,Schley County,,GA,366,4542,4908
13251,Screven County,,GA,880,15340,16220
13253,Seminole County,,GA,675,9189,9864
13255,Spalding County,,GA,5516,67124,72640
13257,Stephens County,,GA,1915,28457,30372
13259,Stewart County,,GA,322,4776,5098
13261,Sumter County,,GA,2131,32290,34421
13263,Talbot County,,GA,579,7063,7642
13265,Taliaferro County,,GA,131,1770,1901
13267,Tattnall County,,GA,1410,19876,21286
13269,Taylor County,,GA,587,9044,9631
13271,Telfair County,,GA,777,10880,11657
13273,Terrell County,,GA,699,10929,11628
13275,Thomas County,,GA,3041,47703,50744
13277,Tift County,,GA,2967,41618,44585
13279,Toombs County,,GA,2115,27638,29753
13281,Towns County,,GA,666,11041,11707
13283,Treutlen County,,GA,350,6243,6593
13285,Troup County,,GA,4070,71044,75114
13287,Turner County,,GA,650,9821,10471
13289,Twiggs County,,GA,842,10379,11221
13291,Union County,,GA,1239,22205,23444
13293,Upson County,,GA,1506,28977,30483
13295,Walker County,,GA,4520,69008,73528
13297,Walton County,,GA,6037,88169,94206
13299,Ware County,,GA,2597,35640,38237
13301,Warren County,,GA,505,6542,7047
13303,Washington County,,GA,976,22373,23349
13305,Wayne County,,GA,1938,28638,30576
13307,Webster County,,GA,158,2603,2761
13309,Wheeler County,,GA,305,4934,5239
13311,White County,,GA,2082,26306,28388
13313,Whitfield County,,GA,7717,120299,128016
13315,Wilcox County,,GA,457,7158,7615
13317,Wilkes County,,GA,555,11161,11716
13319,Wilkinson County,,GA,728,11295,12023
13321,Worth County,,GA,1596,23413,25009
15001,Hawaii County,,HI,9034,192486,201520
15003,Honolulu County,,HI,68102,1083165,1151267
15005,Kalawao County,,HI,-2,-2,-4
15007,Kauai County,,HI,3149,75932,79081
15009,Maui County,,HI,8754,168375,177129
16001,Ada County,,ID,26914,427250,454164
16003,Adams County,,ID,347,4178,4525
16005,Bannock County,,ID,6489,86737,93226
16007,Bear Lake County,,ID,462,6858,7320
16009,Benewah County,,ID,782,10072,10854
16011,Bingham County,,ID,3549,50131,53680
16013,Blaine County,,ID,1803,25531,27334
16015,Boise County,,ID,727,7281,8008
16017,Bonner County,,ID,3004,43222,46226
16019,Bonneville County,,ID,7970,114234,122204
16021,Boundary County,,ID,828,11686,12514
16023,Butte County,,ID,233,3172,3405
16025,Camas County,,ID,90,1086,1176
16027,Canyon County,,ID,15089,198524,213613
16029,Caribou County,,ID,502,7998,8500
16031,Cassia County,,ID,2038,24061,26099
16033,Clark County,,ID,99,1051,1150
16035,Clearwater County,,ID,610,8819,9429
16037,Custer County,,ID,412,4588,5000
16039,Elmore County,,ID,4762,29077,33839
16041,Franklin County,,ID,918,14574,15492
16043,Fremont County,,ID,1270,14421,15691
16045,Gem County,,ID,1565,18124,19689
16047,Gooding County,,ID,1443,16557,18000
16049,Idaho County,,ID,818,15315,16133
16051,Jefferson County,,ID,2214,28003,30217
16053,Jerome County,,ID,2023,23598,25621
16055,Kootenai County,,ID,8832,153793,162625
16057,Latah County,,ID,4026,34812,38838
16059,Lemhi County,,ID,646,8367,9013
16061,Lewis County,,ID,370,4785,5155
16063,Lincoln County,,ID,580,5310,5890
16065,Madison County,,ID,5504,28512,34016
16067,Minidoka County,,ID,1741,22689,24430
16069,Nez Perce County,,ID,3075,43423,46498
16071,Oneida County,,ID,274,4814,5088
16073,Owyhee County,,ID,1279,11741,13020
16075,Payette County,,ID,2156,24541,26697
16077,Power County,,ID,734,8718,9452
16079,Shoshone County,,ID,1125,13317,14442
16081,Teton County,,ID,999,9891,10890
16083,Twin Falls County,,ID,5769,83112,88881
16085,Valley County,,ID,1360,10509,11869
16087,Washington County,,ID,786,10492,11278
17001,Adams County,,IL,3054,81771,84825
17003,Alexander County,,IL,634,8115,8749
17005,Bond County,,IL,1216,18637,19853
17007,Boone County,,IL,4726,68510,73236
17009,Brown County,,IL,294,6119,6413
17011,Bureau County,,IL,2113,44062,46175
17013,Calhoun County,,IL,251,6048,6299
17015,Carroll County,,IL,989,20102,21091
17017,Cass County,,IL,1281,16103,17384
17019,Champaign County,,IL,14329,199746,214075
17021,Christian County,,IL,1909,41371,43280
17023,Clark County,,IL,1014,20042,21056
17025,Clay County,,IL,889,16907,17796
17027,Clinton County,,IL,2104,44446,46550
17029,Coles County,,IL,3434,52808,56242
17031,Cook County,,IL,219405,6072075,6291480
17033,Crawford County,,IL,858,23292,24150
17035,Cumberland County,,IL,841,13265,14106
17037,DeKalb County,,IL,8534,112049,120583
17039,De Witt County,,IL,1312,19958,21270
17041,Douglas County,,IL,1504,25952,27456
17043,DuPage County,,IL,70821,1122818,1193639
17045,Edgar County,,IL,1108,22006,23114
17047,Edwards County,,IL,381,8173,8554
17049,Effingham County,,IL,2061,44003,46064
17051,Fayette County,,IL,1231,25008,26239
17053,Ford County,,IL,1218,17085,18303
17055,Franklin County,,IL,2219,44416,46635
17057,Fulton County,,IL,1858,42901,44759
17059,Gallatin County,,IL,471,6513,6984
17061,Greene County,,IL,836,16224,17060
17063,Grundy County,,IL,4346,62124,66470
17065,Hamilton County,,IL,412,9592,10004
17067,Hancock County,,IL,1301,23407,24708
17069,Hardin County,,IL,264,4493,4757
17071,Henderson County,,IL,629,8691,9320
17073,Henry County,,IL,3548,63069,66617
17075,Iroquois County,,IL,2053,37150,39203
17077,Jackson County,,IL,5993,53332,59325
17079,Jasper County,,IL,629,12611,13240
17081,Jefferson County,,IL,2328,43636,45964
17083,Jersey County,,IL,1555,27572,29127
17085,Jo Daviess County,,IL,1284,28785,30069
17087,Johnson County,,IL,731,12777,13508
17089,Kane County,,IL,33318,607688,641006
17091,Kankakee County,,IL,5802,132070,137872
17093,Kendall County,,IL,9319,135235,144554
17095,Knox County,,IL,2871,59394,62265
17097,Lake County,,IL,42171,834515,876686
17099,LaSalle County,,IL,6233,141151,147384
17101,Lawrence County,,IL,891,16980,17871
17103,Lee County,,IL,2253,42641,44894
17105,Livingston County,,IL,2231,45907,48138
17107,Logan County,,IL,1851,32795,34646
17109,McDonough County,,IL,2266,30215,32481
17111,McHenry County,,IL,18000,391676,409676
17113,McLean County,,IL,10591,188413,199004
17115,Macon County,,IL,6175,129999,136174
17117,Macoupin County,,IL,3224,57280,60504
17119,Madison County,,IL,15253,322309,337562
17121,Marion County,,IL,2330,47114,49444
17123,Marshall County,,IL,943,15899,16842
17125,Mason County,,IL,1111,17839,18950
17127,Massac County,,IL,994,17884,18878
17129,Menard County,,IL,967,15798,16765
17131,Mercer County,,IL,1215,21323,22538
17133,Monroe County,,IL,1958,41911,43869
17135,Montgomery County,,IL,1752,34253,36005
17137,Morgan County,,IL,2264,40267,42531
17139,Moultrie County,,IL,1201,17771,18972
17141,Ogle County,,IL,4048,66842,70890
17143,Peoria County,,IL,12495,221742,234237
17145,Perry County,,IL,1163,23681,24844
17147,Piatt County,,IL,1306,20410,21716
17149,Pike County,,IL,913,18800,19713
17151,Pope County,,IL,258,4289,4547
17153,Pulaski County,,IL,406,6796,7202
17155,Putnam County,,IL,464,7499,7963
17157,Randolph County,,IL,1724,36568,38292
17159,Richland County,,IL,873,19478,20351
17161,Rock Island County,,IL,9205,179582,188787
17163,St. Clair County,,IL,17830,309330,327160
17165,Saline County,,IL,1356,27708,29064
17167,Sangamon County,,IL,10126,242149,252275
17169,Schuyler County,,IL,629,8401,9030
17171,Scott County,,IL,304,6285,6589
17173,Shelby County,,IL,1377,26599,27976
17175,Stark County,,IL,446,7466,7912
17177,Stephenson County,,IL,2630,58377,61007
17179,Tazewell County,,IL,8379,166444,174823
17181,Union County,,IL,899,20348,21247
17183,Vermilion County,,IL,4164,92507,96671
17185,Wabash County,,IL,705,14625,15330
17187,Warren County,,IL,1070,20333,21403
17189,Washington County,,IL,1190,18429,19619
17191,Wayne County,,IL,887,19635,20522
17193,White County,,IL,871,17519,18390
17195,Whiteside County,,IL,3234,74742,77976
17197,Will County,,IL,42402,825758,868160
17199,Williamson County,,IL,4042,73393,77435
17201,Winnebago County,,IL,15462,360978,376440
17203,Woodford County,,IL,2787,47009,49796
18001,Adams County,,IN,1610,42510,44120
18003,Allen County,,IN,17328,429351,446679
18005,Bartholomew County,,IN,5423,95987,101410
18007,Benton County,,IN,897,10549,11446
18009,Blackford County,,IN,934,15961,16895
18011,Boone County,,IN,3985,65601,69586
18013,Brown County,,IN,1259,18247,19506
18015,Carroll County,,IN,1636,24905,26541
18017,Cass County,,IN,2530,48052,50582
18019,Clark County,,IN,8396,128885,137281
18021,Clay County,,IN,1939,31848,33787
18023,Clinton County,,IN,2265,41392,43657
18025,Crawford County,,IN,765,12151,12916
18027,Daviess County,,IN,1228,36104,37332
18029,Dearborn County,,IN,3509,62248,65757
18031,Decatur County,,IN,2043,32306,34349
18033,DeKalb County,,IN,3127,51764,54891
18035,Delaware County,,IN,7005,121080,128085
18037,Dubois County,,IN,2348,54460,56808
18039,Elkhart County,,IN,12380,244567,256947
18041,Fayette County,,IN,1528,28050,29578
18043,Floyd County,,IN,6672,87155,93827
18045,Fountain County,,IN,1480,21718,23198
18047,Franklin County,,IN,1658,29869,31527
18049,Fulton County,,IN,1612,25170,26782
18051,Gibson County,,IN,1955,40436,42391
18053,Grant County,,IN,3745,78383,82128
18055,Greene County,,IN,2003,37563,39566
18057,Hamilton County,,IN,20803,311237,332040
18059,Hancock County,,IN,5370,83440,88810
18061,Harrison County,,IN,2574,46832,49406
18063,Hendricks County,,IN,11823,168977,180800
18065,Henry County,,IN,3008,57989,60997
18067,Howard County,,IN,5382,103154,108536
18069,Huntington County,,IN,2301,47153,49454
18071,Jackson County,,IN,3004,55552,58556
18073,Jasper County,,IN,2366,40076,42442
18075,Jay County,,IN,1285,26355,27640
18077,Jefferson County,,IN,1912,37996,39908
18079,Jennings County,,IN,2173,33684,35857
18081,Johnson County,,IN,13451,164250,177701
18083,Knox County,,IN,1906,42402,44308
18085,Kosciusko County,,IN,5164,97194,102358
18087,LaGrange County,,IN,2555,45760,48315
18089,Lake County,,IN,27085,580076,607161
18091,LaPorte County,,IN,5392,129528,134920
18093,Lawrence County,,IN,2390,54653,57043
18095,Madison County,,IN,7387,152405,159792
18097,Marion County,,IN,64338,1057922,1122260
18099,Marshall County,,IN,3084,57170,60254
18101,Martin County,,IN,595,12484,13079
18103,Miami County,,IN,2783,40263,43046
18105,Monroe County,,IN,11101,120246,131347
18107,Montgomery County,,IN,2442,46730,49172
18109,Morgan County,,IN,5828,84009,89837
18111,Newton County,,IN,1169,16922,18091
18113,Noble County,,IN,3423,56562,59985
18115,Ohio County,,IN,642,7404,8046
18117,Orange County,,IN,1251,22368,23619
18119,Owen County,,IN,1750,24710,26460
18121,Parke County,,IN,1253,17967,19220
18123,Perry County,,IN,1022,21336,22358
18125,Pike County,,IN,950,15271,16221
18127,Porter County,,IN,11406,194916,206322
18129,Posey County,,IN,1704,31894,33598
18131,Pulaski County,,IN,1049,16023,17072
18133,Putnam County,,IN,2843,39957,42800
18135,Randolph County,,IN,1965,31413,33378
18137,Ripley County,,IN,2001,33249,35250
18139,Rush County,,IN,1341,20986,22327
18141,St. Joseph County,,IN,16213,312608,328821
18143,Scott County,,IN,1633,27074,28707
18145,Shelby County,,IN,3368,54761,58129
18147,Spencer County,,IN,1510,25857,27367
18149,Starke County,,IN,1585,27304,28889
18151,Steuben County,,IN,2638,39295,41933
18153,Sullivan County,,IN,1285,23233,24518
18155,Switzerland County,,IN,734,9899,10633
18157,Tippecanoe County,,IN,13784,169635,183419
18159,Tipton County,,IN,1210,19865,21075
18161,Union County,,IN,552,8401,8953
18163,Vanderburgh County,,IN,10522,204191,214713
18165,Vermillion County,,IN,1099,19668,20767
18167,Vigo County,,IN,6788,113917,120705
18169,Wabash County,,IN,1918,40061,41979
18171,Warren County,,IN,722,10423,11145
18173,Warrick County,,IN,4645,70545,75190
18175,Washington County,,IN,1945,32730,34675
18177,Wayne County,,IN,3706,81714,85420
18179,Wells County,,IN,1821,33308,35129
18181,White County,,IN,2229,30467,32696
18183,Whitley County,,IN,2352,42060,44412
19001,Adair County,,IA,603,9210,9813
19003,Adams County,,IA,281,5020,5301
19005,Allamakee County,,IA,947,17436,18383
19007,Appanoose County,,IA,748,14649,15397
19009,Audubon County,,IA,405,7581,7986
19011,Benton County,,IA,1911,31398,33309
19013,Black Hawk County,,IA,7485,143558,151043
19015,Boone County,,IA,1812,31464,33276
19017,Bremer County,,IA,1853,27823,29676
19019,Buchanan County,,IA,1439,25188,26627
19021,Buena Vista County,,IA,1738,23616,25354
19023,Butler County,,IA,1275,18034,19309
19025,Calhoun County,,IA,742,12159,12901
19027,Carroll County,,IA,1307,26205,27512
19029,Cass County,,IA,880,16704,17584
19031,Cedar County,,IA,1346,22790,24136
19033,Cerro Gordo County,,IA,2728,52926,55654
19035,Cherokee County,,IA,738,14814,15552
19037,Chickasaw County,,IA,728,15526,16254
19039,Clarke County,,IA,863,10833,11696
19041,Clay County,,IA,1196,20946,22142
19043,Clayton County,,IA,1098,22323,23421
19045,Clinton County,,IA,2815,59344,62159
19047,Crawford County,,IA,1095,20409,21504
19049,Dallas County,,IA,5843,72482,78325
19051,Davis County,,IA,530,9930,10460
19053,Decatur County,,IA,562,8440,9002
19055,Delaware County,,IA,998,22065,23063
19057,Des Moines County,,IA,2687,48186,50873
19059,Dickinson County,,IA,1345,20660,22005
19061,Dubuque County,,IA,4565,113276,117841
19063,Emmet County,,IA,742,11985,12727
19065,Fayette County,,IA,1286,23504,24790
19067,Floyd County,,IA,1006,19396,20402
19069,Franklin County,,IA,750,12440,13190
19071,Fremont County,,IA,721,8832,9553
19073,Greene County,,IA,605,11469,12074
19075,Grundy County,,IA,922,15115,16037
19077,Guthrie County,,IA,972,13168,14140
19079,Hamilton County,,IA,1093,18949,20042
19081,Hancock County,,IA,793,14152,14945
19083,Hardin County,,IA,1281,20199,21480
19085,Harrison County,,IA,903,17809,18712
19087,Henry County,,IA,1595,22814,24409
19089,Howard County,,IA,576,12189,12765
19091,Humboldt County,,IA,752,12041,12793
19093,Ida County,,IA,583,8871,9454
19095,Iowa County,,IA,1142,20614,21756
19097,Jackson County,,IA,1161,24642,25803
19099,Jasper County,,IA,2679,43502,46181
19101,Jefferson County,,IA,1080,17238,18318
19103,Johnson County,,IA,11845,131710,143555
19105,Jones County,,IA,1281,23678,24959
19107,Keokuk County,,IA,732,12696,13428
19109,Kossuth County,,IA,798,19895,20693
19111,Lee County,,IA,2063,41214,43277
19113,Linn County,,IA,12067,252095,264162
19115,Louisa County,,IA,1264,13449,14713
19117,Lucas County,,IA,669,10317,10986
19119,Lyon County,,IA,717,14245,14962
19121,Madison County,,IA,1221,18391,19612
19123,Mahaska County,,IA,1660,25546,27206
19125,Marion County,,IA,2142,39332,41474
19127,Marshall County,,IA,2695,47489,50184
19129,Mills County,,IA,1256,17138,18394
19131,Mitchell County,,IA,579,13012,13591
19133,Monona County,,IA,547,11007,11554
19135,Monroe County,,IA,543,8867,9410
19137,Montgomery County,,IA,750,12752,13502
19139,Muscatine County,,IA,2692,52317,55009
19141,O'Brien County,,IA,1030,17570,18600
19143,Osceola County,,IA,507,7961,8468
19145,Page County,,IA,1108,17677,18785
19147,Palo Alto County,,IA,645,11321,11966
19149,Plymouth County,,IA,1663,31126,32789
19151,Pocahontas County,,IA,634,9022,9656
19153,Polk County,,IA,24658,502800,527458
19155,Pottawattamie County,,IA,6103,106479,112582
19157,Poweshiek County,,IA,1414,21178,22592
19159,Ringgold County,,IA,356,5513,5869
19161,Sac County,,IA,605,12689,13294
19163,Scott County,,IA,12502,195634,208136
19165,Shelby County,,IA,948,14973,15921
19167,Sioux County,,IA,1664,39197,40861
19169,Story County,,IA,8448,84284,92732
19171,Tama County,,IA,1373,21828,23201
19173,Taylor County,,IA,433,7345,7778
19175,Union County,,IA,930,14275,15205
19177,Van Buren County,,IA,546,8712,9258
19179,Wapello County,,IA,2362,40917,43279
19181,Warren County,,IA,3427,53779,57206
19183,Washington County,,IA,1541,26291,27832
19185,Wayne County,,IA,395,7234,7629
19187,Webster County,,IA,2297,43210,45507
19189,Winnebago County,,IA,830,13415,14245
19191,Winneshiek County,,IA,1103,24147,25250
19193,Woodbury County,,IA,6336,118408,124744
19195,Worth County,,IA,526,9335,9861
19197,Wright County,,IA,926,15581,16507
20001,Allen County,,KS,972,15380,16352
20003,Anderson County,,KS,642,9657,10299
20005,Atchison County,,KS,1119,18541,19660
20007,Barber County,,KS,400,5649,6049
20009,Barton County,,KS,2000,32145,34145
20011,Bourbon County,,KS,1000,16973,17973
20013,Brown County,,KS,771,11838,12609
20015,Butler County,,KS,5114,71741,76855
20017,Chase County,,KS,224,3112,3336
20019,Chautauqua County,,KS,274,4043,4317
20021,Cherokee County,,KS,1644,23389,25033
20023,Cheyenne County,,KS,233,3290,3523
20025,Clark County,,KS,177,2451,2628
20027,Clay County,,KS,782,10464,11246
20029,Cloud County,,KS,788,10790,11578
20031,Coffey County,,KS,705,10270,10975
20033,Comanche County,,KS,170,2091,2261
20035,Cowley County,,KS,2993,40151,43144
20037,Crawford County,,KS,2963,40560,43523
20039,Decatur County,,KS,295,3529,3824
20041,Dickinson County,,KS,2115,23638,25753
20043,Doniphan County,,KS,718,8745,9463
20045,Douglas County,,KS,10041,105564,115605
20047,Edwards County,,KS,313,3603,3916
20049,Elk County,,KS,236,3230,3466
20051,Ellis County,,KS,2313,31503,33816
20053,Ellsworth County,,KS,442,6844,7286
20055,Finney County,,KS,3064,44222,47286
20057,Ford County,,KS,2677,38132,40809
20059,Franklin County,,KS,2140,30176,32316
20061,Geary County,,KS,11615,33134,44749
20063,Gove County,,KS,178,3349,3527
20065,Graham County,,KS,263,3325,3588
20067,Grant County,,KS,657,9027,9684
20069,Gray County,,KS,575,7006,7581
20071,Greeley County,,KS,137,1501,1638
20073,Greenwood County,,KS,587,7382,7969
20075,Hamilton County,,KS,235,2912,3147
20077,Harper County,,KS,528,6985,7513
20079,Harvey County,,KS,2352,40397,42749
20081,Haskell County,,KS,460,4687,5147
20083,Hodgeman County,,KS,163,2349,2512
20085,Jackson County,,KS,1013,16099,17112
20087,Jefferson County,,KS,1560,22314,23874
20089,Jewell County,,KS,246,3928,4174
20091,Johnson County,,KS,39476,633505,672981
20093,Kearny County,,KS,359,4672,5031
20095,Kingman County,,KS,616,9372,9988
20097,Kiowa County,,KS,262,2511,2773
20099,Labette County,,KS,1337,25855,27192
20101,Lane County,,KS,138,2137,2275
20103,Leavenworth County,,KS,9608,77206,86814
20105,Lincoln County,,KS,321,3879,4200
20107,Linn County,,KS,751,10676,11427
20109,Logan County,,KS,246,3293,3539
20111,Lyon County,,KS,4616,37187,41803
20113,McPherson County,,KS,2132,35026,37158
20115,Marion County,,KS,882,14348,15230
20117,Marshall County,,KS,728,13149,13877
20119,Meade County,,KS,379,5272,5651
20121,Miami County,,KS,2546,37231,39777
20123,Mitchell County,,KS,449,7473,7922
20125,Montgomery County,,KS,2742,39602,42344
20127,Morris County,,KS,456,6972,7428
20129,Morton County,,KS,296,3858,4154
20131,Nemaha County,,KS,725,12982,13707
20133,Neosho County,,KS,1213,18918,20131
20135,Ness County,,KS,265,3781,4046
20137,Norton County,,KS,404,5931,6335
20139,Osage County,,KS,1460,19477,20937
20141,Osborne County,,KS,281,4870,5151
20143,Ottawa County,,KS,605,7435,8040
20145,Pawnee County,,KS,585,7502,8087
20147,Phillips County,,KS,353,7028,7381
20149,Pottawatomie County,,KS,1977,24700,26677
20151,Pratt County,,KS,913,10832,11745
20153,Rawlins County,,KS,199,3023,3222
20155,Reno County,,KS,3525,74606,78131
20157,Republic County,,KS,294,6353,6647
20159,Rice County,,KS,899,11041,11940
20161,Riley County,,KS,12300,53748,66048
20163,Rooks County,,KS,446,6223,6669
20165,Rush County,,KS,306,4013,4319
20167,Russell County,,KS,518,7942,8460
20169,Saline County,,KS,4054,66439,70493
20171,Scott County,,KS,378,5955,6333
20173,Sedgwick County,,KS,23857,574017,597874
20175,Seward County,,KS,2278,26764,29042
20177,Shawnee County,,KS,9805,210768,220573
20179,Sheridan County,,KS,178,3383,3561
20181,Sherman County,,KS,590,6669,7259
20183,Smith County,,KS,287,4939,5226
20185,Stafford County,,KS,374,5104,5478
20187,Stanton County,,KS,252,2637,2889
20189,Stevens County,,KS,434,6484,6918
20191,Sumner County,,KS,1935,28375,30310
20193,Thomas County,,KS,830,8382,9212
20195,Trego County,,KS,215,3823,4038
20197,Wabaunsee County,,KS,627,8473,9100
20199,Wallace County,,KS,122,1748,1870
20201,Washington County,,KS,381,7425,7806
20203,Wichita County,,KS,225,2742,2967
20205,Wilson County,,KS,822,11098,11920
20207,Woodson County,,KS,242,3619,3861
20209,Wyandotte County,,KS,13432,165891,179323
21001,Adair County,,KY,930,17444,18374
21003,Allen County,,KY,1221,19806,21027
21005,Anderson County,,KY,1575,25548,27123
21007,Ballard County,,KY,626,9264,9890
21009,Barren County,,KY,2468,46311,48779
21011,Bath County,,KY,880,11783,12663
21013,Bell County,,KY,1340,25738,27078
21015,Boone County,,KY,11638,133575,145213
21017,Bourbon County,,KY,1518,21885,23403
21019,Boyd County,,KY,2976,51818,54794
21021,Boyle County,,KY,2373,29437,31810
21023,Bracken County,,KY,715,9980,10695
21025,Breathitt County,,KY,548,13396,13944
21027,Breckinridge County,,KY,1267,21241,22508
21029,Bullitt County,,KY,5441,86607,92048
21031,Butler County,,KY,751,13493,14244
21033,Caldwell County,,KY,788,14130,14918
21035,Calloway County,,KY,2523,35340,37863
21037,Campbell County,,KY,7043,99360,106403
21039,Carlisle County,,KY,292,5777,6069
21041,Carroll County,,KY,1031,12876,13907
21043,Carter County,,KY,1270,29529,30799
21045,Casey County,,KY,670,15886,16556
21047,Christian County,,KY,10856,72358,83214
21049,Clark County,,KY,2511,39719,42230
21051,Clay County,,KY,781,18263,19044
21053,Clinton County,,KY,575,9876,10451
21055,Crittenden County,,KY,591,9518,10109
21057,Cumberland County,,KY,335,6923,7258
21059,Daviess County,,KY,4158,111911,116069
21061,Edmonson County,,KY,742,12836,13578
21063,Elliott County,,KY,258,6248,6506
21065,Estill County,,KY,668,15506,16174
21067,Fayette County,,KY,21662,305242,326904
21069,Fleming County,,KY,875,16374,17249
21071,Floyd County,,KY,1664,38616,40280
21073,Franklin County,,KY,3432,57812,61244
21075,Fulton County,,KY,657,6489,7146
21077,Gallatin County,,KY,846,8351,9197
21079,Garrard County,,KY,1561,17288,18849
21081,Grant County,,KY,2575,27922,30497
21083,Graves County,,KY,1941,40061,42002
21085,Grayson County,,KY,1138,27465,28603
21087,Green County,,KY,620,11859,12479
21089,Greenup County,,KY,2242,40808,43050
21091,Hancock County,,KY,612,10106,10718
21093,Hardin County,,KY,11962,110626,122588
21095,Harlan County,,KY,864,28484,29348
21097,Harrison County,,KY,1148,20759,21907
21099,Hart County,,KY,1118,19280,20398
21101,Henderson County,,KY,2718,52242,54960
21103,Henry County,,KY,1086,17306,18392
21105,Hickman County,,KY,299,5164,5463
21107,Hopkins County,,KY,2466,51910,54376
21109,Jackson County,,KY,602,12762,13364
21111,Jefferson County,,KY,36514,840374,876888
21113,Jessamine County,,KY,4214,49583,53797
21115,Johnson County,,KY,1174,22750,23924
21117,Kenton County,,KY,14740,179698,194438
21119,Knott County,,KY,617,14731,15348
21121,Knox County,,KY,1655,31166,32821
21123,Larue County,,KY,1096,15520,16616
21125,Laurel County,,KY,3130,59610,62740
21127,Lawrence County,,KY,844,15606,16450
21129,Lee County,,KY,304,6348,6652
21131,Leslie County,,KY,475,10982,11457
21133,Letcher County,,KY,793,23653,24446
21135,Lewis County,,KY,696,13921,14617
21137,Lincoln County,,KY,1540,26365,27905
21139,Livingston County,,KY,727,10327,11054
21141,Logan County,,KY,1575,29569,31144
21143,Lyon County,,KY,603,7728,8331
21145,McCracken County,,KY,4558,73872,78430
21147,McCreary County,,KY,698,14541,15239
21149,McLean County,,KY,653,10626,11279
21151,Madison County,,KY,5852,81425,87277
21153,Magoffin County,,KY,309,11957,12266
21155,Marion County,,KY,922,20444,21366
21157,Marshall County,,KY,2142,35585,37727
21159,Martin County,,KY,542,10141,10683
21161,Mason County,,KY,1371,19183,20554
21163,Meade County,,KY,4156,30788,34944
21165,Menifee County,,KY,497,6230,6727
21167,Mercer County,,KY,1495,24731,26226
21169,Metcalfe County,,KY,744,10637,11381
21171,Monroe County,,KY,513,11893,12406
21173,Montgomery County,,KY,1972,28100,30072
21175,Morgan County,,KY,559,12083,12642
21177,Muhlenberg County,,KY,1293,33973,35266
21179,Nelson County,,KY,2391,51791,54182
21181,Nicholas County,,KY,518,7961,8479
21183,Ohio County,,KY,1448,25863,27311
21185,Oldham County,,KY,4567,63577,68144
21187,Owen County,,KY,724,10840,11564
21189,Owsley County,,KY,155,3807,3962
21191,Pendleton County,,KY,1120,16280,17400
21193,Perry County,,KY,1181,30221,31402
21195,Pike County,,KY,2100,60726,62826
21197,Powell County,,KY,961,13663,14624
21199,Pulaski County,,KY,2932,65590,68522
21201,Robertson County,,KY,112,2175,2287
21203,Rockcastle County,,KY,825,16967,17792
21205,Rowan County,,KY,1612,20759,22371
21207,Russell County,,KY,814,17814,18628
21209,Scott County,,KY,3642,50655,54297
21211,Shelby County,,KY,2913,45064,47977
21213,Simpson County,,KY,1394,19570,20964
21215,Spencer County,,KY,1281,19039,20320
21217,Taylor County,,KY,1338,25453,26791
21219,Todd County,,KY,822,13200,14022
21221,Trigg County,,KY,963,14915,15878
21223,Trimble County,,KY,863,9741,10604
21225,Union County,,KY,869,16361,17230
21227,Warren County,,KY,6938,115401,122339
21229,Washington County,,KY,763,12649,13412
21231,Wayne County,,KY,894,20006,20900
21233,Webster County,,KY,907,14981,15888
21235,Whitley County,,KY,2034,35653,37687
21237,Wolfe County,,KY,416,6765,7181
21239,Woodford County,,KY,1988,28685,30673
22001,Acadia Parish,,LA,3445,65080,68525
22003,Allen Parish,,LA,1619,23236,24855
22005,Ascension Parish,,LA,7074,113938,121012
22007,Assumption Parish,,LA,1482,25413,26895
22009,Avoyelles Parish,,LA,1801,44327,46128
22011,Beauregard Parish,,LA,2834,35110,37944
22013,Bienville Parish,,LA,1058,15321,16379
22015,Bossier Parish,,LA,13289,120817,134106
22017,Caddo Parish,,LA,16144,274940,291084
22019,Calcasieu Parish,,LA,9252,208233,217485
22021,Caldwell Parish,,LA,564,10430,10994
22023,Cameron Parish,,LA,1064,7331,8395
22025,Catahoula Parish,,LA,651,10629,11280
22027,Claiborne Parish,,LA,878,15258,16136
22029,Concordia Parish,,LA,1295,20418,21713
22031,De Soto Parish,,LA,2006,29752,31758
22033,East Baton Rouge Parish,,LA,28992,452238,481230
22035,East Carroll Parish,,LA,382,7505,7887
22037,East Feliciana Parish,,LA,1584,21088,22672
22039,Evangeline Parish,,LA,1860,35229,37089
22041,Franklin Parish,,LA,1240,21230,22470
22043,Grant Parish,,LA,1720,20402,22122
22045,Iberia Parish,,LA,4672,83929,88601
22047,Iberville Parish,,LA,2385,34130,36515
22049,Jackson Parish,,LA,1131,16318,17449
22051,Jefferson Parish,,LA,35649,455848,491497
22053,Jefferson Davis Parish,,LA,2062,33726,35788
22055,Lafayette Parish,,LA,15049,228349,243398
22057,Lafourche Parish,,LA,5733,104178,109911
22059,La Salle Parish,,LA,693,14288,14981
22061,Lincoln Parish,,LA,3404,40204,43608
22063,Livingston Parish,,LA,8446,130416,138862
22065,Madison Parish,,LA,877,11818,12695
22067,Morehouse Parish,,LA,1801,31633,33434
22069,Natchitoches Parish,,LA,2583,38810,41393
22071,Orleans Parish,,LA,23788,258599,282387
22073,Ouachita Parish,,LA,8572,163207,171779
22075,Plaquemines Parish,,LA,3030,23306,26336
22077,Pointe Coupee Parish,,LA,1449,24442,25891
22079,Rapides Parish,,LA,7482,145418,152900
22081,Red River Parish,,LA,625,9563,10188
22083,Richland Parish,,LA,1556,21456,23012
22085,Sabine Parish,,LA,1273,24398,25671
22087,St. Bernard Parish,,LA,1740,25813,27553
22089,St. Charles Parish,,LA,4328,59298,63626
22091,St. Helena Parish,,LA,1055,14576,15631
22093,St. James Parish,,LA,1358,26486,27844
22095,St. John the Baptist Parish,,LA,4301,52215,56516
22097,St. Landry Parish,,LA,4895,94228,99123
22099,St. Martin Parish,,LA,3620,57086,60706
22101,St. Mary Parish,,LA,3940,62561,66501
22103,St. Tammany Parish,,LA,14299,239535,253834
22105,Tangipahoa Parish,,LA,7480,116847,124327
22107,Tensas Parish,,LA,470,5279,5749
22109,Terrebonne Parish,,LA,6989,124463,131452
22111,Union Parish,,LA,1610,23331,24941
22113,Vermilion Parish,,LA,3172,62314,65486
22115,Vernon Parish,,LA,7676,48254,55930
22117,Washington Parish,,LA,2222,44857,47079
22119,Webster Parish,,LA,2763,43548,46311
22121,West Baton Rouge Parish,,LA,2221,25734,27955
22123,West Carroll Parish,,LA,788,12134,12922
22125,West Feliciana Parish,,LA,907,10979,11886
22127,Winn Parish,,LA,891,14500,15391
23001,Androscoggin County,,ME,7236,121039,128275
23003,Aroostook County,,ME,2873,82065,84938
23005,Cumberland County,,ME,19548,326746,346294
23007,Franklin County,,ME,1867,32159,34026
23009,Hancock County,,ME,3085,61814,64899
23011,Kennebec County,,ME,7191,140880,148071
23013,Knox County,,ME,2387,45322,47709
23015,Lincoln County,,ME,2465,41154,43619
23017,Oxford County,,ME,3628,62867,66495
23019,Penobscot County,,ME,8457,166674,175131
23021,Piscataquis County,,ME,1130,18527,19657
23023,Sagadahoc County,,ME,3793,42413,46206
23025,Somerset County,,ME,3444,55180,58624
23027,Waldo County,,ME,2492,42711,45203
23029,Washington County,,ME,1746,36084,37830
23031,York County,,ME,12643,235629,248272
24001,Allegany County,,MD,2707,76491,79198
24003,Anne Arundel County,,MD,42629,612559,655188
24005,Baltimore County,,MD,60376,928091,988467
24009,Calvert County,,MD,5701,106159,111860
24011,Caroline County,,MD,2601,37007,39608
24013,Carroll County,,MD,9141,206099,215240
24015,Cecil County,,MD,6256,113918,120174
24017,Charles County,,MD,12724,169840,182564
24019,Dorchester County,,MD,2264,37153,39417
24021,Frederick County,,MD,16904,276562,293466
24023,Garrett County,,MD,1307,34386,35693
24025,Harford County,,MD,16749,297493,314242
24027,Howard County,,MD,25118,322026,347144
24029,Kent County,,MD,1149,21775,22924
24031,Montgomery County,,MD,69298,1090986,1160284
24033,Prince George's County,,MD,71110,974155,1045265
24035,Queen Anne's County,,MD,3007,54371,57378
24037,St. Mary's County,,MD,8014,119138,127152
24039,Somerset County,,MD,1550,22316,23866
24041,Talbot County,,MD,2465,42025,44490
24043,Washington County,,MD,9267,169318,178585
24045,Wicomico County,,MD,6717,103747,110464
24047,Worcester County,,MD,4030,60072,64102
24510,Baltimore city,,MD,48869,593410,642279
25001,Barnstable County,,MA,11385,267528,278913
25003,Berkshire County,,MA,4955,152724,157679
25005,Bristol County,,MA,23116,637693,660809
25007,Dukes County,,MA,920,19567,20487
25009,Essex County,,MA,36128,861478,897606
25011,Franklin County,,MA,4744,83051,87795
25013,Hampden County,,MA,17626,531580,549206
25015,Hampshire County,,MA,11279,163635,174914
25017,Middlesex County,,MA,96490,1698030,1794520
25019,Nantucket County,,MA,1013,12182,13195
25021,Norfolk County,,MA,49488,765047,814535
25023,Plymouth County,,MA,24291,585183,609474
25025,Suffolk County,,MA,71477,695925,767402
25027,Worcester County,,MA,34165,935473,969638
26001,Alcona County,,MI,715,12982,13697
26003,Alger County,,MI,463,10596,11059
26005,Allegan County,,MI,8134,136841,144975
26007,Alpena County,,MI,1721,36028,37749
26009,Antrim County,,MI,2053,28138,30191
26011,Arenac County,,MI,1169,18966,20135
26013,Baraga County,,MI,390,9137,9527
26015,Barry County,,MI,4283,72294,76577
26017,Bay County,,MI,5189,134764,139953
26019,Benzie County,,MI,1431,21070,22501
26021,Berrien County,,MI,9404,183328,192732
26023,Branch County,,MI,3011,50849,53860
26025,Calhoun County,,MI,8253,156661,164914
26027,Cass County,,MI,3770,59566,63336
26029,Charlevoix County,,MI,1969,31759,33728
26031,Cheboygan County,,MI,1876,31278,33154
26033,Chippewa County,,MI,2104,39491,41595
26035,Clare County,,MI,2274,33448,35722
26037,Clinton County,,MI,5795,88095,93890
26039,Crawford County,,MI,1039,15339,16378
26041,Delta County,,MI,1853,45521,47374
26043,Dickinson County,,MI,1454,32916,34370
26045,Eaton County,,MI,10317,129666,139983
26047,Emmet County,,MI,2701,39531,42232
26049,Genesee County,,MI,23044,502402,525446
26051,Gladwin County,,MI,1707,29730,31437
26053,Gogebic County,,MI,845,16894,17739
26055,Grand Traverse County,,MI,6331,103947,110278
26057,Gratiot County,,MI,2653,44680,47333
26059,Hillsdale County,,MI,3109,53439,56548
26061,Houghton County,,MI,2207,36364,38571
26063,Huron County,,MI,1733,43186,44919
26065,Ingham County,,MI,23824,291141,314965
26067,Ionia County,,MI,4229,70680,74909
26069,Iosco County,,MI,1856,30473,32329
26071,Iron County,,MI,605,13911,14516
26073,Isabella County,,MI,5061,61806,66867
26075,Jackson County,,MI,7942,181400,189342
26077,Kalamazoo County,,MI,15995,275895,291890
26079,Kalkaska County,,MI,1595,19173,20768
26081,Kent County,,MI,33472,717185,750657
26083,Keweenaw County,,MI,150,2506,2656
26085,Lake County,,MI,945,11306,12251
26087,Lapeer County,,MI,6341,108488,114829
26089,Leelanau County,,MI,1588,26105,27693
26091,Lenawee County,,MI,5953,118543,124496
26093,Livingston County,,MI,12021,220855,232876
26095,Luce County,,MI,392,6528,6920
26097,Mackinac County,,MI,941,13634,14575
26099,Macomb County,,MI,47980,1032270,1080250
26101,Manistee County,,MI,1556,28419,29975
26103,Marquette County,,MI,3451,73504,76955
26105,Mason County,,MI,1695,34303,35998
26107,Mecosta County,,MI,3239,41286,44525
26109,Menominee County,,MI,1286,28869,30155
26111,Midland County,,MI,5377,101637,107014
26113,Missaukee County,,MI,1178,16891,18069
26115,Monroe County,,MI,9025,187275,196300
26117,Montcalm County,,MI,4879,70801,75680
26119,Montmorency County,,MI,740,11240,11980
26121,Muskegon County,,MI,8593,198369,206962
26123,Newaygo County,,MI,3660,56786,60446
26125,Oakland County,,MI,83669,1418351,1502020
26127,Oceana County,,MI,1957,31434,33391
26129,Ogemaw County,,MI,1385,24548,25933
26131,Ontonagon County,,MI,360,7773,8133
26133,Osceola County,,MI,1844,26455,28299
26135,Oscoda County,,MI,575,9694,10269
26137,Otsego County,,MI,2062,29132,31194
26139,Ottawa County,,MI,17132,310871,328003
26141,Presque Isle County,,MI,753,16357,17110
26143,Roscommon County,,MI,1852,27571,29423
26145,Saginaw County,,MI,9975,235417,245392
26147,St. Clair County,,MI,10499,201852,212351
26149,St. Joseph County,,MI,4159,73648,77807
26151,Sanilac County,,MI,2978,52190,55168
26153,Schoolcraft County,,MI,348,9844,10192
26155,Shiawassee County,,MI,4934,86503,91437
26157,Tuscola County,,MI,3726,69047,72773
26159,Van Buren County,,MI,5342,90131,95473
26161,Washtenaw County,,MI,29221,360452,389673
26163,Wayne County,,MI,101713,2037729,2139442
26165,Wexford County,,MI,2717,37607,40324
27001,Aitkin County,,MN,1002,17483,18485
27003,Anoka County,,MN,25821,400189,426010
27005,Becker County,,MN,2118,38012,40130
27007,Beltrami County,,MN,2772,47035,49807
27009,Benton County,,MN,4612,43964,48576
27011,Big Stone County,,MN,337,6329,6666
27013,Blue Earth County,,MN,5832,65932,71764
27015,Brown County,,MN,1560,32985,34545
27017,Carlton County,,MN,1942,40025,41967
27019,Carver County,,MN,6752,107248,114000
27021,Cass County,,MN,2295,33623,35918
27023,Chippewa County,,MN,958,15620,16578
27025,Chisago County,,MN,4020,64142,68162
27027,Clay County,,MN,4433,61935,66368
27029,Clearwater County,,MN,577,9781,10358
27031,Cook County,,MN,434,6422,6856
27033,Cottonwood County,,MN,771,14174,14945
27035,Crow Wing County,,MN,3806,72960,76766
27037,Dakota County,,MN,33350,489067,522417
27039,Dodge County,,MN,1544,24403,25947
27041,Douglas County,,MN,2385,44589,46974
27043,Faribault County,,MN,1003,18440,19443
27045,Fillmore County,,MN,1235,25525,26760
27047,Freeborn County,,MN,1668,38897,40565
27049,Goodhue County,,MN,3037,57126,60163
27051,Grant County,,MN,523,7513,8036
27053,Hennepin County,,MN,86998,1333531,1420529
27055,Houston County,,MN,1118,24080,25198
27057,Hubbard County,,MN,1582,22669,24251
27059,Isanti County,,MN,3130,44291,47421
27061,Itasca County,,MN,1832,52135,53967
27063,Jackson County,,MN,790,12972,13762
27065,Kanabec County,,MN,1378,18909,20287
27067,Kandiyohi County,,MN,2664,51099,53763
27069,Kittson County,,MN,250,5646,5896
27071,Koochiching County,,MN,701,15451,16152
27073,Lac qui Parle County,,MN,441,9152,9593
27075,Lake County,,MN,639,12936,13575
27077,Lake of the Woods County,,MN,278,4955,5233
27079,Le Sueur County,,MN,2206,34310,36516
27081,Lincoln County,,MN,411,7268,7679
27083,Lyon County,,MN,2199,30130,32329
27085,McLeod County,,MN,2879,46928,49807
27087,Mahnomen County,,MN,406,6050,6456
27089,Marshall County,,MN,684,11974,12658
27091,Martin County,,MN,1422,26183,27605
27093,Meeker County,,MN,1730,28375,30105
27095,Mille Lacs County,,MN,2137,30086,32223
27097,Morrison County,,MN,2081,40815,42896
27099,Mower County,,MN,2306,48320,50626
27101,Murray County,,MN,508,10937,11445
27103,Nicollet County,,MN,3468,36430,39898
27105,Nobles County,,MN,1619,25214,26833
27107,Norman County,,MN,539,8148,8687
27109,Olmsted County,,MN,9702,178951,188653
27111,Otter Tail County,,MN,3454,69072,72526
27113,Pennington County,,MN,990,16416,17406
27115,Pine County,,MN,1906,31416,33322
27117,Pipestone County,,MN,760,11762,12522
27119,Polk County,,MN,2173,36513,38686
27121,Pope County,,MN,897,13568,14465
27123,Ramsey County,,MN,49621,563251,612872
27125,Red Lake County,,MN,252,4988,5240
27127,Redwood County,,MN,1133,19746,20879
27129,Renville County,,MN,1183,19974,21157
27131,Rice County,,MN,4277,69417,73694
27133,Rock County,,MN,610,11884,12494
27135,Roseau County,,MN,891,20199,21090
27137,St. Louis County,,MN,9456,225187,234643
27139,Scott County,,MN,10371,153419,163790
27141,Sherburne County,,MN,8011,101016,109027
27143,Sibley County,,MN,1163,18979,20142
27145,Stearns County,,MN,10946,168931,179877
27147,Steele County,,MN,2755,46575,49330
27149,Stevens County,,MN,715,10444,11159
27151,Swift County,,MN,661,12186,12847
27153,Todd County,,MN,1734,28204,29938
27155,Traverse County,,MN,260,4290,4550
27157,Wabasha County,,MN,1442,27413,28855
27159,Wadena County,,MN,1100,15964,17064
27161,Waseca County,,MN,1444,22792,24236
27163,Washington County,,MN,19684,284104,303788
27165,Watonwan County,,MN,730,13400,14130
27167,Wilkin County,,MN,601,8241,8842
27169,Winona County,,MN,3065,55123,58188
27171,Wright County,,MN,9037,148935,157972
27173,Yellow Medicine County,,MN,713,12850,13563
28001,Adams County,,MS,2067,31967,34034
28003,Alcorn County,,MS,2083,36849,38932
28005,Amite County,,MS,986,13343,14329
28007,Attala County,,MS,1058,20108,21166
28009,Benton County,,MS,692,8665,9357
28011,Bolivar County,,MS,2277,36503,38780
28013,Calhoun County,,MS,715,15804,16519
28015,Carroll County,,MS,845,11130,11975
28017,Chickasaw County,,MS,1190,20065,21255
28019,Choctaw County,,MS,631,8728,9359
28021,Claiborne County,,MS,873,10730,11603
28023,Clarke County,,MS,1117,18725,19842
28025,Clay County,,MS,1257,22007,23264
28027,Coahoma County,,MS,1707,28537,30244
28029,Copiah County,,MS,1774,31711,33485
28031,Covington County,,MS,1219,20826,22045
28033,DeSoto County,,MS,13551,179255,192806
28035,Forrest County,,MS,7504,72133,79637
28037,Franklin County,,MS,499,8850,9349
28039,George County,,MS,1308,22880,24188
28041,Greene County,,MS,684,12177,12861
28043,Grenada County,,MS,1583,24532,26115
28045,Hancock County,,MS,3172,39267,42439
28047,Harrison County,,MS,17816,186657,204473
28049,Hinds County,,MS,17047,265309,282356
28051,Holmes County,,MS,1279,21188,22467
28053,Humphreys County,,MS,673,9985,10658
28055,Issaquena County,,MS,96,1077,1173
28057,Itawamba County,,MS,1727,25014,26741
28059,Jackson County,,MS,10730,148180,158910
28061,Jasper County,,MS,1347,19261,20608
28063,Jefferson County,,MS,481,8494,8975
28065,Jefferson Davis County,,MS,839,13514,14353
28067,Jones County,,MS,3935,68741,72676
28069,Kemper County,,MS,536,9507,10043
28071,Lafayette County,,MS,3651,37913,41564
28073,Lamar County,,MS,5811,51759,57570
28075,Lauderdale County,,MS,4500,83770,88270
28077,Lawrence County,,MS,791,14145,14936
28079,Leake County,,MS,1113,22750,23863
28081,Lee County,,MS,5630,90814,96444
28083,Leflore County,,MS,2155,32844,34999
28085,Lincoln County,,MS,1843,37273,39116
28087,Lowndes County,,MS,4509,63276,67785
28089,Madison County,,MS,8528,98910,107438
28091,Marion County,,MS,1566,27827,29393
28093,Marshall County,,MS,2889,39207,42096
28095,Monroe County,,MS,2141,41177,43318
28097,Montgomery County,,MS,821,11985,12806
28099,Neshoba County,,MS,1664,31927,33591
28101,Newton County,,MS,1361,24483,25844
28103,Noxubee County,,MS,635,13634,14269
28105,Oktibbeha County,,MS,4017,39221,43238
28107,Panola County,,MS,2322,38431,40753
28109,Pearl River County,,MS,3413,55374,58787
28111,Perry County,,MS,962,13018,13980
28113,Pike County,,MS,2676,43487,46163
28115,Pontotoc County,,MS,1924,31709,33633
28117,Prentiss County,,MS,1357,25939,27296
28119,Quitman County,,MS,625,8144,8769
28121,Rankin County,,MS,10750,147850,158600
28123,Scott County,,MS,1786,30015,31801
28125,Sharkey County,,MS,395,5428,5823
28127,Simpson County,,MS,1781,27370,29151
28129,Smith County,,MS,952,15916,16868
28131,Stone County,,MS,1205,16452,17657
28133,Sunflower County,,MS,1751,27758,29509
28135,Tallahatchie County,,MS,934,13831,14765
28137,Tate County,,MS,1997,30206,32203
28139,Tippah County,,MS,1217,24030,25247
28141,Tishomingo County,,MS,1178,20400,21578
28143,Tunica County,,MS,1415,13267,14682
28145,Union County,,MS,1607,29713,31320
28147,Walthall County,,MS,987,15691,16678
28149,Warren County,,MS,3339,56474,59813
28151,Washington County,,MS,3407,57947,61354
28153,Wayne County,,MS,1040,22449,23489
28155,Webster County,,MS,788,11093,11881
28157,Wilkinson County,,MS,551,9901,10452
28159,Winston County,,MS,958,20710,21668
28161,Yalobusha County,,MS,793,13924,14717
28163,Yazoo County,,MS,1459,25447,26906
29001,Adair County,,MO,1980,23556,25536
29003,Andrew County,,MO,1828,20770,22598
29005,Atchison County,,MO,307,6897,7204
29007,Audrain County,,MO,1789,28069,29858
29009,Barry County,,MO,2971,36753,39724
29011,Barton County,,MO,973,14228,15201
29013,Bates County,,MO,1319,18864,20183
29015,Benton County,,MO,1428,19520,20948
29017,Bollinger County,,MO,795,13060,13855
29019,Boone County,,MO,12548,162130,174678
29021,Buchanan County,,MO,5722,96007,101729
29023,Butler County,,MO,2815,44405,47220
29025,Caldwell County,,MO,769,10202,10971
29027,Callaway County,,MO,3605,47051,50656
29029,Camden County,,MO,3820,44753,48573
29031,Cape Girardeau County,,MO,4834,82461,87295
29033,Carroll County,,MO,690,11122,11812
29035,Carter County,,MO,464,6344,6808
29037,Cass County,,MO,8027,114331,122358
29039,Cedar County,,MO,1188,14493,15681
29041,Chariton County,,MO,500,9300,9800
29043,Christian County,,MO,8001,82046,90047
29045,Clark County,,MO,454,8262,8716
29047,Clay County,,MO,19348,256116,275464
29049,Clinton County,,MO,2080,23944,26024
29051,Cole County,,MO,5470,86508,91978
29053,Cooper County,,MO,1375,18591,19966
29055,Crawford County,,MO,1695,26537,28232
29057,Dade County,,MO,676,8496,9172
29059,Dallas County,,MO,1608,17747,19355
29061,Daviess County,,MO,669,9531,10200
29063,DeKalb County,,MO,845,10643,11488
29065,Dent County,,MO,935,15365,16300
29067,Douglas County,,MO,870,13299,14169
29069,Dunklin County,,MO,2249,31403,33652
29071,Franklin County,,MO,6054,125222,131276
29073,Gasconade County,,MO,1183,17968,19151
29075,Gentry County,,MO,463,7541,8004
29077,Greene County,,MO,21727,294292,316019
29079,Grundy County,,MO,712,11238,11950
29081,Harrison County,,MO,620,9993,10613
29083,Henry County,,MO,1669,24895,26564
29085,Hickory County,,MO,723,9177,9900
29087,Holt County,,MO,359,5977,6336
29089,Howard County,,MO,750,10978,11728
29091,Howell County,,MO,2570,42255,44825
29093,Iron County,,MO,835,10702,11537
29095,Jackson County,,MO,44300,745191,789491
29097,Jasper County,,MO,8339,124185,132524
29099,Jefferson County,,MO,13638,263709,277347
29101,Johnson County,,MO,5867,52378,58245
29103,Knox County,,MO,334,4636,4970
29105,Laclede County,,MO,2486,39207,41693
29107,Lafayette County,,MO,2656,38444,41100
29109,Lawrence County,,MO,3146,41438,44584
29111,Lewis County,,MO,650,11079,11729
29113,Lincoln County,,MO,3943,60487,64430
29115,Linn County,,MO,910,14923,15833
29117,Livingston County,,MO,969,16024,16993
29119,McDonald County,,MO,1934,22309,24243
29121,Macon County,,MO,1043,18264,19307
29123,Madison County,,MO,869,13137,14006
29125,Maries County,,MO,702,9456,10158
29127,Marion County,,MO,2003,32790,34793
29129,Mercer County,,MO,311,4092,4403
29131,Miller County,,MO,2018,25731,27749
29133,Mississippi County,,MO,778,13425,14203
29135,Moniteau County,,MO,1123,17176,18299
29137,Monroe County,,MO,695,10508,11203
29139,Montgomery County,,MO,1055,14022,15077
29141,Morgan County,,MO,1789,21817,23606
29143,New Madrid County,,MO,1316,19323,20639
29145,Newton County,,MO,5010,61006,66016
29147,Nodaway County,,MO,1521,21866,23387
29149,Oregon County,,MO,698,9891,10589
29151,Osage County,,MO,675,16232,16907
29153,Ozark County,,MO,664,9520,10184
29155,Pemiscot County,,MO,1298,18305,19603
29157,Perry County,,MO,1009,22078,23087
29159,Pettis County,,MO,2923,47671,50594
29161,Phelps County,,MO,3537,44241,47778
29163,Pike County,,MO,1077,19082,20159
29165,Platte County,,MO,11652,97932,109584
29167,Polk County,,MO,2484,31121,33605
29169,Pulaski County,,MO,8279,42020,50299
29171,Putnam County,,MO,389,5524,5913
29173,Ralls County,,MO,791,11910,12701
29175,Randolph County,,MO,1883,26906,28789
29177,Ray County,,MO,1799,27483,29282
29179,Reynolds County,,MO,368,6637,7005
29181,Ripley County,,MO,806,13912,14718
29183,St. Charles County,,MO,22354,433070,455424
29185,St. Clair County,,MO,719,9242,9961
29186,Ste. Genevieve County,,MO,1410,22188,23598
29187,St. Francois County,,MO,3507,65030,68537
29189,St. Louis County,,MO,70746,1194159,1264905
29195,Saline County,,MO,1532,24796,26328
29197,Schuyler County,,MO,275,4387,4662
29199,Scotland County,,MO,250,5527,5777
29201,Scott County,,MO,2885,44252,47137
29203,Shannon County,,MO,473,8305,8778
29205,Shelby County,,MO,433,7732,8165
29207,Stoddard County,,MO,2009,32504,34513
29209,Stone County,,MO,3101,33328,36429
29211,Sullivan County,,MO,696,7405,8101
29213,Taney County,,MO,4938,49832,54770
29215,Texas County,,MO,1661,24732,26393
29217,Vernon County,,MO,1402,22003,23405
29219,Warren County,,MO,2595,37345,39940
29221,Washington County,,MO,1465,23967,25432
29223,Wayne County,,MO,903,12284,13187
29225,Webster County,,MO,3081,39156,42237
29227,Worth County,,MO,93,2532,2625
29229,Wright County,,MO,1503,18944,20447
29510,St. Louis city,,MO,36551,311146,347697
30001,Beaverhead County,,MT,885,9376,10261
30003,Big Horn County,,MT,759,12954,13713
30005,Blaine County,,MT,479,7065,7544
30007,Broadwater County,,MT,363,5505,5868
30009,Carbon County,,MT,884,10507,11391
30011,Carter County,,MT,56,1332,1388
30013,Cascade County,,MT,6856,93633,100489
30015,Chouteau County,,MT,354,5341,5695
30017,Custer County,,MT,812,13026,13838
30019,Daniels County,,MT,95,2204,2299
30021,Dawson County,,MT,574,10161,10735
30023,Deer Lodge County,,MT,686,9761,10447
30025,Fallon County,,MT,227,3360,3587
30027,Fergus County,,MT,760,13358,14118
30029,Flathead County,,MT,6181,102567,108748
30031,Gallatin County,,MT,9149,95472,104621
30033,Garfield County,,MT,57,1396,1453
30035,Glacier County,,MT,782,13906,14688
30037,Golden Valley County,,MT,79,1151,1230
30039,Granite County,,MT,198,3076,3274
30041,Hill County,,MT,1234,19097,20331
30043,Jefferson County,,MT,978,12471,13449
30045,Judith Basin County,,MT,142,2269,2411
30047,Lake County,,MT,1858,28866,30724
30049,Lewis and Clark County,,MT,4218,73050,77268
30051,Liberty County,,MT,115,2086,2201
30053,Lincoln County,,MT,1326,20240,21566
30055,McCone County,,MT,135,2005,2140
30057,Madison County,,MT,615,7914,8529
30059,Meagher County,,MT,142,2018,2160
30061,Mineral County,,MT,397,4373,4770
30063,Missoula County,,MT,9304,115244,124548
30065,Musselshell County,,MT,383,4485,4868
30067,Park County,,MT,1530,17689,19219
30069,Petroleum County,,MT,-2,-2,-4
30071,Phillips County,,MT,203,4853,5056
30073,Pondera County,,MT,494,7135,7629
30075,Powder River County,,MT,134,1675,1809
30077,Powell County,,MT,466,6320,6786
30079,Prairie County,,MT,78,1320,1398
30081,Ravalli County,,MT,3175,43839,47014
30083,Richland County,,MT,720,11684,12404
30085,Roosevelt County,,MT,639,10636,11275
30087,Rosebud County,,MT,849,10548,11397
30089,Sanders County,,MT,824,11531,12355
30091,Sheridan County,,MT,192,4349,4541
30093,Silver Bow County,,MT,2145,37151,39296
30095,Stillwater County,,MT,855,10141,10996
30097,Sweet Grass County,,MT,334,4080,4414
30099,Teton County,,MT,500,7472,7972
30101,Toole County,,MT,366,5529,5895
30103,Treasure County,,MT,-2,-2,-4
30105,Valley County,,MT,561,8521,9082
30107,Wheatland County,,MT,149,2398,2547
30109,Wibaux County,,MT,59,1066,1125
30111,Yellowstone County,,MT,8888,169915,178803
31001,Adams County,,NE,2159,35496,37655
31003,Antelope County,,NE,412,8138,8550
31005,Arthur County,,NE,-2,-2,-4
31007,Banner County,,NE,53,720,773
31009,Blaine County,,NE,-2,-2,-4
31011,Boone County,,NE,358,7036,7394
31013,Box Butte County,,NE,985,14070,15055
31015,Boyd County,,NE,127,2471,2598
31017,Brown County,,NE,244,3624,3868
31019,Buffalo County,,NE,3667,50662,54329
31021,Burt County,,NE,483,8331,8814
31023,Butler County,,NE,626,10422,11048
31025,Cass County,,NE,2420,30461,32881
31027,Cedar County,,NE,542,11177,11719
31029,Chase County,,NE,232,4470,4702
31031,Cherry County,,NE,486,6518,7004
31033,Cheyenne County,,NE,1012,12001,13013
31035,Clay County,,NE,527,7691,8218
31037,Colfax County,,NE,807,11918,12725
31039,Cuming County,,NE,655,11385,12040
31041,Custer County,,NE,692,13246,13938
31043,Dakota County,,NE,2280,24670,26950
31045,Dawes County,,NE,890,8658,9548
31047,Dawson County,,NE,2131,28707,30838
31049,Deuel County,,NE,197,2184,2381
31051,Dixon County,,NE,428,7389,7817
31053,Dodge County,,NE,2569,43261,45830
31055,Douglas County,,NE,32923,594245,627168
31057,Dundy County,,NE,106,2167,2273
31059,Fillmore County,,NE,425,7313,7738
31061,Franklin County,,NE,251,3761,4012
31063,Frontier County,,NE,273,2958,3231
31065,Furnas County,,NE,405,5664,6069
31067,Gage County,,NE,1659,26748,28407
31069,Garden County,,NE,192,2238,2430
31071,Garfield County,,NE,123,2103,2226
31073,Gosper County,,NE,245,2380,2625
31075,Grant County,,NE,-2,-2,-4
31077,Greeley County,,NE,262,2903,3165
31079,Hall County,,NE,4229,66566,70795
31081,Hamilton County,,NE,770,11595,12365
31083,Harlan County,,NE,254,3797,4051
31085,Hayes County,,NE,52,1159,1211
31087,Hitchcock County,,NE,291,3412,3703
31089,Holt County,,NE,634,12460,13094
31091,Hooker County,,NE,-2,-2,-4
31093,Howard County,,NE,545,7616,8161
31095,Jefferson County,,NE,584,9004,9588
31097,Johnson County,,NE,453,5328,5781
31099,Kearney County,,NE,757,7521,8278
31101,Keith County,,NE,760,9482,10242
31103,Keya Paha County,,NE,74,1053,1127
31105,Kimball County,,NE,327,4159,4486
31107,Knox County,,NE,476,10379,10855
31109,Lancaster County,,NE,17178,320504,337682
31111,Lincoln County,,NE,2426,43247,45673
31113,Logan County,,NE,-2,-2,-4
31115,Loup County,,NE,-2,-2,-4
31117,McPherson County,,NE,-2,-2,-4
31119,Madison County,,NE,2663,41534,44197
31121,Merrick County,,NE,572,9063,9635
31123,Morrill County,,NE,514,5577,6091
31125,Nance County,,NE,254,4228,4482
31127,Nemaha County,,NE,735,7856,8591
31129,Nuckolls County,,NE,313,5598,5911
31131,Otoe County,,NE,1392,18723,20115
31133,Pawnee County,,NE,172,3129,3301
31135,Perkins County,,NE,271,3448,3719
31137,Phelps County,,NE,755,11109,11864
31139,Pierce County,,NE,625,8781,9406
31141,Platte County,,NE,2251,39905,42156
31143,Polk County,,NE,407,6618,7025
31145,Red Willow County,,NE,870,12840,13710
31147,Richardson County,,NE,524,9982,10506
31149,Rock County,,NE,79,1523,1602
31151,Saline County,,NE,1169,16004,17173
31153,Sarpy County,,NE,19027,184691,203718
31155,Saunders County,,NE,1650,24537,26187
31157,Scotts Bluff County,,NE,2321,41611,43932
31159,Seward County,,NE,1426,19036,20462
31161,Sheridan County,,NE,460,6251,6711
31163,Sherman County,,NE,235,3590,3825
31165,Sioux County,,NE,106,1287,1393
31167,Stanton County,,NE,441,7267,7708
31169,Thayer County,,NE,430,6329,6759
31171,Thomas County,,NE,72,757,829
31173,Thurston County,,NE,481,7403,7884
31175,Valley County,,NE,312,4929,5241
31177,Washington County,,NE,1660,23739,25399
31179,Wayne County,,NE,820,9399,10219
31181,Webster County,,NE,282,4277,4559
31183,Wheeler County,,NE,-2,-2,-4
31185,York County,,NE,1289,16008,17297
32001,Churchill County,,NV,2813,27346,30159
32003,Clark County,,NV,117346,2157497,2274843
32005,Douglas County,,NV,4936,54640,59576
32007,Elko County,,NV,4099,54690,58789
32009,Esmeralda County,,NV,115,798,913
32011,Eureka County,,NV,203,1696,1899
32013,Humboldt County,,NV,1533,19130,20663
32015,Lander County,,NV,647,6304,6951
32017,Lincoln County,,NV,362,4659,5021
32019,Lyon County,,NV,6440,56510,62950
32021,Mineral County,,NV,382,5032,5414
32023,Nye County,,NV,4382,45270,49652
32027,Pershing County,,NV,475,5137,5612
32029,Storey County,,NV,438,4109,4547
32031,Washoe County,,NV,28187,470596,498783
32033,White Pine County,,NV,773,9870,10643
32510,Carson City,,NV,6012,61289,67301
33001,Belknap County,,NH,4999,74048,79047
33003,Carroll County,,NH,3335,57170,60505
33005,Cheshire County,,NH,4972,89464,94436
33007,Coos County,,NH,2208,39128,41336
33009,Grafton County,,NH,7654,97238,104892
33011,Hillsborough County,,NH,25645,486924,512569
33013,Merrimack County,,NH,11297,171900,183197
33015,Rockingham County,,NH,21645,367127,388772
33017,Strafford County,,NH,9274,138675,147949
33019,Sullivan County,,NH,3038,50895,53933
34001,Atlantic County,,NJ,13685,341291,354976
34003,Bergen County,,NJ,50344,1057215,1107559
34005,Burlington County,,NJ,27850,545627,573477
34007,Camden County,,NJ,29040,611356,640396
34009,Cape May County,,NJ,5930,116327,122257
34011,Cumberland County,,NJ,6860,177316,184176
34013,Essex County,,NJ,49292,851007,900299
34015,Gloucester County,,NJ,15343,349414,364757
34017,Hudson County,,NJ,58180,686632,744812
34019,Hunterdon County,,NJ,7315,154030,161345
34021,Mercer County,,NJ,22345,410237,432582
34023,Middlesex County,,NJ,58995,961050,1020045
34025,Monmouth County,,NJ,30152,746466,776618
34027,Morris County,,NJ,30978,591310,622288
34029,Ocean County,,NJ,23806,682846,706652
34031,Passaic County,,NJ,30217,597635,627852
34033,Salem County,,NJ,3814,80939,84753
34035,Somerset County,,NJ,23729,383423,407152
34037,Sussex County,,NJ,8694,183388,192082
34039,Union County,,NJ,35830,624006,659836
34041,Warren County,,NJ,7129,132490,139619
35001,Bernalillo County,,NM,41060,708661,749721
35003,Catron County,,NM,250,3178,3428
35005,Chaves County,,NM,3819,66371,70190
35006,Cibola County,,NM,1787,24258,26045
35007,Colfax County,,NM,1171,14232,15403
35009,Curry County,,NM,5855,48011,53866
35011,De Baca County,,NM,163,2221,2384
35013,Dona Ana County,,NM,12571,212030,224601
35015,Eddy County,,NM,3116,57743,60859
35017,Grant County,,NM,2122,32985,35107
35019,Guadalupe County,,NM,349,4660,5009
35021,Harding County,,NM,38,733,771
35023,Hidalgo County,,NM,456,5299,5755
35025,Lea County,,NM,4260,67305,71565
35027,Lincoln County,,NM,1651,20957,22608
35028,Los Alamos County,,NM,1773,22391,24164
35029,Luna County,,NM,2061,27935,29996
35031,McKinley County,,NM,8140,88542,96682
35033,Mora County,,NM,331,5109,5440
35035,Otero County,,NM,6634,63318,69952
35037,Quay County,,NM,754,9046,9800
35039,Rio Arriba County,,NM,2194,42804,44998
35041,Roosevelt County,,NM,1942,18478,20420
35043,Sandoval County,,NM,12035,138832,150867
35045,San Juan County,,NM,10212,148657,158869
35047,San Miguel County,,NM,1743,27896,29639
35049,Santa Fe County,,NM,9111,152265,161376
35051,Sierra County,,NM,763,11427,12190
35053,Socorro County,,NM,1324,18066,19390
35055,Taos County,,NM,2062,34409,36471
35057,Torrance County,,NM,1187,15064,16251
35059,Union County,,NM,331,4258,4589
35061,Valencia County,,NM,5050,77843,82893
36001,Albany County,,NY,21651,343520,365171
36003,Allegany County,,NY,2666,50394,53060
36005,Bronx County,,NY,99741,1398879,1498620
36007,Broome County,,NY,9519,227539,237058
36009,Cattaraugus County,,NY,4420,90550,94970
36011,Cayuga County,,NY,4007,89828,93835
36013,Chautauqua County,,NY,5084,150389,155473
36015,Chemung County,,NY,4044,101035,105079
36017,Chenango County,,NY,2936,58939,61875
36019,Clinton County,,NY,3381,92338,95719
36021,Columbia County,,NY,3408,71138,74546
36023,Cortland County,,NY,2803,51954,54757
36025,Delaware County,,NY,2915,49915,52830
36027,Dutchess County,,NY,14542,335791,350333
36029,Erie County,,NY,29952,1074176,1104128
36031,Essex County,,NY,2163,42998,45161
36033,Franklin County,,NY,2161,52529,54690
36035,Fulton County,,NY,2983,64652,67635
36037,Genesee County,,NY,3283,71663,74946
36039,Greene County,,NY,2755,53032,55787
36041,Hamilton County,,NY,368,5841,6209
36043,Herkimer County,,NY,3176,73468,76644
36045,Jefferson County,,NY,15348,124197,139545
36047,Kings County,,NY,145306,2541329,2686635
36049,Lewis County,,NY,1353,29014,30367
36051,Livingston County,,NY,3854,71278,75132
36053,Madison County,,NY,4546,77616,82162
36055,Monroe County,,NY,29396,875466,904862
36057,Montgomery County,,NY,3317,58805,62122
36059,Nassau County,,NY,58950,1605722,1664672
36061,New York County,,NY,180177,1578940,1759117
36063,Niagara County,,NY,9654,258721,268375
36065,Oneida County,,NY,9255,265871,275126
36067,Onondaga County,,NY,21231,539316,560547
36069,Ontario County,,NY,6542,126607,133149
36071,Orange County,,NY,21327,433403,454730
36073,Orleans County,,NY,2454,48194,50648
36075,Oswego County,,NY,6779,138509,145288
36077,Otsego County,,NY,3728,67077,70805
36079,Putnam County,,NY,6109,116176,122285
36081,Queens County,,NY,132549,2457856,2590405
36083,Rensselaer County,,NY,11818,183291,195109
36085,Richmond County,,NY,19504,531156,550660
36087,Rockland County,,NY,13380,351064,364444
36089,St. Lawrence County,,NY,4631,116689,121320
36091,Saratoga County,,NY,15406,263251,278657
36093,Schenectady County,,NY,9947,181411,191358
36095,Schoharie County,,NY,1870,35662,37532
36097,Schuyler County,,NY,1322,21569,22891
36099,Seneca County,,NY,2052,39017,41069
36101,Steuben County,,NY,4964,114073,119037
36103,Suffolk County,,NY,53992,1822708,1876700
36105,Sullivan County,,NY,4860,83569,88429
36107,Tioga County,,NY,3416,62181,65597
36109,Tompkins County,,NY,7943,92778,100721
36111,Ulster County,,NY,9902,203563,213465
36113,Warren County,,NY,5211,78951,84162
36115,Washington County,,NY,4044,69611,73655
36117,Wayne County,,NY,5481,114478,119959
36119,Westchester County,,NY,47922,1052501,1100423
36121,Wyoming County,,NY,2350,47381,49731
36123,Yates County,,NY,1528,28682,30210
37001,Alamance County,,NC,8010,166322,174332
37003,Alexander County,,NC,2141,41220,43361
37005,Alleghany County,,NC,576,11731,12307
37007,Anson County,,NC,1270,26266,27536
37009,Ashe County,,NC,1024,28088,29112
37011,Avery County,,NC,1011,17228,18239
37013,Beaufort County,,NC,2606,52230,54836
37015,Bertie County,,NC,1129,21769,22898
37017,Bladen County,,NC,1912,32794,34706
37019,Brunswick County,,NC,7319,108271,115590
37021,Buncombe County,,NC,15928,255558,271486
37023,Burke County,,NC,4909,98553,103462
37025,Cabarrus County,,NC,13649,198644,212293
37027,Caldwell County,,NC,4187,90875,95062
37029,Camden County,,NC,1000,10881,11881
37031,Carteret County,,NC,4504,70956,75460
37033,Caswell County,,NC,1593,24529,26122
37035,Catawba County,,NC,10353,181628,191981
37037,Chatham County,,NC,4681,68399,73080
37039,Cherokee County,,NC,1586,27404,28990
37041,Chowan County,,NC,827,16075,16902
37043,Clay County,,NC,687,10439,11126
37045,Cleveland County,,NC,5358,108406,113764
37047,Columbus County,,NC,2449,56796,59245
37049,Craven County,,NC,12189,110096,122285
37051,Cumberland County,,NC,46446,326593,373039
37053,Currituck County,,NC,2047,24993,27040
37055,Dare County,,NC,2746,38448,41194
37057,Davidson County,,NC,9576,185835,195411
37059,Davie County,,NC,2481,46563,49044
37061,Duplin County,,NC,3192,54334,57526
37063,Durham County,,NC,25909,281060,306969
37065,Edgecombe County,,NC,4792,60052,64844
37067,Forsyth County,,NC,21131,388624,409755
37069,Franklin County,,NC,4027,59563,63590
37071,Gaston County,,NC,11746,229608,241354
37073,Gates County,,NC,864,12286,13150
37075,Graham County,,NC,394,8756,9150
37077,Granville County,,NC,3704,59244,62948
37079,Greene County,,NC,1389,19113,20502
37081,Guilford County,,NC,31066,528482,559548
37083,Halifax County,,NC,3025,58157,61182
37085,Harnett County,,NC,11248,107727,118975
37087,Haywood County,,NC,2914,63863,66777
37089,Henderson County,,NC,6592,116714,123306
37091,Hertford County,,NC,1363,22227,23590
37093,Hoke County,,NC,6139,42175,48314
37095,Hyde County,,NC,319,4914,5233
37097,Iredell County,,NC,10925,180096,191021
37099,Jackson County,,NC,2617,33598,36215
37101,Johnston County,,NC,10197,177844,188041
37103,Jones County,,NC,817,10913,11730
37105,Lee County,,NC,4203,63173,67376
37107,Lenoir County,,NC,3502,64545,68047
37109,Lincoln County,,NC,5869,85388,91257
37111,McDowell County,,NC,2066,48029,50095
37113,Macon County,,NC,1969,36637,38606
37115,Madison County,,NC,1240,20462,21702
37117,Martin County,,NC,1411,27132,28543
37119,Mecklenburg County,,NC,69357,985586,1054943
37121,Mitchell County,,NC,837,16491,17328
37123,Montgomery County,,NC,1628,29507,31135
37125,Moore County,,NC,5426,95777,101203
37127,Nash County,,NC,7956,108203,116159
37129,New Hanover County,,NC,17074,197137,214211
37131,Northampton County,,NC,1477,21895,23372
37133,Onslow County,,NC,33869,168570,202439
37135,Orange County,,NC,13403,126267,139670
37137,Pamlico County,,NC,775,13443,14218
37139,Pasquotank County,,NC,3623,42058,45681
37141,Pender County,,NC,4173,51008,55181
37143,Perquimans County,,NC,1052,14138,15190
37145,Person County,,NC,1798,43062,44860
37147,Pitt County,,NC,10402,158909,169311
37149,Polk County,,NC,1372,20884,22256
37151,Randolph County,,NC,7914,161952,169866
37153,Richmond County,,NC,2090,48901,50991
37155,Robeson County,,NC,5324,129107,134431
37157,Rockingham County,,NC,4436,106176,110612
37159,Rowan County,,NC,8566,154966,163532
37161,Rutherford County,,NC,2917,68391,71308
37163,Sampson County,,NC,3595,67847,71442
37165,Scotland County,,NC,2331,37840,40171
37167,Stanly County,,NC,3103,67298,70401
37169,Stokes County,,NC,2929,51863,54792
37171,Surry County,,NC,3734,81024,84758
37173,Swain County,,NC,1012,18641,19653
37175,Transylvania County,,NC,1840,33081,34921
37177,Tyrrell County,,NC,313,4068,4381
37179,Union County,,NC,11904,219429,231333
37181,Vance County,,NC,2821,48718,51539
37183,Wake County,,NC,57881,977817,1035698
37185,Warren County,,NC,1319,19689,21008
37187,Washington County,,NC,739,14582,15321
37189,Watauga County,,NC,3918,39587,43505
37191,Wayne County,,NC,8715,125604,134319
37193,Wilkes County,,NC,2970,74459,77429
37195,Wilson County,,NC,4538,89759,94297
37197,Yadkin County,,NC,2386,43215,45601
37199,Yancey County,,NC,826,19070,19896
38001,Adams County,,ND,157,2807,2964
38003,Barnes County,,ND,664,12915,13579
38005,Benson County,,ND,384,7116,7500
38007,Billings County,,ND,96,967,1063
38009,Bottineau County,,ND,420,7705,8125
38011,Bowman County,,ND,235,3822,4057
38013,Burke County,,ND,132,2423,2555
38015,Burleigh County,,ND,5536,94868,100404
38017,Cass County,,ND,11038,167368,178406
38019,Cavalier County,,ND,262,5134,5396
38021,Dickey County,,ND,454,6077,6531
38023,Divide County,,ND,124,2458,2582
38025,Dunn County,,ND,201,3962,4163
38027,Eddy County,,ND,196,2785,2981
38029,Emmons County,,ND,182,4286,4468
38031,Foster County,,ND,292,4112,4404
38033,Golden Valley County,,ND,133,1971,2104
38035,Grand Forks County,,ND,7910,70769,78679
38037,Grant County,,ND,163,2898,3061
38039,Griggs County,,ND,184,2974,3158
38041,Hettinger County,,ND,163,2922,3085
38043,Kidder County,,ND,219,2939,3158
38045,LaMoure County,,ND,291,5023,5314
38047,Logan County,,ND,128,2400,2528
38049,McHenry County,,ND,440,6503,6943
38051,McIntosh County,,ND,193,3447,3640
38053,McKenzie County,,ND,364,5857,6221
38055,McLean County,,ND,685,10608,11293
38057,Mercer County,,ND,567,10552,11119
38059,Morton County,,ND,2525,32163,34688
38061,Mountrail County,,ND,582,8157,8739
38063,Nelson County,,ND,220,3944,4164
38065,Oliver County,,ND,149,2274,2423
38067,Pembina County,,ND,575,9543,10118
38069,Pierce County,,ND,292,5165,5457
38071,Ramsey County,,ND,915,13558,14473
38073,Ransom County,,ND,456,6803,7259
38075,Renville County,,ND,257,2925,3182
38077,Richland County,,ND,1443,19286,20729
38079,Rolette County,,ND,667,14562,15229
38081,Sargent County,,ND,306,5103,5409
38083,Sheridan County,,ND,65,1686,1751
38085,Sioux County,,ND,224,3667,3891
38087,Slope County,,ND,68,811,879
38089,Stark County,,ND,1754,27909,29663
38091,Steele County,,ND,158,2390,2548
38093,Stutsman County,,ND,1265,24131,25396
38095,Towner County,,ND,194,2764,2958
38097,Traill County,,ND,663,9451,10114
38099,Walsh County,,ND,731,13631,14362
38101,Ward County,,ND,6134,69514,75648
38103,Wells County,,ND,261,5394,5655
38105,Williams County,,ND,1374,25089,26463
39001,Adams County,,OH,1561,31006,32567
39003,Allen County,,OH,5897,123568,129465
39005,Ashland County,,OH,3256,61795,65051
39007,Ashtabula County,,OH,5048,118601,123649
39009,Athens County,,OH,4242,52705,56947
39011,Auglaize County,,OH,3093,58979,62072
39013,Belmont County,,OH,2934,78673,81607
39015,Brown County,,OH,3216,50675,53891
39017,Butler County,,OH,24623,414979,439602
39019,Carroll County,,OH,1929,33680,35609
39021,Champaign County,,OH,2799,47523,50322
39023,Clark County,,OH,6825,163347,170172
39025,Clermont County,,OH,13678,232389,246067
39027,Clinton County,,OH,3539,50142,53681
39029,Columbiana County,,OH,4793,124279,129072
39031,Coshocton County,,OH,1734,42244,43978
39033,Crawford County,,OH,2781,53486,56267
39035,Cuyahoga County,,OH,57938,1484640,1542578
39037,Darke County,,OH,2861,65842,68703
39039,Defiance County,,OH,2580,48650,51230
39041,Delaware County,,OH,13045,195740,208785
39043,Erie County,,OH,5221,94379,99600
39045,Fairfield County,,OH,10326,167760,178086
39047,Fayette County,,OH,2047,33186,35233
39049,Franklin County,,OH,73053,1329835,1402888
39051,Fulton County,,OH,2932,54098,57030
39053,Gallia County,,OH,1482,32688,34170
39055,Geauga County,,OH,5425,111933,117358
39057,Greene County,,OH,15584,175876,191460
39059,Guernsey County,,OH,2093,46993,49086
39061,Hamilton County,,OH,46809,923926,970735
39063,Hancock County,,OH,4883,89837,94720
39065,Hardin County,,OH,2099,34205,36304
39067,Harrison County,,OH,1008,17528,18536
39069,Henry County,,OH,2031,36553,38584
39071,Highland County,,OH,3066,48528,51594
39073,Hocking County,,OH,1961,32392,34353
39075,Holmes County,,OH,1724,44715,46439
39077,Huron County,,OH,4002,74857,78859
39079,Jackson County,,OH,1827,36517,38344
39081,Jefferson County,,OH,3061,80081,83142
39083,Knox County,,OH,3342,67220,70562
39085,Lake County,,OH,11921,289233,301154
39087,Lawrence County,,OH,2878,68607,71485
39089,Licking County,,OH,9945,196388,206333
39091,Logan County,,OH,3068,56697,59765
39093,Lorain County,,OH,14176,357588,371764
39095,Lucas County,,OH,22221,497738,519959
39097,Madison County,,OH,3283,45678,48961
39099,Mahoning County,,OH,11707,274771,286478
39101,Marion County,,OH,3509,73526,77035
39103,Medina County,,OH,10566,212166,222732
39105,Meigs County,,OH,993,24820,25813
39107,Mercer County,,OH,2171,53466,55637
39109,Miami County,,OH,6898,125581,132479
39111,Monroe County,,OH,787,16920,17707
39113,Montgomery County,,OH,32708,625195,657903
39115,Morgan County,,OH,710,16000,16710
39117,Morrow County,,OH,2517,39100,41617
39119,Muskingum County,,OH,4160,100349,104509
39121,Noble County,,OH,641,14029,14670
39123,Ottawa County,,OH,2666,51612,54278
39125,Paulding County,,OH,1207,23925,25132
39127,Perry County,,OH,2269,40026,42295
39129,Pickaway County,,OH,4024,59211,63235
39131,Pike County,,OH,1698,30620,32318
39133,Portage County,,OH,10982,177819,188801
39135,Preble County,,OH,2724,50781,53505
39137,Putnam County,,OH,1814,45203,47017
39139,Richland County,,OH,6300,146864,153164
39141,Ross County,,OH,3733,83447,87180
39143,Sandusky County,,OH,3463,76093,79556
39145,Scioto County,,OH,3039,79469,82508
39147,Seneca County,,OH,3303,68556,71859
39149,Shelby County,,OH,2950,61919,64869
39151,Stark County,,OH,16479,455828,472307
39153,Summit County,,OH,28771,638482,667253
39155,Trumbull County,,OH,9916,255112,265028
39157,Tuscarawas County,,OH,4274,115422,119696
39159,Union County,,OH,3738,58026,61764
39161,Van Wert County,,OH,1720,36717,38437
39163,Vinton County,,OH,845,13903,14748
39165,Warren County,,OH,16932,243343,260275
39167,Washington County,,OH,3195,72869,76064
39169,Wayne County,,OH,6299,139404,145703
39171,Williams County,,OH,2358,47482,49840
39173,Wood County,,OH,10986,139612,150598
39175,Wyandot County,,OH,1451,28010,29461
40001,Adair County,,OK,1420,23084,24504
40003,Alfalfa County,,OK,373,5084,5457
40005,Atoka County,,OK,1012,13898,14910
40007,Beaver County,,OK,555,5596,6151
40009,Beckham County,,OK,1798,21264,23062
40011,Blaine County,,OK,906,10569,11475
40013,Bryan County,,OK,2999,37547,40546
40015,Caddo County,,OK,2137,28270,30407
40017,Canadian County,,OK,9173,119541,128714
40019,Carter County,,OK,3009,50516,53525
40021,Cherokee County,,OK,3305,42291,45596
40023,Choctaw County,,OK,966,14367,15333
40025,Cimarron County,,OK,211,2979,3190
40027,Cleveland County,,OK,23441,251083,274524
40029,Coal County,,OK,384,5222,5606
40031,Comanche County,,OK,14446,113144,127590
40033,Cotton County,,OK,479,6248,6727
40035,Craig County,,OK,1082,14318,15400
40037,Creek County,,OK,6197,73428,79625
40039,Custer County,,OK,2509,26070,28579
40041,Delaware County,,OK,2893,37343,40236
40043,Dewey County,,OK,375,5015,5390
40045,Ellis County,,OK,343,4096,4439
40047,Garfield County,,OK,4891,65581,70472
40049,Garvin County,,OK,1921,28751,30672
40051,Grady County,,OK,3896,52006,55902
40053,Grant County,,OK,467,4682,5149
40055,Greer County,,OK,440,5050,5490
40057,Harmon County,,OK,216,2808,3024
40059,Harper County,,OK,327,3976,4303
40061,Haskell County,,OK,768,12587,13355
40063,Hughes County,,OK,846,12110,12956
40065,Jackson County,,OK,3085,27914,30999
40067,Jefferson County,,OK,509,5794,6303
40069,Johnston County,,OK,944,10238,11182
40071,Kay County,,OK,3208,50763,53971
40073,Kingfisher County,,OK,1005,16580,17585
40075,Kiowa County,,OK,787,9409,10196
40077,Latimer County,,OK,899,12052,12951
40079,Le Flore County,,OK,2945,48536,51481
40081,Lincoln County,,OK,2636,33806,36442
40083,Logan County,,OK,3288,39432,42720
40085,Love County,,OK,855,9464,10319
40087,McClain County,,OK,3221,35071,38292
40089,McCurtain County,,OK,1754,32459,34213
40091,McIntosh County,,OK,1489,18637,20126
40093,Major County,,OK,597,8288,8885
40095,Marshall County,,OK,1162,14449,15611
40097,Mayes County,,OK,2940,42665,45605
40099,Murray County,,OK,1047,12804,13851
40101,Muskogee County,,OK,4465,72415,76880
40103,Noble County,,OK,1046,12058,13104
40105,Nowata County,,OK,1019,11066,12085
40107,Okfuskee County,,OK,953,10599,11552
40109,Oklahoma County,,OK,48856,735753,784609
40111,Okmulgee County,,OK,2969,39672,42641
40113,Osage County,,OK,3968,43862,47830
40115,Ottawa County,,OK,2273,33593,35866
40117,Pawnee County,,OK,1502,16321,17823
40119,Payne County,,OK,6886,64091,70977
40121,Pittsburg County,,OK,2876,45759,48635
40123,Pontotoc County,,OK,2547,37867,40414
40125,Pottawatomie County,,OK,4839,69890,74729
40127,Pushmataha County,,OK,768,11325,12093
40129,Roger Mills County,,OK,318,3864,4182
40131,Rogers County,,OK,6947,93504,100451
40133,Seminole County,,OK,1833,23825,25658
40135,Sequoyah County,,OK,2495,41919,44414
40137,Stephens County,,OK,2874,46547,49421
40139,Texas County,,OK,2105,24123,26228
40141,Tillman County,,OK,693,7915,8608
40143,Tulsa County,,OK,40567,650900,691467
40145,Wagoner County,,OK,7097,73408,80505
40147,Washington County,,OK,3953,57320,61273
40149,Washita County,,OK,1228,11710,12938
40151,Woods County,,OK,687,8240,8927
40153,Woodward County,,OK,1554,21446,23000
41001,Baker County,,OR,1123,17248,18371
41003,Benton County,,OR,8013,82527,90540
41005,Clackamas County,,OR,29370,409814,439184
41007,Clatsop County,,OR,3231,37780,41011
41009,Columbia County,,OR,3320,54738,58058
41011,Coos County,,OR,3965,64910,68875
41013,Crook County,,OR,1921,22502,24423
41015,Curry County,,OR,1668,23130,24798
41017,Deschutes County,,OR,12820,169933,182753
41019,Douglas County,,OR,5979,112909,118888
41021,Gilliam County,,OR,222,1982,2204
41023,Grant County,,OR,539,7523,8062
41025,Harney County,,OR,590,7688,8278
41027,Hood River County,,OR,1519,25260,26779
41029,Jackson County,,OR,11353,222544,233897
41031,Jefferson County,,OR,2034,22418,24452
41033,Josephine County,,OR,4952,86117,91069
41035,Klamath County,,OR,4469,69724,74193
41037,Lake County,,OR,599,7902,8501
41039,Lane County,,OR,19197,368444,387641
41041,Lincoln County,,OR,3776,46504,50280
41043,Linn County,,OR,8098,124319,132417
41045,Malheur County,,OR,2271,29066,31337
41047,Marion County,,OR,18342,340096,358438
41049,Morrow County,,OR,926,12484,13410
41051,Multnomah County,,OR,55399,771470,826869
41053,Polk County,,OR,6869,77292,84161
41055,Sherman County,,OR,139,1912,2051
41057,Tillamook County,,OR,1869,26717,28586
41059,Umatilla County,,OR,4617,79751,84368
41061,Union County,,OR,2019,27823,29842
41063,Wallowa County,,OR,519,7947,8466
41065,Wasco County,,OR,1711,25911,27622
41067,Washington County,,OR,41191,583038,624229
41069,Wheeler County,,OR,152,1274,1426
41071,Yamhill County,,OR,6306,102850,109156
42001,Adams County,,PA,5854,124535,130389
42003,Allegheny County,,PA,49375,1454650,1504025
42005,Armstrong County,,PA,3282,84970,88252
42007,Beaver County,,PA,7493,212644,220137
42009,Bedford County,,PA,2012,62540,64552
42011,Berks County,,PA,17882,503572,521454
42013,Blair County,,PA,4270,151534,155804
42015,Bradford County,,PA,2941,74931,77872
42017,Bucks County,,PA,33024,787954,820978
42019,Butler County,,PA,9550,225364,234914
42021,Cambria County,,PA,5537,170275,175812
42023,Cameron County,,PA,298,6467,6765
42025,Carbon County,,PA,3755,77093,80848
42027,Centre County,,PA,9112,139283,148395
42029,Chester County,,PA,28058,593318,621376
42031,Clarion County,,PA,1943,44951,46894
42033,Clearfield County,,PA,3413,94736,98149
42035,Clinton County,,PA,1900,43211,45111
42037,Columbia County,,PA,3137,73188,76325
42039,Crawford County,,PA,3993,102142,106135
42041,Cumberland County,,PA,15584,284140,299724
42043,Dauphin County,,PA,18156,328765,346921
42045,Delaware County,,PA,30138,656936,687074
42047,Elk County,,PA,1138,42379,43517
42049,Erie County,,PA,10095,324325,334420
42051,Fayette County,,PA,5001,158434,163435
42053,Forest County,,PA,370,5642,6012
42055,Franklin County,,PA,6824,189577,196401
42057,Fulton County,,PA,767,18852,19619
42059,Greene County,,PA,1795,41954,43749
42061,Huntingdon County,,PA,1772,50927,52699
42063,Indiana County,,PA,4077,96065,100142
42065,Jefferson County,,PA,2457,55432,57889
42067,Juniata County,,PA,936,29087,30023
42069,Lackawanna County,,PA,8895,248754,257649
42071,Lancaster County,,PA,19457,648996,668453
42073,Lawrence County,,PA,3598,107814,111412
42075,Lebanon County,,PA,6650,168636,175286
42077,Lehigh County,,PA,22821,419725,442546
42079,Luzerne County,,PA,12086,377526,389612
42081,Lycoming County,,PA,4518,137547,142065
42083,McKean County,,PA,1769,49988,51757
42085,Mercer County,,PA,5236,137766,143002
42087,Mifflin County,,PA,1703,56110,57813
42089,Monroe County,,PA,10868,187999,198867
42091,Montgomery County,,PA,47775,961246,1009021
42093,Montour County,,PA,1483,22001,23484
42095,Northampton County,,PA,17772,359243,377015
42097,Northumberland County,,PA,4592,110341,114933
42099,Perry County,,PA,2635,57754,60389
42101,Philadelphia County,,PA,75974,1502490,1578464
42103,Pike County,,PA,4036,65900,69936
42105,Potter County,,PA,1116,20176,21292
42107,Schuylkill County,,PA,5746,175757,181503
42109,Snyder County,,PA,2031,44872,46903
42111,Somerset County,,PA,2818,91964,94782
42113,Sullivan County,,PA,382,7215,7597
42115,Susquehanna County,,PA,2449,50809,53258
42117,Tioga County,,PA,1880,47602,49482
42119,Union County,,PA,2534,42813,45347
42121,Venango County,,PA,2464,66740,69204
42123,Warren County,,PA,1687,49853,51540
42125,Washington County,,PA,9178,251267,260445
42127,Wayne County,,PA,3097,58069,61166
42129,Westmoreland County,,PA,15152,454816,469968
42131,Wyoming County,,PA,1883,34289,36172
42133,York County,,PA,20005,544021,564026
44001,Bristol County,,RI,3365,55997,59362
44003,Kent County,,RI,11755,204275,216030
44005,Newport County,,RI,8067,92830,100897
44007,Providence County,,RI,32756,702368,735124
44009,Washington County,,RI,7599,146435,154034
45001,Abbeville County,,SC,1387,27192,28579
45003,Aiken County,,SC,8694,172971,181665
45005,Allendale County,,SC,685,9689,10374
45007,Anderson County,,SC,9622,205849,215471
45009,Bamberg County,,SC,960,14989,15949
45011,Barnwell County,,SC,1347,23945,25292
45013,Beaufort County,,SC,14726,165052,179778
45015,Berkeley County,,SC,19668,181535,201203
45017,Calhoun County,,SC,1024,15883,16907
45019,Charleston County,,SC,30591,351715,382306
45021,Cherokee County,,SC,2705,59781,62486
45023,Chester County,,SC,2254,37121,39375
45025,Chesterfield County,,SC,2093,47848,49941
45027,Clarendon County,,SC,1997,34968,36965
45029,Colleton County,,SC,2395,42531,44926
45031,Darlington County,,SC,3913,74413,78326
45033,Dillon County,,SC,1561,34339,35900
45035,Dorchester County,,SC,14654,141508,156162
45037,Edgefield County,,SC,1643,25402,27045
45039,Fairfield County,,SC,1421,25573,26994
45041,Florence County,,SC,7812,147754,155566
45043,Georgetown County,,SC,3801,69067,72868
45045,Greenville County,,SC,27039,486989,514028
45047,Greenwood County,,SC,3400,76168,79568
45049,Hampton County,,SC,1167,21734,22901
45051,Horry County,,SC,17578,287087,304665
45053,Jasper County,,SC,1829,21596,23425
45055,Kershaw County,,SC,3789,67822,71611
45057,Lancaster County,,SC,3784,75973,79757
45059,Laurens County,,SC,3994,70583,74577
45061,Lee County,,SC,1384,18993,20377
45063,Lexington County,,SC,16916,282892,299808
45065,McCormick County,,SC,564,10151,10715
45067,Marion County,,SC,2151,36170,38321
45069,Marlboro County,,SC,1470,29680,31150
45071,Newberry County,,SC,1896,41957,43853
45073,Oconee County,,SC,3631,80266,83897
45075,Orangeburg County,,SC,5362,96422,101784
45077,Pickens County,,SC,8194,119541,127735
45079,Richland County,,SC,31742,377511,409253
45081,Saluda County,,SC,1209,20888,22097
45083,Spartanburg County,,SC,13937,313663,327600
45085,Sumter County,,SC,8416,117388,125804
45087,Union County,,SC,1284,31036,32320
45089,Williamsburg County,,SC,1925,36061,37986
45091,York County,,SC,13427,250708,264135
46003,Aurora County,,SD,197,3410,3607
46005,Beadle County,,SD,1086,19425,20511
46007,Bennett County,,SD,211,3162,3373
46009,Bon Homme County,,SD,404,7144,7548
46011,Brookings County,,SD,2918,30249,33167
46013,Brown County,,SD,2283,43205,45488
46015,Brule County,,SD,437,6059,6496
46017,Buffalo County,,SD,189,1941,2130
46019,Butte County,,SD,1017,11040,12057
46021,Campbell County,,SD,83,1806,1889
46023,Charles Mix County,,SD,502,9549,10051
46025,Clark County,,SD,250,3934,4184
46027,Clay County,,SD,1720,11933,13653
46029,Codington County,,SD,2178,32381,34559
46031,Corson County,,SD,304,3516,3820
46033,Custer County,,SD,809,8649,9458
46035,Davison County,,SD,1710,22540,24250
46037,Day County,,SD,399,6827,7226
46039,Deuel County,,SD,408,5451,5859
46041,Dewey County,,SD,418,6445,6863
46043,Douglas County,,SD,177,3670,3847
46045,Edmunds County,,SD,366,4425,4791
46047,Fall River County,,SD,641,7767,8408
46049,Faulk County,,SD,153,2443,2596
46051,Grant County,,SD,432,9528,9960
46053,Gregory County,,SD,281,5123,5404
46055,Haakon County,,SD,120,2535,2655
46057,Hamlin County,,SD,406,6511,6917
46059,Hand County,,SD,191,4139,4330
46061,Hanson County,,SD,485,5495,5980
46063,Harding County,,SD,88,1543,1631
46065,Hughes County,,SD,1571,20212,21783
46067,Hutchinson County,,SD,465,8597,9062
46069,Hyde County,,SD,106,1674,1780
46071,Jackson County,,SD,189,2695,2884
46073,Jerauld County,,SD,136,2198,2334
46075,Jones County,,SD,70,1253,1323
46077,Kingsbury County,,SD,408,6289,6697
46079,Lake County,,SD,1115,13159,14274
46081,Lawrence County,,SD,2398,26243,28641
46083,Lincoln County,,SD,4905,50075,54980
46085,Lyman County,,SD,272,4217,4489
46087,McCook County,,SD,535,6569,7104
46089,McPherson County,,SD,142,2731,2873
46091,Marshall County,,SD,332,4906,5238
46093,Meade County,,SD,4293,29198,33491
46095,Mellette County,,SD,113,1890,2003
46097,Miner County,,SD,170,2766,2936
46099,Minnehaha County,,SD,13987,209132,223119
46101,Moody County,,SD,587,7716,8303
46103,Pennington County,,SD,9059,114857,123916
46105,Perkins County,,SD,169,3525,3694
46107,Potter County,,SD,172,2970,3142
46109,Roberts County,,SD,720,11563,12283
46111,Sanborn County,,SD,175,2911,3086
46113,Shannon County,,SD,760,11692,12452
46115,Spink County,,SD,366,7400,7766
46117,Stanley County,,SD,380,3510,3890
46119,Sully County,,SD,86,1756,1842
46121,Todd County,,SD,544,8709,9253
46123,Tripp County,,SD,375,6818,7193
46125,Turner County,,SD,705,9851,10556
46127,Union County,,SD,1343,17384,18727
46129,Walworth County,,SD,438,6451,6889
46135,Yankton County,,SD,1462,25513,26975
46137,Ziebach County,,SD,113,1231,1344
47001,Anderson County,,TN,5572,82498,88070
47003,Bedford County,,TN,3230,50666,53896
47005,Benton County,,TN,958,17471,18429
47007,Bledsoe County,,TN,744,11745,12489
47009,Blount County,,TN,7264,138883,146147
47011,Bradley County,,TN,6162,106309,112471
47013,Campbell County,,TN,1925,39726,41651
47015,Cannon County,,TN,1222,15079,16301
47017,Carroll County,,TN,2000,31602,33602
47019,Carter County,,TN,3494,58816,62310
47021,Cheatham County,,TN,3183,45191,48374
47023,Chester County,,TN,1326,16969,18295
47025,Claiborne County,,TN,1674,33098,34772
47027,Clay County,,TN,485,7950,8435
47029,Cocke County,,TN,1900,38063,39963
47031,Coffee County,,TN,3898,58866,62764
47033,Crockett County,,TN,1062,16199,17261
47035,Cumberland County,,TN,2838,62539,65377
47037,Davidson County,,TN,54244,662241,716485
47039,Decatur County,,TN,737,12293,13030
47041,DeKalb County,,TN,1441,19919,21360
47043,Dickson County,,TN,3397,54888,58285
47045,Dyer County,,TN,2533,42933,45466
47047,Fayette County,,TN,2826,43304,46130
47049,Fentress County,,TN,746,18111,18857
47051,Franklin County,,TN,2441,45135,47576
47053,Gibson County,,TN,3068,55673,58741
47055,Giles County,,TN,1825,33199,35024
47057,Grainger County,,TN,1511,23155,24666
47059,Greene County,,TN,3060,75324,78384
47061,Grundy County,,TN,815,14731,15546
47063,Hamblen County,,TN,4336,68378,72714
47065,Hamilton County,,TN,18102,365040,383142
47067,Hancock County,,TN,252,6212,6464
47069,Hardeman County,,TN,1542,28208,29750
47071,Hardin County,,TN,1520,27975,29495
47073,Hawkins County,,TN,3589,61693,65282
47075,Haywood County,,TN,1419,22202,23621
47077,Henderson County,,TN,1801,30788,32589
47079,Henry County,,TN,1827,35483,37310
47081,Hickman County,,TN,1749,24386,26135
47083,Houston County,,TN,547,8495,9042
47085,Humphreys County,,TN,1118,20890,22008
47087,Jackson County,,TN,846,11479,12325
47089,Jefferson County,,TN,4701,53531,58232
47091,Johnson County,,TN,691,17067,17758
47093,Knox County,,TN,26986,459835,486821
47095,Lake County,,TN,453,5577,6030
47097,Lauderdale County,,TN,1614,26459,28073
47099,Lawrence County,,TN,1802,44507,46309
47101,Lewis County,,TN,725,12382,13107
47103,Lincoln County,,TN,1890,37572,39462
47105,Loudon County,,TN,3623,54493,58116
47107,McMinn County,,TN,3179,55840,59019
47109,McNairy County,,TN,1563,27286,28849
47111,Macon County,,TN,1388,23679,25067
47113,Madison County,,TN,7057,107194,114251
47115,Marion County,,TN,1472,31581,33053
47117,Marshall County,,TN,2110,34866,36976
47119,Maury County,,TN,5529,91565,97094
47121,Meigs County,,TN,947,12250,13197
47123,Monroe County,,TN,2911,47031,49942
47125,Montgomery County,,TN,19123,174867,193990
47127,Moore County,,TN,473,7048,7521
47129,Morgan County,,TN,1226,20997,22223
47131,Obion County,,TN,2162,36545,38707
47133,Overton County,,TN,1300,23075,24375
47135,Perry County,,TN,460,8063,8523
47137,Pickett County,,TN,279,5324,5603
47139,Polk County,,TN,1407,18042,19449
47141,Putnam County,,TN,5268,73296,78564
47143,Rhea County,,TN,1782,33057,34839
47145,Roane County,,TN,3495,59554,63049
47147,Robertson County,,TN,5078,75924,81002
47149,Rutherford County,,TN,20813,283006,303819
47151,Scott County,,TN,787,22557,23344
47153,Sequatchie County,,TN,868,14685,15553
47155,Sevier County,,TN,7048,96374,103422
47157,Shelby County,,TN,49955,1060669,1110624
47159,Smith County,,TN,1296,21217,22513
47161,Stewart County,,TN,960,14451,15411
47163,Sullivan County,,TN,9072,176030,185102
47165,Sumner County,,TN,11584,177707,189291
47167,Tipton County,,TN,4407,68282,72689
47169,Trousdale County,,TN,740,8458,9198
47171,Unicoi County,,TN,1139,19216,20355
47173,Union County,,TN,1290,19609,20899
47175,Van Buren County,,TN,372,5853,6225
47177,Warren County,,TN,1999,43664,45663
47179,Washington County,,TN,8752,127868,136620
47181,Wayne County,,TN,646,15677,16323
47183,Weakley County,,TN,2157,33942,36099
47185,White County,,TN,1499,27509,29008
47187,Williamson County,,TN,13678,195768,209446
47189,Wilson County,,TN,8468,126906,135374
48001,Anderson County,,TX,3155,46938,50093
48003,Andrews County,,TX,1164,15940,17104
48005,Angelina County,,TX,5073,90979,96052
48007,Aransas County,,TX,2387,22850,25237
48009,Archer County,,TX,878,9170,10048
48011,Armstrong County,,TX,252,1929,2181
48013,Atascosa County,,TX,3392,46616,50008
48015,Austin County,,TX,2304,30531,32835
48017,Bailey County,,TX,747,7069,7816
48019,Bandera County,,TX,1761,19615,21376
48021,Bastrop County,,TX,5818,71735,77553
48023,Baylor County,,TX,310,3718,4028
48025,Bee County,,TX,1895,25561,27456
48027,Bell County,,TX,51875,304229,356104
48029,Bexar County,,TX,89715,1809293,1899008
48031,Blanco County,,TX,825,9989,10814
48033,Borden County,,TX,66,578,644
48035,Bosque County,,TX,1631,17747,19378
48037,Bowie County,,TX,6579,96294,102873
48039,Brazoria County,,TX,21265,320524,341789
48041,Brazos County,,TX,15538,151866,167404
48043,Brewster County,,TX,1025,8774,9799
48045,Briscoe County,,TX,154,1658,1812
48047,Brooks County,,TX,528,8157,8685
48049,Brown County,,TX,2672,38692,41364
48051,Burleson County,,TX,1341,17993,19334
48053,Burnet County,,TX,3505,43787,47292
48055,Caldwell County,,TX,3334,36086,39420
48057,Calhoun County,,TX,1590,22749,24339
48059,Callahan County,,TX,1271,13903,15174
48061,Cameron County,,TX,15876,415338,431214
48063,Camp County,,TX,1126,13191,14317
48065,Carson County,,TX,564,6448,7012
48067,Cass County,,TX,2189,32708,34897
48069,Castro County,,TX,765,7557,8322
48071,Chambers County,,TX,2428,30330,32758
48073,Cherokee County,,TX,3239,50514,53753
48075,Childress County,,TX,523,6089,6612
48077,Clay County,,TX,989,11442,12431
48079,Cochran County,,TX,314,3428,3742
48081,Coke County,,TX,375,3348,3723
48083,Coleman County,,TX,737,8641,9378
48085,Collin County,,TX,65750,799640,865390
48087,Collingsworth County,,TX,263,3081,3344
48089,Colorado County,,TX,1324,22495,23819
48091,Comal County,,TX,8607,110964,119571
48093,Comanche County,,TX,991,13910,14901
48095,Concho County,,TX,258,2597,2855
48097,Cooke County,,TX,3109,41449,44558
48099,Coryell County,,TX,14592,61907,76499
48101,Cottle County,,TX,135,1589,1724
48103,Crane County,,TX,429,4670,5099
48105,Crockett County,,TX,338,4240,4578
48107,Crosby County,,TX,713,6281,6994
48109,Culberson County,,TX,327,2671,2998
48111,Dallam County,,TX,751,7148,7899
48113,Dallas County,,TX,168583,2494655,2663238
48115,Dawson County,,TX,995,12936,13931
48117,Deaf Smith County,,TX,1716,21487,23203
48119,Delta County,,TX,535,5032,5567
48121,Denton County,,TX,61516,666970,728486
48123,DeWitt County,,TX,1144,19742,20886
48125,Dickens County,,TX,176,2053,2229
48127,Dimmit County,,TX,761,9974,10735
48129,Donley County,,TX,291,3476,3767
48131,Duval County,,TX,790,12289,13079
48133,Eastland County,,TX,1390,18035,19425
48135,Ector County,,TX,8211,149821,158032
48137,Edwards County,,TX,237,2060,2297
48139,Ellis County,,TX,11185,159349,170534
48141,El Paso County,,TX,43932,867618,911550
48143,Erath County,,TX,3154,32965,36119
48145,Falls County,,TX,1305,15750,17055
48147,Fannin County,,TX,2559,32747,35306
48149,Fayette County,,TX,1464,25240,26704
48151,Fisher County,,TX,347,3885,4232
48153,Floyd County,,TX,591,7145,7736
48155,Foard County,,TX,100,1273,1373
48157,Fort Bend County,,TX,40277,576593,616870
48159,Franklin County,,TX,1103,10697,11800
48161,Freestone County,,TX,1364,19241,20605
48163,Frio County,,TX,952,14596,15548
48165,Gaines County,,TX,1040,17234,18274
48167,Galveston County,,TX,28456,297937,326393
48169,Garza County,,TX,398,4542,4940
48171,Gillespie County,,TX,1352,25869,27221
48173,Glasscock County,,TX,116,1338,1454
48175,Goliad County,,TX,562,6966,7528
48177,Gonzales County,,TX,1238,20124,21362
48179,Gray County,,TX,1969,23722,25691
48181,Grayson County,,TX,7676,127231,134907
48183,Gregg County,,TX,10288,133934,144222
48185,Grimes County,,TX,2096,24424,26520
48187,Guadalupe County,,TX,11638,136809,148447
48189,Hale County,,TX,2897,37165,40062
48191,Hall County,,TX,322,3239,3561
48193,Hamilton County,,TX,843,8635,9478
48195,Hansford County,,TX,468,6065,6533
48197,Hardeman County,,TX,408,4122,4530
48199,Hardin County,,TX,4311,57598,61909
48201,Harris County,,TX,199724,4235159,4434883
48203,Harrison County,,TX,5261,70079,75340
48205,Hartley County,,TX,380,4283,4663
48207,Haskell County,,TX,542,5586,6128
48209,Hays County,,TX,15127,140084,155211
48211,Hemphill County,,TX,328,4135,4463
48213,Henderson County,,TX,6213,76183,82396
48215,Hidalgo County,,TX,22247,747688,769935
48217,Hill County,,TX,3083,35245,38328
48219,Hockley County,,TX,2089,24383,26472
48221,Hood County,,TX,4410,51793,56203
48223,Hopkins County,,TX,2175,36834,39009
48225,Houston County,,TX,1365,20635,22000
48227,Howard County,,TX,2295,31420,33715
48229,Hudspeth County,,TX,289,3488,3777
48231,Hunt County,,TX,7135,85696,92831
48233,Hutchinson County,,TX,1668,24844,26512
48235,Irion County,,TX,194,1639,1833
48237,Jack County,,TX,828,7815,8643
48239,Jackson County,,TX,1091,15789,16880
48241,Jasper County,,TX,2520,36020,38540
48243,Jeff Davis County,,TX,243,2237,2480
48245,Jefferson County,,TX,15564,259036,274600
48247,Jim Hogg County,,TX,295,5479,5774
48249,Jim Wells County,,TX,2742,44374,47116
48251,Johnson County,,TX,12737,160805,173542
48253,Jones County,,TX,1569,16085,17654
48255,Karnes County,,TX,852,12856,13708
48257,Kaufman County,,TX,9147,109912,119059
48259,Kendall County,,TX,2497,34212,36709
48261,Kenedy County,,TX,-2,-2,-4
48263,Kent County,,TX,83,808,891
48265,Kerr County,,TX,3548,51572,55120
48267,Kimble County,,TX,341,4780,5121
48269,King County,,TX,-2,-2,-4
48271,Kinney County,,TX,259,3262,3521
48273,Kleberg County,,TX,3263,30940,34203
48275,Knox County,,TX,292,3798,4090
48277,Lamar County,,TX,2896,53147,56043
48279,Lamb County,,TX,1377,14789,16166
48281,Lampasas County,,TX,2022,20440,22462
48283,La Salle County,,TX,375,5649,6024
48285,Lavaca County,,TX,1061,21486,22547
48287,Lee County,,TX,1148,17408,18556
48289,Leon County,,TX,1547,17708,19255
48291,Liberty County,,TX,6575,72877,79452
48293,Limestone County,,TX,1802,22439,24241
48295,Lipscomb County,,TX,337,3250,3587
48297,Live Oak County,,TX,803,9465,10268
48299,Llano County,,TX,1627,17256,18883
48301,Loving County,,TX,-2,-2,-4
48303,Lubbock County,,TX,17371,268307,285678
48305,Lynn County,,TX,685,6287,6972
48307,McCulloch County,,TX,715,8526,9241
48309,McLennan County,,TX,13407,237617,251024
48311,McMullen County,,TX,80,831,911
48313,Madison County,,TX,989,11301,12290
48315,Marion County,,TX,997,9667,10664
48317,Martin County,,TX,434,4816,5250
48319,Mason County,,TX,224,3939,4163
48321,Matagorda County,,TX,2643,39252,41895
48323,Maverick County,,TX,2869,64782,67651
48325,Medina County,,TX,3350,44616,47966
48327,Menard County,,TX,184,2167,2351
48329,Midland County,,TX,10186,142857,153043
48331,Milam County,,TX,2039,26118,28157
48333,Mills County,,TX,397,4800,5197
48335,Mitchell County,,TX,563,7234,7797
48337,Montague County,,TX,1608,20635,22243
48339,Montgomery County,,TX,32429,440402,472831
48341,Moore County,,TX,2053,23049,25102
48343,Morris County,,TX,1328,14360,15688
48345,Motley County,,TX,100,1073,1173
48347,Nacogdoches County,,TX,4812,58090,62902
48349,Navarro County,,TX,3500,50111,53611
48351,Newton County,,TX,961,12163,13124
48353,Nolan County,,TX,1460,16042,17502
48355,Nueces County,,TX,22394,348353,370747
48357,Ochiltree County,,TX,747,10947,11694
48359,Oldham County,,TX,257,2064,2321
48361,Orange County,,TX,7259,89966,97225
48363,Palo Pinto County,,TX,2226,28317,30543
48365,Panola County,,TX,1765,25560,27325
48367,Parker County,,TX,9850,117878,127728
48369,Parmer County,,TX,1115,11050,12165
48371,Pecos County,,TX,1267,14276,15543
48373,Polk County,,TX,5341,54485,59826
48375,Potter County,,TX,13239,119521,132760
48377,Presidio County,,TX,1111,10560,11671
48379,Rains County,,TX,940,9938,10878
48381,Randall County,,TX,11981,125143,137124
48383,Reagan County,,TX,374,3867,4241
48385,Real County,,TX,265,3230,3495
48387,Red River County,,TX,1021,13459,14480
48389,Reeves County,,TX,749,11502,12251
48391,Refugio County,,TX,611,8404,9015
48393,Roberts County,,TX,127,872,999
48395,Robertson County,,TX,1620,16770,18390
48397,Rockwall County,,TX,6735,78058,84793
48399,Runnels County,,TX,926,11337,12263
48401,Rusk County,,TX,3635,51505,55140
48403,Sabine County,,TX,695,10793,11488
48405,San Augustine County,,TX,588,8709,9297
48407,San Jacinto County,,TX,2392,22654,25046
48409,San Patricio County,,TX,8257,74105,82362
48411,San Saba County,,TX,418,5501,5919
48413,Schleicher County,,TX,299,3247,3546
48415,Scurry County,,TX,1288,16739,18027
48417,Shackelford County,,TX,306,3560,3866
48419,Shelby County,,TX,1505,25806,27311
48421,Sherman County,,TX,291,2847,3138
48423,Smith County,,TX,13718,217469,231187
48425,Somervell County,,TX,836,8282,9118
48427,Starr County,,TX,2695,67075,69770
48429,Stephens County,,TX,762,8938,9700
48431,Sterling County,,TX,124,1148,1272
48433,Stonewall County,,TX,111,1549,1660
48435,Sutton County,,TX,594,4964,5558
48437,Swisher County,,TX,783,7668,8451
48439,Tarrant County,,TX,114939,1933303,2048242
48441,Taylor County,,TX,12453,138130,150583
48443,Terrell County,,TX,108,900,1008
48445,Terry County,,TX,1053,12016,13069
48447,Throckmorton County,,TX,126,1626,1752
48449,Titus County,,TX,2202,33072,35274
48451,Tom Green County,,TX,10209,115360,125569
48453,Travis County,,TX,83317,980539,1063856
48455,Trinity County,,TX,1230,13556,14786
48457,Tyler County,,TX,1437,19016,20453
48459,Upshur County,,TX,3508,38537,42045
48461,Upton County,,TX,341,3399,3740
48463,Uvalde County,,TX,1894,29045,30939
48465,Val Verde County,,TX,4568,53658,58226
48467,Van Zandt County,,TX,3958,52087,56045
48469,Victoria County,,TX,5721,97153,102874
48471,Walker County,,TX,4882,47399,52281
48473,Waller County,,TX,3479,36326,39805
48475,Ward County,,TX,996,11579,12575
48477,Washington County,,TX,1946,34519,36465
48479,Webb County,,TX,7920,270562,278482
48481,Wharton County,,TX,2516,46538,49054
48483,Wheeler County,,TX,434,5730,6164
48485,Wichita County,,TX,11792,130794,142586
48487,Wilbarger County,,TX,1109,14358,15467
48489,Willacy County,,TX,1155,20458,21613
48491,Williamson County,,TX,38780,426327,465107
48493,Wilson County,,TX,3217,44109,47326
48495,Winkler County,,TX,586,7630,8216
48497,Wise County,,TX,4989,60440,65429
48499,Wood County,,TX,3106,42032,45138
48501,Yoakum County,,TX,679,8990,9669
48503,Young County,,TX,1228,19488,20716
48505,Zapata County,,TX,518,13462,13980
48507,Zavala County,,TX,908,11617,12525
49001,Beaver County,,UT,443,7355,7798
49003,Box Elder County,,UT,3639,57927,61566
49005,Cache County,,UT,8991,116616,125607
49007,Carbon County,,UT,1459,22639,24098
49009,Daggett County,,UT,62,906,968
49011,Davis County,,UT,27525,338864,366389
49013,Duchesne County,,UT,1120,19340,20460
49015,Emery County,,UT,756,11960,12716
49017,Garfield County,,UT,417,5259,5676
49019,Grand County,,UT,846,9915,10761
49021,Iron County,,UT,4030,38215,42245
49023,Juab County,,UT,766,10796,11562
49025,Kane County,,UT,720,6890,7610
49027,Millard County,,UT,907,13740,14647
49029,Morgan County,,UT,804,10541,11345
49031,Piute County,,UT,92,1491,1583
49033,Rich County,,UT,233,2299,2532
49035,Salt Lake County,,UT,60077,1178477,1238554
49037,San Juan County,,UT,1256,10255,11511
49039,Sanpete County,,UT,1836,25649,27485
49041,Sevier County,,UT,1425,22465,23890
49043,Summit County,,UT,3756,41275,45031
49045,Tooele County,,UT,4651,63705,68356
49047,Uintah County,,UT,2228,32039,34267
49049,Utah County,,UT,34752,516680,551432
49051,Wasatch County,,UT,2293,24119,26412
49053,Washington County,,UT,11180,140260,151440
49055,Wayne County,,UT,289,2835,3124
49057,Weber County,,UT,16773,259614,276387
50001,Addison County,,VT,2391,43504,45895
50003,Bennington County,,VT,2043,44299,46342
50005,Caledonia County,,VT,1965,36523,38488
50007,Chittenden County,,VT,10719,181938,192657
50009,Essex County,,VT,621,7296,7917
50011,Franklin County,,VT,2580,59174,61754
50013,Grand Isle County,,VT,818,8829,9647
50015,Lamoille County,,VT,1863,29477,31340
50017,Orange County,,VT,2366,34934,37300
50019,Orleans County,,VT,1452,32803,34255
50021,Rutland County,,VT,3366,76309,79675
50023,Washington County,,VT,3935,72743,76678
50025,Windham County,,VT,3079,53090,56169
50027,Windsor County,,VT,4661,69783,74444
51001,Accomack County,,VA,1839,37924,39763
51003,Albemarle County,,VA,10300,98608,108908
51005,Alleghany County,,VA,724,18858,19582
51007,Amelia County,,VA,891,14696,15587
51009,Amherst County,,VA,2086,35982,38068
51011,Appomattox County,,VA,951,17240,18191
51013,Arlington County,,VA,38485,215322,253807
51015,Augusta County,,VA,4156,86076,90232
51017,Bath County,,VA,386,5627,6013
51019,Bedford County,,VA,4704,79031,83735
51021,Bland County,,VA,409,6974,7383
51023,Botetourt County,,VA,2518,39815,42333
51025,Brunswick County,,VA,1156,17382,18538
51027,Buchanan County,,VA,1031,23512,24543
51029,Buckingham County,,VA,773,15737,16510
51031,Campbell County,,VA,4208,62253,66461
51033,Caroline County,,VA,2923,32271,35194
51035,Carroll County,,VA,1322,31774,33096
51036,Charles City County,,VA,535,8407,8942
51037,Charlotte County,,VA,721,13908,14629
51041,Chesterfield County,,VA,26438,368536,394974
51043,Clarke County,,VA,1250,15535,16785
51045,Craig County,,VA,357,5643,6000
51047,Culpeper County,,VA,4345,50582,54927
51049,Cumberland County,,VA,669,10456,11125
51051,Dickenson County,,VA,591,15257,15848
51053,Dinwiddie County,,VA,2192,31017,33209
51057,Essex County,,VA,773,12722,13495
51059,Fairfax County,,VA,108523,1198588,1307111
51061,Fauquier County,,VA,5378,73712,79090
51063,Floyd County,,VA,908,16636,17544
51065,Fluvanna County,,VA,1992,28392,30384
51067,Franklin County,,VA,2930,60822,63752
51069,Frederick County,,VA,6736,89268,96004
51071,Giles County,,VA,931,19482,20413
51073,Gloucester County,,VA,2782,43776,46558
51075,Goochland County,,VA,1358,23157,24515
51077,Grayson County,,VA,776,16768,17544
51079,Greene County,,VA,1431,20860,22291
51081,Greensville County,,VA,472,9360,9832
51083,Halifax County,,VA,1453,39657,41110
51085,Hanover County,,VA,7246,117763,125009
51087,Henrico County,,VA,28900,349213,378113
51089,Henry County,,VA,2882,62161,65043
51091,Highland County,,VA,141,2778,2919
51093,Isle of Wight County,,VA,3127,42030,45157
51095,James City County,,VA,5723,74908,80631
51097,King and Queen County,,VA,566,7254,7820
51099,King George County,,VA,2709,26308,29017
51101,King William County,,VA,1350,19306,20656
51103,Lancaster County,,VA,712,13849,14561
51105,Lee County,,VA,833,22651,23484
51107,Loudoun County,,VA,28936,346358,375294
51109,Louisa County,,VA,2438,36246,38684
51111,Lunenburg County,,VA,677,12109,12786
51113,Madison County,,VA,998,14958,15956
51115,Mathews County,,VA,569,10264,10833
51117,Mecklenburg County,,VA,1692,34773,36465
51119,Middlesex County,,VA,741,12008,12749
51121,Montgomery County,,VA,7828,77538,85366
51125,Nelson County,,VA,953,17167,18120
51127,New Kent County,,VA,1366,20870,22236
51131,Northampton County,,VA,790,14051,14841
51133,Northumberland County,,VA,686,14462,15148
51135,Nottoway County,,VA,1050,16051,17101
51137,Orange County,,VA,3018,38233,41251
51139,Page County,,VA,1260,27904,29164
51141,Patrick County,,VA,845,19648,20493
51143,Pittsylvania County,,VA,3317,72105,75422
51145,Powhatan County,,VA,1656,30528,32184
51147,Prince Edward County,,VA,1403,19049,20452
51149,Prince George County,,VA,5047,34655,39702
51153,Prince William County,,VA,47546,433160,480706
51155,Pulaski County,,VA,1960,37690,39650
51157,Rappahannock County,,VA,690,8412,9102
51159,Richmond County,,VA,635,8540,9175
51161,Roanoke County,,VA,8549,108897,117446
51163,Rockbridge County,,VA,1406,24808,26214
51165,Rockingham County,,VA,4620,90874,95494
51167,Russell County,,VA,1019,28175,29194
51169,Scott County,,VA,1033,23586,24619
51171,Shenandoah County,,VA,2964,48969,51933
51173,Smyth County,,VA,1343,35453,36796
51175,Southampton County,,VA,1202,19514,20716
51177,Spotsylvania County,,VA,13118,138157,151275
51179,Stafford County,,VA,16770,136686,153456
51181,Surry County,,VA,530,7718,8248
51183,Sussex County,,VA,1019,11377,12396
51185,Tazewell County,,VA,2116,45097,47213
51187,Warren County,,VA,3086,42505,45591
51191,Washington County,,VA,3059,58131,61190
51193,Westmoreland County,,VA,1372,19523,20895
51195,Wise County,,VA,1785,39943,41728
51197,Wythe County,,VA,1581,32906,34487
51199,York County,,VA,10080,74293,84373
51510,Alexandria city,,VA,28595,143857,172452
51515,Bedford city,,VA,642,6851,7493
51520,Bristol city,,VA,1885,17542,19427
51530,Buena Vista city,,VA,641,6848,7489
51540,Charlottesville city,,VA,6236,37756,43992
51550,Chesapeake city,,VA,25483,246660,272143
51570,Colonial Heights city,,VA,2478,20372,22850
51580,Covington city,,VA,504,7155,7659
51590,Danville city,,VA,3061,46265,49326
51595,Emporia city,,VA,518,6512,7030
51600,Fairfax city,,VA,3869,24869,28738
51610,Falls Church city,,VA,2042,11849,13891
51620,Franklin city,,VA,954,9451,10405
51630,Fredericksburg city,,VA,5213,20032,25245
51640,Galax city,,VA,610,7761,8371
51650,Hampton city,,VA,21237,145311,166548
51660,Harrisonburg city,,VA,4597,33474,38071
51670,Hopewell city,,VA,3147,24576,27723
51678,Lexington city,,VA,639,5323,5962
51680,Lynchburg city,,VA,6580,68731,75311
51683,Manassas city,,VA,6994,38922,45916
51685,Manassas Park city,,VA,2855,13382,16237
51690,Martinsville city,,VA,1231,15287,16518
51700,Newport News city,,VA,28616,190963,219579
51710,Norfolk city,,VA,37758,222253,260011
51720,Norton city,,VA,460,4210,4670
51730,Petersburg city,,VA,4843,33670,38513
51735,Poquoson city,,VA,1097,14482,15579
51740,Portsmouth city,,VA,12988,103841,116829
51750,Radford city,,VA,1820,10776,12596
51760,Richmond city,,VA,23986,184424,208410
51770,Roanoke city,,VA,9684,103746,113430
51775,Salem city,,VA,2714,27561,30275
51790,Staunton city,,VA,2439,26217,28656
51800,Suffolk city,,VA,8594,91641,100235
51810,Virginia Beach city,,VA,54472,491303,545775
51820,Waynesboro city,,VA,2354,24321,26675
51830,Williamsburg city,,VA,1663,9177,10840
51840,Winchester city,,VA,4341,26761,31102
53001,Adams County,,WA,1316,21195,22511
53003,Asotin County,,WA,2109,22849,24958
53005,Benton County,,WA,12349,187539,199888
53007,Chelan County,,WA,5417,81696,87113
53009,Clallam County,,WA,4014,79294,83308
53011,Clark County,,WA,25172,476974,502146
53013,Columbia County,,WA,307,4284,4591
53015,Cowlitz County,,WA,6129,112522,118651
53017,Douglas County,,WA,3477,38982,42459
53019,Ferry County,,WA,541,6715,7256
53021,Franklin County,,WA,6417,80504,86921
53023,Garfield County,,WA,140,2302,2442
53025,Grant County,,WA,5208,95551,100759
53027,Grays Harbor County,,WA,4155,74188,78343
53029,Island County,,WA,9950,86821,96771
53031,Jefferson County,,WA,2073,32874,34947
53033,King County,,WA,119404,2179798,2299202
53035,Kitsap County,,WA,21423,276967,298390
53037,Kittitas County,,WA,3466,37168,40634
53039,Klickitat County,,WA,1481,21833,23314
53041,Lewis County,,WA,4966,81960,86926
53043,Lincoln County,,WA,790,11693,12483
53045,Mason County,,WA,4367,63165,67532
53047,Okanogan County,,WA,2363,43937,46300
53049,Pacific County,,WA,1637,22295,23932
53051,Pend Oreille County,,WA,1179,13600,14779
53053,Pierce County,,WA,65733,891433,957166
53055,San Juan County,,WA,1105,16504,17609
53057,Skagit County,,WA,7806,132450,140256
53059,Skamania County,,WA,825,11065,11890
53061,Snohomish County,,WA,47730,809398,857128
53063,Spokane County,,WA,25219,521640,546859
53065,Stevens County,,WA,3115,46481,49596
53067,Thurston County,,WA,21796,282317,304113
53069,Wahkiakum County,,WA,359,4269,4628
53071,Walla Walla County,,WA,3609,59951,63560
53073,Whatcom County,,WA,12041,215159,227200
53075,Whitman County,,WA,4789,35195,39984
53077,Yakima County,,WA,9591,267702,277293
54001,Barbour County,,WV,684,16769,17453
54003,Berkeley County,,WV,6941,117926,124867
54005,Boone County,,WV,983,25703,26686
54007,Braxton County,,WV,675,14184,14859
54009,Brooke County,,WV,1109,28075,29184
54011,Cabell County,,WV,5783,98152,103935
54013,Calhoun County,,WV,383,7321,7704
54015,Clay County,,WV,514,9686,10200
54017,Doddridge County,,WV,343,5276,5619
54019,Fayette County,,WV,2263,45758,48021
54021,Gilmer County,,WV,451,6425,6876
54023,Grant County,,WV,666,13705,14371
54025,Greenbrier County,,WV,1821,37850,39671
54027,Hampshire County,,WV,1297,25607,26904
54029,Hancock County,,WV,1733,37620,39353
54031,Hardy County,,WV,768,15892,16660
54033,Harrison County,,WV,3458,79848,83306
54035,Jackson County,,WV,1319,32693,34012
54037,Jefferson County,,WV,3894,59101,62995
54039,Kanawha County,,WV,9023,220918,229941
54041,Lewis County,,WV,819,19548,20367
54043,Lincoln County,,WV,1027,22163,23190
54045,Logan County,,WV,1291,36965,38256
54047,McDowell County,,WV,841,18123,18964
54049,Marion County,,WV,2777,63484,66261
54051,Marshall County,,WV,1623,37179,38802
54053,Mason County,,WV,1207,27933,29140
54055,Mercer County,,WV,2599,65128,67727
54057,Mineral County,,WV,1355,32664,34019
54059,Mingo County,,WV,1127,25616,26743
54061,Monongalia County,,WV,6289,84105,90394
54063,Monroe County,,WV,692,13967,14659
54065,Morgan County,,WV,991,19443,20434
54067,Nicholas County,,WV,1040,28098,29138
54069,Ohio County,,WV,2511,51521,54032
54071,Pendleton County,,WV,536,8842,9378
54073,Pleasants County,,WV,489,8402,8891
54075,Pocahontas County,,WV,482,9491,9973
54077,Preston County,,WV,1541,34858,36399
54079,Putnam County,,WV,3922,63501,67423
54081,Raleigh County,,WV,3390,81434,84824
54083,Randolph County,,WV,1278,31734,33012
54085,Ritchie County,,WV,633,12126,12759
54087,Roane County,,WV,750,15549,16299
54089,Summers County,,WV,474,11607,12081
54091,Taylor County,,WV,917,17701,18618
54093,Tucker County,,WV,391,8205,8596
54095,Tyler County,,WV,564,10216,10780
54097,Upshur County,,WV,1153,25170,26323
54099,Wayne County,,WV,2126,42567,44693
54101,Webster County,,WV,375,9055,9430
54103,Wetzel County,,WV,832,19010,19842
54105,Wirt County,,WV,390,5537,5927
54107,Wood County,,WV,4052,99366,103418
54109,Wyoming County,,WV,930,22777,23707
55001,Adams County,,WI,1531,21821,23352
55003,Ashland County,,WI,1074,18935,20009
55005,Barron County,,WI,2895,57035,59930
55007,Bayfield County,,WI,992,18313,19305
55009,Brown County,,WI,12892,308348,321240
55011,Buffalo County,,WI,965,17053,18018
55013,Burnett County,,WI,935,19120,20055
55015,Calumet County,,WI,3880,60970,64850
55017,Chippewa County,,WI,3898,74867,78765
55019,Clark County,,WI,2206,40648,42854
55021,Columbia County,,WI,4664,71692,76356
55023,Crawford County,,WI,1075,20008,21083
55025,Dane County,,WI,30436,591919,622355
55027,Dodge County,,WI,6337,106750,113087
55029,Door County,,WI,1603,36057,37660
55031,Douglas County,,WI,2424,51191,53615
55033,Dunn County,,WI,3112,45659,48771
55035,Eau Claire County,,WI,7435,110212,117647
55037,Florence County,,WI,303,5521,5824
55039,Fond du Lac County,,WI,5702,127203,132905
55041,Forest County,,WI,582,10977,11559
55043,Grant County,,WI,3062,57530,60592
55045,Green County,,WI,2433,47185,49618
55047,Green Lake County,,WI,1446,23843,25289
55049,Iowa County,,WI,1800,29560,31360
55051,Iron County,,WI,412,7260,7672
55053,Jackson County,,WI,1470,23010,24480
55055,Jefferson County,,WI,6180,100420,106600
55057,Juneau County,,WI,2054,30258,32312
55059,Kenosha County,,WI,10493,195375,205868
55061,Kewaunee County,,WI,1132,25923,27055
55063,La Crosse County,,WI,6600,130585,137185
55065,Lafayette County,,WI,1178,21606,22784
55067,Langlade County,,WI,1231,24750,25981
55069,Lincoln County,,WI,1681,36759,38440
55071,Manitowoc County,,WI,3747,104709,108456
55073,Marathon County,,WI,6993,169452,176445
55075,Marinette County,,WI,2667,51137,53804
55077,Marquette County,,WI,1299,18888,20187
55078,Menominee County,,WI,346,4502,4848
55079,Milwaukee County,,WI,47158,1084894,1132052
55081,Monroe County,,WI,3336,53448,56784
55083,Oconto County,,WI,2416,47086,49502
55085,Oneida County,,WI,2546,47171,49717
55087,Outagamie County,,WI,13307,221378,234685
55089,Ozaukee County,,WI,5955,108129,114084
55091,Pepin County,,WI,575,9153,9728
55093,Pierce County,,WI,2987,45412,48399
55095,Polk County,,WI,2657,54634,57291
55097,Portage County,,WI,4412,80593,85005
55099,Price County,,WI,912,18245,19157
55101,Racine County,,WI,11078,241051,252129
55103,Richland County,,WI,1173,20820,21993
55105,Rock County,,WI,8964,198308,207272
55107,Rusk County,,WI,832,17515,18347
55109,St. Croix County,,WI,5820,102539,108359
55111,Sauk County,,WI,4678,77925,82603
55113,Sawyer County,,WI,1056,20608,21664
55115,Shawano County,,WI,2497,49959,52456
55117,Sheboygan County,,WI,5776,149174,154950
55119,Taylor County,,WI,1147,23931,25078
55121,Trempealeau County,,WI,1951,38240,40191
55123,Vernon County,,WI,1708,34480,36188
55125,Vilas County,,WI,1362,26621,27983
55127,Walworth County,,WI,6982,118600,125582
55129,Washburn County,,WI,1166,20003,21169
55131,Washington County,,WI,8217,169206,177423
55133,Waukesha County,,WI,24821,492973,517794
55135,Waupaca County,,WI,3160,63572,66732
55137,Waushara County,,WI,1654,28721,30375
55139,Winnebago County,,WI,11631,195679,207310
55141,Wood County,,WI,4559,94815,99374
56001,Albany County,,WY,4178,31551,35729
56003,Big Horn County,,WY,889,12350,13239
56005,Campbell County,,WY,3573,49995,53568
56007,Carbon County,,WY,1861,17492,19353
56009,Converse County,,WY,1315,15648,16963
56011,Crook County,,WY,648,7769,8417
56013,Fremont County,,WY,2558,44166,46724
56015,Goshen County,,WY,940,13451,14391
56017,Hot Springs County,,WY,376,5342,5718
56019,Johnson County,,WY,794,9167,9961
56021,Laramie County,,WY,7958,104973,112931
56023,Lincoln County,,WY,1501,19786,21287
56025,Natrona County,,WY,5503,85536,91039
56027,Niobrara County,,WY,228,2634,2862
56029,Park County,,WY,2304,33085,35389
56031,Platte County,,WY,751,9802,10553
56033,Sheridan County,,WY,2270,33106,35376
56035,Sublette County,,WY,1034,9644,10678
56037,Sweetwater County,,WY,4316,50732,55048
56039,Teton County,,WY,2588,24469,27057
56041,Uinta County,,WY,1956,24611,26567
56043,Washakie County,,WY,652,9768,10420
56045,Weston County,,WY,641,8187,8828
