Id,Label,timeset,state,totalmig,totalnonmig,population,indegree,outdegree,Degree,weighted indegree,weighted outdegree,Weighted Degree,Eccentricity,closnesscentrality,harmonicclosnesscentrality,betweenesscentrality,Authority,Hub,modularity_class,pageranks,componentnumber,strongcompnum,clustering,eigencentrality
6037,Los Angeles County,,CA,361769,9682175,10043944,731,826,1557,4318368,5850672,10169040,4,0.555515,0.623128,346117.725442,0.102614,0.102826,45,0.00463,0,10,0.113387,0.949141
17031,Cook County,,IL,268617,5917492,6186109,693,764,1457,2709701,3786100,6495801,4,0.548865,0.612766,527632.252908,0.097489,0.097849,8,0.004475,0,10,0.122176,0.896551
48201,Harris County,,TX,195417,3532942,3728359,801,699,1500,3079029,3103852,6182881,4,0.536969,0.599013,449707.839686,0.101662,0.095541,62,0.005667,0,10,0.116707,0.946941
4013,Maricopa County,,AZ,152544,3155314,3307858,978,878,1856,3041665,2487194,5528859,4,0.56367,0.633111,807613.311517,0.106692,0.103036,45,0.006975,0,10,0.084671,1
6073,San Diego County,,CA,174485,3069555,3244040,716,767,1483,2411402,2582828,4994230,4,0.545939,0.611491,249888.051417,0.102,0.101882,45,0.004477,0,10,0.13008,0.943109
6059,Orange County,,CA,169635,3072118,3241753,439,498,937,2216944,2517937,4734881,4,0.506262,0.558675,48383.862275,0.086455,0.088702,45,0.002555,0,10,0.238148,0.790829
48113,Dallas County,,TX,182501,2271027,2453528,639,593,1232,2348624,2661856,5010480,4,0.521473,0.578505,271418.493295,0.091977,0.088059,62,0.004537,0,10,0.152696,0.857686
12086,Dade County,,FL,111283,2321618,2432901,513,585,1098,1454632,1974486,3429118,5,0.525398,0.579899,208717.182149,0.09056,0.092235,5,0.003296,0,10,0.182934,0.8374
36047,Kings County,,NY,138895,2252292,2391187,378,387,765,1804319,2384129,4188448,5,0.489406,0.535411,32845.370545,0.080583,0.080258,47,0.002028,0,10,0.324225,0.726797
36081,Queens County,,NY,145355,2207110,2352465,299,353,652,1679389,2235627,3915016,5,0.481354,0.526188,14405.723788,0.071504,0.077422,47,0.001563,0,10,0.380057,0.644354
26163,Wayne County,,MI,96050,2109563,2205613,335,427,762,959447,1386521,2345968,5,0.492308,0.541786,84191.953182,0.069172,0.078294,43,0.001956,0,10,0.270408,0.631259
53033,King County,,WA,136297,1976063,2112360,532,471,1003,1844506,1854065,3698571,4,0.505846,0.55542,122544.125592,0.090125,0.084381,45,0.003372,0,10,0.216588,0.826965
6085,Santa Clara County,,CA,153731,1886312,2040043,345,338,683,1347676,1684719,3032395,4,0.481203,0.524414,18446.404338,0.074322,0.072434,45,0.001969,0,10,0.333773,0.67378
12011,Broward County,,FL,108876,1702379,1811255,505,556,1061,1947465,1924725,3872190,5,0.514142,0.569916,89335.817745,0.092372,0.092366,5,0.002998,0,10,0.199167,0.846698
6071,San Bernardino County,,CA,111390,1691798,1803188,367,459,826,2037898,1897658,3935556,4,0.505679,0.553982,40108.851017,0.074588,0.081738,45,0.002191,0,10,0.256577,0.690391
25017,Middlesex County,,MA,115120,1664689,1779809,365,362,727,1420117,1601506,3021623,4,0.479925,0.526123,56667.065228,0.077884,0.077287,33,0.002029,0,10,0.34273,0.701629
36103,Suffolk County,,NY,59919,1695927,1755846,246,352,598,768725,876503,1645228,5,0.465173,0.514399,16344.794851,0.061793,0.07287,47,0.001315,0,10,0.358355,0.562308
36059,Nassau County,,NY,76536,1595419,1671955,190,283,473,913279,1039465,1952744,5,0.463628,0.505637,4160.732968,0.053283,0.067685,47,0.000983,0,10,0.485828,0.479858
6001,Alameda County,,CA,122829,1536146,1658975,313,323,636,1536335,1700141,3236476,4,0.481052,0.522651,15501.787712,0.071126,0.07052,45,0.001766,0,10,0.368034,0.647143
39035,Cuyahoga County,,OH,66580,1587201,1653781,307,354,661,637370,910578,1547948,5,0.483551,0.527789,35596.654618,0.069933,0.076931,41,0.001671,0,10,0.367857,0.627364
48439,Tarrant County,,TX,111315,1532516,1643831,638,567,1205,1862039,1656130,3518169,4,0.516824,0.572808,255041.996069,0.09198,0.086148,62,0.00455,0,10,0.153251,0.856299
6065,Riverside County,,CA,89234,1549400,1638634,371,436,807,2345565,1728355,4073920,4,0.502043,0.549154,36046.038307,0.076473,0.080206,45,0.002195,0,10,0.26982,0.706853
48029,Bexar County,,TX,88149,1533665,1621814,548,477,1025,1393234,1205942,2599176,4,0.506513,0.556505,132680.80134,0.089391,0.082697,62,0.003727,0,10,0.202536,0.832589
36061,New York County,,NY,147364,1470774,1618138,431,385,816,2256804,2571531,4828335,4,0.486846,0.533474,41926.384073,0.085667,0.079672,47,0.002368,0,10,0.294424,0.771823
42003,Allegheny County,,PA,56444,1506305,1562749,359,379,738,631671,736401,1368072,5,0.482639,0.52985,112157.667225,0.074681,0.077028,41,0.002043,0,10,0.318334,0.671694
32003,Clark County,,NV,78702,1469592,1548294,719,677,1396,1853033,1385441,3238474,4,0.533519,0.594754,262558.749881,0.100647,0.096805,45,0.004698,0,10,0.13669,0.93021
42101,Philadelphia County,,PA,78943,1458202,1537145,298,300,598,953073,1187429,2140502,5,0.472979,0.514345,23361.798076,0.069779,0.069907,47,0.001567,0,10,0.418867,0.62286
26125,Oakland County,,MI,90825,1400940,1491765,338,399,737,1105814,1217589,2323403,5,0.485385,0.534055,75545.288114,0.069591,0.077398,43,0.002036,0,10,0.295841,0.639709
27053,Hennepin County,,MN,95327,1265345,1360672,439,414,853,1194187,1333989,2528176,4,0.49862,0.544542,304081.553098,0.071345,0.072574,39,0.003285,0,10,0.21917,0.65731
6067,Sacramento County,,CA,69077,1278823,1347900,291,330,621,1185458,1110647,2296105,4,0.485922,0.526747,27915.63537,0.063562,0.06777,45,0.001774,0,10,0.345156,0.590621
17043,DuPage County,,IL,96797,1218325,1315122,289,348,637,1041755,1160119,2201874,5,0.482867,0.526704,30934.684771,0.064297,0.072404,8,0.001689,0,10,0.344504,0.583149
29189,St. Louis County,,MO,78504,1214994,1293498,331,352,683,921440,1027821,1949261,5,0.489406,0.531586,155926.525658,0.067398,0.07118,14,0.002302,0,10,0.31238,0.619018
12099,Palm Beach County,,FL,69275,1201273,1270548,435,461,896,1314615,1109736,2424351,5,0.498378,0.549463,51734.089625,0.085479,0.085588,5,0.002491,0,10,0.245729,0.781445
39049,Franklin County,,OH,79889,1175184,1255073,450,451,901,1038355,1147529,2185884,5,0.496204,0.54694,263781.988417,0.080801,0.080889,41,0.00286,0,10,0.236752,0.731171
36005,Bronx County,,NY,77009,1177089,1254098,200,258,458,1080986,1371740,2452726,5,0.460294,0.500581,4226.496327,0.054724,0.062447,47,0.001014,0,10,0.511863,0.488151
51059,Fairfax County,,VA,115839,1119172,1235011,486,474,960,1489504,1693522,3183026,5,0.499106,0.551416,135462.280067,0.088636,0.086304,13,0.002929,0,10,0.232386,0.808209
12057,Hillsborough County,,FL,74707,1088813,1163520,626,569,1195,1461482,1304391,2765873,4,0.523874,0.577148,158584.625484,0.097716,0.092635,5,0.003838,0,10,0.161382,0.895477
55079,Milwaukee County,,WI,52888,1053503,1106391,274,300,574,535742,696181,1231923,5,0.478728,0.518511,80851.506425,0.057104,0.062448,8,0.001754,0,10,0.34817,0.521851
36029,Erie County,,NY,33383,1067893,1101276,229,280,509,302876,385658,688534,5,0.463558,0.50523,23478.464898,0.058507,0.067639,36,0.001207,0,10,0.474274,0.524279
6013,Contra Costa County,,CA,69029,1030151,1099180,223,253,476,1038261,960358,1998619,5,0.465949,0.504026,6082.764757,0.055467,0.058982,45,0.001249,0,10,0.462334,0.509898
34003,Bergen County,,NJ,57993,1026605,1084598,173,235,408,746667,810301,1556968,5,0.451499,0.49088,2176.058053,0.050023,0.060294,47,0.000855,0,10,0.568967,0.442639
24031,Montgomery County,,MD,74381,1009625,1084006,350,350,700,980059,1094322,2074381,5,0.480977,0.525602,30513.746636,0.077968,0.075612,13,0.001926,0,10,0.343468,0.701775
47157,Shelby County,,TN,54605,1017737,1072342,403,392,795,544430,656280,1200710,5,0.49294,0.538477,216859.950393,0.073207,0.073314,52,0.002888,0,10,0.258053,0.682089
36119,Westchester County,,NY,54895,1016842,1071737,196,249,445,686605,784492,1471097,5,0.44932,0.491005,4724.795898,0.054463,0.061388,47,0.000995,0,10,0.522019,0.486464
12095,Orange County,,FL,90130,970878,1061008,494,468,962,1608749,1534022,3142771,5,0.498944,0.550656,48130.571691,0.091442,0.088083,5,0.002884,0,10,0.233942,0.835712
9003,Hartford County,,CT,43450,1010082,1053532,235,269,504,519894,581927,1101821,5,0.463908,0.504281,8642.897631,0.061574,0.066067,47,0.001217,0,10,0.493143,0.551011
12103,Pinellas County,,FL,61956,989470,1051426,516,479,995,897923,829178,1727101,5,0.500244,0.552691,69299.236643,0.090359,0.086954,5,0.003053,0,10,0.213711,0.822666
49035,Salt Lake County,,UT,60637,977236,1037873,339,360,699,760148,822475,1582623,4,0.490578,0.533203,94683.422976,0.067118,0.069021,45,0.002259,0,10,0.297233,0.624899
15003,Honolulu County,,HI,63801,971311,1035112,426,440,866,723902,805875,1529777,4,0.501305,0.549154,44168.255964,0.084629,0.084587,45,0.002507,0,10,0.283803,0.77976
9001,Fairfield County,,CT,51176,974235,1025411,224,295,519,572567,671476,1244043,5,0.460639,0.504687,7140.888752,0.060197,0.068499,47,0.001134,0,10,0.452932,0.537179
18097,Marion County,,IN,66377,947771,1014148,358,351,709,817073,918376,1735449,5,0.482109,0.526487,199302.068916,0.067759,0.068135,42,0.002383,0,10,0.28029,0.619171
26099,Macomb County,,MI,43397,967008,1010405,180,240,420,647635,619667,1267302,5,0.457007,0.495736,21827.062581,0.043037,0.05474,43,0.001041,0,10,0.427191,0.395938
39061,Hamilton County,,OH,53442,939428,992870,265,294,559,547359,733346,1280705,5,0.479326,0.518104,74205.406184,0.058149,0.065752,42,0.001659,0,10,0.367085,0.527752
9009,New Haven County,,CT,40676,931788,972464,225,261,486,517590,571281,1088871,5,0.458987,0.499696,4699.530455,0.059583,0.064667,47,0.001157,0,10,0.515813,0.534424
24005,Baltimore County,,MD,61497,895913,957410,246,261,507,894128,882399,1776527,5,0.463139,0.502762,12986.728049,0.0623,0.064725,13,0.001322,0,10,0.481843,0.557239
24033,Prince George's County,,MD,69700,881887,951587,300,311,611,982365,1075058,2057423,5,0.474513,0.516585,30549.181934,0.068419,0.068884,13,0.001733,0,10,0.376079,0.618805
34023,Middlesex County,,NJ,61620,869513,931133,206,265,471,793906,914286,1708192,5,0.464329,0.504064,3963.652139,0.0573,0.06617,47,0.001049,0,10,0.513168,0.507223
12031,Duval County,,FL,61257,860847,922104,465,426,891,917289,886773,1804062,5,0.494925,0.543414,83032.822674,0.087034,0.083204,5,0.002886,0,10,0.256379,0.802512
6075,San Francisco County,,CA,82214,837397,919611,273,233,506,1035446,1161206,2196652,5,0.464118,0.500472,6810.46935,0.066376,0.057319,45,0.001501,0,10,0.482014,0.59959
4019,Pima County,,AZ,48517,865548,914065,452,396,848,634831,576043,1210874,4,0.498378,0.542426,46007.751931,0.085758,0.078011,45,0.00271,0,10,0.270094,0.782208
42091,Montgomery County,,PA,51646,855921,907567,233,247,480,719585,719108,1438693,5,0.454236,0.494379,10462.682227,0.060115,0.061736,47,0.001196,0,10,0.516767,0.53628
48453,Travis County,,TX,83842,819040,902882,687,570,1257,1704771,1503558,3208329,4,0.51665,0.573079,233781.221255,0.097674,0.089888,62,0.004693,0,10,0.150422,0.911237
25027,Worcester County,,MA,34845,864490,899335,195,251,446,459255,474242,933497,5,0.458166,0.497906,6895.728643,0.052064,0.062422,33,0.00099,0,10,0.516282,0.465006
36055,Monroe County,,NY,34482,861591,896073,231,264,495,310891,390532,701423,5,0.4614,0.501839,30322.357486,0.058178,0.064656,36,0.001211,0,10,0.479309,0.518252
6111,Ventura County,,CA,43984,825664,869648,202,257,459,566940,602568,1169508,4,0.464469,0.503201,5041.43376,0.051456,0.058543,45,0.001147,0,10,0.45169,0.477087
34013,Essex County,,NJ,51697,813859,865556,156,220,376,620717,769655,1390372,5,0.447487,0.486339,2074.581698,0.0466,0.057074,47,0.000775,0,10,0.59643,0.412609
25009,Essex County,,MA,39664,822351,862015,185,211,396,520345,549521,1069866,5,0.44176,0.480588,5994.870265,0.050219,0.054704,33,0.000933,0,10,0.568017,0.447515
6081,San Mateo County,,CA,73254,783330,856584,181,192,373,779720,885220,1664940,5,0.449583,0.484587,2319.047478,0.048649,0.049683,45,0.000989,0,10,0.575808,0.444598
21111,Jefferson County,,KY,38176,797439,835615,319,297,616,443957,478764,922721,5,0.477538,0.517301,198028.889657,0.06322,0.062406,42,0.002481,0,10,0.321492,0.584409
6019,Fresno County,,CA,32516,800573,833089,170,169,339,432761,432868,865629,5,0.44438,0.477713,4525.950437,0.041666,0.038651,45,0.001011,0,10,0.503128,0.393975
13121,Fulton County,,GA,108073,717439,825512,488,439,927,1698875,1709104,3407979,5,0.497409,0.546425,144701.804974,0.085549,0.081185,6,0.003245,0,10,0.233778,0.790099
42017,Bucks County,,PA,39702,776787,816489,194,220,414,495428,483250,978678,5,0.446836,0.485428,10400.839224,0.052772,0.056292,47,0.000989,0,10,0.563338,0.471719
48141,El Paso County,,TX,44570,771586,816156,294,305,599,449148,523419,972567,5,0.480601,0.520437,55724.838381,0.062673,0.061696,35,0.001943,0,10,0.346784,0.589921
53053,Pierce County,,WA,58718,756458,815176,378,351,729,894134,816432,1710566,4,0.489172,0.531277,44633.701479,0.073777,0.068031,45,0.002373,0,10,0.29868,0.690355
37119,Mecklenburg County,,NC,60315,741449,801764,523,398,921,1123045,962262,2085307,5,0.486461,0.53469,126395.258866,0.087342,0.077996,37,0.003271,0,10,0.217973,0.797851
25021,Norfolk County,,MA,55817,734326,790143,196,216,412,743513,778432,1521945,5,0.451234,0.488547,4756.30876,0.053239,0.056538,33,0.001004,0,10,0.579722,0.475153
17097,Lake County,,IL,49940,736771,786711,231,296,527,582597,601834,1184431,4,0.475615,0.515815,12342.09331,0.058632,0.067386,8,0.001298,0,10,0.423115,0.533112
1073,Jefferson County,,AL,37708,735609,773317,238,238,476,425200,491189,916389,5,0.466302,0.502707,90397.848052,0.048638,0.051785,6,0.001714,0,10,0.387649,0.464796
29095,Jackson County,,MO,45460,719792,765252,271,258,529,541588,594054,1135642,5,0.472252,0.509098,142459.732867,0.051989,0.053012,14,0.00213,0,10,0.326135,0.486255
13089,DeKalb County,,GA,95362,666773,762135,379,365,744,1241948,1359029,2600977,5,0.49097,0.534055,84921.848621,0.075274,0.072917,6,0.00245,0,10,0.289227,0.693159
41051,Multnomah County,,OR,60218,685353,745571,335,272,607,882401,861515,1743916,4,0.472543,0.510959,43484.295564,0.06704,0.056847,45,0.002119,0,10,0.337805,0.619395
25025,Suffolk County,,MA,74700,669698,744398,281,257,538,937588,1147866,2085454,5,0.462651,0.502029,14377.17851,0.067032,0.06281,33,0.001481,0,10,0.459505,0.595842
34025,Monmouth County,,NJ,36901,701377,738278,143,208,351,444722,467651,912373,5,0.443162,0.481456,688.057675,0.04354,0.056716,47,0.000713,0,10,0.647346,0.388003
53061,Snohomish County,,WA,51302,680451,731753,254,252,506,745808,656752,1402560,4,0.46279,0.501438,18945.873748,0.055106,0.053413,45,0.001621,0,10,0.395763,0.521995
13067,Cobb County,,GA,75767,646434,722201,414,368,782,1035352,1044433,2079785,5,0.485999,0.531017,65842.179425,0.080167,0.075817,6,0.002646,0,10,0.283552,0.741246
40109,Oklahoma County,,OK,51556,657170,708726,342,301,643,638753,656719,1295472,5,0.480751,0.520139,149543.667188,0.060359,0.057278,52,0.002697,0,10,0.276732,0.576638
37183,Wake County,,NC,51070,651354,702424,492,387,879,1033487,796718,1830205,5,0.487001,0.533757,127364.731478,0.08597,0.077243,37,0.00303,0,10,0.238074,0.781619
26081,Kent County,,MI,34161,668133,702294,192,229,421,396471,431918,828389,5,0.462651,0.498882,28926.645592,0.042831,0.052312,43,0.001153,0,10,0.426614,0.392838
39113,Montgomery County,,OH,38032,647761,685793,215,244,459,366005,440587,806592,5,0.465878,0.502951,31201.677354,0.049177,0.056732,42,0.001297,0,10,0.411482,0.451181
13135,Gwinnett County,,GA,63480,621027,684507,396,362,758,1123161,988586,2111747,5,0.48439,0.529308,72314.133962,0.078502,0.074428,6,0.002571,0,10,0.300111,0.724965
34017,Hudson County,,NJ,54237,627026,681263,203,217,420,725349,897620,1622969,5,0.453097,0.49012,2175.130368,0.056437,0.058408,47,0.001009,0,10,0.590097,0.49686
6029,Kern County,,CA,29415,650455,679870,172,210,382,463245,404481,867726,5,0.452964,0.48916,6094.189128,0.038738,0.043522,45,0.001052,0,10,0.424928,0.371088
44007,Providence County,,RI,28366,649194,677560,164,210,374,360226,429398,789624,5,0.448664,0.486176,2514.187191,0.0475,0.055396,33,0.000822,0,10,0.611259,0.423089
47037,Davidson County,,TN,56162,620190,676352,442,348,790,715585,760071,1475656,5,0.488006,0.530203,210953.926315,0.07784,0.068856,51,0.003313,0,10,0.247558,0.72251
42045,Delaware County,,PA,33113,635530,668643,142,156,298,421017,441038,862055,5,0.43892,0.472043,2068.936592,0.041736,0.045045,47,0.000712,0,10,0.701342,0.369111
39153,Summit County,,OH,31071,630961,662032,164,208,372,363046,397544,760590,5,0.450969,0.487354,12898.578681,0.041347,0.053227,41,0.000918,0,10,0.509857,0.375672
24510,Baltimore city,,MD,48638,592755,641393,213,188,401,612074,726833,1338907,5,0.448533,0.483626,6828.155159,0.05634,0.051622,13,0.00113,0,10,0.584683,0.499374
25005,Bristol County,,MA,23755,606477,630232,102,137,239,318445,318907,637352,5,0.417902,0.4514,1190.402828,0.029349,0.038653,33,0.00053,0,10,0.696278,0.264583
8041,El Paso County,,CO,54957,574827,629784,510,463,973,721536,664607,1386143,4,0.510214,0.557292,140259.223482,0.087622,0.083084,35,0.00343,0,10,0.225922,0.813792
34039,Union County,,NJ,39709,588778,628487,117,176,293,498578,559734,1058312,5,0.42953,0.466347,641.209013,0.035416,0.048686,47,0.000571,0,10,0.683613,0.310673
8005,Arapahoe County,,CO,72519,548666,621185,317,279,596,1006335,961223,1967558,4,0.4803,0.517253,39080.864638,0.068069,0.06324,35,0.002109,0,10,0.368067,0.62898
24003,Anne Arundel County,,MD,44475,576119,620594,287,295,582,614724,601612,1216336,5,0.466869,0.509397,15802.894124,0.068858,0.069363,13,0.001575,0,10,0.418983,0.62468
11001,District of Columbia,,DC,62410,554389,616799,346,283,629,849729,906124,1755853,5,0.476723,0.515213,19590.964579,0.077619,0.067719,13,0.001908,0,10,0.386161,0.696442
40143,Tulsa County,,OK,44718,568794,613512,284,274,558,513011,534237,1047248,5,0.476797,0.514307,89193.91198,0.053754,0.054662,52,0.002175,0,10,0.317027,0.509343
8031,Denver County,,CO,85802,526864,612666,378,298,676,1196853,1207077,2403930,4,0.486769,0.52379,55957.179376,0.075734,0.065225,35,0.002474,0,10,0.315857,0.695711
34029,Ocean County,,NJ,23717,587602,611319,124,177,301,420500,330092,750592,5,0.427498,0.464502,617.224449,0.035917,0.047473,47,0.000625,0,10,0.651309,0.320998
34007,Camden County,,NJ,32017,576843,608860,127,157,284,387875,426017,813892,5,0.428811,0.46339,572.083482,0.038677,0.046429,47,0.000625,0,10,0.753965,0.341476
27123,Ramsey County,,MN,51493,555320,606813,228,209,437,621273,720634,1341907,5,0.462999,0.49681,68817.789688,0.041725,0.04246,39,0.001719,0,10,0.314532,0.388895
10003,New Castle County,,DE,26994,575921,602915,184,208,392,327537,333403,660940,5,0.450176,0.486892,4125.833099,0.051054,0.05687,47,0.00094,0,10,0.601462,0.452237
34027,Morris County,,NJ,38664,563586,602250,151,209,360,435270,465816,901086,5,0.448664,0.485726,890.089977,0.045486,0.057031,47,0.000757,0,10,0.642248,0.404012
8059,Jefferson County,,CO,59864,540355,600219,261,238,499,744807,742042,1486849,4,0.471744,0.506456,27833.938006,0.058331,0.053341,35,0.001741,0,10,0.400568,0.542919
42071,Lancaster County,,PA,18891,579777,598668,167,175,342,231246,218185,449431,5,0.435004,0.47085,14704.594877,0.041184,0.044177,47,0.000874,0,10,0.539074,0.364059
48085,Collin County,,TX,56576,540955,597531,394,316,710,1273844,960951,2234795,5,0.483019,0.523367,38978.063209,0.077145,0.067809,62,0.002547,0,10,0.30624,0.713242
6077,San Joaquin County,,CA,30509,566060,596569,128,159,287,577225,494032,1071257,5,0.440367,0.473291,3500.040508,0.029983,0.035547,45,0.000776,0,10,0.521065,0.285003
48215,Hidalgo County,,TX,26609,567169,593778,209,185,394,253753,237010,490763,5,0.45044,0.484413,38331.597764,0.038588,0.034832,62,0.001488,0,10,0.296889,0.366781
31055,Douglas County,,NE,35199,552973,588172,245,241,486,405061,416481,821542,5,0.475763,0.509749,183492.472684,0.046791,0.051065,50,0.002223,0,10,0.329091,0.440439
18089,Lake County,,IN,26446,557344,583790,117,148,265,328641,338273,666914,5,0.447683,0.478158,7296.86752,0.031119,0.037311,8,0.000706,0,10,0.557436,0.284639
34031,Passaic County,,NJ,32002,550275,582277,102,165,267,358821,455592,814413,5,0.425721,0.461789,445.353359,0.031644,0.04513,47,0.000486,0,10,0.695233,0.273731
35001,Bernalillo County,,NM,41589,535247,576836,299,279,578,512574,502245,1014819,4,0.48045,0.517388,48512.843034,0.064458,0.061833,35,0.001985,0,10,0.383796,0.600095
25023,Plymouth County,,MA,26482,550062,576544,107,135,242,373939,359072,733011,5,0.417051,0.450369,1795.138672,0.031591,0.036534,33,0.000558,0,10,0.651724,0.285112
20091,Johnson County,,KS,39869,532369,572238,288,271,559,556736,503985,1060721,5,0.478803,0.515148,135119.491329,0.057216,0.058176,14,0.00214,0,10,0.327952,0.529623
12009,Brevard County,,FL,30113,534011,564124,380,332,712,460669,340655,801324,4,0.478505,0.521756,17702.407623,0.080474,0.074981,5,0.002117,0,10,0.328216,0.729801
42029,Chester County,,PA,30641,528084,558725,192,203,395,420667,377949,798616,5,0.442651,0.480084,4074.758383,0.052275,0.053521,47,0.000968,0,10,0.57752,0.464635
26049,Genesee County,,MI,21973,524108,546081,116,176,292,210194,249509,459703,5,0.448795,0.482172,16323.338375,0.024906,0.038429,43,0.000723,0,10,0.412529,0.233992
39095,Lucas County,,OH,24856,521088,545944,129,170,299,217412,286533,503945,5,0.442269,0.476465,13780.191985,0.030225,0.042577,43,0.000732,0,10,0.499397,0.273438
36067,Onondaga County,,NY,23585,516613,540198,184,225,409,217677,259582,477259,5,0.447096,0.486556,16593.178097,0.047893,0.056672,36,0.000954,0,10,0.536224,0.426636
34005,Burlington County,,NJ,30327,507522,537849,170,200,370,389106,373441,762547,5,0.44567,0.482378,2070.615296,0.048391,0.054645,47,0.000871,0,10,0.610351,0.431791
12105,Polk County,,FL,28854,508179,537033,358,305,663,572176,433905,1006081,5,0.470805,0.513368,20080.507525,0.074288,0.06675,5,0.001983,0,10,0.311633,0.667423
20173,Sedgwick County,,KS,27272,507309,534581,208,216,424,256433,278337,534770,5,0.470156,0.502832,152039.222664,0.040158,0.044916,14,0.001789,0,10,0.342761,0.382952
55025,Dane County,,WI,29489,501257,530746,271,263,534,396339,383492,779831,5,0.473636,0.510672,69247.451219,0.05365,0.054186,8,0.001775,0,10,0.351297,0.48744
6097,Sonoma County,,CA,26638,500163,526801,132,145,277,295889,302473,598362,5,0.426904,0.460189,1952.36222,0.033061,0.032599,45,0.000769,0,10,0.542424,0.312919
22051,Jefferson Parish,,LA,34997,491734,526731,178,254,432,422044,497053,919097,5,0.46758,0.505409,28134.851219,0.041341,0.052825,12,0.001155,0,10,0.373448,0.392872
25013,Hampden County,,MA,18242,506865,525107,110,147,257,185777,219493,405270,5,0.421341,0.455713,496.253196,0.031778,0.041356,33,0.000553,0,10,0.708522,0.283562
51810,Virginia Beach city,,VA,55008,461345,516353,355,377,732,618453,664501,1282954,5,0.483247,0.530094,62145.944561,0.074594,0.076304,13,0.002066,0,10,0.313275,0.677679
17197,Will County,,IL,26592,485523,512115,158,201,359,689625,535041,1224666,5,0.456599,0.491032,10387.920121,0.04068,0.048412,8,0.000935,0,10,0.502126,0.371811
36085,Richmond County,,NY,21869,476684,498553,78,132,210,298851,304639,603490,5,0.420016,0.452865,411.598497,0.024681,0.037213,47,0.000383,0,10,0.762076,0.213225
41067,Washington County,,OR,42412,452197,494609,239,201,440,629730,586564,1216294,5,0.454909,0.489757,14277.849085,0.051492,0.044308,45,0.001517,0,10,0.433323,0.483329
12071,Lee County,,FL,26222,465890,492112,456,385,841,716418,456590,1173008,5,0.484008,0.531597,39685.425013,0.083967,0.077336,5,0.002558,0,10,0.239354,0.755335
12127,Volusia County,,FL,28903,461873,490776,340,287,627,481084,379963,861047,5,0.470516,0.511051,14688.8538,0.073475,0.06817,5,0.001855,0,10,0.348242,0.660523
22071,Orleans Parish,,LA,33687,456913,490600,236,369,605,419721,574089,993810,5,0.485461,0.530881,75882.194898,0.053758,0.067022,12,0.00152,0,10,0.283392,0.503728
37081,Guilford County,,NC,32172,455145,487317,299,247,546,404499,395255,799754,5,0.456396,0.496034,48717.890496,0.062452,0.055227,37,0.001906,0,10,0.374362,0.574176
6099,Stanislaus County,,CA,23288,462507,485795,93,120,213,383881,348286,732167,5,0.408674,0.441037,732.611326,0.020722,0.025383,45,0.000558,0,10,0.597806,0.198794
53063,Spokane County,,WA,25878,456809,482687,200,195,395,330071,300023,630094,4,0.447162,0.482693,31208.346164,0.036035,0.037611,45,0.001464,0,10,0.3755,0.35048
33011,Hillsborough County,,NH,28411,454029,482440,166,186,352,344612,350464,695076,5,0.437482,0.474213,7003.731945,0.045187,0.048739,33,0.000875,0,10,0.583888,0.40797
27037,Dakota County,,MN,35734,444118,479852,190,192,382,461708,452009,913717,4,0.461469,0.493679,52285.881154,0.035048,0.038997,39,0.001484,0,10,0.34159,0.33272
42011,Berks County,,PA,16158,463614,479772,112,143,255,220622,202579,423201,5,0.420707,0.454763,2016.697024,0.030183,0.039173,47,0.000557,0,10,0.660948,0.261156
48121,Denton County,,TX,48615,428331,476946,368,285,653,1082157,836415,1918572,5,0.476945,0.515663,39927.244037,0.071544,0.059491,62,0.00245,0,10,0.307145,0.664864
39151,Stark County,,OH,17878,456249,474127,88,123,211,183767,197221,380988,5,0.428691,0.459809,5996.573677,0.021867,0.031777,41,0.000522,0,10,0.544634,0.199141
42133,York County,,PA,17078,455507,472585,143,151,294,270160,220225,490385,5,0.427082,0.461328,10781.359661,0.03562,0.038205,47,0.000764,0,10,0.578771,0.315541
55133,Waukesha County,,WI,27863,441854,469717,127,151,278,351036,333403,684439,5,0.44297,0.474523,10880.625193,0.029565,0.035801,8,0.000825,0,10,0.488071,0.274801
19153,Polk County,,IA,24682,435640,460322,223,206,429,321879,298274,620153,5,0.461469,0.495291,222210.844012,0.038271,0.040112,8,0.002022,0,10,0.287789,0.35966
8001,Adams County,,CO,48695,404728,453423,189,173,362,725502,645412,1370914,4,0.458987,0.489692,25142.871665,0.042742,0.038845,35,0.001348,0,10,0.42935,0.404265
6095,Solano County,,CA,33503,417128,450631,146,175,321,413691,413558,827249,5,0.446058,0.479883,4078.328149,0.034857,0.039903,45,0.000869,0,10,0.49696,0.328588
45045,Greenville County,,SC,27401,422914,450315,294,204,498,372322,316017,688339,5,0.454169,0.489974,22491.231299,0.06577,0.052296,37,0.001805,0,10,0.41422,0.604655
22033,East Baton Rouge Parish,,LA,28184,421141,449325,181,192,373,335417,378645,714062,5,0.455854,0.489741,38950.622973,0.03873,0.043057,12,0.001311,0,10,0.414989,0.370992
1097,Mobile County,,AL,18195,428010,446205,159,168,327,159583,180675,340258,5,0.443995,0.47793,29092.669192,0.034529,0.037596,6,0.001086,0,10,0.437606,0.328376
6053,Monterey County,,CA,30228,415902,446130,169,187,356,288494,371484,659978,5,0.447879,0.482633,2900.584608,0.042801,0.042783,45,0.000974,0,10,0.498537,0.403355
6083,Santa Barbara County,,CA,28130,407869,435999,141,160,301,265065,317121,582186,5,0.437545,0.471219,2012.219635,0.035854,0.038802,45,0.000825,0,10,0.560952,0.338293
42129,Westmoreland County,,PA,15272,419409,434681,80,109,189,176044,174981,351025,5,0.417959,0.448334,5810.890243,0.021011,0.029175,41,0.000477,0,10,0.628872,0.192821
47093,Knox County,,TN,26286,407101,433387,266,229,495,326754,304004,630758,5,0.4614,0.497987,82070.474685,0.057109,0.055215,51,0.002037,0,10,0.396904,0.542874
12117,Seminole County,,FL,43891,389230,433121,261,237,498,651683,623297,1274980,5,0.464469,0.501161,3376.575402,0.067651,0.06382,5,0.001465,0,10,0.519041,0.618773
41005,Clackamas County,,OR,35159,393074,428233,143,139,282,491820,438173,929993,5,0.421688,0.454763,6549.813145,0.030344,0.029433,45,0.000964,0,10,0.521857,0.294638
5119,Pulaski County,,AR,28841,398399,427240,217,211,428,315169,337510,652679,5,0.465314,0.498926,141989.160612,0.041792,0.044384,52,0.001715,0,10,0.343388,0.399236
48157,Fort Bend County,,TX,32902,394242,427144,237,159,396,857464,571207,1428671,5,0.451765,0.482677,10251.112895,0.055491,0.039234,62,0.001481,0,10,0.454588,0.511904
17089,Kane County,,IL,30798,389802,420600,133,167,300,514966,462189,977155,5,0.449978,0.482091,6009.612321,0.035058,0.042346,8,0.000782,0,10,0.555069,0.321417
18003,Allen County,,IN,19487,400861,420348,156,174,330,174584,185827,360411,5,0.456057,0.487614,32089.796395,0.033076,0.040244,42,0.000994,0,10,0.436286,0.302995
34021,Mercer County,,NJ,24095,394814,418909,117,166,283,280680,308410,589090,5,0.439296,0.473193,826.999493,0.036541,0.04795,47,0.000576,0,10,0.749182,0.320002
39017,Butler County,,OH,26421,390541,416962,131,147,278,333172,323135,656307,5,0.443931,0.474957,16338.590617,0.03299,0.038462,42,0.000804,0,10,0.531722,0.299196
36071,Orange County,,NY,21163,387608,408771,135,207,342,280620,272974,553594,5,0.439674,0.47813,2484.530734,0.039495,0.051871,47,0.000665,0,10,0.560652,0.348412
53011,Clark County,,WA,22514,383894,406408,174,161,335,408012,312213,720225,5,0.433347,0.467405,14622.290061,0.034697,0.033354,45,0.001182,0,10,0.435602,0.335011
49049,Utah County,,UT,28854,368963,397817,185,203,388,420187,423386,843573,4,0.456667,0.491292,24768.487609,0.037098,0.043673,45,0.0013,0,10,0.405423,0.361023
32031,Washoe County,,NV,23588,371347,394935,208,205,413,355940,305868,661808,5,0.452363,0.488184,21334.778823,0.044214,0.044404,45,0.001388,0,10,0.436177,0.42453
27003,Anoka County,,MN,25975,367546,393521,88,102,190,372661,354987,727648,5,0.420591,0.449799,11392.987319,0.012708,0.018584,39,0.000749,0,10,0.352544,0.123583
42077,Lehigh County,,PA,19655,370412,390067,122,151,273,298425,279917,578342,5,0.427974,0.461952,1610.955003,0.03449,0.042632,47,0.000599,0,10,0.710888,0.300145
6107,Tulare County,,CA,17352,361474,378826,73,92,165,210895,200974,411869,5,0.401464,0.430838,478.952255,0.017379,0.019633,45,0.000443,0,10,0.65668,0.16727
47065,Hamilton County,,TN,20141,354949,375090,182,160,342,207700,207239,414939,5,0.44814,0.480235,45370.054541,0.039517,0.038277,51,0.00142,0,10,0.451474,0.382956
12115,Sarasota County,,FL,23124,351871,374995,317,244,561,438525,329919,768444,5,0.459261,0.497933,8137.767388,0.070463,0.061026,5,0.00166,0,10,0.381965,0.62593
42079,Luzerne County,,PA,11153,361291,372444,99,118,217,138177,130979,269156,5,0.416204,0.447683,6384.834298,0.026318,0.032509,47,0.000504,0,10,0.7004,0.224847
12101,Pasco County,,FL,24836,343904,368740,295,258,553,626212,420015,1046227,5,0.458576,0.499333,6360.738665,0.068443,0.062485,5,0.001518,0,10,0.388619,0.606269
29183,St. Charles County,,MO,20111,346073,366184,157,150,307,342859,261014,603873,5,0.450044,0.480317,29565.928291,0.034819,0.035741,14,0.001127,0,10,0.444247,0.321194
51153,Prince William County,,VA,38640,327159,365799,273,279,552,700501,608276,1308777,5,0.467936,0.508312,28457.982398,0.063345,0.062944,13,0.001604,0,10,0.404754,0.578643
37051,Cumberland County,,NC,50387,313029,363416,374,353,727,464149,523334,987483,5,0.484619,0.52844,39032.391966,0.077155,0.07418,37,0.002212,0,10,0.325558,0.711299
29510,St. Louis city,,MO,37163,325573,362736,147,139,286,429427,520191,949618,5,0.454371,0.482541,21486.901981,0.036345,0.037863,14,0.001026,0,10,0.535026,0.337169
33015,Rockingham County,,NH,24186,338348,362534,119,133,252,321030,299397,620427,5,0.420995,0.453787,2504.642239,0.033195,0.036709,33,0.000626,0,10,0.654765,0.298036
16001,Ada County,,ID,22442,339569,362011,222,201,423,381449,310000,691449,5,0.455786,0.490299,77559.392852,0.03962,0.03871,45,0.001702,0,10,0.349549,0.384211
48355,Nueces County,,TX,25907,332744,358651,156,146,302,238941,263824,502765,5,0.43347,0.466075,11598.491464,0.030857,0.030738,62,0.001149,0,10,0.409187,0.299161
34035,Somerset County,,NJ,27444,331124,358568,111,160,271,367494,364683,732177,5,0.432981,0.467459,383.380299,0.035022,0.046847,47,0.000544,0,10,0.745856,0.305975
48061,Cameron County,,TX,17621,338019,355640,100,99,199,149084,168428,317512,5,0.423024,0.451736,3483.268927,0.024445,0.023718,62,0.000688,0,10,0.485559,0.236758
36001,Albany County,,NY,22413,332910,355323,134,159,293,266933,287394,554327,5,0.428213,0.463336,6602.025693,0.034255,0.041855,36,0.000688,0,10,0.595788,0.301297
8013,Boulder County,,CO,35671,319331,355002,262,207,469,350598,368837,719435,4,0.462651,0.496257,15440.85573,0.060776,0.049741,35,0.001602,0,10,0.442425,0.5543
39093,Lorain County,,OH,15127,338885,354012,71,104,175,187896,169397,357293,5,0.426075,0.455279,1507.833006,0.020611,0.029052,41,0.000393,0,10,0.652043,0.18538
41039,Lane County,,OR,21136,331304,352440,165,140,305,234030,226842,460872,5,0.422733,0.456028,11097.161486,0.031495,0.029775,45,0.001116,0,10,0.459033,0.304977
45019,Charleston County,,SC,29828,319237,349065,317,245,562,409422,385269,794691,5,0.465525,0.502789,26538.162825,0.069076,0.06113,37,0.001943,0,10,0.391625,0.637725
36087,Rockland County,,NY,16947,329743,346690,70,124,194,162202,194983,357185,5,0.414743,0.447114,339.806012,0.022184,0.034271,47,0.00034,0,10,0.75295,0.190106
37067,Forsyth County,,NC,21292,324453,345745,216,165,381,260098,249681,509779,5,0.446577,0.479449,31333.005154,0.049089,0.041006,37,0.001418,0,10,0.45776,0.456666
51087,Henrico County,,VA,29298,315615,344913,229,182,411,393243,383984,777227,5,0.447422,0.481765,58602.029926,0.050113,0.043531,13,0.001559,0,10,0.417939,0.454905
51041,Chesterfield County,,VA,23258,320204,343462,211,186,397,347233,302876,650109,5,0.43655,0.473589,52200.597235,0.046292,0.042251,13,0.001423,0,10,0.410574,0.423499
17201,Winnebago County,,IL,15009,327633,342642,93,117,210,154271,154019,308290,5,0.436178,0.465191,3941.025774,0.021344,0.029606,8,0.000575,0,10,0.526834,0.193439
45079,Richland County,,SC,29621,311524,341145,248,232,480,405554,389365,794919,5,0.46286,0.499425,40632.579179,0.056627,0.054876,37,0.001582,0,10,0.448163,0.526914
26161,Washtenaw County,,MI,30013,309842,339855,198,218,416,340974,372883,713857,5,0.459605,0.495302,12418.429174,0.049281,0.054534,43,0.001081,0,10,0.491615,0.439337
42043,Dauphin County,,PA,17649,320499,338148,131,135,266,198229,210760,408989,5,0.422268,0.455414,9690.970491,0.033191,0.035631,47,0.000701,0,10,0.616566,0.292459
12033,Escambia County,,FL,32185,304156,336341,273,237,510,281224,324448,605672,5,0.466798,0.502886,22224.130026,0.062974,0.055379,5,0.001655,0,10,0.405559,0.590056
1089,Madison County,,AL,17601,315922,333523,221,171,392,228119,198348,426467,5,0.445476,0.479476,27723.540708,0.049131,0.041802,6,0.001471,0,10,0.432779,0.462039
42049,Erie County,,PA,10849,322461,333310,91,134,225,68421,91329,159750,5,0.428452,0.460731,8996.823426,0.023969,0.035478,41,0.000512,0,10,0.601116,0.215118
42095,Northampton County,,PA,15714,312487,328201,94,119,213,254803,218590,473393,5,0.412737,0.44451,864.665638,0.026904,0.034249,47,0.000458,0,10,0.751107,0.231134
23005,Cumberland County,,ME,20335,306994,327329,165,165,330,238451,233058,471509,5,0.432189,0.467323,12259.39776,0.043287,0.044102,33,0.000914,0,10,0.579333,0.394036
36027,Dutchess County,,NY,15407,308638,324045,93,150,243,189992,184614,374606,5,0.419443,0.454275,1548.741307,0.027109,0.040192,47,0.000467,0,10,0.65393,0.237824
34001,Atlantic County,,NJ,13122,309070,322192,89,113,202,158845,166091,324936,5,0.416091,0.447141,415.020103,0.027019,0.033857,47,0.000433,0,10,0.802451,0.23352
17119,Madison County,,IL,14278,307740,322018,88,104,192,155695,156960,312655,5,0.433409,0.461366,24210.293017,0.017249,0.022834,14,0.000694,0,10,0.433283,0.160486
9011,New London County,,CT,19017,298783,317800,146,169,315,187518,203419,390937,5,0.430252,0.466211,688.474022,0.041139,0.046472,47,0.000721,0,10,0.639626,0.363166
48339,Montgomery County,,TX,23959,291448,315407,238,163,401,601563,406323,1007886,5,0.448402,0.480371,15133.602275,0.05023,0.035543,62,0.001615,0,10,0.395816,0.474796
18141,St. Joseph County,,IN,16481,296169,312650,104,125,229,142470,166200,308670,5,0.441633,0.470562,5438.344473,0.028178,0.03444,42,0.000623,0,10,0.625028,0.2567
17163,St. Clair County,,IL,18224,292351,310575,140,135,275,172831,184818,357649,5,0.446901,0.476085,20017.126197,0.030363,0.031728,14,0.000957,0,10,0.441531,0.28301
34015,Gloucester County,,NJ,15033,294111,309144,59,83,142,230529,197758,428287,5,0.40469,0.432926,183.988814,0.018223,0.02546,47,0.0003,0,10,0.869821,0.156934
41047,Marion County,,OR,20487,287328,307815,106,102,208,255795,243164,498959,5,0.400626,0.431342,2579.716478,0.019728,0.019744,45,0.000719,0,10,0.560031,0.194261
39099,Mahoning County,,OH,12765,293695,306460,63,86,149,116721,138163,254884,5,0.418643,0.446707,1243.723323,0.015896,0.024184,41,0.000354,0,10,0.638069,0.140725
17111,McHenry County,,IL,18621,287711,306332,70,107,177,272964,230274,503238,5,0.431885,0.460308,1228.141502,0.019688,0.029279,8,0.000417,0,10,0.635072,0.179148
12081,Manatee County,,FL,20076,281746,301822,272,200,472,360426,260341,620767,5,0.452164,0.487598,4339.392206,0.065543,0.052965,5,0.001429,0,10,0.435196,0.581926
31109,Lancaster County,,NE,16849,284304,301153,151,163,314,167420,169058,336478,5,0.45464,0.485173,165548.851218,0.023286,0.031573,50,0.001859,0,10,0.299063,0.224456
48027,Bell County,,TX,47629,253254,300883,348,331,679,479155,493134,972289,5,0.482867,0.52494,31064.078054,0.070221,0.066359,62,0.002196,0,10,0.319629,0.654097
2020,Anchorage Municipality,,AK,24777,274631,299408,274,271,545,280701,354808,635509,4,0.47466,0.512316,80715.788774,0.056047,0.055593,45,0.001972,0,10,0.352104,0.533079
24027,Howard County,,MD,26660,272370,299030,173,169,342,375249,353781,729030,5,0.443931,0.477425,3667.671756,0.049455,0.048104,13,0.000911,0,10,0.633934,0.442377
49011,Davis County,,UT,24372,272835,297207,124,127,251,346799,319010,665809,4,0.43347,0.463704,7055.94694,0.025998,0.029397,45,0.000878,0,10,0.504914,0.253049
55009,Brown County,,WI,13236,283455,296691,85,87,172,146760,144953,291713,5,0.409928,0.438298,15078.976955,0.013324,0.015931,8,0.000678,0,10,0.367347,0.125871
39085,Lake County,,OH,13057,281785,294842,47,75,122,151815,148345,300160,5,0.416712,0.443424,200.575522,0.013408,0.023447,41,0.000267,0,10,0.779942,0.118368
8069,Larimer County,,CO,23689,271123,294812,257,183,440,293545,267989,561534,4,0.458439,0.490316,42665.053562,0.052213,0.039861,35,0.001899,0,10,0.375713,0.488297
48167,Galveston County,,TX,21288,272742,294030,148,123,271,307419,266011,573430,5,0.428571,0.459321,6082.805453,0.033369,0.028893,62,0.001036,0,10,0.481335,0.321678
26065,Ingham County,,MI,24769,269147,293916,142,180,322,247110,296390,543500,5,0.450638,0.484413,16583.993789,0.030875,0.043273,43,0.000858,0,10,0.46935,0.281716
21067,Fayette County,,KY,23061,269880,292941,204,205,409,236797,257343,494140,5,0.461608,0.495356,211636.430508,0.039387,0.043819,42,0.001946,0,10,0.343237,0.370191
6061,Placer County,,CA,20962,270531,291493,118,122,240,467550,343675,811225,5,0.41075,0.443207,2137.261909,0.027478,0.028544,45,0.000724,0,10,0.6122,0.265309
6087,Santa Cruz County,,CA,19867,269240,289107,82,102,184,190512,221337,411849,5,0.407157,0.437267,424.241995,0.020198,0.022727,45,0.000487,0,10,0.659119,0.193761
26139,Ottawa County,,MI,15423,270120,285543,86,90,176,208801,199279,408080,5,0.416882,0.445567,4779.324665,0.018073,0.021283,43,0.000522,0,10,0.489544,0.163122
12083,Marion County,,FL,16148,268190,284338,245,171,416,301840,200812,502652,5,0.44814,0.481402,4949.951867,0.059905,0.046502,5,0.001321,0,10,0.475242,0.532109
45083,Spartanburg County,,SC,11958,270663,282621,122,89,211,159877,141870,301747,5,0.4187,0.447141,5093.988494,0.031048,0.023571,37,0.000821,0,10,0.592249,0.296364
12021,Collier County,,FL,18079,264088,282167,264,212,476,339682,269407,609089,5,0.455719,0.491667,4762.526775,0.064221,0.056378,5,0.001371,0,10,0.452018,0.568533
45063,Lexington County,,SC,18465,261742,280207,143,105,248,245165,213396,458561,5,0.419844,0.449772,12374.318189,0.035099,0.027041,37,0.000992,0,10,0.542741,0.333987
26077,Kalamazoo County,,MI,17284,262371,279655,106,136,242,174731,184739,359470,5,0.440115,0.47085,6323.111079,0.023102,0.034235,43,0.000625,0,10,0.500045,0.2098
42041,Cumberland County,,PA,16050,263564,279614,124,116,240,196596,173958,370554,5,0.417108,0.448389,9372.363818,0.031577,0.030004,47,0.000682,0,10,0.592189,0.28167
22017,Caddo Parish,,LA,16954,262439,279393,116,112,228,178024,196422,374446,5,0.431825,0.461003,15950.887621,0.023263,0.024481,12,0.000852,0,10,0.411897,0.220467
28049,Hinds County,,MS,17422,261753,279175,103,117,220,182066,220949,403015,5,0.427915,0.45867,49535.953714,0.016731,0.022068,12,0.000878,0,10,0.334603,0.160042
53035,Kitsap County,,WA,23693,255398,279091,155,147,302,245954,243118,489072,5,0.424955,0.458984,2605.535663,0.03558,0.034115,45,0.000961,0,10,0.515655,0.341203
29077,Greene County,,MO,20058,256961,277019,164,142,306,239539,231935,471474,5,0.447422,0.477197,69323.753764,0.029012,0.029223,14,0.00144,0,10,0.340524,0.280591
24025,Harford County,,MD,15928,260614,276542,117,127,244,206734,183751,390485,5,0.417562,0.450043,1741.895762,0.032926,0.034552,13,0.000627,0,10,0.617763,0.296191
39155,Trumbull County,,OH,10709,264347,275056,46,67,113,97866,112936,210802,5,0.408511,0.434988,389.061835,0.012087,0.018922,41,0.000258,0,10,0.699581,0.105817
25001,Barnstable County,,MA,12680,261146,273826,119,120,239,158051,144186,302237,5,0.409764,0.441824,1301.010627,0.032536,0.031905,33,0.000598,0,10,0.647679,0.288227
48245,Jefferson County,,TX,16349,257450,273799,96,95,191,148377,181551,329928,5,0.414239,0.443289,6969.516294,0.020752,0.020892,62,0.000683,0,10,0.480734,0.201639
48039,Brazoria County,,TX,18093,255589,273682,118,107,225,321846,256314,578160,5,0.411796,0.442584,4032.54204,0.026599,0.020296,62,0.000819,0,10,0.427171,0.256412
39025,Clermont County,,OH,18455,253740,272195,51,69,120,200312,185697,386009,5,0.420707,0.446257,2504.008571,0.0139,0.020645,42,0.00035,0,10,0.709009,0.125758
6041,Marin County,,CA,19721,251545,271266,89,99,188,215448,224080,439528,5,0.413181,0.442746,1105.558359,0.025645,0.026264,45,0.000514,0,10,0.700774,0.237766
13063,Clayton County,,GA,33700,237389,271089,195,169,364,520642,523991,1044633,5,0.452164,0.48463,11867.511507,0.048297,0.042604,6,0.001203,0,10,0.502057,0.446415
36065,Oneida County,,NY,10270,256167,266437,73,99,172,81007,95900,176907,5,0.409218,0.439084,2681.566944,0.019585,0.02694,36,0.000399,0,10,0.662859,0.173221
36063,Niagara County,,NY,10350,255860,266210,38,67,105,96637,101083,197720,5,0.410421,0.436724,1648.664032,0.01092,0.020295,36,0.000237,0,10,0.710571,0.098286
6079,San Luis Obispo County,,CA,15041,245214,260255,92,103,195,206586,187164,393750,5,0.402463,0.433035,521.694352,0.02074,0.022863,45,0.000555,0,10,0.653071,0.199867
13051,Chatham County,,GA,20549,238440,258989,263,225,488,243057,245733,488790,5,0.46286,0.498573,46066.898804,0.05925,0.052135,5,0.001717,0,10,0.444012,0.555652
48491,Williamson County,,TX,26130,232201,258331,283,185,468,687304,479445,1166749,5,0.456464,0.489269,16026.602144,0.060359,0.041412,62,0.001863,0,10,0.386147,0.564758
37063,Durham County,,NC,22702,235407,258109,233,184,417,338457,331165,669622,5,0.448271,0.48303,16976.443883,0.055636,0.047077,37,0.001406,0,10,0.480654,0.508046
48303,Lubbock County,,TX,18463,238308,256771,136,139,275,201409,201069,402478,5,0.430011,0.462278,73355.385741,0.020656,0.024531,62,0.001419,0,10,0.326458,0.20657
1101,Montgomery County,,AL,18436,238213,256649,153,165,318,179054,208755,387809,5,0.443482,0.477224,37952.13525,0.032061,0.03658,6,0.001104,0,10,0.438139,0.306306
36091,Saratoga County,,NY,16303,237001,253304,129,129,258,214421,187838,402259,5,0.414743,0.447575,10093.223203,0.033768,0.034378,36,0.000691,0,10,0.610552,0.300654
12069,Lake County,,FL,16371,236471,252842,215,152,367,397124,261822,658946,5,0.438983,0.471674,1454.18556,0.056004,0.043996,5,0.001129,0,10,0.544118,0.498014
42069,Lackawanna County,,PA,8047,243912,251959,78,88,166,88154,88830,176984,5,0.406511,0.435286,3385.075173,0.020652,0.024907,47,0.000395,0,10,0.759772,0.174029
26145,Saginaw County,,MI,10809,240999,251808,56,88,144,86118,109282,195400,5,0.418187,0.44649,4269.624715,0.010292,0.018337,43,0.000354,0,10,0.470162,0.093525
37021,Buncombe County,,NC,14723,235468,250191,206,145,351,187693,163231,350924,5,0.441633,0.47321,39626.934195,0.048591,0.03639,37,0.001464,0,10,0.488442,0.464851
29099,Jefferson County,,MO,13279,236782,250061,47,55,102,187640,164840,352480,5,0.401831,0.426861,9055.250227,0.008836,0.009197,14,0.000449,0,10,0.419099,0.086005
12073,Leon County,,FL,21489,228555,250044,177,195,372,249810,286821,536631,5,0.456735,0.490663,26152.64031,0.044469,0.052018,5,0.001224,0,10,0.544179,0.423209
53067,Thurston County,,WA,18105,229684,247789,160,142,302,286454,237988,524442,5,0.41813,0.452121,3137.357284,0.033362,0.030451,45,0.001026,0,10,0.481344,0.324443
51710,Norfolk city,,VA,34576,211514,246090,212,219,431,362977,423326,786303,5,0.456125,0.493175,15498.226684,0.052878,0.055678,13,0.001202,0,10,0.492213,0.478675
53077,Yakima County,,WA,11957,233955,245912,71,78,149,101904,118421,220325,5,0.3942,0.422092,646.264578,0.014072,0.015137,45,0.000482,0,10,0.605054,0.136553
54039,Kanawha County,,WV,11424,233777,245201,75,86,161,85038,95070,180108,5,0.422384,0.450016,70763.522165,0.015906,0.020069,41,0.000731,0,10,0.406035,0.151979
24021,Frederick County,,MD,14091,230716,244807,119,118,237,222434,191966,414400,5,0.425426,0.456283,2355.676772,0.034358,0.034283,13,0.000678,0,10,0.667638,0.314106
29047,Clay County,,MO,18623,223505,242128,123,103,226,263277,229883,493160,5,0.435868,0.463281,28298.569214,0.023859,0.022442,14,0.001015,0,10,0.395324,0.225238
51013,Arlington County,,VA,38848,203087,241935,273,210,483,499612,562868,1062480,5,0.461816,0.496251,9795.701374,0.06731,0.056322,13,0.001476,0,10,0.481929,0.601262
36007,Broome County,,NY,10276,230761,241037,79,115,194,78241,93608,171849,5,0.420476,0.451427,2719.340163,0.020197,0.031557,36,0.000419,0,10,0.655252,0.178019
17167,Sangamon County,,IL,10753,230183,240936,78,93,171,100636,98865,199501,5,0.430312,0.457568,28241.742479,0.013738,0.021444,8,0.000647,0,10,0.440788,0.128182
27163,Washington County,,MN,17854,222946,240800,81,95,176,277086,249260,526346,5,0.425898,0.453543,7030.082769,0.014594,0.020151,39,0.000653,0,10,0.430421,0.138489
51550,Chesapeake city,,VA,23765,216068,239833,147,136,283,320338,293411,613749,5,0.426016,0.458887,8533.921967,0.037847,0.03632,13,0.000899,0,10,0.573923,0.350249
42125,Washington County,,PA,9136,229064,238200,57,61,118,110528,99807,210335,5,0.404104,0.429997,3585.581933,0.012007,0.015503,41,0.000386,0,10,0.53706,0.107867
55101,Racine County,,WI,11717,224257,235974,42,67,109,123811,119023,242834,5,0.403892,0.430702,908.078452,0.009473,0.014223,8,0.000279,0,10,0.543271,0.08647
19113,Linn County,,IA,12444,223487,235931,104,98,202,118646,114862,233508,5,0.424896,0.45319,33347.028948,0.019203,0.020319,8,0.000919,0,10,0.394933,0.180982
18057,Hamilton County,,IN,17677,217968,235645,187,150,337,352028,241688,593716,5,0.445864,0.476801,21679.501653,0.042282,0.038225,42,0.001187,0,10,0.455811,0.385406
37071,Gaston County,,NC,13363,222282,235645,78,61,139,144202,132173,276375,5,0.392387,0.418359,1221.703672,0.019985,0.015464,37,0.000556,0,10,0.650172,0.193087
40027,Cleveland County,,OK,21546,213051,234597,128,133,261,308563,279651,588214,5,0.434021,0.465262,22663.708299,0.025423,0.028208,52,0.001086,0,10,0.39557,0.247159
18039,Elkhart County,,IN,11999,218408,230407,52,71,123,105317,109300,214617,5,0.413905,0.440658,4005.502527,0.010858,0.016845,42,0.000357,0,10,0.531285,0.099294
9005,Litchfield County,,CT,10924,218796,229720,44,84,128,126593,116941,243534,5,0.401621,0.430105,121.275383,0.013976,0.023423,47,0.000237,0,10,0.770941,0.122405
49057,Weber County,,UT,16108,213344,229452,81,74,155,205815,199847,405662,5,0.397156,0.424517,2504.282364,0.017763,0.016819,45,0.000579,0,10,0.573289,0.170786
27137,St. Louis County,,MN,9969,218820,228789,66,70,136,90922,99299,190221,5,0.402358,0.429145,5484.511214,0.005912,0.010065,39,0.000639,0,10,0.315506,0.058755
23031,York County,,ME,11671,216005,227676,79,86,165,162477,141684,304161,5,0.403998,0.432628,4447.37354,0.018475,0.022591,33,0.000477,0,10,0.614254,0.167462
48309,McLennan County,,TX,13730,213611,227341,99,92,191,138240,141884,280124,5,0.409873,0.438921,2771.277624,0.018469,0.016935,62,0.00079,0,10,0.477289,0.18528
17143,Peoria County,,IL,13517,210587,224104,80,99,179,121985,139475,261460,5,0.435374,0.462478,11483.883497,0.017131,0.024843,8,0.000558,0,10,0.534614,0.157474
12001,Alachua County,,FL,20689,203362,224051,168,173,341,229442,258144,487586,5,0.452897,0.485498,6051.435645,0.04629,0.049977,5,0.001056,0,10,0.629472,0.432164
48479,Webb County,,TX,8042,215733,223775,59,51,110,64087,80501,144588,5,0.397876,0.422645,2467.635653,0.013369,0.011645,62,0.000471,0,10,0.496927,0.131406
13215,Muscogee County,,GA,24471,199110,223581,182,172,354,226221,251207,477428,5,0.445088,0.478971,39267.159015,0.040517,0.039864,6,0.001273,0,10,0.462591,0.382115
45051,Horry County,,SC,14958,208142,223100,296,201,497,254770,155252,410022,5,0.436178,0.474837,20000.358063,0.055419,0.04592,37,0.001726,0,10,0.329371,0.495837
6047,Merced County,,CA,11714,210911,222625,47,66,113,188659,176366,365025,5,0.393543,0.420095,111.232377,0.011626,0.015974,45,0.000283,0,10,0.814111,0.109193
42019,Butler County,,PA,9415,211695,221110,56,68,124,110466,95377,205843,5,0.407427,0.43393,3128.376805,0.014319,0.018603,41,0.000337,0,10,0.638362,0.128339
42007,Beaver County,,PA,8242,212458,220700,36,57,93,74896,76006,150902,5,0.403467,0.428966,1404.914828,0.007802,0.015387,41,0.000234,0,10,0.643483,0.069502
22055,Lafayette Parish,,LA,14683,205908,220591,86,86,172,190697,182267,372964,5,0.408348,0.437104,3987.518481,0.017869,0.019197,12,0.000619,0,10,0.504004,0.174714
22103,St. Tammany Parish,,LA,13598,206935,220533,111,133,244,205031,157602,362633,5,0.433898,0.465397,4832.27922,0.027078,0.032238,12,0.00074,0,10,0.541604,0.260558
12111,St. Lucie County,,FL,13723,205296,219019,173,149,322,331157,219260,550417,5,0.431582,0.465316,1058.756418,0.048003,0.041638,5,0.000886,0,10,0.591407,0.42675
8035,Douglas County,,CO,21826,194959,216785,191,154,345,460509,337190,797699,4,0.450506,0.48093,5248.530894,0.047433,0.040738,35,0.001216,0,10,0.539694,0.445934
37057,Davidson County,,NC,11597,203550,215147,47,42,89,118604,110495,229099,5,0.380245,0.403141,826.228073,0.009015,0.007959,37,0.000387,0,10,0.603411,0.090824
51107,Loudoun County,,VA,17265,197497,214762,215,205,420,498936,328249,827185,5,0.450044,0.486431,10532.228479,0.056156,0.053352,13,0.001212,0,10,0.519429,0.510224
22019,Calcasieu Parish,,LA,10108,204378,214486,67,73,140,96228,99796,196024,5,0.397876,0.425738,4112.632582,0.011842,0.013452,12,0.000508,0,10,0.460706,0.116776
47149,Rutherford County,,TN,15100,198756,213856,171,132,303,281677,216942,498619,5,0.436798,0.467784,34628.575149,0.036204,0.031002,51,0.001411,0,10,0.411117,0.343787
45007,Anderson County,,SC,9940,202445,212385,73,50,123,118030,102237,220267,5,0.382613,0.40733,1791.201191,0.017611,0.013499,37,0.000549,0,10,0.650034,0.176234
28047,Harrison County,,MS,20639,191304,211943,177,211,388,174381,199901,374282,4,0.460018,0.494873,43875.261166,0.038406,0.043174,12,0.001202,0,10,0.377109,0.36615
12091,Okaloosa County,,FL,21624,189913,211537,225,212,437,214662,230119,444781,4,0.460156,0.495009,13408.273928,0.051471,0.049489,5,0.001426,0,10,0.458731,0.487113
55087,Outagamie County,,WI,12537,197173,209710,55,62,117,166422,161048,327470,5,0.39767,0.423703,2723.042991,0.005945,0.009809,8,0.000444,0,10,0.417006,0.055149
51700,Newport News city,,VA,26356,183304,209660,191,197,388,274660,307685,582345,5,0.447813,0.483881,21661.337188,0.045411,0.0468,13,0.001168,0,10,0.467709,0.41691
24013,Carroll County,,MD,10417,198730,209147,39,55,94,133795,111276,245071,5,0.385397,0.410113,235.740122,0.009725,0.014874,13,0.000249,0,10,0.726476,0.089255
6007,Butte County,,CA,12446,195803,208249,73,89,162,149191,139859,289050,5,0.387292,0.416135,806.041053,0.013748,0.016646,45,0.000462,0,10,0.629719,0.131015
44003,Kent County,,RI,11305,196630,207935,47,68,115,150041,147420,297461,5,0.401674,0.428342,99.16321,0.01522,0.021133,33,0.000252,0,10,0.861622,0.133708
26093,Livingston County,,MI,11989,195752,207741,49,83,132,172899,131736,304635,5,0.415978,0.443886,1655.929689,0.010875,0.019245,43,0.000289,0,10,0.525281,0.095675
13245,Richmond County,,GA,20636,186860,207496,155,162,317,196632,232959,429591,5,0.439989,0.473655,36060.265064,0.036243,0.038705,37,0.001089,0,10,0.496276,0.346238
39041,Delaware County,,OH,17012,190427,207439,107,98,205,269481,178643,448124,5,0.431885,0.459359,8124.386119,0.024081,0.026475,41,0.000653,0,10,0.51129,0.217289
12097,Osceola County,,FL,21053,183878,204931,179,161,340,478210,385470,863680,5,0.437482,0.471636,974.649574,0.05133,0.046558,5,0.000941,0,10,0.647835,0.459978
26147,St. Clair County,,MI,8975,195741,204716,28,56,84,95196,92464,187660,5,0.399792,0.42525,574.390205,0.007286,0.013631,43,0.00018,0,10,0.612662,0.064527
26121,Muskegon County,,MI,7682,195691,203373,38,50,88,77560,78110,155670,5,0.398806,0.423785,1238.016859,0.007497,0.011051,43,0.000257,0,10,0.618778,0.067375
41029,Jackson County,,OR,11019,190660,201679,107,93,200,144841,119300,264141,5,0.394656,0.424164,1446.380639,0.018712,0.018827,45,0.00072,0,10,0.589688,0.184699
18163,Vanderburgh County,,IN,11350,189891,201241,74,78,152,106886,112659,219545,5,0.420361,0.447222,63561.717611,0.012257,0.017315,42,0.000741,0,10,0.367888,0.115961
20177,Shawnee County,,KS,10234,189854,200088,75,79,154,89880,94640,184520,5,0.416542,0.443479,22632.035222,0.012416,0.016399,14,0.000752,0,10,0.402293,0.119311
8123,Weld County,,CO,14961,184265,199226,112,105,217,293391,212907,506298,4,0.420534,0.449924,16020.852738,0.021751,0.020855,35,0.000937,0,10,0.403646,0.21302
39103,Medina County,,OH,11043,188061,199104,42,59,101,161735,131038,292773,5,0.404956,0.430539,501.749736,0.010766,0.015446,41,0.000242,0,10,0.69887,0.093963
37035,Catawba County,,NC,11624,187051,198675,71,66,137,113332,111430,224762,5,0.403785,0.430132,2329.117194,0.01644,0.015596,37,0.000534,0,10,0.563686,0.163387
9007,Middlesex County,,CT,12001,186454,198455,63,80,143,145282,133892,279174,5,0.401989,0.430024,44.338303,0.019488,0.02479,47,0.000317,0,10,0.865987,0.169211
48423,Smith County,,TX,12792,185226,198018,92,84,176,168047,155437,323484,5,0.402727,0.431651,2799.522071,0.015523,0.014703,62,0.000728,0,10,0.452222,0.154529
17019,Champaign County,,IL,14709,183204,197913,134,149,283,119544,142004,261548,5,0.450242,0.480219,26836.370602,0.03061,0.036854,8,0.000891,0,10,0.492107,0.278128
26021,Berrien County,,MI,10269,187179,197448,60,72,132,78105,89791,167896,5,0.418586,0.444998,844.578412,0.016236,0.02073,42,0.000366,0,10,0.688575,0.146342
45091,York County,,SC,10422,186652,197074,164,91,255,193370,129096,322466,5,0.420822,0.449067,5987.313342,0.04159,0.023753,37,0.001016,0,10,0.572181,0.385132
37025,Cabarrus County,,NC,13315,180736,194051,124,79,203,191151,146518,337669,5,0.408511,0.436561,3015.048362,0.032234,0.021427,37,0.000787,0,10,0.619771,0.298905
19163,Scott County,,IA,12035,181888,193923,124,97,221,115852,102727,218579,5,0.4398,0.466086,12842.253088,0.031571,0.0249,8,0.000822,0,10,0.550638,0.286085
6025,Imperial County,,CA,11441,181103,192544,34,43,77,106743,107966,214709,5,0.388222,0.411957,73.517615,0.009423,0.011084,45,0.00022,0,10,0.846465,0.08852
26115,Monroe County,,MI,9332,182432,191764,28,37,65,106659,94628,201287,5,0.398237,0.421615,301.920142,0.006585,0.010136,43,0.000179,0,10,0.696951,0.056154
46099,Minnehaha County,,SD,13236,177295,190531,128,123,251,152919,147772,300691,5,0.42905,0.459511,174065.689012,0.01764,0.020778,50,0.00169,0,10,0.241108,0.172091
50007,Chittenden County,,VT,11991,178346,190337,114,126,240,109717,118059,227776,5,0.418358,0.450477,13866.230524,0.028751,0.032123,33,0.000637,0,10,0.589767,0.255838
55139,Winnebago County,,WI,11417,178361,189778,61,63,124,141418,140297,281715,5,0.396848,0.423052,2730.061466,0.006906,0.010289,8,0.000487,0,10,0.395344,0.065559
55059,Kenosha County,,WI,10483,178084,188567,40,54,94,124956,110269,235225,5,0.403467,0.428695,454.054723,0.009815,0.011954,8,0.000257,0,10,0.618644,0.088384
36111,Ulster County,,NY,8904,179280,188184,57,86,143,109491,102725,212216,5,0.404104,0.432737,626.338142,0.015528,0.023929,47,0.00029,0,10,0.742424,0.130444
26075,Jackson County,,MI,7838,180076,187914,35,50,85,76530,76180,152710,5,0.395978,0.420828,361.924226,0.006882,0.011127,43,0.000219,0,10,0.663529,0.059782
13021,Bibb County,,GA,11425,175304,186729,88,91,179,105033,123984,229017,5,0.412626,0.441933,21854.300267,0.017057,0.019458,6,0.000748,0,10,0.464376,0.165595
13057,Cherokee County,,GA,15104,170646,185750,135,113,248,266658,192929,459587,5,0.425603,0.455561,3705.658075,0.034329,0.030849,6,0.000909,0,10,0.603718,0.3277
55105,Rock County,,WI,8474,175681,184155,46,65,111,86793,82038,168831,5,0.40469,0.430849,1979.50217,0.006297,0.010569,8,0.000336,0,10,0.449737,0.056886
36083,Rensselaer County,,NY,10853,172884,183737,56,78,134,133185,135814,268999,5,0.403097,0.430865,1808.882093,0.013231,0.021796,36,0.000311,0,10,0.706715,0.111556
47163,Sullivan County,,TN,10184,173497,183681,51,46,97,96811,94589,191400,5,0.394301,0.418875,34458.43443,0.010918,0.010044,51,0.000571,0,10,0.461283,0.110169
39057,Greene County,,OH,16230,167427,183657,93,109,202,172602,184745,357347,5,0.433653,0.462522,7151.871476,0.021427,0.029565,42,0.000599,0,10,0.538984,0.197199
10005,Sussex County,,DE,7960,175189,183149,105,85,190,134772,87037,221809,5,0.40786,0.436263,1783.4162,0.026611,0.023445,47,0.000553,0,10,0.647676,0.233155
39165,Warren County,,OH,13760,169385,183145,97,92,189,260799,204540,465339,5,0.434943,0.461312,4696.206613,0.025301,0.026323,42,0.000608,0,10,0.606672,0.230886
6017,El Dorado County,,CA,12638,170413,183051,71,84,155,192281,159745,352026,5,0.39084,0.419146,4105.999083,0.01424,0.016302,45,0.00045,0,10,0.650811,0.136009
17161,Rock Island County,,IL,9700,172956,182656,66,71,137,80472,93670,174142,5,0.427498,0.452523,4459.513989,0.01484,0.017271,8,0.000465,0,10,0.555245,0.135298
53073,Whatcom County,,WA,11187,171265,182452,108,92,200,135922,123139,259061,5,0.404583,0.433811,1290.557165,0.02297,0.020005,45,0.000729,0,10,0.590155,0.223801
42021,Cambria County,,PA,6217,176212,182429,36,44,80,41743,49279,91022,5,0.382756,0.406288,603.322481,0.007069,0.010234,41,0.000233,0,10,0.696365,0.062265
51760,Richmond city,,VA,21990,160155,182145,158,143,301,300001,327983,627984,5,0.433776,0.466374,41217.837963,0.034201,0.032825,13,0.001155,0,10,0.42593,0.31804
34037,Sussex County,,NJ,9889,171878,181767,38,77,115,114382,102734,217116,5,0.391987,0.419553,42.553534,0.011603,0.022071,47,0.000187,0,10,0.857189,0.093986
5007,Benton County,,AR,12663,168568,181231,166,114,280,210097,152560,362657,5,0.438419,0.466699,27482.169309,0.033712,0.026634,52,0.001312,0,10,0.401969,0.320207
39045,Fairfield County,,OH,11999,168914,180913,54,48,102,165564,135801,301365,5,0.401831,0.426416,4489.788727,0.008315,0.009843,41,0.000413,0,10,0.431967,0.073972
21117,Kenton County,,KY,15093,165750,180843,52,54,106,188783,187516,376299,5,0.410915,0.435748,8772.895209,0.012887,0.014303,42,0.000467,0,10,0.574245,0.11964
35013,Dona Ana County,,NM,13802,166867,180669,89,90,179,142531,144046,286577,5,0.411025,0.439421,2705.212253,0.020512,0.021782,35,0.000671,0,10,0.527656,0.200423
12019,Clay County,,FL,16824,163671,180495,151,122,273,262564,215817,478381,5,0.429951,0.460894,2762.388642,0.041816,0.034699,5,0.000896,0,10,0.63583,0.390895
39133,Portage County,,OH,11883,168585,180468,41,57,98,142527,140392,282919,5,0.406134,0.431516,625.074145,0.009366,0.015564,41,0.000238,0,10,0.659722,0.08059
37133,Onslow County,,NC,33380,145960,179340,331,347,678,282598,321903,604501,5,0.484543,0.527734,24782.084259,0.072536,0.074274,45,0.001867,0,10,0.34954,0.663052
6113,Yolo County,,CA,14804,163500,178304,76,83,159,208212,209548,417760,5,0.401464,0.429888,534.3448,0.017569,0.020017,45,0.000452,0,10,0.70774,0.166581
37129,New Hanover County,,NC,14081,164083,178164,199,147,346,195201,176764,371965,5,0.426607,0.460569,8274.450994,0.044706,0.037525,37,0.001208,0,10,0.47595,0.409261
1125,Tuscaloosa County,,AL,10149,167935,178084,88,90,178,104517,99278,203795,5,0.418073,0.446761,19869.905287,0.014894,0.017739,6,0.000736,0,10,0.395149,0.14412
42051,Fayette County,,PA,5867,171865,177732,22,28,50,44868,48789,93657,5,0.384,0.40561,2206.522841,0.003584,0.005702,41,0.000181,0,10,0.594758,0.030178
17113,McLean County,,IL,10998,166169,177167,101,109,210,102631,103671,206302,5,0.440746,0.468094,9463.722036,0.020221,0.026412,8,0.000698,0,10,0.468258,0.185881
45003,Aiken County,,SC,8667,168428,177095,77,58,135,91476,85835,177311,5,0.395672,0.421425,5342.252921,0.019064,0.013866,37,0.000582,0,10,0.565793,0.186214
4027,Yuma County,,AZ,12015,164798,176813,93,79,172,123536,117287,240823,5,0.402305,0.430322,438.503449,0.02288,0.020758,45,0.00059,0,10,0.689039,0.220805
6089,Shasta County,,CA,8676,167456,176132,82,82,164,123851,103940,227791,5,0.386415,0.414453,947.867128,0.015451,0.016041,45,0.000527,0,10,0.659707,0.149797
42107,Schuylkill County,,PA,5362,170484,175846,31,31,62,60230,55096,115326,5,0.371823,0.392752,77.644038,0.006883,0.006724,47,0.00018,0,10,0.848348,0.056146
39089,Licking County,,OH,9260,165345,174605,44,54,98,131030,113833,244863,5,0.391987,0.41665,2623.775909,0.007438,0.010698,41,0.000334,0,10,0.481169,0.066611
12005,Bay County,,FL,14164,160073,174237,173,151,324,128060,123499,251559,5,0.437171,0.470416,15316.047067,0.038381,0.037587,5,0.001192,0,10,0.479313,0.370661
4025,Yavapai County,,AZ,12443,161596,174039,129,102,231,203611,141613,345224,5,0.41396,0.443821,1566.471389,0.031665,0.024855,45,0.000817,0,10,0.60923,0.299016
45015,Berkeley County,,SC,19920,153831,173751,134,110,244,248286,225211,473497,5,0.421168,0.451698,2355.855095,0.037603,0.03154,37,0.000807,0,10,0.648946,0.350946
39023,Clark County,,OH,8541,164319,172860,31,43,74,73415,81563,154978,5,0.39922,0.423378,1341.676684,0.006158,0.009453,42,0.000241,0,10,0.58361,0.055911
18127,Porter County,,IN,10393,160188,170581,43,55,98,140833,116194,257027,5,0.409873,0.435205,1095.908105,0.010208,0.014641,8,0.000288,0,10,0.685272,0.091002
37001,Alamance County,,NC,7861,162500,170361,53,46,99,92482,81915,174397,5,0.392488,0.416732,1080.117888,0.01185,0.011202,37,0.000401,0,10,0.625331,0.115708
53005,Benton County,,WA,11118,158171,169289,95,82,177,171840,148959,320799,5,0.400052,0.428532,5469.292977,0.017571,0.016046,45,0.000682,0,10,0.499281,0.171932
36093,Schenectady County,,NY,9982,158472,168454,59,72,131,117821,115399,233220,5,0.401464,0.428586,1638.494314,0.015221,0.019997,36,0.000327,0,10,0.719241,0.130775
17179,Tazewell County,,IL,9440,158681,168121,42,46,88,95551,89637,185188,5,0.393846,0.418332,2627.552182,0.006218,0.008464,8,0.000337,0,10,0.496863,0.055557
23019,Penobscot County,,ME,8024,159940,167964,53,64,117,79475,81896,161371,5,0.390393,0.416759,2394.884731,0.012109,0.016337,33,0.000339,0,10,0.66825,0.108262
25015,Hampshire County,,MA,11673,155594,167267,67,78,145,123424,131055,254479,5,0.405438,0.433062,222.97183,0.019876,0.023532,33,0.000358,0,10,0.821187,0.17794
20209,Wyandotte County,,KS,12911,153409,166320,46,52,98,147703,170038,317741,5,0.410476,0.43488,3352.837776,0.010534,0.011628,14,0.000388,0,10,0.578901,0.100282
42055,Franklin County,,PA,6097,159522,165619,52,50,102,72559,57637,130196,5,0.3819,0.406098,3388.917457,0.010511,0.010805,47,0.000339,0,10,0.594536,0.094003
22073,Ouachita Parish,,LA,9763,154203,163966,65,80,145,85695,91712,177407,5,0.407806,0.436155,23659.532972,0.01051,0.014512,12,0.000607,0,10,0.387415,0.10176
34011,Cumberland County,,NJ,6333,157604,163937,35,42,77,66388,69109,135497,5,0.384288,0.407482,60.825473,0.010564,0.012735,47,0.000191,0,10,0.922727,0.089627
1117,Shelby County,,AL,13237,149943,163180,99,90,189,221397,177563,398960,5,0.419844,0.448334,7107.412818,0.021817,0.021444,6,0.000718,0,10,0.525569,0.212214
55073,Marathon County,,WI,7157,155151,162308,48,54,102,69805,69679,139484,5,0.381047,0.405366,1479.37163,0.004941,0.005114,8,0.000394,0,10,0.455827,0.04655
51650,Hampton city,,VA,20124,142178,162302,126,128,254,197820,220042,417862,5,0.428811,0.460541,6233.937525,0.033962,0.035349,13,0.000764,0,10,0.600313,0.315959
33013,Merrimack County,,NH,10469,151425,161894,56,76,132,140359,127675,268034,5,0.404796,0.43233,982.21996,0.015133,0.021907,33,0.000324,0,10,0.741259,0.137088
18095,Madison County,,IN,7907,153506,161413,37,46,83,71373,74011,145384,5,0.397721,0.422211,2019.206099,0.005792,0.009273,42,0.000296,0,10,0.510629,0.053829
1003,Baldwin County,,AL,9033,152298,161331,125,92,217,133216,89693,222909,5,0.41108,0.440386,10881.1087,0.027129,0.019684,6,0.000875,0,10,0.466334,0.259091
26025,Calhoun County,,MI,8552,152523,161075,44,52,96,70306,76700,147006,5,0.400835,0.425955,619.931959,0.008451,0.011492,43,0.000274,0,10,0.592105,0.073716
42089,Monroe County,,PA,9335,151656,160991,66,96,162,161706,124881,286587,5,0.398444,0.428342,577.511883,0.016995,0.025778,47,0.000313,0,10,0.753252,0.138433
5143,Washington County,,AR,13120,147116,160236,131,105,236,170074,161686,331760,5,0.42732,0.456228,34433.726031,0.022151,0.021318,52,0.001178,0,10,0.311015,0.215216
9013,Tolland County,,CT,10304,149487,159791,40,56,96,129431,119487,248918,5,0.399376,0.42487,17.186146,0.011464,0.017871,47,0.000215,0,10,0.911017,0.099267
25003,Berkshire County,,MA,6096,153312,159408,51,66,117,39689,44277,83966,5,0.394251,0.420557,168.818982,0.014549,0.019053,33,0.00027,0,10,0.842656,0.126273
27109,Olmsted County,,MN,9756,149602,159358,85,79,164,88429,91221,179650,5,0.422791,0.449338,12889.604825,0.013441,0.016317,39,0.000724,0,10,0.375347,0.125316
4015,Mohave County,,AZ,12534,146508,159042,113,96,209,174656,128810,303466,5,0.401359,0.431342,2538.19766,0.022233,0.021094,45,0.000791,0,10,0.539161,0.216708
8101,Pueblo County,,CO,7338,151572,158910,64,52,116,80301,68490,148791,5,0.397516,0.422157,7674.226131,0.012644,0.012417,35,0.000607,0,10,0.449062,0.126004
51510,Alexandria city,,VA,30284,128577,158861,200,165,365,380393,417164,797557,5,0.449451,0.481576,3854.493334,0.055761,0.047057,13,0.001074,0,10,0.613005,0.498832
12015,Charlotte County,,FL,10535,147042,157577,164,93,257,165685,124213,289898,5,0.416542,0.445432,624.400815,0.044731,0.027695,5,0.000802,0,10,0.613596,0.385879
24017,Charles County,,MD,10206,147140,157346,67,72,139,164717,133554,298271,5,0.400887,0.427935,421.213484,0.020369,0.021306,13,0.000402,0,10,0.732558,0.189583
34019,Hunterdon County,,NJ,10059,146930,156989,46,66,112,104338,89838,194176,5,0.401779,0.428261,30.662705,0.014036,0.020143,47,0.000223,0,10,0.872084,0.114298
10001,Kent County,,DE,8997,147961,156958,106,86,192,125015,71254,196269,5,0.41097,0.439328,1740.028972,0.028697,0.025114,47,0.000561,0,10,0.66042,0.252036
15001,Hawaii County,,HI,6559,150332,156891,85,67,152,94101,72717,166818,5,0.400417,0.427148,125.54357,0.021426,0.01933,45,0.000528,0,10,0.807939,0.206591
47125,Montgomery County,,TN,19937,136590,156527,187,180,367,222966,210011,432977,5,0.452697,0.485862,24527.962581,0.04458,0.042163,51,0.001262,0,10,0.457547,0.417258
13139,Hall County,,GA,9794,146612,156406,88,77,165,145858,125182,271040,5,0.408511,0.436344,4652.197828,0.01956,0.017655,6,0.000703,0,10,0.532587,0.192457
24043,Washington County,,MD,7149,148870,156019,54,55,109,106876,89731,196607,5,0.388418,0.41326,5039.925384,0.012303,0.014725,13,0.000373,0,10,0.654018,0.113391
36013,Chautauqua County,,NY,5920,149659,155579,26,42,68,32062,39554,71616,5,0.394605,0.418224,1010.504533,0.007151,0.013093,36,0.000185,0,10,0.72833,0.064397
30111,Yellowstone County,,MT,9333,146060,155393,99,94,193,92896,80374,173270,5,0.405277,0.434652,93788.714734,0.014011,0.01524,45,0.001376,0,10,0.316719,0.141357
42013,Blair County,,PA,4934,150422,155356,26,34,60,33702,35659,69361,5,0.378558,0.400591,276.658341,0.003962,0.007672,41,0.000177,0,10,0.6997,0.032694
55131,Washington County,,WI,8504,146692,155196,31,41,72,114267,98087,212354,5,0.381662,0.404606,205.643474,0.003978,0.005535,8,0.000241,0,10,0.614618,0.036452
18157,Tippecanoe County,,IN,13616,139846,153462,108,132,240,116273,126721,242994,5,0.440683,0.470562,18546.078645,0.021784,0.032206,42,0.000758,0,10,0.46139,0.198916
38017,Cass County,,ND,11003,141060,152063,113,104,217,135400,120344,255744,5,0.423783,0.452648,137799.18986,0.010948,0.014114,39,0.001729,0,10,0.191838,0.108943
12085,Martin County,,FL,11702,140282,151984,116,86,202,159228,128754,287982,5,0.414128,0.442475,184.782457,0.035218,0.027997,5,0.000599,0,10,0.785652,0.312458
42075,Lebanon County,,PA,5731,144470,150201,36,38,74,74051,62765,136816,5,0.383712,0.406749,235.001572,0.008108,0.009957,47,0.000201,0,10,0.800089,0.065499
37097,Iredell County,,NC,8417,141124,149541,114,67,181,117879,97260,215139,5,0.403998,0.430566,8286.635673,0.02948,0.016586,37,0.000735,0,10,0.603144,0.273246
29019,Boone County,,MO,11708,137117,148825,123,126,249,115640,115812,231452,5,0.444637,0.473101,50909.627526,0.021755,0.027148,14,0.001115,0,10,0.38427,0.206542
48251,Johnson County,,TX,11099,137634,148733,57,54,111,172265,142001,314266,5,0.388615,0.413802,857.384823,0.011,0.010508,62,0.000492,0,10,0.596774,0.112306
15009,Maui County,,HI,6356,142376,148732,75,68,143,76858,71163,148021,5,0.402463,0.429047,62.976721,0.021252,0.019775,45,0.00046,0,10,0.881804,0.202987
4021,Pinal County,,AZ,12051,136351,148402,185,113,298,453774,286120,739894,5,0.420016,0.45045,3613.389454,0.042586,0.027503,45,0.001144,0,10,0.498991,0.392541
26005,Allegan County,,MI,8649,139372,148021,30,33,63,105588,97691,203279,5,0.382185,0.404199,263.625672,0.004983,0.007078,43,0.000197,0,10,0.676113,0.041832
13151,Henry County,,GA,11060,136779,147839,148,122,270,304478,217997,522475,5,0.428153,0.459375,5619.330362,0.038739,0.030519,6,0.00092,0,10,0.580149,0.3594
27145,Stearns County,,MN,10025,137316,147341,61,61,122,122344,129049,251393,5,0.395062,0.421072,4839.434068,0.004677,0.006698,39,0.0006,0,10,0.330563,0.045929
44009,Washington County,,RI,8181,138688,146869,45,57,102,89589,82071,171660,5,0.397259,0.422727,69.717361,0.013443,0.017803,33,0.000238,0,10,0.886657,0.116577
18081,Johnson County,,IN,11509,135346,146855,68,54,122,175416,148787,324203,5,0.397876,0.423188,4852.973953,0.012216,0.010903,42,0.000505,0,10,0.421745,0.108832
6055,Napa County,,CA,8425,138059,146484,47,54,101,118252,111463,229715,5,0.385542,0.410303,28.103022,0.011961,0.012875,45,0.00028,0,10,0.889897,0.11243
19013,Black Hawk County,,IA,8268,137799,146067,69,64,133,60138,71581,131719,5,0.408456,0.434185,22397.684798,0.008616,0.011004,8,0.000683,0,10,0.294304,0.083215
16027,Canyon County,,ID,9407,136652,146059,99,78,177,199751,150510,350261,5,0.385639,0.413449,8419.778032,0.015396,0.012725,45,0.000799,0,10,0.454268,0.1508
23011,Kennebec County,,ME,6655,139201,145856,42,44,86,78511,72807,151318,5,0.375642,0.398448,1279.697239,0.009086,0.009736,33,0.000288,0,10,0.684397,0.081017
12053,Hernando County,,FL,9207,136567,145774,120,75,195,176059,114193,290252,5,0.41108,0.438406,120.513378,0.035686,0.024993,5,0.000613,0,10,0.771686,0.313735
28059,Jackson County,,MS,10488,134698,145186,86,86,172,100128,105707,205835,5,0.41119,0.439844,8774.324673,0.019519,0.019677,12,0.000608,0,10,0.485717,0.185105
48183,Gregg County,,TX,10635,134546,145181,67,60,127,120299,129852,250151,5,0.39084,0.416623,1341.300233,0.010547,0.009446,62,0.000545,0,10,0.490189,0.107187
45013,Beaufort County,,SC,13876,130922,144798,214,149,363,158991,125349,284340,5,0.441189,0.473481,5867.103621,0.05391,0.041942,5,0.001223,0,10,0.543117,0.489165
55117,Sheboygan County,,WI,5642,139029,144671,33,39,72,50337,53220,103557,5,0.382375,0.405203,359.871416,0.005532,0.00563,8,0.000244,0,10,0.625,0.050682
42081,Lycoming County,,PA,5668,138897,144565,35,50,85,38516,43783,82299,5,0.387585,0.412202,4336.685178,0.005556,0.010245,47,0.00026,0,10,0.552525,0.048417
18063,Hendricks County,,IN,9812,134441,144253,61,48,109,178967,128847,307814,5,0.402621,0.427257,3901.42841,0.012502,0.009848,42,0.000445,0,10,0.509658,0.111923
37101,Johnston County,,NC,8832,135255,144087,89,53,142,155770,112421,268191,5,0.388615,0.413639,1165.679073,0.021768,0.011903,37,0.000566,0,10,0.59693,0.200033
26017,Bay County,,MI,6303,137546,143849,29,35,64,50920,54017,104937,5,0.38001,0.402219,530.052023,0.003696,0.005606,43,0.000196,0,10,0.648649,0.03058
48441,Taylor County,,TX,14343,129095,143438,103,109,212,103284,118374,221658,5,0.422442,0.452159,25143.852369,0.018143,0.020488,62,0.000901,0,10,0.419158,0.180457
22079,Rapides Parish,,LA,7584,135835,143419,51,52,103,66199,69454,135653,5,0.393998,0.419173,4644.182711,0.007479,0.008737,12,0.000426,0,10,0.440395,0.072589
47187,Williamson County,,TN,12103,131237,143340,145,100,245,213827,161479,375306,5,0.435683,0.462804,8211.816033,0.03845,0.02772,51,0.001003,0,10,0.583292,0.362208
47165,Sumner County,,TN,10059,133153,143212,80,62,142,151110,122536,273646,5,0.415528,0.441417,6395.627107,0.020331,0.014466,51,0.000674,0,10,0.542717,0.195575
39139,Richland County,,OH,6889,135779,142668,31,43,74,60356,67404,127760,5,0.390343,0.413596,1094.678439,0.005547,0.007401,41,0.000213,0,10,0.551208,0.048438
45041,Florence County,,SC,8033,133780,141813,55,51,106,77902,81176,159078,5,0.383568,0.408442,1157.546771,0.012526,0.012533,37,0.000411,0,10,0.634585,0.121711
36075,Oswego County,,NY,6839,134877,141716,27,36,63,59017,63400,122417,5,0.382423,0.404905,471.234008,0.005422,0.009674,36,0.000177,0,10,0.716667,0.046412
48485,Wichita County,,TX,15484,126160,141644,107,120,227,84312,117717,202029,4,0.415023,0.446859,22824.033835,0.02176,0.022478,62,0.000915,0,10,0.435693,0.210748
17115,Macon County,,IL,6870,134255,141125,34,51,85,38994,49119,88113,5,0.40469,0.429655,3459.533959,0.004889,0.009984,8,0.000295,0,10,0.513627,0.042426
12109,St. Johns County,,FL,11293,129774,141067,184,104,288,249036,159669,408705,5,0.430735,0.459484,1297.120551,0.050884,0.032811,5,0.001049,0,10,0.655662,0.470741
39173,Wood County,,OH,10509,130464,140973,49,64,113,123170,122622,245792,5,0.407968,0.434201,2515.115033,0.008854,0.014536,43,0.000301,0,10,0.547264,0.075739
39169,Wayne County,,OH,6787,133962,140749,21,31,52,64472,66676,131148,5,0.385494,0.4074,303.617955,0.003179,0.006288,41,0.000149,0,10,0.672348,0.026112
42085,Mercer County,,PA,5332,134993,140325,25,30,55,44572,45265,89837,5,0.380104,0.401758,630.34846,0.004419,0.006377,41,0.000177,0,10,0.64678,0.038098
28033,DeSoto County,,MS,9760,130220,139980,90,75,165,188089,125559,313648,5,0.406457,0.434364,16363.562314,0.015425,0.013243,52,0.000763,0,10,0.346939,0.146656
48135,Ector County,,TX,8772,130827,139599,81,66,147,105376,99379,204755,5,0.391338,0.41779,14469.140378,0.012409,0.010568,62,0.000809,0,10,0.377439,0.127517
1015,Calhoun County,,AL,7572,131785,139357,49,50,99,57641,63659,121300,5,0.387977,0.412636,4041.28938,0.007752,0.008908,6,0.000409,0,10,0.495614,0.077198
42027,Centre County,,PA,9423,129866,139289,99,116,215,65956,75408,141364,5,0.422094,0.453082,6254.975615,0.022599,0.030983,41,0.000557,0,10,0.575295,0.198447
39003,Allen County,,OH,6248,132937,139185,31,37,68,46953,56733,103686,5,0.388075,0.4109,1465.718811,0.005127,0.007203,43,0.000228,0,10,0.534615,0.044249
17099,LaSalle County,,IL,6345,131198,137543,31,35,66,67721,61993,129714,5,0.381805,0.404525,2301.087451,0.004939,0.005519,8,0.000241,0,10,0.619841,0.043687
31153,Sarpy County,,NE,15775,121641,137416,109,105,214,219981,192398,412379,4,0.437856,0.464898,19023.955058,0.022482,0.02431,50,0.000924,0,10,0.449803,0.214391
48041,Brazos County,,TX,15523,121854,137377,120,119,239,145028,166162,311190,5,0.424075,0.45517,5597.151752,0.019848,0.023542,62,0.000956,0,10,0.378263,0.196366
37179,Union County,,NC,7883,129474,137357,135,62,197,181999,115477,297476,5,0.401202,0.427311,2051.303567,0.037363,0.01691,37,0.000783,0,10,0.682164,0.338377
13153,Houston County,,GA,11402,125873,137275,147,118,265,129447,110195,239642,5,0.426016,0.456717,38822.186353,0.029779,0.026972,6,0.00111,0,10,0.420264,0.2849
39029,Columbiana County,,OH,5876,130954,136830,19,29,48,49769,54959,104728,5,0.376563,0.397743,298.606287,0.00399,0.006005,41,0.000143,0,10,0.663441,0.03453
12113,Santa Rosa County,,FL,12297,124386,136683,137,109,246,174255,143040,317295,5,0.425426,0.455469,2607.043739,0.035117,0.029762,5,0.000865,0,10,0.574285,0.336612
8077,Mesa County,,CO,8231,127979,136210,87,78,165,96243,76641,172884,5,0.40241,0.43023,10839.049415,0.015948,0.016033,35,0.000706,0,10,0.44495,0.158177
26045,Eaton County,,MI,10865,124432,135297,40,49,89,125521,123040,248561,5,0.399584,0.424354,697.385255,0.00581,0.010492,43,0.000259,0,10,0.606494,0.050247
37151,Randolph County,,NC,7796,127469,135265,33,33,66,83690,82806,166496,5,0.371778,0.393213,197.115871,0.00552,0.006062,37,0.000292,0,10,0.710526,0.058415
35045,San Juan County,,NM,11953,123041,134994,59,61,120,122289,136255,258544,5,0.388615,0.414507,1067.190396,0.011288,0.01189,35,0.000478,0,10,0.516901,0.113082
41017,Deschutes County,,OR,9605,125368,134973,119,97,216,181684,124166,305850,5,0.393443,0.423313,7768.467694,0.019414,0.017261,45,0.000855,0,10,0.505487,0.193489
42001,Adams County,,PA,6104,128787,134891,27,26,53,75312,62633,137945,5,0.373405,0.393837,248.218638,0.005818,0.006256,47,0.000185,0,10,0.822581,0.050674
37147,Pitt County,,NC,9827,124969,134796,103,92,195,111162,105744,216906,5,0.406188,0.435422,12342.073454,0.021721,0.020283,37,0.000778,0,10,0.482331,0.208865
28121,Rankin County,,MS,10059,124568,134627,76,78,154,142974,113910,256884,5,0.403998,0.432357,13820.969969,0.010371,0.013387,12,0.000658,0,10,0.356929,0.100192
48375,Potter County,,TX,13662,120810,134472,69,69,138,143004,156629,299633,5,0.408348,0.434798,43235.719674,0.011866,0.012725,62,0.000792,0,10,0.403165,0.119436
36045,Jefferson County,,NY,15717,118634,134351,140,156,296,104117,128100,232217,5,0.436054,0.469558,6989.040277,0.036387,0.039337,36,0.00078,0,10,0.553678,0.330942
33017,Strafford County,,NH,9111,124865,133976,52,59,111,113522,102594,216116,5,0.396132,0.421804,435.847772,0.013985,0.017272,33,0.000297,0,10,0.802678,0.124411
18091,LaPorte County,,IN,5968,127905,133873,22,29,51,56775,51690,108465,5,0.387146,0.409543,302.091355,0.005138,0.006521,8,0.000167,0,10,0.752874,0.045729
18035,Delaware County,,IN,7354,124815,132169,42,54,96,56413,67832,124245,5,0.403573,0.428993,3190.841372,0.00575,0.011027,42,0.000329,0,10,0.479944,0.052595
1103,Morgan County,,AL,7238,124726,131964,47,45,92,69363,73419,142782,5,0.385107,0.409771,3863.312988,0.007438,0.007387,6,0.00043,0,10,0.447671,0.073044
48329,Midland County,,TX,9695,122220,131915,104,80,184,132170,119955,252125,5,0.392939,0.420991,30066.967674,0.015155,0.01256,62,0.001099,0,10,0.34611,0.155805
51161,Roanoke County,,VA,10700,121151,131851,47,46,93,102744,98920,201664,5,0.386561,0.410411,13562.150801,0.008246,0.010338,37,0.000456,0,10,0.478083,0.080304
4005,Coconino County,,AZ,14154,117428,131582,69,76,145,129604,142893,272497,5,0.39552,0.42315,735.977479,0.017827,0.017843,45,0.000485,0,10,0.691597,0.172917
9015,Windham County,,CT,6638,124822,131460,22,41,63,70995,72551,143546,5,0.378465,0.40127,1.064375,0.005652,0.012756,47,0.000131,0,10,0.932447,0.046213
12061,Indian River County,,FL,7419,123443,130862,110,71,181,116455,77675,194130,5,0.412349,0.439138,142.980701,0.034066,0.023754,5,0.000569,0,10,0.811675,0.301796
6023,Humboldt County,,CA,7571,123227,130798,67,76,143,70045,73708,143753,5,0.382613,0.409462,405.594194,0.013575,0.014803,45,0.000426,0,10,0.712587,0.130275
47009,Blount County,,TN,6589,123962,130551,62,42,104,77095,65975,143070,5,0.39731,0.421208,3609.027288,0.014336,0.009696,51,0.000588,0,10,0.557666,0.142486
48139,Ellis County,,TX,9777,120766,130543,52,52,104,166605,125937,292542,5,0.393141,0.418197,370.215602,0.010767,0.010165,62,0.000423,0,10,0.673624,0.109054
13117,Forsyth County,,GA,10759,119642,130401,121,80,201,229295,130252,359547,5,0.411355,0.439247,2281.983695,0.033426,0.021642,6,0.000773,0,10,0.628331,0.312974
39007,Ashtabula County,,OH,5587,123924,129511,17,27,44,47213,48630,95843,5,0.377396,0.398394,15.992461,0.00346,0.006879,41,0.000121,0,10,0.853276,0.028471
37159,Rowan County,,NC,7070,122136,129206,40,38,78,82385,82204,164589,5,0.373768,0.395557,595.86521,0.009018,0.007603,37,0.000337,0,10,0.680408,0.092348
12017,Citrus County,,FL,7662,121530,129192,104,58,162,107534,71750,179284,5,0.405063,0.430594,245.92025,0.030309,0.018668,5,0.000583,0,10,0.765927,0.273029
37045,Cleveland County,,NC,6493,122532,129025,26,26,52,55842,57411,113253,5,0.350405,0.368034,49.033874,0.003636,0.004956,37,0.000259,0,10,0.71954,0.042089
5131,Sebastian County,,AR,9570,118636,128206,51,47,98,93407,99683,193090,5,0.394251,0.418576,5959.314006,0.00918,0.008786,52,0.00049,0,10,0.468358,0.089908
53057,Skagit County,,WA,8127,119876,128003,58,56,114,96213,81029,177242,5,0.391088,0.416461,325.037015,0.013065,0.012012,45,0.000393,0,10,0.683401,0.126751
55063,La Crosse County,,WI,6935,120741,127676,59,58,117,66632,66321,132953,5,0.384625,0.409706,3849.241399,0.005928,0.006186,39,0.000483,0,10,0.398362,0.056308
39109,Miami County,,OH,7077,120258,127335,24,29,53,77662,72472,150134,5,0.384432,0.406288,590.288267,0.004267,0.005723,42,0.000186,0,10,0.612903,0.037676
36069,Ontario County,,NY,6929,119807,126736,34,42,76,77753,69292,147045,5,0.391238,0.414833,1746.920274,0.006517,0.010439,36,0.000225,0,10,0.571014,0.057049
17091,Kankakee County,,IL,6224,120070,126294,25,42,67,58663,52161,110824,5,0.400626,0.424544,542.358599,0.005074,0.009085,8,0.000196,0,10,0.650406,0.045099
19193,Woodbury County,,IA,7954,118209,126163,40,53,93,50513,63527,114040,5,0.406242,0.430713,11460.061979,0.005674,0.009449,8,0.000443,0,10,0.435065,0.053374
4003,Cochise County,,AZ,13775,110811,124586,98,89,187,107471,116813,224284,5,0.413793,0.44197,1582.983059,0.024482,0.021996,45,0.00063,0,10,0.562572,0.233244
40031,Comanche County,,OK,16262,108020,124282,97,117,214,104644,124539,229183,5,0.43292,0.46263,11422.420109,0.023237,0.027531,52,0.000708,0,10,0.512774,0.222143
16055,Kootenai County,,ID,8062,116007,124069,96,75,171,119599,86289,205888,5,0.385639,0.412625,4378.290782,0.015029,0.012291,45,0.000746,0,10,0.505149,0.147497
55039,Fond du Lac County,,WI,5847,118193,124040,33,34,67,60070,60788,120858,5,0.375412,0.396848,250.945245,0.003288,0.003617,8,0.000262,0,10,0.672831,0.030374
19103,Johnson County,,IA,11958,111706,123664,120,121,241,112082,117896,229978,5,0.443802,0.471837,34554.946839,0.02218,0.028531,8,0.001011,0,10,0.395443,0.206812
6039,Madera County,,CA,7306,115679,122985,38,41,79,110315,94928,205243,5,0.371598,0.393685,16.215052,0.008421,0.008911,45,0.000232,0,10,0.908537,0.077698
18019,Clark County,,IN,8559,113962,122521,36,32,68,107701,95031,202732,5,0.384625,0.406641,2730.854406,0.006324,0.005254,42,0.000358,0,10,0.438834,0.060824
37155,Robeson County,,NC,5168,116899,122067,34,34,68,48088,54653,102741,5,0.374908,0.397011,558.58592,0.007093,0.006052,37,0.000277,0,10,0.587179,0.071007
34041,Warren County,,NJ,7246,114312,121558,34,50,84,99867,78551,178418,5,0.380858,0.40485,18.593114,0.009925,0.013768,47,0.000171,0,10,0.915535,0.079323
29097,Jasper County,,MO,8162,113272,121434,55,50,105,83332,79856,163188,5,0.39608,0.420828,8026.62721,0.008342,0.008002,14,0.000551,0,10,0.3789,0.082193
34009,Cape May County,,NJ,6792,114560,121352,43,59,102,67512,68700,136212,5,0.390095,0.415294,83.414257,0.012654,0.017691,47,0.000226,0,10,0.898361,0.107276
48181,Grayson County,,TX,7529,113470,120999,48,42,90,86184,76068,162252,5,0.384818,0.408377,1102.463157,0.009111,0.008508,62,0.000434,0,10,0.587843,0.092849
6031,Kings County,,CA,9118,111616,120734,56,63,119,104920,107154,212074,5,0.401884,0.427989,140.828138,0.015198,0.017596,45,0.000338,0,10,0.748304,0.143225
35049,Santa Fe County,,NM,9667,110869,120536,93,76,169,103167,101125,204292,5,0.410256,0.437484,1812.056371,0.025421,0.020545,35,0.000613,0,10,0.646931,0.241751
23001,Androscoggin County,,ME,6153,114216,120369,37,43,80,70375,68711,139086,5,0.377488,0.400374,1175.209382,0.007513,0.010176,33,0.000266,0,10,0.643137,0.067789
18105,Monroe County,,IN,11744,108157,119901,104,112,216,93591,105054,198645,5,0.435374,0.464258,16931.681877,0.022834,0.027826,42,0.000748,0,10,0.488484,0.211462
13073,Columbia County,,GA,10529,109265,119794,104,83,187,144313,108166,252479,5,0.405866,0.434337,9992.064646,0.024973,0.021754,37,0.000732,0,10,0.557613,0.240397
48451,Tom Green County,,TX,11471,107595,119066,97,105,202,79410,93372,172782,5,0.403414,0.434364,52263.792976,0.016651,0.018858,62,0.001044,0,10,0.355914,0.165925
22015,Bossier Parish,,LA,12316,106741,119057,91,86,177,141556,133266,274822,5,0.418415,0.446327,7350.290026,0.019408,0.019094,12,0.000649,0,10,0.496795,0.184117
21015,Boone County,,KY,10629,107990,118619,63,53,116,155407,128668,284075,5,0.411796,0.436751,10236.037349,0.014639,0.013093,42,0.000548,0,10,0.497869,0.13519
29071,Franklin County,,MO,5708,112768,118476,28,32,60,67539,62205,129744,5,0.384673,0.407075,1754.926732,0.003274,0.003804,14,0.000306,0,10,0.460784,0.031588
36089,St. Lawrence County,,NY,5283,113111,118394,28,40,68,22928,28229,51157,5,0.384914,0.408431,469.360084,0.005481,0.009046,36,0.000179,0,10,0.696567,0.045392
21093,Hardin County,,KY,12983,105098,118081,92,95,187,102399,106013,208412,5,0.426548,0.454693,12525.074773,0.021357,0.02123,42,0.000693,0,10,0.498633,0.200459
39055,Geauga County,,OH,6425,111378,117803,15,27,42,72380,66814,139194,5,0.388566,0.410167,5.566874,0.003563,0.007844,41,0.000108,0,10,0.945869,0.028997
45085,Sumter County,,SC,9448,108102,117550,90,83,173,56226,68595,124821,5,0.413292,0.44139,3098.989882,0.021802,0.021512,37,0.000607,0,10,0.575743,0.211698
36079,Putnam County,,NY,7825,109688,117513,22,44,66,88681,81387,170068,5,0.381757,0.405013,5.228978,0.006754,0.013884,47,0.000127,0,10,0.910606,0.054231
47179,Washington County,,TN,8244,109029,117273,66,48,114,92749,85896,178645,5,0.40437,0.428912,22943.808923,0.014914,0.012027,51,0.000673,0,10,0.517997,0.149135
18167,Vigo County,,IN,7235,109743,116978,42,54,96,50222,58269,108491,5,0.401306,0.426633,8506.890634,0.004686,0.009013,42,0.000404,0,10,0.407581,0.043196
51003,Albemarle County,,VA,10982,105967,116949,110,95,205,109598,107832,217430,5,0.420189,0.448931,16341.261347,0.028923,0.024462,13,0.000736,0,10,0.597619,0.26677
37191,Wayne County,,NC,9359,107368,116727,67,69,136,62158,70121,132279,5,0.406941,0.433605,1726.118672,0.015606,0.018131,37,0.000474,0,10,0.571677,0.153054
37085,Harnett County,,NC,9426,106911,116337,84,79,163,147263,118305,265568,5,0.396951,0.425222,1113.590409,0.019247,0.017826,37,0.000554,0,10,0.57227,0.186598
26087,Lapeer County,,MI,6712,109280,115992,17,26,43,71792,65914,137706,5,0.374588,0.395112,152.339489,0.003657,0.004391,43,0.000123,0,10,0.807692,0.030546
36101,Steuben County,,NY,5662,109757,115419,35,45,80,41631,44153,85784,5,0.377349,0.400646,1527.72611,0.006058,0.009149,36,0.000238,0,10,0.494902,0.052265
36117,Wayne County,,NY,5701,109480,115181,16,26,42,58495,59662,118157,5,0.374451,0.395193,183.771786,0.00227,0.006189,36,0.000127,0,10,0.688034,0.018877
26091,Lenawee County,,MI,5610,109513,115123,19,29,48,53575,50761,104336,5,0.386999,0.408838,227.847064,0.003705,0.006038,43,0.000136,0,10,0.748768,0.029756
1081,Lee County,,AL,9840,104667,114507,93,96,189,126389,113490,239879,5,0.416542,0.44592,8778.227058,0.018206,0.022177,6,0.000704,0,10,0.480931,0.177832
51179,Stafford County,,VA,11641,102423,114064,104,94,198,199194,167652,366846,5,0.412349,0.441553,3109.964315,0.027445,0.02612,13,0.000638,0,10,0.626377,0.256203
51177,Spotsylvania County,,VA,8416,105027,113443,64,74,138,158619,125326,283945,5,0.395011,0.4227,1878.151676,0.016683,0.020038,13,0.000427,0,10,0.649742,0.156607
41043,Linn County,,OR,7534,105790,113324,53,44,97,103554,89785,193339,5,0.372409,0.394987,157.781647,0.010766,0.008452,45,0.000379,0,10,0.729637,0.104528
42073,Lawrence County,,PA,3841,109402,113243,12,20,32,31418,33846,65264,5,0.378885,0.399262,65.736549,0.001239,0.004188,41,0.000103,0,10,0.794737,0.009083
37049,Craven County,,NC,12326,100866,113192,109,105,214,87085,95386,182471,5,0.424544,0.454112,4235.349594,0.029527,0.029318,37,0.00068,0,10,0.631644,0.27485
19061,Dubuque County,,IA,5018,108130,113148,30,32,62,35074,36797,71871,5,0.385591,0.407411,2723.712762,0.004519,0.005437,8,0.000288,0,10,0.473684,0.041721
54011,Cabell County,,WV,6933,105937,112870,34,47,81,55977,58227,114204,5,0.405491,0.429617,9007.055037,0.004335,0.009372,41,0.000389,0,10,0.373299,0.040367
18067,Howard County,,IN,5666,106458,112124,31,33,64,44718,48575,93293,5,0.380198,0.402219,938.704616,0.004199,0.005378,42,0.00026,0,10,0.499289,0.037911
45077,Pickens County,,SC,7905,104124,112029,40,39,79,82006,85749,167755,5,0.392337,0.415647,474.98289,0.00858,0.011051,37,0.000336,0,10,0.700255,0.087496
51740,Portsmouth city,,VA,12129,99849,111978,63,60,123,136314,143932,280246,5,0.404477,0.430404,2207.373583,0.018083,0.017901,13,0.000418,0,10,0.738806,0.1703
41019,Douglas County,,OR,6400,105545,111945,64,43,107,60656,56272,116928,5,0.372725,0.395258,88.117675,0.012265,0.008535,45,0.000422,0,10,0.738147,0.118363
39157,Tuscarawas County,,OH,4557,107147,111704,18,24,42,44901,46813,91714,5,0.373859,0.394135,143.782235,0.00166,0.003791,41,0.000154,0,10,0.628333,0.013118
13095,Dougherty County,,GA,8555,102885,111440,57,62,119,70900,83658,154558,5,0.386027,0.412511,24299.036761,0.011378,0.013388,5,0.000522,0,10,0.521071,0.108757
1055,Etowah County,,AL,5532,105822,111354,31,30,61,50812,51909,102721,5,0.368081,0.389426,676.014189,0.004781,0.005364,6,0.000278,0,10,0.587838,0.046485
22057,Lafourche Parish,,LA,5211,106140,111351,23,31,54,60548,60090,120638,5,0.365801,0.38712,94.306841,0.002697,0.004722,12,0.000184,0,10,0.646169,0.024314
55089,Ozaukee County,,WI,6790,104489,111279,25,32,57,73610,66388,139998,5,0.384384,0.406668,57.461827,0.004827,0.007009,8,0.000186,0,10,0.760417,0.044205
21059,Daviess County,,KY,4771,106487,111258,26,32,58,36202,36383,72585,5,0.38001,0.402474,12025.140933,0.002081,0.003411,42,0.000357,0,10,0.312834,0.020541
13113,Fayette County,,GA,9524,101304,110828,78,70,148,113272,104889,218161,5,0.414239,0.440739,1248.050322,0.022911,0.020325,6,0.000508,0,10,0.709627,0.21584
55027,Dodge County,,WI,6367,104456,110823,30,31,61,73798,71115,144913,5,0.374954,0.396034,207.147614,0.002444,0.003092,8,0.000244,0,10,0.688235,0.023246
37023,Burke County,,NC,5805,104944,110749,23,26,49,48175,52400,100575,6,0.337138,0.355642,189.857854,0.00251,0.003544,37,0.000249,0,10,0.607143,0.028129
6057,Nevada County,,CA,7386,103220,110606,52,57,109,93754,81023,174777,5,0.374543,0.39873,598.257597,0.011868,0.012263,45,0.00033,0,10,0.823446,0.111953
22109,Terrebonne Parish,,LA,5548,104846,110394,34,43,77,59330,67168,126498,5,0.381,0.404932,298.64399,0.006219,0.007609,12,0.000253,0,10,0.600833,0.060022
42097,Northumberland County,,PA,4459,105183,109642,25,25,50,48083,49224,97307,6,0.330465,0.346381,70.39023,0.003612,0.003191,47,0.00018,0,10,0.698006,0.029601
42039,Crawford County,,PA,4443,105043,109486,18,20,38,34703,35364,70067,5,0.367201,0.386306,414.3598,0.002495,0.002893,41,0.000149,0,10,0.647186,0.020867
55127,Walworth County,,WI,6970,101883,108853,34,39,73,85348,76073,161421,5,0.382137,0.404905,155.380226,0.005652,0.006777,8,0.000239,0,10,0.665854,0.050702
36015,Chemung County,,NY,5208,103595,108803,24,33,57,34314,36545,70859,5,0.376424,0.398069,567.692452,0.004648,0.007814,36,0.000173,0,10,0.606349,0.039508
26037,Clinton County,,MI,7005,101680,108685,28,28,56,77622,71050,148672,5,0.37345,0.394027,187.109214,0.003871,0.003732,43,0.000183,0,10,0.802299,0.03153
27139,Scott County,,MN,7024,101478,108502,42,47,89,160756,119048,279804,5,0.397567,0.422076,1776.150475,0.006032,0.008469,39,0.000383,0,10,0.445175,0.057781
47189,Wilson County,,TN,7765,100470,108235,46,36,82,117604,88225,205829,5,0.395367,0.418766,3411.393828,0.010711,0.007341,51,0.00047,0,10,0.511054,0.106155
22063,Livingston Parish,,LA,6193,101816,108009,45,40,85,121212,86066,207278,5,0.362051,0.383648,940.900598,0.00623,0.004458,12,0.000364,0,10,0.466667,0.059193
37127,Nash County,,NC,8226,99599,107825,35,32,67,87140,87304,174444,5,0.361624,0.38252,333.629796,0.006497,0.006212,37,0.000287,0,10,0.616463,0.063356
30063,Missoula County,,MT,9147,98280,107427,82,86,168,84495,84877,169372,5,0.4,0.428738,38537.82011,0.014415,0.016007,45,0.000851,0,10,0.420892,0.14301
48367,Parker County,,TX,8709,98717,107426,52,43,95,141844,109260,251104,5,0.383952,0.407644,964.968435,0.010438,0.007658,62,0.000464,0,10,0.603247,0.10483
17037,DeKalb County,,IL,8732,98314,107046,30,40,70,102831,92579,195410,5,0.393543,0.417247,227.577046,0.005125,0.008495,8,0.000211,0,10,0.662805,0.044949
13097,Douglas County,,GA,10903,96129,107032,98,84,182,198823,169630,368453,5,0.419787,0.447656,3555.491323,0.02805,0.022326,6,0.000609,0,10,0.664254,0.260661
27171,Wright County,,MN,6429,100440,106869,31,37,68,131328,100547,231875,5,0.371149,0.392735,600.178464,0.002914,0.002814,39,0.000312,0,10,0.527665,0.028418
39043,Erie County,,OH,5446,100812,106258,25,29,54,51214,54474,105688,5,0.387683,0.409787,299.588667,0.005244,0.006524,41,0.000165,0,10,0.720766,0.044388
51085,Hanover County,,VA,6413,99839,106252,35,32,67,90812,75151,165963,5,0.356133,0.37609,643.51805,0.004443,0.005278,13,0.000342,0,10,0.451219,0.042556
48381,Randall County,,TX,11251,94988,106239,75,65,140,158285,141913,300198,5,0.389996,0.416081,41185.326683,0.011165,0.010951,62,0.000917,0,10,0.35411,0.11409
55035,Eau Claire County,,WI,7368,98637,106005,58,54,112,81392,82199,163591,5,0.381805,0.406179,8653.797559,0.005871,0.00516,39,0.000492,0,10,0.409322,0.055367
53015,Cowlitz County,,WA,5700,99982,105682,45,41,86,71741,62469,134210,5,0.372228,0.394444,903.83006,0.008786,0.008082,45,0.000346,0,10,0.73913,0.086444
19155,Pottawattamie County,,IA,6391,99263,105654,30,27,57,60429,60856,121285,5,0.384914,0.406055,3292.873366,0.004151,0.003923,50,0.000376,0,10,0.409274,0.039174
46103,Pennington County,,SD,8254,97257,105511,92,95,187,84119,77799,161918,4,0.420016,0.448269,87388.217604,0.014881,0.017871,50,0.001227,0,10,0.346141,0.147029
20045,Douglas County,,KS,10232,95209,105441,75,80,155,91040,96515,187555,5,0.425014,0.451101,15470.560183,0.012433,0.019177,14,0.000713,0,10,0.426316,0.121741
13077,Coweta County,,GA,7312,98049,105361,90,93,183,127525,101942,229467,5,0.414687,0.444021,5744.024332,0.022279,0.020885,6,0.000647,0,10,0.515473,0.215571
26055,Grand Traverse County,,MI,6434,98634,105068,56,52,108,72174,58732,130906,5,0.392087,0.41684,2256.783082,0.00798,0.008676,43,0.000392,0,10,0.458475,0.071827
13313,Whitfield County,,GA,7425,97606,105031,31,36,67,58598,67311,125909,5,0.393846,0.417084,887.274599,0.007291,0.008462,51,0.000263,0,10,0.586585,0.070718
21037,Campbell County,,KY,7040,97741,104781,21,22,43,86963,88920,175883,5,0.384144,0.404959,903.562302,0.003392,0.004247,42,0.000231,0,10,0.600791,0.030705
55071,Manitowoc County,,WI,3764,100861,104625,22,22,44,30410,36254,66664,5,0.373405,0.393213,202.685628,0.002547,0.002386,8,0.000195,0,10,0.755,0.023377
24037,St. Mary's County,,MD,7833,96710,104543,63,67,130,83033,66592,149625,5,0.395774,0.422754,411.37534,0.016626,0.018994,13,0.000388,0,10,0.697018,0.157607
24015,Cecil County,,MD,5617,98523,104140,32,28,60,79776,62447,142223,5,0.370433,0.390744,66.561308,0.007407,0.006487,47,0.000189,0,10,0.820571,0.06163
44005,Newport County,,RI,9694,93553,103247,71,74,145,65979,71014,136993,5,0.401359,0.42864,189.835124,0.021689,0.022802,33,0.00039,0,10,0.752521,0.198014
1069,Houston County,,AL,6724,96513,103237,61,56,117,75081,70748,145829,5,0.387146,0.412636,11544.371463,0.013658,0.012473,6,0.000494,0,10,0.598372,0.13351
5051,Garland County,,AR,5709,97520,103229,61,39,100,57234,46859,104093,5,0.394859,0.418712,10838.780122,0.010583,0.007775,52,0.000556,0,10,0.400053,0.102383
29037,Cass County,,MO,7261,95606,102867,34,39,73,102995,83297,186292,5,0.387487,0.410628,1711.309056,0.005398,0.006217,14,0.000331,0,10,0.495732,0.051903
54107,Wood County,,WV,4710,97873,102583,20,28,48,32223,30722,62945,6,0.345518,0.365392,22076.440244,0.00107,0.002651,41,0.000336,0,10,0.29064,0.009749
49005,Cache County,,UT,9552,92963,102515,58,68,126,82101,92039,174140,5,0.388173,0.414605,8089.162207,0.008752,0.01299,45,0.000537,0,10,0.445789,0.086978
42063,Indiana County,,PA,4505,97776,102281,21,27,48,31485,36136,67621,5,0.372093,0.392643,187.094001,0.002519,0.00431,41,0.000157,0,10,0.617241,0.020205
47011,Bradley County,,TN,6126,96107,102233,41,32,73,54336,51608,105944,5,0.36411,0.385232,1769.087458,0.008721,0.005544,51,0.000409,0,10,0.488437,0.085774
40017,Canadian County,,OK,8053,93706,101759,52,40,92,140156,107466,247622,5,0.38593,0.409028,3420.059894,0.008246,0.00714,52,0.00053,0,10,0.386364,0.08243
56021,Laramie County,,WY,8619,93138,101757,82,74,156,64063,58654,122717,5,0.411576,0.43826,14687.902017,0.018558,0.01842,35,0.000689,0,10,0.516239,0.180461
2090,Fairbanks North Star Borough,,AK,11279,89538,100817,119,135,254,85169,100186,185355,4,0.430312,0.461968,16379.501985,0.025339,0.027179,45,0.000864,0,10,0.440671,0.240985
55055,Jefferson County,,WI,6728,93897,100625,29,30,59,76517,70782,147299,5,0.374954,0.395898,68.560413,0.003417,0.00291,8,0.000217,0,10,0.726381,0.030824
13115,Floyd County,,GA,5266,95167,100433,44,43,87,45917,49285,95202,5,0.389897,0.414073,1768.138946,0.008753,0.008025,6,0.000366,0,10,0.561684,0.086543
18005,Bartholomew County,,IN,5951,94321,100272,35,31,66,49627,50777,100404,5,0.392037,0.414969,1345.582151,0.004972,0.005775,42,0.000303,0,10,0.51052,0.043073
39119,Muskingum County,,OH,4286,95728,100014,20,21,41,40537,41696,82233,5,0.366894,0.385927,234.280461,0.002145,0.002555,41,0.000194,0,10,0.584416,0.017713
48361,Orange County,,TX,6045,93770,99815,31,36,67,56177,60575,116752,5,0.372725,0.395313,229.980767,0.005932,0.006671,62,0.000277,0,10,0.646424,0.0617
13059,Clarke County,,GA,11862,87865,99727,101,109,210,107842,127140,234982,5,0.425249,0.455387,10524.123861,0.021119,0.026107,6,0.000781,0,10,0.498599,0.20728
1077,Lauderdale County,,AL,5091,94599,99690,28,29,57,43046,45691,88737,6,0.346531,0.365685,745.201762,0.002904,0.00346,6,0.000307,0,10,0.469758,0.029718
45075,Orangeburg County,,SC,5093,94538,99631,38,35,73,42644,52600,95244,5,0.365714,0.386833,574.364467,0.008058,0.007922,37,0.000321,0,10,0.662262,0.079577
13015,Bartow County,,GA,7238,92070,99308,45,40,85,89706,74926,164632,5,0.385687,0.409191,1104.816122,0.010134,0.008386,6,0.000364,0,10,0.625882,0.100135
48209,Hays County,,TX,10493,88634,99127,93,63,156,238086,175735,413821,5,0.398237,0.424599,1514.804388,0.01708,0.012656,62,0.000745,0,10,0.474244,0.170267
48037,Bowie County,,TX,6830,92127,98957,42,45,87,64809,65204,130013,5,0.388369,0.412853,11574.421004,0.006798,0.007984,62,0.000406,0,10,0.449025,0.069761
13045,Carroll County,,GA,6117,92814,98931,55,48,103,102986,88735,191721,5,0.375275,0.39911,2303.884779,0.011,0.009229,6,0.000424,0,10,0.586066,0.105581
51015,Augusta County,,VA,4400,94394,98794,23,21,44,50517,43298,93815,6,0.337212,0.354291,3550.871877,0.002149,0.002198,13,0.000301,0,10,0.426154,0.020868
28035,Forrest County,,MS,8397,90096,98493,60,61,121,83305,85229,168534,5,0.387634,0.413965,7177.179093,0.006956,0.009032,12,0.000546,0,10,0.378882,0.06712
45035,Dorchester County,,SC,9376,89069,98445,106,77,183,176773,152945,329718,5,0.408946,0.436507,1305.005237,0.030368,0.022481,37,0.000653,0,10,0.701327,0.283141
5045,Faulkner County,,AR,7434,90784,98218,70,57,127,94544,80347,174891,5,0.394402,0.42015,15520.694832,0.008458,0.00799,52,0.000724,0,10,0.280452,0.085519
29021,Buchanan County,,MO,6142,92011,98153,45,43,88,51528,56265,107793,5,0.388812,0.412391,20825.418532,0.005192,0.005217,14,0.000518,0,10,0.330552,0.04972
33009,Grafton County,,NH,7668,90302,97970,56,65,121,76556,75941,152497,5,0.401831,0.428125,7145.770638,0.01275,0.01734,33,0.000341,0,10,0.69648,0.113271
17183,Vermilion County,,IL,4216,93680,97896,23,28,51,26554,30640,57194,5,0.376609,0.39758,1495.351531,0.00299,0.003458,8,0.000224,0,10,0.480159,0.026153
30013,Cascade County,,MT,7859,89551,97410,56,57,113,42626,48759,91385,5,0.401202,0.426215,25238.221871,0.010551,0.01206,45,0.000566,0,10,0.496927,0.10288
42005,Armstrong County,,PA,3836,93563,97399,12,12,24,36565,36971,73536,6,0.326115,0.340131,2.749686,0.000998,0.000845,41,0.000113,0,10,0.801282,0.007642
16019,Bonneville County,,ID,6743,90624,97367,55,46,101,83832,74729,158561,5,0.375688,0.398747,6376.641867,0.00969,0.00772,45,0.00051,0,10,0.495763,0.095926
47113,Madison County,,TN,6594,90691,97285,47,49,96,66656,69324,135980,5,0.404423,0.429454,6255.75107,0.007552,0.009094,52,0.000495,0,10,0.362674,0.073189
22105,Tangipahoa Parish,,LA,5482,91778,97260,37,34,71,87707,71484,159191,5,0.378745,0.401351,671.229736,0.0054,0.005209,12,0.000293,0,10,0.57468,0.050583
24045,Wicomico County,,MD,5778,91224,97002,43,48,91,66594,61687,128281,5,0.384336,0.408594,451.287003,0.009979,0.012503,47,0.00028,0,10,0.677498,0.090242
48187,Guadalupe County,,TX,7671,89255,96926,85,62,147,169909,129752,299661,5,0.395367,0.421642,892.424673,0.018448,0.014335,62,0.000634,0,10,0.578239,0.181796
27019,Carver County,,MN,6956,89909,96865,34,29,63,102343,79007,181350,5,0.380716,0.40211,667.55927,0.005323,0.004219,39,0.000295,0,10,0.540541,0.050032
37027,Caldwell County,,NC,4553,92288,96841,23,23,46,40008,40388,80396,6,0.335481,0.352452,90.063269,0.004057,0.0035,37,0.000225,0,10,0.683761,0.041733
37157,Rockingham County,,NC,4469,91855,96324,18,20,38,42886,45082,87968,6,0.335371,0.351888,116.392151,0.002809,0.003001,37,0.00018,0,10,0.597619,0.028806
42033,Clearfield County,,PA,3905,92163,96068,17,23,40,29485,30850,60335,6,0.330358,0.346094,49.968947,0.001746,0.002336,41,0.000147,0,10,0.601449,0.013841
36011,Cayuga County,,NY,4599,91417,96016,17,21,38,37484,37729,75213,5,0.368611,0.388086,90.617366,0.002474,0.003903,36,0.000126,0,10,0.725296,0.019466
21227,Warren County,,KY,6901,89096,95997,70,61,131,64459,62962,127421,5,0.414631,0.440359,28815.039662,0.010352,0.012065,42,0.00075,0,10,0.310608,0.100372
21047,Christian County,,KY,18176,77681,95857,98,103,201,95652,127844,223496,5,0.432737,0.460769,13540.123892,0.024613,0.025865,51,0.000689,0,10,0.57755,0.230824
51165,Rockingham County,,VA,5018,90740,95758,22,23,45,50311,46050,96361,6,0.338065,0.355756,1472.037016,0.002988,0.002968,13,0.000249,0,10,0.527692,0.028184
18085,Kosciusko County,,IN,5243,90332,95575,30,29,59,45742,47239,92981,5,0.380292,0.402002,991.126843,0.004406,0.004457,42,0.00024,0,10,0.511905,0.0403
36009,Cattaraugus County,,NY,5129,90446,95575,12,21,33,38055,41031,79086,5,0.380292,0.40108,634.353973,0.001583,0.004706,36,0.000117,0,10,0.609524,0.013122
35043,Sandoval County,,NM,9558,85900,95458,72,64,136,162535,123525,286060,5,0.400678,0.427121,1247.017243,0.01815,0.017219,35,0.000522,0,10,0.614352,0.176895
28081,Lee County,,MS,5591,89856,95447,36,31,67,60915,57833,118748,5,0.363722,0.384679,3602.515298,0.002719,0.003001,52,0.000381,0,10,0.359146,0.026564
55141,Wood County,,WI,4653,90627,95280,31,37,68,38311,45080,83391,5,0.374406,0.39598,542.75239,0.002699,0.002941,8,0.000276,0,10,0.58637,0.025845
48469,Victoria County,,TX,5880,89247,95127,44,40,84,59116,64055,123171,5,0.376609,0.399181,515.155745,0.006925,0.006386,62,0.000406,0,10,0.555072,0.073491
26111,Midland County,,MI,5439,89531,94970,36,43,79,49953,49562,99515,5,0.395214,0.419146,1128.608718,0.004822,0.008052,43,0.000237,0,10,0.53869,0.041072
35031,McKinley County,,NM,9640,85092,94732,17,20,37,99097,110575,209672,5,0.370835,0.390321,28.495927,0.003106,0.004181,35,0.000171,0,10,0.771053,0.031134
37089,Henderson County,,NC,5494,88851,94345,70,53,123,71914,55246,127160,5,0.389947,0.414562,2265.124333,0.017456,0.013677,37,0.000554,0,10,0.656396,0.1768
6045,Mendocino County,,CA,5056,89251,94307,42,48,90,42836,44508,87344,5,0.372093,0.395041,16.155671,0.009138,0.009624,45,0.000256,0,10,0.889031,0.085109
4017,Navajo County,,AZ,8326,85846,94172,29,27,56,103405,93221,196626,5,0.372048,0.392491,53.451996,0.00614,0.006016,45,0.000246,0,10,0.694624,0.06
49053,Washington County,,UT,7298,86466,93764,85,63,148,141134,102335,243469,5,0.384962,0.410726,3024.600412,0.014963,0.011041,45,0.000671,0,10,0.451685,0.146225
48091,Comal County,,TX,7367,86331,93698,70,48,118,155511,108899,264410,5,0.386318,0.410655,659.684449,0.014651,0.009489,62,0.000579,0,10,0.619876,0.146793
47001,Anderson County,,TN,5848,87648,93496,24,20,44,56701,58831,115532,5,0.351608,0.370182,657.941163,0.002557,0.002224,51,0.000348,0,10,0.468661,0.028019
39063,Hancock County,,OH,4957,88235,93192,32,38,70,47642,45831,93473,5,0.392287,0.415864,1274.965639,0.004491,0.007198,43,0.000228,0,10,0.503171,0.036922
40131,Rogers County,,OK,6566,86422,92988,35,31,66,91597,78296,169893,5,0.378092,0.399832,1545.078396,0.005885,0.004801,52,0.000364,0,10,0.513495,0.059293
51143,Pittsylvania County,,VA,4161,88778,92939,14,26,40,36431,37207,73638,6,0.336473,0.354785,148.525387,0.000742,0.002867,37,0.000163,0,10,0.48,0.007643
36109,Tompkins County,,NY,8373,84456,92829,85,90,175,60065,72568,132633,5,0.416147,0.444591,4156.962989,0.022359,0.026209,36,0.000456,0,10,0.668996,0.196214
22005,Ascension Parish,,LA,5083,87704,92787,38,32,70,101878,71758,173636,5,0.379494,0.401487,702.134661,0.004936,0.004719,12,0.000294,0,10,0.563677,0.046694
24009,Calvert County,,MD,4972,87698,92670,24,35,59,72635,53285,125920,5,0.377303,0.399344,57.587004,0.006957,0.009226,13,0.000173,0,10,0.809309,0.065636
36019,Clinton County,,NY,3208,89160,92368,28,32,60,21615,20298,41913,5,0.373859,0.395166,1037.775447,0.005409,0.006951,36,0.000196,0,10,0.707207,0.043112
41003,Benton County,,OR,8591,83692,92283,60,61,121,78068,93524,171592,5,0.392287,0.418305,416.894022,0.012874,0.014192,45,0.000423,0,10,0.711895,0.126471
54003,Berkeley County,,WV,4608,87561,92169,46,38,84,93012,54053,147065,5,0.379681,0.401812,5419.114684,0.007058,0.006993,13,0.000386,0,10,0.472789,0.065149
29165,Platte County,,MO,10655,81306,91961,64,59,123,137011,130056,267067,5,0.415247,0.440061,5445.671602,0.014178,0.014949,14,0.000516,0,10,0.550581,0.132448
42111,Somerset County,,PA,2990,88748,91738,17,18,35,22104,23196,45300,6,0.336694,0.353451,22.688414,0.001956,0.002001,41,0.000141,0,10,0.721053,0.016398
37135,Orange County,,NC,11714,79946,91660,122,95,217,141807,161254,303061,5,0.423607,0.452105,2932.327664,0.032679,0.027775,37,0.000775,0,10,0.656903,0.306179
12087,Monroe County,,FL,10668,80396,91064,114,85,199,72276,85508,157784,5,0.413737,0.441905,277.631486,0.036192,0.026786,5,0.000641,0,10,0.783772,0.335488
30029,Flathead County,,MT,5514,85169,90683,66,53,119,50053,40811,90864,5,0.387097,0.411947,7509.929834,0.013992,0.010719,45,0.000582,0,10,0.589802,0.139266
5069,Jefferson County,,AR,5652,84870,90522,34,41,75,33479,49549,83028,5,0.391587,0.415375,5009.869057,0.004617,0.0062,52,0.000365,0,10,0.383092,0.045171
51019,Bedford County,,VA,6161,84217,90378,23,22,45,63450,54652,118102,6,0.340803,0.359364,1714.330684,0.003492,0.002975,37,0.000242,0,10,0.575,0.033758
13185,Lowndes County,,GA,9065,81042,90107,105,110,215,81583,86233,167816,5,0.417108,0.448063,36461.481123,0.020619,0.02439,5,0.000908,0,10,0.435408,0.200785
48005,Angelina County,,TX,5588,84032,89620,41,42,83,46029,50912,96941,5,0.371239,0.394309,446.067066,0.005982,0.00645,62,0.000376,0,10,0.585024,0.063898
13223,Paulding County,,GA,6765,82830,89595,72,53,125,179440,124560,304000,5,0.403573,0.428749,971.79009,0.020418,0.014417,6,0.000468,0,10,0.705961,0.191294
5031,Craighead County,,AR,5935,83164,89099,49,46,95,72652,61853,134505,5,0.394099,0.418766,21866.138247,0.006178,0.006063,52,0.000555,0,10,0.319382,0.062909
37037,Chatham County,,NC,6543,82201,88744,38,26,64,72423,56890,129313,5,0.381662,0.40306,108.24222,0.010818,0.006399,37,0.000278,0,10,0.791667,0.103752
33005,Cheshire County,,NH,4957,83554,88511,39,45,84,45962,43310,89272,5,0.381378,0.404877,138.720732,0.009003,0.010751,33,0.000218,0,10,0.773061,0.077111
39013,Belmont County,,OH,3545,84508,88053,22,21,43,29107,30081,59188,6,0.338662,0.355566,361.854987,0.001883,0.002115,41,0.000221,0,10,0.44,0.015932
41071,Yamhill County,,OR,6382,81436,87818,39,39,78,83008,73238,156246,5,0.372635,0.394607,28.304735,0.008516,0.008286,45,0.000294,0,10,0.832452,0.083467
12055,Highlands County,,FL,5620,82181,87801,48,38,86,59942,49123,109065,5,0.38739,0.410357,201.924938,0.013548,0.011607,5,0.000314,0,10,0.766968,0.127554
18043,Floyd County,,IN,6652,81118,87770,19,22,41,79789,79848,159637,5,0.382232,0.402979,743.777333,0.001812,0.003353,42,0.000232,0,10,0.478261,0.017825
1043,Cullman County,,AL,3928,83757,87685,21,21,42,38470,36402,74872,5,0.348813,0.367198,87.168947,0.001444,0.002123,6,0.000216,0,10,0.713439,0.014716
6101,Sutter County,,CA,6442,81154,87596,39,41,80,87520,82725,170245,5,0.373042,0.395204,87.469228,0.008875,0.009745,45,0.000245,0,10,0.881129,0.08205
38015,Burleigh County,,ND,5455,81641,87096,56,40,96,64871,52292,117163,5,0.385833,0.40918,58520.900672,0.005136,0.004538,39,0.001148,0,10,0.193716,0.051991
47119,Maury County,,TN,5205,81440,86645,45,30,75,69347,55791,125138,5,0.36786,0.389372,1434.656278,0.010042,0.004415,51,0.000414,0,10,0.513726,0.09629
16005,Bannock County,,ID,6803,79833,86636,49,54,103,53404,59773,113177,5,0.376424,0.400347,9661.629482,0.006841,0.007539,45,0.000507,0,10,0.427005,0.068009
48231,Hunt County,,TX,7830,78799,86629,35,36,71,87596,80570,168166,5,0.378465,0.400944,2627.3682,0.006164,0.005897,62,0.000327,0,10,0.575641,0.064371
22045,Iberia Parish,,LA,4146,82387,86533,22,22,44,44789,51676,96465,5,0.356546,0.374995,39.931261,0.003119,0.003042,12,0.000184,0,10,0.744615,0.028681
18053,Grant County,,IN,4299,82102,86401,19,23,42,24642,31339,55981,5,0.377999,0.39853,615.00787,0.002314,0.003314,42,0.000172,0,10,0.58,0.021079
51770,Roanoke city,,VA,9027,77338,86365,54,56,110,101481,112024,213505,5,0.409218,0.434446,33965.491208,0.009435,0.013911,37,0.000519,0,10,0.457587,0.090527
29051,Cole County,,MO,5661,80484,86145,36,35,71,53642,54295,107937,5,0.38424,0.406733,1971.36093,0.003779,0.004143,14,0.000387,0,10,0.469872,0.037144
22097,St. Landry Parish,,LA,3989,81884,85873,28,25,53,53918,54967,108885,5,0.355556,0.374099,68.743066,0.002603,0.002366,12,0.000245,0,10,0.62931,0.024223
28089,Madison County,,MS,7782,78084,85866,67,59,126,112608,90016,202624,5,0.399844,0.426009,9200.991882,0.010215,0.010685,12,0.000561,0,10,0.418364,0.098149
51069,Frederick County,,VA,5406,80056,85462,38,34,72,86381,66198,152579,6,0.341865,0.362104,2546.687826,0.005948,0.004983,13,0.000337,0,10,0.496829,0.055558
1095,Marshall County,,AL,5861,79310,85171,25,28,53,58046,60313,118359,5,0.361029,0.381847,318.870273,0.004287,0.003675,6,0.00023,0,10,0.586555,0.041817
25011,Franklin County,,MA,4810,80145,84955,22,28,50,47819,46548,94367,5,0.375596,0.396631,6.798627,0.005735,0.00751,33,0.00014,0,10,0.956349,0.049322
23003,Aroostook County,,ME,3544,81275,84819,24,23,47,16295,20367,36662,5,0.33272,0.349002,136.837024,0.003911,0.00296,33,0.000195,0,10,0.703704,0.03386
39077,Huron County,,OH,4796,79896,84692,17,20,37,43658,46971,90629,5,0.37012,0.389307,50.370772,0.002184,0.002669,41,0.000128,0,10,0.75,0.016863
17001,Adams County,,IL,3346,81326,84672,26,27,53,17665,19503,37168,5,0.374908,0.395546,17820.162685,0.003199,0.003171,14,0.000334,0,10,0.411494,0.028518
18177,Wayne County,,IN,4007,80175,84182,24,25,49,25992,30668,56660,5,0.379119,0.39994,1208.400529,0.003658,0.003706,42,0.000213,0,10,0.551282,0.032943
1121,Talladega County,,AL,4281,79645,83926,23,26,49,47867,50121,97988,6,0.341789,0.35906,469.694303,0.002719,0.002958,6,0.000232,0,10,0.586895,0.026858
37125,Moore County,,NC,4662,79253,83915,55,39,94,50962,41631,92593,5,0.382042,0.404769,463.555849,0.014354,0.0097,37,0.000387,0,10,0.655757,0.139
36053,Madison County,,NY,4803,78375,83178,18,22,40,46776,45926,92702,5,0.345985,0.36429,24.948273,0.002934,0.00422,36,0.000128,0,10,0.78442,0.022819
45031,Darlington County,,SC,4043,78365,82408,20,21,41,36933,41183,78116,6,0.342208,0.359825,69.380554,0.002256,0.003715,37,0.000205,0,10,0.673913,0.025141
39081,Jefferson County,,OH,3497,78765,82262,17,23,40,26201,29625,55826,5,0.369675,0.389426,334.023684,0.002407,0.003249,41,0.000162,0,10,0.574275,0.020407
55097,Portage County,,WI,4734,77453,82187,36,34,70,38925,40789,79714,5,0.376332,0.397933,355.664877,0.002492,0.00332,8,0.000309,0,10,0.588462,0.023773
21029,Bullitt County,,KY,5506,76627,82133,19,17,36,83048,68095,151143,6,0.326357,0.340088,174.402662,0.001466,0.000769,42,0.000237,0,10,0.342857,0.013701
28075,Lauderdale County,,MS,5513,76512,82025,40,54,94,35649,41035,76684,5,0.384914,0.410965,10793.945591,0.007071,0.009416,12,0.000362,0,10,0.462595,0.066484
54081,Raleigh County,,WV,4223,77506,81729,24,24,48,25758,24143,49901,5,0.368345,0.389068,7973.91255,0.003279,0.003924,41,0.000292,0,10,0.410099,0.031879
54033,Harrison County,,WV,4358,77126,81484,20,24,44,27132,28731,55863,6,0.347236,0.367725,11184.528445,0.000823,0.002408,41,0.000348,0,10,0.326154,0.007278
24001,Allegany County,,MD,3267,77734,81001,21,24,45,21221,22737,43958,6,0.339635,0.357981,1743.215289,0.003375,0.00363,13,0.000194,0,10,0.565217,0.030587
39101,Marion County,,OH,3820,77083,80903,16,20,36,31258,34313,65571,5,0.366806,0.38571,138.095332,0.00131,0.002214,41,0.000155,0,10,0.538095,0.011115
42037,Columbia County,,PA,3390,77286,80676,23,22,45,30458,29205,59663,6,0.330358,0.345893,47.258402,0.003788,0.003339,47,0.000164,0,10,0.811667,0.03073
48213,Henderson County,,TX,6300,74238,80538,37,32,69,77624,67006,144630,5,0.360014,0.380257,87.389112,0.006498,0.005019,62,0.000326,0,10,0.669231,0.068221
48257,Kaufman County,,TX,5996,74510,80506,34,29,63,145721,105497,251218,5,0.374451,0.39598,159.542271,0.007513,0.005955,62,0.000297,0,10,0.761905,0.076441
19169,Story County,,IA,8273,71990,80263,74,65,139,57636,70804,128440,5,0.416768,0.442106,17963.649389,0.005908,0.013889,8,0.000823,0,10,0.261492,0.05655
40037,Creek County,,OK,6593,73651,80244,26,24,50,77333,76291,153624,5,0.373359,0.394054,617.018668,0.003316,0.002902,52,0.000293,0,10,0.594017,0.034368
36037,Genesee County,,NY,3813,76386,80199,12,17,29,31487,33959,65446,5,0.37097,0.39012,100.652626,0.001215,0.002901,36,0.000111,0,10,0.683824,0.009032
20103,Leavenworth County,,KS,9598,70526,80124,66,63,129,87635,83718,171353,5,0.403892,0.429698,1953.663305,0.013943,0.013605,14,0.000466,0,10,0.540841,0.132301
41033,Josephine County,,OR,4702,75167,79869,56,41,97,58909,45989,104898,5,0.371913,0.394065,28.882697,0.011224,0.008648,45,0.00036,0,10,0.820281,0.107039
37019,Brunswick County,,NC,4936,74882,79818,100,44,144,97621,56725,154346,5,0.376609,0.399316,602.080997,0.023118,0.008458,37,0.000606,0,10,0.569501,0.210562
53029,Island County,,WA,9480,70289,79769,63,69,132,102207,90970,193177,5,0.403467,0.430431,471.233314,0.016308,0.017936,45,0.000415,0,10,0.64492,0.156963
18059,Hancock County,,IN,5242,74523,79765,21,18,39,79371,63043,142414,5,0.374497,0.394108,281.273246,0.002023,0.002618,42,0.000193,0,10,0.634387,0.018106
56025,Natrona County,,WY,5255,74321,79576,62,59,121,44463,41310,85773,5,0.393443,0.418972,17560.936015,0.012514,0.011344,35,0.000575,0,10,0.461368,0.124144
1049,DeKalb County,,AL,4146,75391,79537,20,24,44,36277,37520,73797,5,0.356546,0.375347,354.23267,0.0016,0.002211,6,0.000216,0,10,0.509231,0.016267
34033,Salem County,,NJ,3771,75726,79497,14,18,32,43457,37458,80915,6,0.328486,0.342849,0.614115,0.002914,0.003371,47,0.000102,0,10,0.941176,0.022964
29031,Cape Girardeau County,,MO,5020,74372,79392,36,37,73,47162,42164,89326,5,0.387585,0.410693,16136.543508,0.003649,0.004177,14,0.000413,0,10,0.362821,0.035288
5125,Saline County,,AR,5366,73796,79162,39,33,72,97836,73466,171302,5,0.386464,0.409326,2697.125046,0.005635,0.00609,52,0.000408,0,10,0.451219,0.057572
36105,Sullivan County,,NY,4551,74590,79141,26,40,66,53245,44616,97861,5,0.378932,0.401459,50.137132,0.00674,0.011549,47,0.000142,0,10,0.874862,0.052566
45073,Oconee County,,SC,3569,75570,79139,30,21,51,30523,30232,60755,6,0.341106,0.358257,98.095079,0.006642,0.004018,37,0.000274,0,10,0.651515,0.068171
54061,Monongalia County,,WV,5666,73045,78711,53,67,120,49563,48265,97828,5,0.409491,0.435802,62831.897938,0.007522,0.013747,41,0.000614,0,10,0.34551,0.071104
13247,Rockdale County,,GA,8681,70023,78704,58,50,108,127243,120802,248045,5,0.395978,0.420801,875.894149,0.014235,0.011944,6,0.000404,0,10,0.64399,0.132452
55109,St. Croix County,,WI,4570,73968,78538,31,24,55,76662,57670,134332,5,0.373768,0.39381,350.210341,0.003169,0.002638,39,0.000283,0,10,0.586694,0.029973
26015,Barry County,,MI,4469,74005,78474,16,19,35,48855,45744,94599,5,0.371958,0.391287,39.472028,0.002367,0.002494,43,0.000124,0,10,0.807895,0.019077
36113,Warren County,,NY,4806,72956,77762,30,31,61,53790,49474,103264,5,0.373405,0.394623,1060.304929,0.006103,0.007276,36,0.000198,0,10,0.702703,0.049401
53007,Chelan County,,WA,6399,71190,77589,36,33,69,68058,66611,134669,5,0.372273,0.393631,24.120829,0.007427,0.007257,45,0.000267,0,10,0.822561,0.0728
30031,Gallatin County,,MT,6920,70582,77502,108,84,192,70435,60662,131097,5,0.397824,0.426188,45566.430244,0.017555,0.01575,45,0.001103,0,10,0.368732,0.173804
41059,Umatilla County,,OR,5674,71810,77484,44,47,91,44279,49013,93292,5,0.373405,0.396316,1411.651708,0.00648,0.006402,45,0.000382,0,10,0.539216,0.065524
38035,Grand Forks County,,ND,7917,69529,77446,64,68,132,45873,54516,100389,4,0.407752,0.433892,29521.492235,0.009033,0.011194,39,0.000809,0,10,0.331335,0.088064
53025,Grant County,,WA,5098,72307,77405,44,40,84,55042,54710,109752,5,0.374087,0.396452,254.173576,0.00759,0.006832,45,0.000347,0,10,0.675102,0.075216
53041,Lewis County,,WA,4848,72496,77344,32,33,65,57472,51359,108831,5,0.37088,0.391949,44.467669,0.006952,0.006399,45,0.000245,0,10,0.819069,0.068522
51121,Montgomery County,,VA,7815,69492,77307,64,81,145,52784,64685,117469,5,0.412903,0.440902,25248.704845,0.010982,0.018841,37,0.000558,0,10,0.486267,0.105667
22087,St. Bernard Parish,,LA,3563,73693,77256,23,91,114,46665,68875,115540,5,0.402042,0.431624,519.948451,0.00316,0.014595,12,0.000188,0,10,0.402808,0.029533
36051,Livingston County,,NY,4249,72930,77179,11,15,26,39228,40181,79409,5,0.367684,0.386296,80.101733,0.001192,0.002774,36,0.000105,0,10,0.72381,0.008912
42015,Bradford County,,PA,3206,73559,76765,21,22,43,22649,23557,46206,6,0.332324,0.348378,710.70285,0.003058,0.002741,36,0.00018,0,10,0.495,0.024827
45047,Greenwood County,,SC,3830,72930,76760,25,23,48,34299,37379,71678,6,0.340841,0.35886,224.531905,0.003491,0.003763,37,0.000259,0,10,0.62,0.038157
50021,Rutland County,,VT,3514,73227,76741,27,32,59,21299,22892,44191,5,0.34482,0.363477,248.773309,0.004447,0.005038,33,0.000201,0,10,0.580672,0.037237
1083,Limestone County,,AL,3793,72884,76677,26,22,48,61796,46895,108691,5,0.351487,0.36983,289.283475,0.003439,0.002373,6,0.000258,0,10,0.534188,0.034128
13127,Glynn County,,GA,5536,70964,76500,54,50,104,42792,40718,83510,5,0.383425,0.407807,2340.462201,0.012376,0.011744,5,0.000452,0,10,0.592636,0.1222
17195,Whiteside County,,IL,3544,72855,76399,17,22,39,27233,28958,56191,5,0.370835,0.390392,48.080516,0.002192,0.003049,8,0.000153,0,10,0.725108,0.020075
1051,Elmore County,,AL,5557,70837,76394,40,38,78,79872,67639,147511,5,0.365193,0.386974,1330.393297,0.00633,0.006163,6,0.000344,0,10,0.558072,0.063053
47059,Greene County,,TN,3024,73267,76291,21,13,34,24502,23970,48472,6,0.331749,0.345633,242.546564,0.003302,0.001227,51,0.000287,0,10,0.557143,0.034095
37193,Wilkes County,,NC,2973,73302,76275,17,20,37,22941,24316,47257,6,0.332144,0.348248,121.648648,0.002061,0.002674,37,0.000201,0,10,0.683333,0.022054
42025,Carbon County,,PA,3303,72932,76235,31,16,47,50584,38602,89186,6,0.333153,0.347857,2.123693,0.007615,0.003107,47,0.000156,0,10,0.910985,0.057184
21145,McCracken County,,KY,5081,70999,76080,29,29,58,37559,36699,74258,5,0.368876,0.38967,33397.012918,0.003116,0.003256,52,0.000437,0,10,0.317235,0.03067
37195,Wilson County,,NC,4432,71461,75893,28,25,53,42857,45010,87867,5,0.358376,0.377881,117.563604,0.00517,0.004656,37,0.000236,0,10,0.67957,0.050247
45059,Laurens County,,SC,3872,72021,75893,18,16,34,42317,44390,86707,6,0.330571,0.345958,40.335629,0.00209,0.002365,37,0.000201,0,10,0.735294,0.023739
51800,Suffolk city,,VA,5597,70237,75834,43,43,86,104236,79325,183561,5,0.374497,0.398161,695.681111,0.009482,0.010108,13,0.000311,0,10,0.614796,0.089415
39141,Ross County,,OH,3660,72055,75715,24,22,46,40632,40321,80953,5,0.369231,0.388694,363.2668,0.002223,0.002418,41,0.000236,0,10,0.538462,0.01904
26155,Shiawassee County,,MI,4188,71468,75656,22,26,48,46350,47434,93784,5,0.373359,0.393701,40.692979,0.002775,0.003696,43,0.000145,0,10,0.821429,0.020604
36021,Columbia County,,NY,3689,71626,75315,21,19,40,36977,32544,69521,5,0.367376,0.386296,7.458997,0.004834,0.00464,47,0.000123,0,10,0.911232,0.037046
39143,Sandusky County,,OH,3661,71648,75309,10,15,25,35930,38170,74100,5,0.368036,0.386632,10.490687,0.001311,0.002798,43,0.000097,0,10,0.890476,0.010417
20155,Reno County,,KS,3960,71304,75264,27,29,56,27022,30781,57803,5,0.379963,0.401405,4081.026673,0.00231,0.003307,14,0.000354,0,10,0.413547,0.022143
33001,Belknap County,,NH,4783,70347,75130,27,31,58,63305,52763,116068,5,0.374954,0.396197,100.368758,0.006055,0.008491,33,0.00017,0,10,0.890469,0.051006
36043,Herkimer County,,NY,3456,71433,74889,16,17,33,30709,31221,61930,5,0.329614,0.344954,66.894118,0.001894,0.002081,36,0.000139,0,10,0.640351,0.014927
53009,Clallam County,,WA,4265,70393,74658,46,38,84,41588,33026,74614,5,0.372048,0.393902,36.96893,0.010233,0.007809,45,0.000325,0,10,0.766122,0.099064
29043,Christian County,,MO,6653,67867,74520,49,31,80,100107,80801,180908,5,0.376286,0.3977,2958.751601,0.008519,0.00344,14,0.000495,0,10,0.45551,0.082968
16083,Twin Falls County,,ID,5725,68373,74098,39,40,79,60874,55619,116493,5,0.374817,0.397211,2072.598613,0.007127,0.006553,45,0.000325,0,10,0.56383,0.068322
13217,Newton County,,GA,4826,69223,74049,57,48,105,135048,97221,232269,5,0.402938,0.427474,1000.712482,0.013749,0.01184,6,0.000397,0,10,0.666827,0.127254
13179,Liberty County,,GA,16876,57127,74003,111,119,230,100445,128274,228719,5,0.42965,0.459983,5927.094071,0.029609,0.030999,5,0.000718,0,10,0.601279,0.278955
38101,Ward County,,ND,7358,66586,73944,66,68,134,38566,44341,82907,5,0.412959,0.439128,39748.190455,0.01238,0.013365,39,0.000768,0,10,0.437815,0.119914
47147,Robertson County,,TN,4903,69008,73911,19,19,38,65637,57352,122989,6,0.338326,0.35478,166.15795,0.002634,0.002271,51,0.00023,0,10,0.575758,0.027402
40101,Muskogee County,,OK,4406,69501,73907,31,28,59,41229,45818,87047,5,0.369942,0.39107,716.440281,0.004582,0.0032,52,0.00033,0,10,0.557765,0.046409
51089,Henry County,,VA,3365,70400,73765,10,15,25,25646,28820,54466,6,0.333333,0.349387,320.944269,0.000649,0.002105,37,0.000132,0,10,0.633333,0.006701
55017,Chippewa County,,WI,3688,69633,73321,29,28,57,45015,42554,87569,5,0.367376,0.387337,1581.553718,0.00282,0.00223,39,0.000281,0,10,0.564368,0.027137
27141,Sherburne County,,MN,5629,67581,73210,31,32,63,113536,91999,205535,5,0.36972,0.390457,335.680855,0.00191,0.002272,39,0.000319,0,10,0.606061,0.019
53027,Grays Harbor County,,WA,4432,68753,73185,30,29,59,44029,43861,87890,5,0.371149,0.39184,28.551813,0.006009,0.005683,45,0.000236,0,10,0.887097,0.05998
47155,Sevier County,,TN,5578,67566,73144,62,41,103,59672,56331,116003,5,0.378558,0.401969,3196.994475,0.014838,0.008966,51,0.000576,0,10,0.57524,0.147898
26159,Van Buren County,,MI,5106,68023,73129,20,22,42,59739,60086,119825,5,0.378512,0.398882,45.254685,0.003916,0.004463,43,0.000146,0,10,0.824111,0.033629
26103,Marquette County,,MI,3644,69425,73069,36,38,74,20966,20875,41841,5,0.380669,0.403223,19353.559692,0.004592,0.005413,8,0.000385,0,10,0.372093,0.038709
51031,Campbell County,,VA,5652,67343,72995,18,20,38,48745,48348,97093,6,0.340614,0.358876,2352.512322,0.00235,0.002972,37,0.000203,0,10,0.631579,0.022653
12107,Putnam County,,FL,4722,68187,72909,28,25,53,47412,46353,93765,5,0.360733,0.379834,12.355722,0.007653,0.007378,5,0.000222,0,10,0.915025,0.075951
48409,San Patricio County,,TX,8129,64773,72902,46,51,97,68768,75947,144715,5,0.38739,0.41212,427.425237,0.010513,0.011814,62,0.000368,0,10,0.643771,0.105949
26149,St. Joseph County,,MI,4085,68550,72635,17,22,39,32101,35837,67938,5,0.372997,0.392833,997.572216,0.002785,0.003073,43,0.000133,0,10,0.628458,0.021977
39145,Scioto County,,OH,3545,68998,72543,18,21,39,24347,28739,53086,6,0.336694,0.352544,1777.294696,0.001269,0.001529,41,0.00022,0,10,0.428571,0.011129
50027,Windsor County,,VT,4825,67008,71833,39,37,76,41739,41485,83224,5,0.375321,0.397228,852.138026,0.00854,0.007568,33,0.000251,0,10,0.708749,0.074633
37065,Edgecombe County,,NC,5278,66492,71770,17,21,38,50658,58931,109589,5,0.355021,0.374159,124.495019,0.003109,0.003988,37,0.000171,0,10,0.679842,0.032024
1127,Walker County,,AL,3214,68547,71761,18,17,35,28046,29505,57551,6,0.322554,0.336453,193.909178,0.001775,0.001263,6,0.000203,0,10,0.615789,0.017591
12089,Nassau County,,FL,5016,66679,71695,41,35,76,62801,50133,112934,5,0.373814,0.395909,463.311201,0.011981,0.010166,5,0.000309,0,10,0.74899,0.116587
17073,Henry County,,IL,4187,67455,71642,18,21,39,31912,33070,64982,5,0.372454,0.392046,519.402033,0.002689,0.002334,8,0.000171,0,10,0.640316,0.023885
39167,Washington County,,OH,3707,67638,71345,17,22,39,26969,29054,56023,5,0.369631,0.38909,4157.189665,0.001472,0.002586,41,0.000217,0,10,0.484848,0.012301
39037,Darke County,,OH,3212,68029,71241,14,16,30,26198,28996,55194,6,0.336326,0.351769,58.026448,0.001603,0.001476,42,0.000135,0,10,0.620833,0.013503
39147,Seneca County,,OH,3360,67851,71211,15,19,34,32477,37472,69949,6,0.336584,0.352393,18.726977,0.00127,0.001943,43,0.000133,0,10,0.684211,0.010431
20015,Butler County,,KS,5103,66011,71114,24,24,48,51241,48404,99645,5,0.380198,0.401242,1377.498152,0.002744,0.004514,14,0.000274,0,10,0.531746,0.026615
28151,Washington County,,MS,4266,66714,70980,24,32,56,16210,27544,43754,5,0.388369,0.411724,6345.498755,0.003572,0.005838,52,0.00023,0,10,0.527629,0.033778
18109,Morgan County,,IN,4770,65753,70523,20,20,40,66758,61898,128656,5,0.361072,0.379525,381.841221,0.001668,0.002333,42,0.000211,0,10,0.634387,0.015828
39033,Crawford County,,OH,3623,66892,70515,13,15,28,30096,32924,63020,6,0.33337,0.348503,9.837599,0.001079,0.001354,41,0.000127,0,10,0.695833,0.009371
41053,Polk County,,OR,6616,63741,70357,41,31,72,92523,81856,174379,5,0.371373,0.392329,29.913121,0.008731,0.006257,45,0.000306,0,10,0.818383,0.084978
17199,Williamson County,,IL,3907,66410,70317,31,26,57,41122,34759,75881,5,0.376424,0.397282,6323.347124,0.004301,0.003315,14,0.000316,0,10,0.453629,0.037988
55111,Sauk County,,WI,4130,66128,70258,35,30,65,48787,44701,93488,5,0.374041,0.394786,395.401855,0.003717,0.002529,8,0.000286,0,10,0.62521,0.033459
45043,Georgetown County,,SC,4076,66126,70202,31,20,51,34250,36887,71137,6,0.344356,0.36154,37.439078,0.007662,0.004625,37,0.000236,0,10,0.764706,0.073248
48099,Coryell County,,TX,14944,54993,69937,81,85,166,120085,131721,251806,5,0.416147,0.443951,1101.280372,0.019178,0.019541,62,0.000545,0,10,0.604566,0.18567
37031,Carteret County,,NC,4588,65322,69910,41,33,74,43283,35214,78497,5,0.364024,0.385031,326.4583,0.008131,0.006961,37,0.00033,0,10,0.602415,0.080038
39087,Lawrence County,,OH,3443,66363,69806,12,13,25,29740,29667,59407,6,0.337768,0.35325,107.125866,0.000909,0.001014,41,0.000176,0,10,0.538462,0.008093
22001,Acadia Parish,,LA,3304,66297,69601,19,15,34,39653,40789,80442,5,0.352253,0.369119,76.338058,0.00191,0.00152,12,0.000182,0,10,0.71345,0.017078
39005,Ashland County,,OH,3569,66010,69579,13,19,32,37119,34908,72027,6,0.336694,0.352745,10.330685,0.00174,0.002246,41,0.000111,0,10,0.710526,0.013435
55021,Columbia County,,WI,4297,65042,69339,28,27,55,55746,52623,108369,5,0.373723,0.394135,195.506891,0.00236,0.002506,8,0.000241,0,10,0.697701,0.022436
21151,Madison County,,KY,5388,63887,69275,52,43,95,55420,49977,105397,6,0.352092,0.374447,11660.658608,0.003053,0.003134,42,0.000731,0,10,0.182792,0.030086
47063,Hamblen County,,TN,4272,64959,69231,20,19,39,38965,42061,81026,5,0.376148,0.396115,5483.76657,0.002753,0.002818,51,0.000291,0,10,0.528333,0.027872
39083,Knox County,,OH,3503,65689,69192,18,18,36,37649,31961,69610,5,0.366543,0.385167,88.397993,0.001848,0.002298,41,0.000152,0,10,0.683333,0.014735
17093,Kendall County,,IL,5244,63803,69047,23,29,52,171507,101891,273398,5,0.389304,0.411659,114.161996,0.005369,0.007534,8,0.000162,0,10,0.769892,0.04741
45057,Lancaster County,,SC,3258,65768,69026,23,16,39,52132,39216,91348,6,0.330429,0.345741,106.437535,0.00536,0.002729,37,0.000209,0,10,0.745,0.054731
37171,Surry County,,NC,4341,64668,69009,20,22,42,33644,37707,71351,6,0.332108,0.34841,9459.616036,0.001963,0.002324,37,0.000263,0,10,0.517787,0.021772
51095,James City County,,VA,5327,63616,68943,63,51,114,70444,51507,121951,5,0.39834,0.423242,3463.762363,0.015794,0.013341,13,0.000433,0,10,0.602213,0.145656
13295,Walker County,,GA,4644,64282,68926,18,18,36,56697,53936,110633,6,0.342704,0.358757,274.401045,0.002248,0.00215,51,0.000207,0,10,0.561404,0.023037
41035,Klamath County,,OR,4743,64155,68898,53,39,92,36729,37204,73933,5,0.372003,0.393956,715.055975,0.00985,0.00802,45,0.000381,0,10,0.758459,0.09497
26067,Ionia County,,MI,3908,64651,68559,18,22,40,45432,45546,90978,5,0.372048,0.391721,30.706349,0.002053,0.002842,43,0.000135,0,10,0.83004,0.015543
50023,Washington County,,VT,3920,64463,68383,30,33,63,34485,33820,68305,5,0.375183,0.396631,1698.442391,0.006029,0.006924,33,0.000223,0,10,0.629412,0.054367
37107,Lenoir County,,NC,3946,64142,68088,21,20,41,31718,37286,69004,6,0.337582,0.354199,138.62373,0.003645,0.003243,37,0.000199,0,10,0.73913,0.037104
40047,Garfield County,,OK,5353,62545,67898,46,50,96,32094,36260,68354,5,0.389601,0.414399,11166.047782,0.009504,0.00932,52,0.000469,0,10,0.462303,0.094589
48291,Liberty County,,TX,5388,62431,67819,24,25,49,82106,73980,156086,5,0.35934,0.37863,52.447653,0.003983,0.004093,62,0.000228,0,10,0.716923,0.041548
30049,Lewis and Clark County,,MT,4381,63312,67693,37,35,72,38992,36138,75130,5,0.375229,0.396984,7274.191234,0.006014,0.006758,45,0.000446,0,10,0.495513,0.060843
51061,Fauquier County,,VA,5106,62563,67669,31,37,68,72665,56348,129013,5,0.378325,0.4007,1111.75854,0.0057,0.007064,13,0.000266,0,10,0.559379,0.055454
1115,St. Clair County,,AL,4211,63343,67554,25,23,48,77709,57296,135005,5,0.350845,0.369406,113.828051,0.002919,0.002913,6,0.000234,0,10,0.646552,0.029333
15007,Kauai County,,HI,2729,64748,67477,31,21,52,17220,22858,40078,5,0.371239,0.390972,0.124098,0.009419,0.006922,45,0.000208,0,10,0.975379,0.089212
5145,White County,,AR,4260,63203,67463,35,31,66,45042,41567,86609,5,0.38001,0.402463,3730.171938,0.003908,0.003934,52,0.000383,0,10,0.392038,0.039287
42121,Venango County,,PA,2773,64609,67382,12,13,25,19931,20496,40427,6,0.326115,0.34024,7.59833,0.000949,0.000817,41,0.000123,0,10,0.74359,0.007324
17095,Knox County,,IL,3464,63727,67191,19,22,41,21687,23003,44690,5,0.371239,0.390826,2862.746423,0.002435,0.002456,8,0.000199,0,10,0.573593,0.021799
28087,Lowndes County,,MS,5431,61720,67151,27,52,79,27472,32032,59504,5,0.399324,0.424626,8356.314476,0.004344,0.010587,52,0.000264,0,10,0.53771,0.041342
27111,Otter Tail County,,MN,3376,63747,67123,27,27,54,30331,30301,60632,5,0.367025,0.386713,911.125873,0.001819,0.001715,39,0.000321,0,10,0.615764,0.01791
35061,Valencia County,,NM,5298,61678,66976,27,21,48,54163,51302,105465,5,0.371014,0.390674,153.869015,0.005271,0.004418,35,0.000249,0,10,0.593596,0.051033
36077,Otsego County,,NY,3741,63234,66975,30,28,58,30652,30236,60888,5,0.337323,0.355029,57.014023,0.005644,0.004838,36,0.000181,0,10,0.698864,0.043564
54055,Mercer County,,WV,3483,63438,66921,20,26,46,20117,19801,39918,6,0.342322,0.361567,14381.757868,0.001504,0.002693,51,0.000288,0,10,0.334656,0.015185
45055,Kershaw County,,SC,3511,63395,66906,22,22,44,39949,35312,75261,6,0.334167,0.350732,58.312323,0.003174,0.003492,37,0.000225,0,10,0.699275,0.034783
51199,York County,,VA,8958,57710,66668,69,65,134,88015,85619,173634,5,0.398857,0.425412,1819.304403,0.016932,0.016974,13,0.000464,0,10,0.625331,0.160643
40125,Pottawatomie County,,OK,4898,61343,66241,31,28,59,54767,53482,108249,5,0.375642,0.397092,954.940748,0.004669,0.003844,52,0.000339,0,10,0.516129,0.047882
36057,Montgomery County,,NY,3408,62797,66205,16,16,32,32980,35028,68008,5,0.3665,0.385021,99.87298,0.003345,0.003014,36,0.000125,0,10,0.802381,0.027736
31079,Hall County,,NE,4723,61445,66168,36,36,72,33416,36327,69743,5,0.394656,0.417394,17007.104302,0.00384,0.004819,50,0.000516,0,10,0.29334,0.038009
17141,Ogle County,,IL,3844,62124,65968,16,20,36,41963,37404,79367,5,0.37021,0.389415,35.699268,0.00259,0.002737,8,0.000133,0,10,0.768421,0.022295
4001,Apache County,,AZ,8675,57110,65785,22,21,43,92011,92003,184014,5,0.366412,0.385493,27.526706,0.004663,0.00379,45,0.000201,0,10,0.73913,0.046065
13285,Troup County,,GA,3862,61919,65781,29,28,57,42417,39661,82078,5,0.353754,0.373155,197.112173,0.005285,0.004731,6,0.000264,0,10,0.65625,0.051954
27013,Blue Earth County,,MN,5380,60374,65754,41,38,79,56656,58643,115299,5,0.379212,0.401459,1594.470268,0.00295,0.003522,39,0.000391,0,10,0.404863,0.028891
18011,Boone County,,IN,4445,61183,65628,22,20,42,58701,43179,101880,5,0.375688,0.39579,173.495167,0.00288,0.00312,42,0.000192,0,10,0.692308,0.024706
54049,Marion County,,WV,2838,62760,65598,17,17,34,23384,23421,46805,6,0.330003,0.346186,1046.516226,0.000689,0.000889,41,0.000274,0,10,0.359649,0.006176
28067,Jones County,,MS,3516,61886,65402,23,26,49,34116,35274,69390,5,0.361327,0.381207,899.537265,0.002394,0.002741,12,0.000238,0,10,0.5,0.022224
42009,Bedford County,,PA,2243,62996,65239,17,15,32,15995,16703,32698,6,0.326948,0.34165,185.911451,0.002313,0.00149,41,0.000144,0,10,0.69281,0.020019
18029,Dearborn County,,IN,3893,61336,65229,14,15,29,45204,38550,83754,6,0.330358,0.344689,76.740051,0.001268,0.001269,42,0.000163,0,10,0.538095,0.01115
17177,Stephenson County,,IL,3207,61832,65039,17,19,36,22368,23272,45640,5,0.370388,0.389524,73.177048,0.002624,0.002504,8,0.000145,0,10,0.678947,0.022931
36115,Washington County,,NY,3560,61390,64950,14,9,23,46226,42994,89220,6,0.30165,0.314144,2.304639,0.002239,0.000592,36,0.000114,0,10,0.802198,0.017668
48021,Bastrop County,,TX,5014,59691,64705,37,28,65,87295,66125,153420,5,0.376609,0.397879,145.023488,0.008389,0.006049,62,0.000323,0,10,0.784495,0.087434
55015,Calumet County,,WI,4578,60062,64640,18,15,33,55748,51450,107198,5,0.359888,0.377165,32.453644,0.001613,0.001776,8,0.000165,0,10,0.868421,0.014766
37069,Franklin County,,NC,4329,60273,64602,22,19,41,58695,46226,104921,6,0.335005,0.351291,112.603215,0.004231,0.002736,37,0.000202,0,10,0.735507,0.042561
37083,Halifax County,,NC,3350,61195,64545,22,25,47,22977,28819,51796,6,0.338848,0.356868,2364.427337,0.003632,0.003543,37,0.000216,0,10,0.5,0.034741
40119,Payne County,,OK,6831,57675,64506,50,48,98,52562,60927,113489,5,0.394099,0.418387,3085.743182,0.006495,0.00934,52,0.000525,0,10,0.390415,0.067215
41011,Coos County,,OR,4166,60211,64377,46,33,79,35767,34138,69905,5,0.371508,0.392708,10.583299,0.009703,0.006723,45,0.000317,0,10,0.842687,0.093434
47141,Putnam County,,TN,4557,59767,64324,47,32,79,45654,44184,89838,5,0.360733,0.381342,14512.503429,0.008477,0.003122,51,0.000568,0,10,0.412549,0.084226
37167,Stanly County,,NC,3071,61191,64262,16,21,37,27323,28006,55329,6,0.335664,0.352403,11.448759,0.001895,0.003526,37,0.000183,0,10,0.816017,0.023216
37169,Stokes County,,NC,4352,59818,64170,11,11,22,35853,35697,71550,6,0.330999,0.345643,710.786981,0.001042,0.001495,37,0.000152,0,10,0.621212,0.011126
18173,Warrick County,,IN,4851,59293,64144,16,19,35,53115,46179,99294,5,0.377349,0.397445,1626.37118,0.001633,0.002642,42,0.000211,0,10,0.510526,0.015305
12035,Flagler County,,FL,4104,59893,63997,108,51,159,113690,63555,177245,5,0.398444,0.423296,52.882684,0.031976,0.018102,5,0.000552,0,10,0.812296,0.282872
45021,Cherokee County,,SC,2751,61101,63852,13,15,28,28044,27772,55816,6,0.3305,0.345741,15.005088,0.001633,0.002466,37,0.000157,0,10,0.780952,0.018522
2170,Matanuska-Susitna Borough,,AK,4384,59426,63810,44,39,83,121631,46486,168117,5,0.383712,0.406695,2426.811024,0.009033,0.009503,45,0.000413,0,10,0.53165,0.088436
6069,San Benito County,,CA,5140,58651,63791,25,32,57,56425,53408,109833,5,0.36972,0.390484,0.383522,0.006769,0.00721,45,0.000166,0,10,0.976326,0.062393
18065,Henry County,,IN,3062,60710,63772,12,18,30,28873,30198,59071,6,0.32775,0.342649,20.718591,0.000776,0.001287,42,0.000142,0,10,0.647059,0.007597
26073,Isabella County,,MI,5000,58718,63718,47,40,87,46538,47736,94274,5,0.383377,0.406586,796.634615,0.004185,0.004986,43,0.000305,0,10,0.494344,0.034723
26027,Cass County,,MI,3911,59479,63390,10,12,22,43660,41111,84771,5,0.373042,0.391802,2.438684,0.001751,0.002157,42,0.000094,0,10,0.928571,0.014165
51191,Washington County,,VA,3488,59862,63350,15,16,31,30464,29149,59613,6,0.33971,0.357156,3578.434492,0.000913,0.001346,51,0.000258,0,10,0.341912,0.009286
1033,Colbert County,,AL,3262,60043,63305,16,13,29,34723,34443,69166,6,0.332612,0.34688,132.571855,0.001526,0.001293,6,0.000202,0,10,0.573529,0.015462
26157,Tuscola County,,MI,3392,59714,63106,14,19,33,34306,35580,69886,5,0.364976,0.383567,10.88816,0.001998,0.002473,43,0.000108,0,10,0.833333,0.014902
23017,Oxford County,,ME,3167,59918,63085,22,20,42,35613,31925,67538,5,0.348616,0.365104,37.949594,0.003202,0.00291,33,0.000165,0,10,0.752308,0.02684
39009,Athens County,,OH,4603,58451,63054,33,32,65,30219,34970,65189,5,0.383616,0.405637,1871.850022,0.004225,0.005595,41,0.000282,0,10,0.496444,0.034594
22089,St. Charles Parish,,LA,4227,58751,62978,17,20,37,50245,47651,97896,5,0.356133,0.374235,11.206719,0.002294,0.003171,12,0.000145,0,10,0.807359,0.020718
36107,Tioga County,,NY,3929,59005,62934,13,14,27,32572,33048,65620,6,0.331284,0.346284,40.20568,0.001351,0.001568,36,0.000122,0,10,0.614286,0.010448
55043,Grant County,,WI,3408,59503,62911,18,24,42,24777,28682,53459,5,0.360945,0.379443,556.413355,0.001477,0.001841,8,0.000196,0,10,0.495,0.013708
13255,Spalding County,,GA,4827,58020,62847,33,30,63,62618,59882,122500,5,0.362008,0.381679,318.948372,0.006159,0.005178,6,0.000284,0,10,0.668908,0.061159
21195,Pike County,,KY,2873,59928,62801,13,19,32,14606,17571,32177,6,0.352051,0.368967,6790.677071,0.00096,0.001088,42,0.000201,0,10,0.24026,0.009313
37161,Rutherford County,,NC,2854,59924,62778,19,18,37,21971,24970,46941,6,0.33218,0.348085,29.67047,0.003519,0.002906,37,0.000192,0,10,0.766234,0.036822
19045,Clinton County,,IA,2994,59721,62715,16,16,32,22435,25064,47499,5,0.372048,0.391016,441.269937,0.001775,0.001763,8,0.00018,0,10,0.595588,0.017467
20169,Saline County,,KS,4058,58544,62602,31,33,64,29957,32049,62006,5,0.38661,0.408811,19215.895377,0.002801,0.004859,14,0.000436,0,10,0.396761,0.027039
47019,Carter County,,TN,3545,58955,62500,12,9,21,33883,35147,69030,6,0.330536,0.343408,187.557942,0.000959,0.000822,51,0.000203,0,10,0.522727,0.010949
5085,Lonoke County,,AR,5135,57364,62499,34,27,61,72700,60227,132927,5,0.379681,0.401622,2049.195679,0.006545,0.004291,52,0.000334,0,10,0.49431,0.064934
36035,Fulton County,,NY,2680,59461,62141,14,13,27,28075,25695,53770,6,0.317061,0.330621,49.318223,0.001823,0.001196,36,0.000125,0,10,0.766667,0.014267
27131,Rice County,,MN,3470,58655,62125,21,24,45,40744,40397,81141,5,0.373541,0.393538,309.664816,0.002246,0.002395,39,0.000211,0,10,0.673913,0.021462
27025,Chisago County,,MN,3614,58413,62027,20,20,40,59476,49435,108911,5,0.365149,0.383729,183.499043,0.001673,0.001569,39,0.000215,0,10,0.669048,0.016242
37087,Haywood County,,NC,2814,59090,61904,28,17,45,23621,18948,42569,5,0.353754,0.371208,686.289584,0.00737,0.004298,37,0.000268,0,10,0.743678,0.073889
35005,Chaves County,,NM,4644,57033,61677,32,30,62,27517,30915,58432,5,0.384432,0.406668,92.728094,0.007145,0.007117,35,0.000284,0,10,0.752941,0.071168
39011,Auglaize County,,OH,3117,58284,61401,13,18,31,31696,33115,64811,6,0.336916,0.352827,20.643245,0.001038,0.001777,43,0.000131,0,10,0.660819,0.008749
55135,Waupaca County,,WI,3213,57984,61197,18,18,36,34444,32887,67331,5,0.364024,0.382454,65.360942,0.001642,0.00151,8,0.000166,0,10,0.758893,0.014935
32510,Carson City,,NV,6046,54995,61041,39,31,70,64398,62570,126968,5,0.379728,0.401297,176.379657,0.009732,0.008261,45,0.000284,0,10,0.75842,0.090868
1071,Jackson County,,AL,2740,58224,60964,15,14,29,23323,24915,48238,6,0.322114,0.335411,84.682906,0.001048,0.000921,6,0.00018,0,10,0.495833,0.010657
40145,Wagoner County,,OK,5681,55217,60898,28,23,51,96438,81219,177657,5,0.373541,0.394162,436.829934,0.00443,0.003749,52,0.000295,0,10,0.650246,0.045753
22101,St. Mary Parish,,LA,3534,57230,60764,20,23,43,25693,35453,61146,5,0.355186,0.373486,62.724924,0.002906,0.00273,12,0.000168,0,10,0.652308,0.026325
28149,Warren County,,MS,3677,57055,60732,25,28,53,18973,22714,41687,5,0.364024,0.384516,6412.832728,0.003605,0.0042,12,0.000302,0,10,0.529234,0.033426
23009,Hancock County,,ME,3338,57383,60721,25,21,46,23850,22676,46526,5,0.352253,0.369851,208.453713,0.003966,0.00364,33,0.000201,0,10,0.705026,0.034086
5033,Crawford County,,AR,4145,56461,60606,16,18,34,49822,47531,97353,5,0.357126,0.375564,539.98479,0.00171,0.002286,52,0.000207,0,10,0.609524,0.016861
29187,St. Francois County,,MO,3557,56964,60521,21,23,44,42666,36547,79213,5,0.367113,0.386442,3244.811069,0.002026,0.00208,14,0.000259,0,10,0.516304,0.019711
39021,Champaign County,,OH,3785,56702,60487,11,13,24,36983,36812,73795,6,0.335444,0.350168,8.580376,0.001066,0.001244,42,0.000121,0,10,0.724359,0.009145
35025,Lea County,,NM,4108,56372,60480,41,31,72,29815,31237,61052,5,0.384336,0.406505,2863.597471,0.008112,0.005637,35,0.000394,0,10,0.57309,0.081357
22113,Vermilion Parish,,LA,2618,57858,60476,17,14,31,35814,34967,70781,5,0.352132,0.368848,77.63791,0.001665,0.001679,12,0.00016,0,10,0.728758,0.01478
13047,Catoosa County,,GA,4915,55512,60427,17,14,31,69588,59317,128905,6,0.337027,0.352176,213.52128,0.002576,0.001978,51,0.000194,0,10,0.640523,0.026131
22115,Vernon Parish,,LA,10987,49409,60396,71,83,154,61035,78494,139529,5,0.415472,0.44292,1808.769736,0.01538,0.019877,12,0.000474,0,10,0.578013,0.146711
48203,Harrison County,,TX,4414,55979,60393,27,24,51,53444,54617,108061,5,0.358962,0.378033,50.040923,0.004615,0.004314,62,0.000252,0,10,0.652688,0.047423
55005,Barron County,,WI,2970,57359,60329,22,23,45,25244,26916,52160,5,0.373723,0.393647,617.267862,0.002209,0.002622,39,0.000226,0,10,0.699275,0.020686
24047,Worcester County,,MD,3929,56300,60229,39,35,74,46826,41639,88465,5,0.381378,0.403304,231.409632,0.008217,0.009264,47,0.000246,0,10,0.698138,0.072987
26057,Gratiot County,,MI,3533,56641,60174,16,20,36,24700,25897,50597,6,0.33308,0.349023,1.579004,0.001753,0.001885,43,0.000127,0,10,0.913158,0.013439
47053,Gibson County,,TN,3161,56909,60070,19,17,36,34419,31785,66204,6,0.33475,0.349864,176.772609,0.001519,0.001291,52,0.000259,0,10,0.484211,0.015978
27035,Crow Wing County,,MN,3651,56325,59976,34,32,66,45843,38548,84391,5,0.368522,0.389073,332.311273,0.001938,0.002182,39,0.000356,0,10,0.582353,0.01944
39149,Shelby County,,OH,2887,56899,59786,13,13,26,28302,31199,59501,6,0.335774,0.350656,10.317268,0.001309,0.001293,42,0.000127,0,10,0.741758,0.010997
47073,Hawkins County,,TN,3345,56386,59731,16,15,31,38312,38381,76693,6,0.330714,0.344331,1041.535316,0.000472,0.000933,51,0.000299,0,10,0.441176,0.006217
39027,Clinton County,,OH,3858,55817,59675,15,15,30,43423,40913,84336,6,0.335628,0.350656,9.304883,0.001801,0.001604,42,0.000148,0,10,0.790476,0.015195
35035,Otero County,,NM,7261,52375,59636,39,59,98,39603,43379,82982,5,0.398495,0.424056,298.446457,0.00972,0.014151,35,0.000301,0,10,0.634177,0.093852
21199,Pulaski County,,KY,2682,56935,59617,26,20,46,21981,19378,41359,6,0.333008,0.348503,7645.622427,0.002522,0.001254,42,0.000386,0,10,0.349206,0.023494
51067,Franklin County,,VA,2993,56339,59332,13,13,26,28162,25186,53348,6,0.315142,0.328695,811.276268,0.000982,0.00052,37,0.000163,0,10,0.509524,0.009303
19033,Cerro Gordo County,,IA,3216,55997,59213,23,22,45,19401,22374,41775,5,0.375826,0.395926,6734.628449,0.002155,0.002318,8,0.000276,0,10,0.376923,0.020736
17077,Jackson County,,IL,6112,53058,59170,43,49,92,40233,47942,88175,5,0.406564,0.431353,15268.768697,0.005905,0.01043,14,0.000387,0,10,0.452381,0.051893
44001,Bristol County,,RI,3177,55894,59071,15,19,34,31811,33693,65504,5,0.351769,0.369092,0,0.003724,0.005395,33,0.000107,0,10,0.992857,0.030773
47035,Cumberland County,,TN,2676,56101,58777,43,20,63,22254,18220,40474,5,0.350525,0.367329,1947.984177,0.010234,0.002333,51,0.000435,0,10,0.59778,0.100899
5093,Mississippi County,,AR,3652,55083,58735,13,23,36,16372,24495,40867,5,0.376886,0.398215,581.309479,0.001642,0.003678,52,0.000169,0,10,0.496047,0.016406
21019,Boyd County,,KY,3366,55268,58634,14,14,28,28724,28345,57069,6,0.337917,0.354378,239.320656,0.001118,0.001123,41,0.00021,0,10,0.485714,0.010456
48427,Starr County,,TX,3428,55188,58616,15,14,29,19774,29042,48816,5,0.374087,0.393821,54.267446,0.004068,0.003985,62,0.000147,0,10,0.809524,0.040059
17117,Macoupin County,,IL,3084,55502,58586,14,13,27,31090,31181,62271,5,0.35775,0.374561,226.276252,0.001652,0.001512,14,0.000164,0,10,0.593407,0.014728
5035,Crittenden County,,AR,3810,54718,58528,18,21,39,31507,33403,64910,5,0.373859,0.39477,395.548364,0.002,0.003337,52,0.000196,0,10,0.543333,0.018556
48323,Maverick County,,TX,3646,54826,58472,24,22,46,20656,24754,45410,5,0.37436,0.394976,273.185291,0.005075,0.004394,62,0.000233,0,10,0.645503,0.051737
48347,Nacogdoches County,,TX,4879,53452,58331,37,37,74,39863,47094,86957,5,0.35993,0.380691,293.191462,0.005306,0.005454,62,0.000343,0,10,0.580128,0.056218
36003,Allegany County,,NY,3186,54802,57988,12,14,26,21230,21999,43229,6,0.320401,0.334191,25.572817,0.000981,0.001022,36,0.000115,0,10,0.642857,0.007238
26023,Branch County,,MI,3627,54215,57842,20,16,36,24351,25987,50338,5,0.358711,0.376242,179.047689,0.002832,0.002209,43,0.000153,0,10,0.575758,0.022406
18099,Marshall County,,IN,3396,54233,57629,13,15,28,30553,31213,61766,5,0.372228,0.391178,78.120317,0.001761,0.00229,42,0.000121,0,10,0.833333,0.014879
47107,McMinn County,,TN,2825,54698,57523,15,15,30,29785,29636,59421,6,0.337212,0.353418,210.779366,0.001796,0.001635,51,0.000221,0,10,0.570175,0.019056
6115,Yuba County,,CA,6775,50730,57505,48,40,88,92451,81915,174366,5,0.376286,0.398839,178.056874,0.011723,0.009937,45,0.000303,0,10,0.763137,0.110105
37013,Beaufort County,,NC,2922,54570,57492,19,18,37,22083,23604,45687,6,0.335261,0.351264,281.212932,0.002273,0.002594,37,0.000216,0,10,0.645238,0.023618
12023,Columbia County,,FL,4150,53327,57477,43,39,82,51562,42473,94035,5,0.363035,0.384201,3099.005425,0.00917,0.00907,5,0.000374,0,10,0.634249,0.092008
36017,Chenango County,,NY,2926,54505,57431,17,15,32,25482,26293,51775,6,0.325251,0.341054,18.278825,0.003043,0.001815,36,0.000123,0,10,0.702632,0.023151
26059,Hillsdale County,,MI,3098,54312,57410,17,19,36,28540,28290,56830,5,0.360394,0.378738,115.333532,0.002896,0.002734,43,0.000134,0,10,0.680952,0.022927
17029,Coles County,,IL,3737,53666,57403,28,27,55,28254,29688,57942,5,0.375229,0.395898,8870.999401,0.002355,0.003005,8,0.000298,0,10,0.398185,0.020155
1009,Blount County,,AL,3154,54246,57400,14,14,28,46796,39686,86482,6,0.320702,0.333496,1.895383,0.000937,0.000972,6,0.000157,0,10,0.912088,0.010008
48373,Polk County,,TX,5051,52340,57391,44,47,91,44031,40843,84874,5,0.384673,0.408811,2448.622598,0.010928,0.009394,62,0.000351,0,10,0.544633,0.110055
53045,Mason County,,WA,4357,52968,57325,27,24,51,58955,47720,106675,5,0.370478,0.390484,3.451366,0.006413,0.005462,45,0.00021,0,10,0.913793,0.063039
27027,Clay County,,MN,3906,53337,57243,30,25,55,51252,46537,97789,5,0.369942,0.389887,2025.808467,0.001764,0.001853,39,0.0004,0,10,0.444556,0.017892
47031,Coffee County,,TN,3622,53596,57218,22,19,41,36494,35480,71974,6,0.336916,0.352903,588.617596,0.002847,0.002126,51,0.000294,0,10,0.554113,0.03039
18113,Noble County,,IN,3400,53713,57113,12,14,26,35324,38170,73494,6,0.340086,0.356841,103.389941,0.001239,0.001497,42,0.000135,0,10,0.566667,0.011064
5115,Pope County,,AR,4065,53030,57095,31,27,58,34313,35669,69982,5,0.37786,0.399561,3218.528531,0.003374,0.003341,52,0.000379,0,10,0.438447,0.035481
21125,Laurel County,,KY,2738,54312,57050,22,22,44,32885,29347,62232,5,0.346883,0.364627,5610.04464,0.002754,0.002029,42,0.000283,0,10,0.370769,0.024947
47089,Jefferson County,,TN,4988,52039,57027,24,16,40,49192,47734,96926,6,0.331213,0.345171,337.621806,0.003776,0.00137,51,0.000301,0,10,0.5,0.038093
42099,Perry County,,PA,2639,54344,56983,11,11,22,30514,29145,59659,6,0.306342,0.318967,3.97365,0.000899,0.000854,47,0.000116,0,10,0.790909,0.007923
39051,Fulton County,,OH,3095,53880,56975,10,12,22,32264,31772,64036,5,0.366107,0.384055,68.081922,0.000994,0.00171,43,0.000104,0,10,0.681818,0.007999
1045,Dale County,,AL,7588,49359,56947,52,52,104,58982,66994,125976,5,0.393342,0.418153,2420.536275,0.011572,0.010991,6,0.000382,0,10,0.622951,0.110802
6109,Tuolumne County,,CA,3382,53525,56907,37,35,72,38922,31115,70037,5,0.369987,0.391135,16.170131,0.00804,0.007656,45,0.000226,0,10,0.914652,0.073942
27009,Benton County,,MN,5078,51608,56686,26,23,49,61045,58227,119272,5,0.366675,0.385872,109.498617,0.001365,0.001668,39,0.000273,0,10,0.672365,0.013146
18093,Lawrence County,,IN,2611,54007,56618,14,18,32,20315,20672,40987,6,0.33107,0.346349,68.425732,0.000727,0.001351,42,0.000181,0,10,0.578431,0.006828
1113,Russell County,,AL,5507,51044,56551,49,32,81,75393,71098,146491,5,0.369053,0.39062,500.217132,0.010598,0.00757,6,0.000364,0,10,0.642041,0.102262
40113,Osage County,,OK,5251,51261,56512,15,15,30,52722,50513,103235,5,0.354898,0.372266,60.114472,0.001306,0.001825,52,0.00019,0,10,0.816667,0.013617
18037,Dubois County,,IN,2373,54065,56438,16,19,35,17916,19157,37073,5,0.360521,0.378711,744.697648,0.000925,0.001639,42,0.000226,0,10,0.457895,0.008841
54069,Ohio County,,WV,3052,53298,56350,12,12,24,23285,25623,48908,6,0.336916,0.352995,118.942601,0.00108,0.001004,41,0.000148,0,10,0.596154,0.00951
4007,Gila County,,AZ,4118,52219,56337,17,15,32,42497,39847,82344,5,0.369675,0.388477,9.933496,0.004588,0.00402,45,0.000155,0,10,0.882353,0.044798
42087,Mifflin County,,PA,1713,54514,56227,12,13,25,13369,13830,27199,6,0.326982,0.341325,23.701225,0.001342,0.001303,41,0.000122,0,10,0.791209,0.011409
42065,Jefferson County,,PA,2398,53797,56195,13,13,26,21668,21581,43249,6,0.3266,0.340999,13.306735,0.001075,0.001069,41,0.000128,0,10,0.686813,0.008319
48199,Hardin County,,TX,4101,52085,56186,26,26,52,51578,48063,99641,5,0.362478,0.382454,127.050182,0.004755,0.004832,62,0.000238,0,10,0.74023,0.048572
40147,Washington County,,OK,4040,52058,56098,28,28,56,32605,33490,66095,5,0.377025,0.398367,1162.899038,0.00468,0.00414,52,0.000303,0,10,0.517045,0.048058
21073,Franklin County,,KY,3453,52524,55977,18,21,39,30254,31574,61828,5,0.369408,0.389616,1107.65411,0.001937,0.003189,42,0.000278,0,10,0.436759,0.017891
53071,Walla Walla County,,WA,4127,51828,55955,33,31,64,35396,36749,72145,5,0.371373,0.392329,964.492288,0.005745,0.006233,45,0.000276,0,10,0.776471,0.058135
2122,Kenai Peninsula Borough,,AK,4092,51861,55953,27,25,52,27070,25581,52651,5,0.382565,0.403874,1155.648132,0.005912,0.006453,45,0.00026,0,10,0.583669,0.058352
40071,Kay County,,OK,3691,52228,55919,18,23,41,21284,27883,49167,5,0.375275,0.395763,2025.376796,0.002576,0.003178,52,0.000229,0,10,0.538462,0.025911
37047,Columbus County,,NC,2399,53466,55865,12,15,27,20106,22895,43001,5,0.353917,0.371663,25.299583,0.002206,0.003568,37,0.000133,0,10,0.791667,0.023435
39129,Pickaway County,,OH,4065,51584,55649,16,16,32,53881,47207,101088,6,0.333406,0.348394,23.303732,0.001139,0.00092,41,0.00018,0,10,0.578431,0.010048
17007,Boone County,,IL,3861,51713,55574,15,14,29,64126,49519,113645,5,0.369853,0.38833,4.873187,0.003133,0.002573,8,0.000117,0,10,0.825,0.026043
1001,Autauga County,,AL,4715,50793,55508,37,37,74,55693,50851,106544,5,0.377953,0.400944,1461.178731,0.007236,0.007999,6,0.000295,0,10,0.588795,0.070827
39039,Defiance County,,OH,3042,52389,55431,11,18,29,24359,25840,50199,6,0.339748,0.356543,97.785168,0.000946,0.002052,43,0.000123,0,10,0.568627,0.007824
26123,Newaygo County,,MI,3139,52291,55430,16,16,32,36560,35087,71647,6,0.332324,0.347721,10.938711,0.001704,0.001437,43,0.000142,0,10,0.760234,0.013513
37061,Duplin County,,NC,3189,52171,55360,20,38,58,34185,45611,79796,5,0.384481,0.407709,311.538814,0.004044,0.007981,37,0.000189,0,10,0.560729,0.04119
27169,Winona County,,MN,3359,51924,55283,23,24,47,21152,27513,48665,5,0.373859,0.393918,629.947496,0.00196,0.002663,39,0.000236,0,10,0.56,0.018603
6033,Lake County,,CA,3525,51583,55108,33,34,67,48894,35476,84370,5,0.370165,0.391216,0.24147,0.00792,0.007334,45,0.000203,0,10,0.974395,0.072728
39091,Logan County,,OH,3261,51669,54930,15,16,31,31869,32445,64314,6,0.340954,0.35759,33.742231,0.001155,0.001723,42,0.000144,0,10,0.632353,0.009877
26151,Sanilac County,,MI,3009,51883,54892,9,15,24,28281,28426,56707,5,0.364759,0.382861,7.618102,0.001433,0.002322,43,0.000084,0,10,0.952381,0.010794
27067,Kandiyohi County,,MN,3046,51625,54671,23,30,53,18634,24182,42816,5,0.369809,0.390267,987.540147,0.001373,0.001978,39,0.000241,0,10,0.486895,0.0133
36023,Cortland County,,NY,3159,51504,54663,17,17,34,24001,24249,48250,6,0.332648,0.348296,19.857327,0.002165,0.002063,36,0.000124,0,10,0.67619,0.016252
48277,Lamar County,,TX,3317,51252,54569,21,24,45,23748,23936,47684,5,0.376424,0.397309,474.613617,0.00333,0.004292,62,0.000228,0,10,0.530769,0.035029
29101,Johnson County,,MO,5950,48598,54548,39,41,80,39131,43124,82255,5,0.39731,0.420774,1331.433762,0.00712,0.008465,14,0.000336,0,10,0.537234,0.0687
55075,Marinette County,,WI,2987,51514,54501,19,20,39,24822,24282,49104,5,0.36031,0.378223,404.248123,0.001619,0.00179,8,0.000201,0,10,0.581028,0.014762
17063,Grundy County,,IL,3467,51014,54481,12,16,28,58148,42949,101097,5,0.378418,0.398557,17.125494,0.0021,0.003638,8,0.000105,0,10,0.882353,0.017183
32007,Elko County,,NV,5229,49143,54372,38,35,73,32535,31742,64277,5,0.372319,0.393739,7022.64089,0.006509,0.005913,45,0.000388,0,10,0.518902,0.064296
27049,Goodhue County,,MN,2700,51610,54310,19,20,39,30398,31011,61409,5,0.365366,0.384001,122.785036,0.001644,0.001627,39,0.0002,0,10,0.662338,0.015609
21101,Henderson County,,KY,2533,51704,54237,12,13,25,21555,22318,43873,6,0.337954,0.354096,416.598324,0.00072,0.00137,42,0.000186,0,10,0.549451,0.006768
42127,Wayne County,,PA,2865,51361,54226,32,22,54,38870,27408,66278,5,0.342666,0.35963,23.881927,0.007513,0.004338,47,0.000163,0,10,0.85126,0.056338
13297,Walton County,,GA,3670,50374,54044,33,28,61,86829,63979,150808,5,0.360817,0.380496,240.788952,0.007081,0.005563,6,0.000283,0,10,0.704991,0.06968
47167,Tipton County,,TN,3601,50345,53946,13,13,26,48303,38953,87256,5,0.360352,0.378342,181.859131,0.002305,0.001589,52,0.000159,0,10,0.5125,0.02226
22099,St. Martin Parish,,LA,2696,51211,53907,15,11,26,43818,41654,85472,5,0.352011,0.368359,13.214264,0.001645,0.001373,12,0.000143,0,10,0.766667,0.014711
37077,Granville County,,NC,3417,50404,53821,19,17,36,43795,37879,81674,6,0.332,0.347304,125.914074,0.003099,0.002522,37,0.000196,0,10,0.65,0.032382
42103,Pike County,,PA,3454,50273,53727,38,39,77,66156,40347,106503,5,0.371239,0.393159,11.661287,0.009014,0.009212,47,0.000175,0,10,0.868182,0.067129
50025,Windham County,,VT,3490,50208,53698,32,31,63,23532,24020,47552,5,0.365627,0.385699,181.843372,0.006552,0.005515,33,0.000197,0,10,0.731746,0.055414
26117,Montcalm County,,MI,4115,49536,53651,20,21,41,52950,50141,103091,6,0.332936,0.348942,7.012163,0.001929,0.001661,43,0.000153,0,10,0.796537,0.01498
33003,Carroll County,,NH,3609,49984,53593,27,27,54,39280,31814,71094,5,0.368566,0.388493,77.263596,0.004854,0.005873,33,0.000176,0,10,0.773619,0.040207
29145,Newton County,,MO,3895,49568,53463,22,19,41,50326,51251,101577,5,0.367684,0.386659,809.951203,0.002865,0.001865,14,0.000258,0,10,0.554348,0.028469
42115,Susquehanna County,,PA,2375,51056,53431,11,10,21,22020,21478,43498,6,0.323471,0.33648,46.793002,0.001542,0.00112,47,0.00011,0,10,0.672727,0.0123
39123,Ottawa County,,OH,2833,50553,53386,15,15,30,31039,29263,60302,5,0.366894,0.38533,16.530539,0.002357,0.002516,43,0.000115,0,10,0.774854,0.018413
13013,Barrow County,,GA,4356,48943,53299,28,26,54,91551,61665,153216,5,0.362435,0.382509,576.803343,0.005592,0.004546,6,0.000258,0,10,0.592692,0.053617
54079,Putnam County,,WV,4177,49048,53225,15,17,32,45359,37421,82780,6,0.341485,0.359505,441.553869,0.000681,0.001654,41,0.000225,0,10,0.477124,0.00623
36025,Delaware County,,NY,3242,49956,53198,22,21,43,27267,24883,52150,5,0.335628,0.351964,19.856549,0.004492,0.003628,36,0.000137,0,10,0.801667,0.034038
1047,Dallas County,,AL,2469,50698,53167,18,22,40,13639,22803,36442,5,0.35193,0.37022,371.098212,0.002603,0.003542,6,0.000193,0,10,0.608696,0.025625
42083,McKean County,,PA,2105,51051,53156,11,13,24,10273,10767,21040,6,0.327436,0.342166,2654.877984,0.001007,0.000967,36,0.000135,0,10,0.416667,0.007982
37163,Sampson County,,NC,2676,50479,53155,21,26,47,38135,40580,78715,5,0.356339,0.376628,57.08913,0.004079,0.004569,37,0.000192,0,10,0.648148,0.041817
21107,Hopkins County,,KY,2744,50324,53068,17,20,37,17538,19403,36941,6,0.344433,0.362142,3964.712487,0.001406,0.001826,42,0.000249,0,10,0.423684,0.013857
39031,Coshocton County,,OH,2375,50568,52943,11,13,24,20458,20350,40808,6,0.333044,0.347797,2.447399,0.001342,0.001313,41,0.000111,0,10,0.820513,0.010825
39107,Mercer County,,OH,2377,50558,52935,11,16,27,17401,20077,37478,6,0.337582,0.353451,90.501123,0.000979,0.001936,43,0.000124,0,10,0.625,0.008544
35015,Eddy County,,NM,3692,49209,52901,26,25,51,24581,25274,49855,5,0.377488,0.398801,210.350924,0.005205,0.005247,35,0.000247,0,10,0.678571,0.052798
51680,Lynchburg city,,VA,5467,47424,52891,37,37,74,54919,65041,119960,5,0.385107,0.408404,6836.615266,0.007047,0.008796,37,0.000323,0,10,0.590194,0.065917
37153,Richmond County,,NC,2543,50215,52758,19,21,40,16862,20696,37558,6,0.335188,0.351725,30.874908,0.002353,0.003242,37,0.000194,0,10,0.638528,0.025306
49003,Box Elder County,,UT,3228,49516,52744,14,15,29,38652,36556,75208,5,0.368081,0.386605,534.104905,0.002486,0.002508,45,0.000166,0,10,0.775,0.024338
18033,DeKalb County,,IN,3289,49320,52609,10,11,21,31862,31156,63018,6,0.327157,0.340582,32.926127,0.000661,0.000618,42,0.000124,0,10,0.590909,0.00587
19057,Des Moines County,,IA,2746,49857,52603,17,20,37,16150,17431,33581,5,0.374087,0.393468,2952.593548,0.001263,0.001831,8,0.000223,0,10,0.471429,0.012174
13129,Gordon County,,GA,3248,49329,52577,19,21,40,39693,34530,74223,5,0.371733,0.392046,194.310321,0.002647,0.003792,6,0.000205,0,10,0.680952,0.026984
42123,Warren County,,PA,2063,50340,52403,9,9,18,11440,12345,23785,6,0.326115,0.339806,10.291225,0.000674,0.000623,41,0.000109,0,10,0.633333,0.005417
47047,Fayette County,,TN,3724,48631,52355,11,10,21,52577,35983,88560,6,0.333732,0.347586,78.589129,0.00154,0.00108,52,0.000147,0,10,0.564103,0.015361
19049,Dallas County,,IA,4208,48116,52324,33,23,56,96829,63501,160330,5,0.382947,0.403505,3391.120804,0.004631,0.003041,8,0.000395,0,10,0.4375,0.044239
48071,Chambers County,,TX,4539,47757,52296,13,16,29,52601,43532,96133,5,0.358669,0.376704,0.569185,0.002641,0.003569,62,0.00014,0,10,0.941667,0.028624
36033,Franklin County,,NY,2205,50038,52243,13,12,25,15176,16983,32159,6,0.323505,0.337858,0.820662,0.002447,0.001638,36,0.000103,0,10,0.92381,0.01865
39059,Guernsey County,,OH,2372,49771,52143,14,15,29,18859,20124,38983,6,0.333261,0.34834,18.112266,0.001401,0.001194,41,0.000148,0,10,0.625,0.011373
6103,Tehama County,,CA,3212,48883,52095,40,34,74,43887,34244,78131,5,0.370701,0.39184,23.732778,0.008114,0.007133,45,0.000251,0,10,0.885976,0.075169
53021,Franklin County,,WA,4797,47295,52092,40,33,73,94568,78214,172782,5,0.385542,0.408105,208.092194,0.008317,0.007371,45,0.000293,0,10,0.739958,0.081005
12039,Gadsden County,,FL,3322,48674,51996,19,19,38,35049,36935,71984,5,0.360394,0.378749,466.43399,0.004641,0.004677,5,0.000205,0,10,0.58658,0.044962
27061,Itasca County,,MN,2404,49563,51967,20,17,37,17932,16868,34800,5,0.366325,0.384787,150.980111,0.001739,0.001594,39,0.000226,0,10,0.757143,0.016777
36039,Greene County,,NY,2740,49196,51936,21,20,41,32727,25998,58725,5,0.341523,0.358431,21.603729,0.004369,0.00429,47,0.000132,0,10,0.789855,0.033183
55031,Douglas County,,WI,2487,49387,51874,19,22,41,20436,20921,41357,5,0.367113,0.386361,130.063358,0.001304,0.002162,39,0.000217,0,10,0.634058,0.01266
32005,Douglas County,,NV,5139,46630,51769,42,30,72,59259,48838,108097,5,0.371149,0.391949,2355.209933,0.010491,0.007584,45,0.000288,0,10,0.804545,0.098489
16011,Bingham County,,ID,3380,48346,51726,16,17,33,31020,36398,67418,5,0.365236,0.383621,978.412201,0.002246,0.002612,45,0.000175,0,10,0.771242,0.022279
5139,Union County,,AR,2602,49088,51690,21,25,46,13453,17403,30856,5,0.357209,0.376405,3353.257298,0.002672,0.002384,52,0.000242,0,10,0.45584,0.027114
23025,Somerset County,,ME,2902,48780,51682,23,17,40,33944,32956,66900,5,0.325389,0.33986,22.549316,0.00296,0.001327,33,0.000189,0,10,0.733202,0.024644
37105,Lee County,,NC,3798,47862,51660,20,19,39,43741,47740,91481,5,0.35696,0.375385,9.134027,0.003563,0.003969,37,0.00018,0,10,0.826087,0.036291
18069,Huntington County,,IN,2656,48971,51627,13,16,29,19709,21248,40957,6,0.326635,0.340804,17.088889,0.000706,0.000938,42,0.000152,0,10,0.5875,0.006358
21185,Oldham County,,KY,4014,47425,51439,17,15,32,52027,42297,94324,5,0.360267,0.37787,594.149371,0.002411,0.001522,42,0.000232,0,10,0.488971,0.022205
54037,Jefferson County,,WV,3252,48132,51384,27,19,46,49480,36441,85921,6,0.352011,0.369076,470.621086,0.004968,0.003657,13,0.000232,0,10,0.625356,0.046111
39135,Preble County,,OH,2780,48562,51342,11,11,22,29707,30086,59793,6,0.335591,0.350168,88.090669,0.001576,0.001405,42,0.000118,0,10,0.781818,0.01318
41009,Columbia County,,OR,3318,48012,51330,20,23,43,41634,33932,75566,5,0.365758,0.385031,7.051959,0.003781,0.003988,45,0.000181,0,10,0.915,0.038873
39015,Brown County,,OH,3531,47709,51240,13,13,26,44648,43661,88309,6,0.335554,0.350331,17.068201,0.001614,0.001471,42,0.000143,0,10,0.814103,0.013877
48497,Wise County,,TX,4042,47122,51164,23,25,48,60215,49550,109765,5,0.36188,0.381776,159.38732,0.004802,0.004851,62,0.000236,0,10,0.789683,0.049686
54019,Fayette County,,WV,2904,48244,51148,12,11,23,17389,19793,37182,6,0.330536,0.34541,384.56435,0.000258,0.0006,41,0.000207,0,10,0.512821,0.002313
13039,Camden County,,GA,6821,44265,51086,47,51,98,48588,50621,99209,5,0.387732,0.412972,1019.974025,0.012562,0.013889,5,0.000338,0,10,0.715909,0.120331
40051,Grady County,,OK,4045,46970,51015,18,18,36,47178,41860,89038,5,0.348932,0.366336,148.672643,0.002418,0.001938,52,0.000218,0,10,0.702632,0.024728
13175,Laurens County,,GA,2314,48293,50607,29,28,57,16887,16971,33858,5,0.359256,0.378461,19166.801107,0.004199,0.004143,6,0.000374,0,10,0.409677,0.042084
17121,Marion County,,IL,2429,48164,50593,14,18,32,16111,18079,34190,5,0.358502,0.376025,4011.592953,0.001221,0.001531,14,0.000169,0,10,0.502924,0.011258
42061,Huntingdon County,,PA,1973,48600,50573,14,14,28,16117,16870,32987,6,0.326774,0.341271,113.482222,0.001782,0.00132,41,0.000129,0,10,0.738095,0.015174
28109,Pearl River County,,MS,2674,47865,50539,23,20,43,35590,28070,63660,5,0.360394,0.379498,122.843101,0.002434,0.002412,12,0.000196,0,10,0.626667,0.021414
48465,Val Verde County,,TX,4916,45611,50527,33,47,80,22419,30541,52960,5,0.391887,0.416135,6840.8836,0.007559,0.010035,62,0.000329,0,10,0.575472,0.076862
45025,Chesterfield County,,SC,2458,48063,50521,14,15,29,20051,21116,41167,6,0.330394,0.345578,14.460288,0.001472,0.002361,37,0.000167,0,10,0.708333,0.017571
47043,Dickson County,,TN,3288,47198,50486,14,16,30,36043,32621,68664,6,0.336953,0.352501,61.312748,0.00164,0.001897,51,0.000192,0,10,0.666667,0.01799
31019,Buffalo County,,NE,3666,46692,50358,29,29,58,28532,29205,57737,5,0.369942,0.390007,13215.860455,0.00136,0.003071,50,0.000498,0,10,0.255793,0.014686
18017,Cass County,,IN,2777,47503,50280,17,18,35,20304,23733,44037,5,0.360733,0.378928,286.992018,0.002136,0.001912,42,0.000173,0,10,0.464286,0.01964
55081,Monroe County,,WI,2929,47307,50236,22,22,44,23274,23549,46823,5,0.367948,0.38731,201.146654,0.00214,0.001963,39,0.000211,0,10,0.612536,0.019894
1031,Coffee County,,AL,4986,45184,50170,45,46,91,46077,45031,91108,5,0.374497,0.397754,1872.389848,0.009659,0.009238,6,0.000342,0,10,0.604123,0.093852
35009,Curry County,,NM,5998,44119,50117,47,51,98,33625,39650,73275,5,0.392688,0.417383,9538.39064,0.00951,0.010164,35,0.000454,0,10,0.4844,0.09387
48073,Cherokee County,,TX,3128,46928,50056,17,20,37,30505,31787,62292,5,0.358334,0.376785,6.792687,0.003357,0.003878,62,0.000177,0,10,0.854762,0.036082
19127,Marshall County,,IA,2697,47226,49923,16,17,33,15141,19929,35070,5,0.366675,0.38514,515.282868,0.001635,0.001293,8,0.000208,0,10,0.497076,0.015955
49045,Tooele County,,UT,4114,45748,49862,22,20,42,62289,46865,109154,5,0.371913,0.391569,67.096771,0.004815,0.003674,45,0.000193,0,10,0.605413,0.04579
39171,Williams County,,OH,2367,47256,49623,12,14,26,18672,20463,39135,6,0.333442,0.348692,74.069462,0.00096,0.000856,43,0.000127,0,10,0.527473,0.007954
40019,Carter County,,OK,3196,46386,49582,23,25,48,26783,27451,54234,5,0.356422,0.375266,839.244897,0.003204,0.003194,52,0.000277,0,10,0.527692,0.032969
33019,Sullivan County,,NH,2838,46664,49502,20,19,39,29779,25985,55764,5,0.326774,0.341569,5.892798,0.003686,0.002471,33,0.000137,0,10,0.81,0.030347
36073,Orleans County,,NY,2555,46912,49467,7,8,15,22928,24394,47322,6,0.346375,0.360829,49.367138,0.001244,0.001128,36,0.000084,0,10,0.839286,0.010083
26107,Mecosta County,,MI,3925,45506,49431,31,27,58,32802,31323,64125,5,0.372273,0.392535,150.761282,0.002935,0.00317,43,0.000212,0,10,0.701705,0.022525
42117,Tioga County,,PA,2078,47215,49293,14,17,31,14481,13699,28180,6,0.3305,0.34566,29.25377,0.002131,0.002484,36,0.000121,0,10,0.649123,0.017603
26063,Huron County,,MI,2035,47226,49261,11,15,26,14234,15566,29800,6,0.332792,0.348074,0.5713,0.001503,0.001817,43,0.000093,0,10,0.942857,0.011273
20161,Riley County,,KS,7921,41122,49043,93,92,185,72458,87421,159879,5,0.422675,0.45026,42774.843188,0.015624,0.019118,14,0.000845,0,10,0.382965,0.148419
18145,Shelby County,,IN,3140,45765,48905,16,18,34,33677,35253,68930,6,0.326288,0.340506,28.311898,0.000913,0.000988,42,0.000176,0,10,0.567251,0.008973
29113,Lincoln County,,MO,2654,46150,48804,12,13,25,53841,36929,90770,6,0.332864,0.34675,22.789992,0.001202,0.001356,14,0.000152,0,10,0.730769,0.01083
56037,Sweetwater County,,WY,3884,44878,48762,43,45,88,24036,26535,50571,5,0.386366,0.410031,1595.81686,0.007845,0.006611,35,0.00038,0,10,0.477504,0.07845
47145,Roane County,,TN,2799,45828,48627,14,17,31,32260,34527,66787,6,0.330892,0.344873,78.297249,0.0011,0.001403,51,0.000233,0,10,0.639706,0.013003
8067,La Plata County,,CO,4355,44268,48623,46,44,90,33492,32969,66461,5,0.391039,0.414914,385.667752,0.010388,0.010528,35,0.000374,0,10,0.646667,0.10418
47021,Cheatham County,,TN,3578,45037,48615,12,11,23,42131,39189,81320,6,0.331749,0.345285,6.59069,0.001489,0.001487,51,0.000158,0,10,0.871795,0.016303
8037,Eagle County,,CO,6143,42471,48614,51,53,104,42595,48185,90780,5,0.403785,0.428684,489.403638,0.015575,0.01529,35,0.000366,0,10,0.71285,0.14965
55095,Polk County,,WI,2375,46228,48603,18,18,36,31679,27901,59580,5,0.366325,0.384977,92.78168,0.001894,0.001803,39,0.000193,0,10,0.826797,0.018239
28045,Hancock County,,MS,3571,45021,48592,19,31,50,34585,32527,67112,5,0.374178,0.396669,395.77736,0.00291,0.004914,12,0.000172,0,10,0.65914,0.026284
27099,Mower County,,MN,2676,45756,48432,17,23,40,16619,21179,37798,5,0.367552,0.386957,940.498233,0.001151,0.001729,39,0.000194,0,10,0.445,0.010934
19139,Muscatine County,,IA,2658,45705,48363,17,16,33,21007,23491,44498,5,0.37436,0.393359,506.257386,0.002315,0.002017,8,0.000204,0,10,0.633987,0.022369
48481,Wharton County,,TX,2727,45620,48347,14,17,31,23177,26588,49765,5,0.358251,0.376351,13.743194,0.002591,0.003626,62,0.000157,0,10,0.836601,0.027917
47105,Loudon County,,TN,3133,45133,48266,17,12,29,38807,35853,74660,6,0.332144,0.346202,101.053829,0.003466,0.001253,51,0.000209,0,10,0.660819,0.034262
48265,Kerr County,,TX,3317,44866,48183,43,31,74,31104,28996,60100,5,0.364154,0.384722,958.883264,0.008116,0.006054,62,0.000423,0,10,0.690275,0.085649
28095,Monroe County,,MS,2626,45551,48177,12,16,28,18658,19877,38535,6,0.332684,0.347103,314.427505,0.000584,0.000662,52,0.000171,0,10,0.525,0.00548
17021,Christian County,,IL,2408,45671,48079,11,14,25,16780,17811,34591,5,0.357875,0.374778,168.16834,0.000792,0.001285,8,0.000139,0,10,0.633333,0.007102
50011,Franklin County,,VT,2263,45769,48032,9,10,19,26801,23043,49844,6,0.321574,0.334576,28.301988,0.000274,0.000608,33,0.000131,0,10,0.5,0.002594
13031,Bulloch County,,GA,3755,44237,47992,40,42,82,43869,43042,86911,5,0.372635,0.395421,2508.894194,0.00648,0.008267,5,0.000388,0,10,0.512411,0.062725
21179,Nelson County,,KY,2212,45770,47982,15,13,28,28002,23840,51842,6,0.326149,0.339328,47.666912,0.000769,0.000733,42,0.000227,0,10,0.495238,0.00791
48321,Matagorda County,,TX,3312,44610,47922,17,18,35,19753,23917,43670,5,0.359508,0.37787,16.965414,0.003647,0.004053,62,0.000172,0,10,0.856725,0.03806
48013,Atascosa County,,TX,3536,44341,47877,19,16,35,42626,39366,81992,5,0.359719,0.377816,26.860429,0.003605,0.003752,62,0.000203,0,10,0.738095,0.037883
29201,Scott County,,MO,2973,44728,47701,14,18,32,27016,28620,55636,6,0.339748,0.355979,1382.243897,0.000986,0.001649,14,0.000203,0,10,0.484211,0.009533
4023,Santa Cruz County,,AZ,2526,45107,47633,12,10,22,25874,32057,57931,5,0.374087,0.392871,0,0.004625,0.003968,45,0.000116,0,10,1,0.044994
26041,Delta County,,MI,1959,45665,47624,15,17,32,8401,10082,18483,5,0.358585,0.376107,3094.206218,0.002025,0.00209,8,0.000199,0,10,0.503676,0.017476
42031,Clarion County,,PA,2092,45470,47562,13,13,26,16347,17191,33538,6,0.326149,0.340294,12.27137,0.000873,0.000739,41,0.000139,0,10,0.642857,0.00713
31119,Madison County,,NE,3189,44368,47557,32,37,69,22423,27594,50017,5,0.400365,0.423145,7895.622825,0.003965,0.004747,50,0.000417,0,10,0.32561,0.038181
37181,Vance County,,NC,2446,45110,47556,11,14,25,24480,28862,53342,6,0.33107,0.346077,13.404667,0.001753,0.002128,37,0.000134,0,10,0.704167,0.017696
40079,Le Flore County,,OK,3169,44350,47519,20,17,37,23738,25425,49163,6,0.329084,0.342849,514.48679,0.001886,0.0011,52,0.000249,0,10,0.495671,0.019434
20055,Finney County,,KS,4545,42955,47500,28,41,69,13598,21396,34994,5,0.397207,0.420502,37156.670104,0.004657,0.006397,14,0.000467,0,10,0.398117,0.045359
48471,Walker County,,TX,4687,42801,47488,31,28,59,50335,55113,105448,5,0.359004,0.378521,99.278102,0.004964,0.005098,62,0.000294,0,10,0.649462,0.053621
41041,Lincoln County,,OR,4290,43196,47486,40,35,75,38357,36776,75133,5,0.371688,0.393142,21.595092,0.008142,0.006774,45,0.000306,0,10,0.85,0.080298
37017,Bladen County,,NC,2873,44562,47435,13,16,29,21270,21440,42710,6,0.335042,0.350966,2.17727,0.00191,0.002789,37,0.000137,0,10,0.866667,0.020095
17055,Franklin County,,IL,2296,45071,47367,13,14,27,18669,18770,37439,5,0.371733,0.390419,3666.727918,0.001084,0.001657,14,0.000194,0,10,0.5375,0.009926
55085,Oneida County,,WI,2689,44677,47366,31,22,53,23160,20996,44156,5,0.373723,0.393538,2019.488806,0.003402,0.002873,8,0.000273,0,10,0.653409,0.0311
17057,Fulton County,,IL,2313,45039,47352,10,11,21,16156,17103,33259,5,0.35535,0.371441,432.507125,0.000919,0.001112,8,0.000127,0,10,0.681818,0.007952
18071,Jackson County,,IN,2708,44618,47326,18,20,38,27369,29444,56813,6,0.337212,0.35434,214.62444,0.002035,0.001754,42,0.000202,0,10,0.432806,0.01848
23013,Knox County,,ME,2357,44822,47179,24,18,42,17849,18515,36364,5,0.327995,0.343077,25.066147,0.003732,0.002036,33,0.000194,0,10,0.701667,0.032293
29159,Pettis County,,MO,3049,44111,47160,19,22,41,23244,25511,48755,5,0.36972,0.389057,270.512002,0.002285,0.002451,14,0.000212,0,10,0.585145,0.02163
27085,McLeod County,,MN,2804,44230,47034,20,23,43,24966,25466,50432,5,0.365932,0.385031,161.266031,0.001406,0.001738,39,0.000205,0,10,0.576923,0.013283
40083,Logan County,,OK,4099,42825,46924,20,18,38,44930,38565,83495,5,0.355926,0.373855,355.643236,0.004249,0.003028,52,0.000215,0,10,0.689723,0.043013
40137,Stephens County,,OK,2983,43823,46806,18,21,39,21088,22512,43600,5,0.356629,0.375022,864.600579,0.002701,0.003204,52,0.000228,0,10,0.611905,0.027644
51023,Botetourt County,,VA,3203,43519,46722,12,11,23,28773,25777,54550,6,0.330749,0.346045,662.576171,0.001249,0.001079,37,0.000179,0,10,0.582418,0.011593
6093,Siskiyou County,,CA,3066,43618,46684,42,36,78,23116,21092,44208,5,0.370925,0.392329,199.369309,0.008729,0.007454,45,0.000278,0,10,0.824748,0.082343
48001,Anderson County,,TX,3388,43175,46563,30,28,58,28447,29867,58314,5,0.358879,0.378358,31.022217,0.004344,0.004843,62,0.000278,0,10,0.73871,0.046645
48349,Navarro County,,TX,3205,43333,46538,18,22,40,32724,33855,66579,5,0.358669,0.377436,11.773912,0.00354,0.004284,62,0.000183,0,10,0.831169,0.037183
21009,Barren County,,KY,2158,44362,46520,16,14,30,23444,21628,45072,6,0.333877,0.348622,1119.53024,0.001461,0.001172,42,0.000256,0,10,0.429167,0.014798
19099,Jasper County,,IA,2418,44061,46479,13,13,26,21108,22682,43790,5,0.364283,0.382048,52.308401,0.000733,0.001122,8,0.000192,0,10,0.666667,0.007192
39137,Putnam County,,OH,1696,44770,46466,9,13,22,14708,17514,32222,6,0.333623,0.348394,18.256918,0.000777,0.001013,43,0.000105,0,10,0.666667,0.006341
12063,Jackson County,,FL,2895,43548,46443,25,24,49,23546,23261,46807,5,0.356174,0.374056,662.329494,0.005435,0.004734,5,0.000255,0,10,0.588319,0.052841
55093,Pierce County,,WI,2886,43548,46434,18,19,37,31559,30861,62420,5,0.3665,0.385303,845.350088,0.001424,0.001865,39,0.000193,0,10,0.664502,0.013532
27007,Beltrami County,,MN,2647,43783,46430,26,27,53,23168,23378,46546,5,0.366981,0.386686,4627.600844,0.001678,0.00171,39,0.000346,0,10,0.574713,0.016853
20061,Geary County,,KS,11340,35081,46421,76,83,159,67456,82763,150219,5,0.423841,0.450559,5504.918749,0.018983,0.020723,14,0.000528,0,10,0.652241,0.180412
29023,Butler County,,MO,2987,43278,46265,19,20,39,22742,21522,44264,6,0.33855,0.354796,8115.947672,0.00115,0.001442,14,0.000304,0,10,0.399209,0.011315
48401,Rusk County,,TX,3369,42859,46228,20,22,42,40127,40617,80744,5,0.358837,0.377653,20.604338,0.002905,0.004261,62,0.000209,0,10,0.755435,0.030942
19187,Webster County,,IA,2525,43623,46148,18,21,39,12459,16459,28918,5,0.377813,0.397933,4609.417677,0.001156,0.002197,8,0.000243,0,10,0.428854,0.011217
1017,Chambers County,,AL,2412,43723,46135,15,12,27,24609,26302,50911,5,0.349091,0.366005,32.205505,0.002089,0.001812,6,0.000164,0,10,0.708333,0.020312
13009,Baldwin County,,GA,2721,43384,46105,20,22,42,21807,25985,47792,6,0.340388,0.356619,319.13556,0.0028,0.003337,6,0.000218,0,10,0.616601,0.028154
55033,Dunn County,,WI,3287,42678,45965,27,27,54,31258,31340,62598,5,0.36742,0.387283,1619.418455,0.002069,0.00245,39,0.000264,0,10,0.572414,0.019039
48221,Hood County,,TX,3699,42221,45920,37,26,63,51660,39776,91436,5,0.376194,0.397255,322.283115,0.0066,0.005273,62,0.00035,0,10,0.65505,0.068801
29027,Callaway County,,MO,3155,42760,45915,20,15,35,33080,31407,64487,6,0.332432,0.346398,60.104977,0.001428,0.001278,14,0.00024,0,10,0.581579,0.013733
12119,Sumter County,,FL,3283,42620,45903,131,29,160,96657,48868,145525,5,0.383234,0.404905,16.031615,0.037666,0.010283,5,0.000676,0,10,0.743511,0.33338
17027,Clinton County,,IL,2021,43823,45844,9,12,21,20535,20172,40707,5,0.357667,0.374289,42.752086,0.000841,0.001459,14,0.000123,0,10,0.692308,0.007569
55115,Shawano County,,WI,2380,43460,45840,17,17,34,27400,27142,54542,5,0.363421,0.381586,113.072913,0.001534,0.00146,8,0.000182,0,10,0.748538,0.014177
47099,Lawrence County,,TN,2037,43774,45811,11,13,24,14717,15215,29932,6,0.33475,0.34943,36.129475,0.000906,0.001463,51,0.000169,0,10,0.602564,0.010768
17011,Bureau County,,IL,2624,43164,45788,19,20,39,19828,20390,40218,5,0.369898,0.389035,1194.56745,0.002431,0.002498,8,0.000187,0,10,0.690476,0.021901
17103,Lee County,,IL,2691,43066,45757,14,16,30,24826,23805,48631,5,0.369453,0.388059,12.499882,0.001749,0.002115,8,0.000123,0,10,0.834559,0.014449
48467,Van Zandt County,,TX,3268,42489,45757,20,19,39,46513,40612,87125,5,0.357334,0.375456,19.006782,0.002848,0.003132,62,0.00021,0,10,0.797619,0.030676
55045,Green County,,WI,2304,43402,45706,14,17,31,25795,23594,49389,5,0.37021,0.389035,152.12922,0.001367,0.001989,8,0.000148,0,10,0.691176,0.012536
8045,Garfield County,,CO,4511,41183,45694,38,36,74,41352,40512,81864,5,0.38001,0.40249,1814.029882,0.008759,0.008659,35,0.000312,0,10,0.697445,0.085734
17049,Effingham County,,IL,2303,43339,45642,17,19,36,14953,15581,30534,5,0.36086,0.379064,8291.271397,0.001335,0.001963,8,0.000206,0,10,0.489177,0.011852
29091,Howell County,,MO,2946,42681,45627,18,20,38,15713,16333,32046,6,0.333116,0.347944,4018.983774,0.001775,0.001314,14,0.000276,0,10,0.426407,0.018407
17105,Livingston County,,IL,2443,43136,45579,15,15,30,19642,21379,41021,5,0.355432,0.372011,13.227384,0.001987,0.001519,8,0.000134,0,10,0.716667,0.016159
22095,St. John the Baptist Parish,,LA,2754,42820,45574,18,18,36,42837,44576,87413,5,0.361752,0.3808,43.128373,0.00356,0.003225,12,0.000153,0,10,0.831579,0.033399
42047,Elk County,,PA,1297,44196,45493,6,8,14,6217,7831,14048,6,0.32608,0.339643,1682.95883,0.000579,0.000624,41,0.000101,0,10,0.660714,0.004787
47003,Bedford County,,TN,2409,42908,45317,19,14,33,30742,27077,57819,5,0.369631,0.388422,730.380219,0.00287,0.002067,51,0.000244,0,10,0.514286,0.028617
24035,Queen Anne's County,,MD,3055,42120,45175,21,22,43,42870,34172,77042,6,0.339823,0.357525,20.194878,0.003468,0.004095,13,0.000166,0,10,0.812253,0.031346
36121,Wyoming County,,NY,2577,42598,45175,9,10,19,24760,25940,50700,6,0.3198,0.33278,1.712547,0.000869,0.000725,36,0.000096,0,10,0.877778,0.006485
19111,Lee County,,IA,2374,42564,44938,10,14,24,12082,14563,26645,5,0.364932,0.382888,5435.630725,0.000482,0.001158,8,0.000182,0,10,0.461538,0.004642
31053,Dodge County,,NE,2871,42032,44903,17,14,31,21598,24345,45943,5,0.365019,0.382753,409.960814,0.001651,0.001073,50,0.000252,0,10,0.480392,0.016002
19181,Warren County,,IA,3018,41852,44870,14,13,27,40550,35930,76480,5,0.36411,0.381831,329.964191,0.000886,0.001031,8,0.000225,0,10,0.542857,0.008234
50003,Bennington County,,VT,2439,42417,44856,20,15,35,13782,14652,28434,5,0.333913,0.348985,22.475545,0.004212,0.002599,36,0.00014,0,10,0.807143,0.0346
13071,Colquitt County,,GA,2478,42339,44817,21,22,43,17272,19412,36684,5,0.361923,0.380783,1354.380117,0.004235,0.003949,5,0.000239,0,10,0.563333,0.040809
18061,Harrison County,,IN,2642,42056,44698,11,9,20,28031,26799,54830,6,0.330216,0.344048,35.588545,0.000832,0.00073,42,0.000157,0,10,0.627273,0.008269
17081,Jefferson County,,IL,2297,42386,44683,16,19,35,16579,16299,32878,5,0.361327,0.379514,5536.209509,0.00165,0.001847,14,0.000211,0,10,0.502632,0.015046
29169,Pulaski County,,MO,7642,37008,44650,60,63,123,58676,60338,119014,5,0.407211,0.433019,4575.709751,0.01315,0.013395,14,0.000443,0,10,0.562555,0.125952
29161,Phelps County,,MO,3549,41084,44633,22,32,54,24176,26350,50526,5,0.384336,0.406462,1218.86481,0.001979,0.004416,14,0.000257,0,10,0.478151,0.019175
40121,Pittsburg County,,OK,2815,41735,44550,28,26,54,19689,20945,40634,5,0.356339,0.375266,3513.820954,0.002904,0.002753,52,0.000344,0,10,0.464718,0.031023
6009,Calaveras County,,CA,3189,41357,44546,28,31,59,45285,32313,77598,5,0.369675,0.390321,4.11516,0.006758,0.007152,45,0.000182,0,10,0.976344,0.062689
47045,Dyer County,,TN,2597,41754,44351,15,15,30,19264,19801,39065,6,0.335738,0.350732,4031.156903,0.001627,0.001304,52,0.000215,0,10,0.454248,0.015599
1123,Tallapoosa County,,AL,2507,41839,44346,20,22,42,25870,30618,56488,6,0.33475,0.351649,115.260458,0.001587,0.002063,6,0.000209,0,10,0.556159,0.016213
22119,Webster Parish,,LA,2558,41711,44269,15,14,29,23370,25023,48393,5,0.354693,0.371956,946.876957,0.002061,0.0019,12,0.000172,0,10,0.573529,0.01999
18087,LaGrange County,,IN,2414,41837,44251,9,12,21,24821,26910,51731,6,0.330181,0.344803,10.315397,0.000518,0.001112,42,0.000109,0,10,0.643939,0.004298
21113,Jessamine County,,KY,4126,40117,44243,16,16,32,47132,40606,87738,6,0.330323,0.344379,110.598171,0.000926,0.000861,42,0.000274,0,10,0.558824,0.008929
22009,Avoyelles Parish,,LA,1792,42445,44237,13,16,29,14508,16437,30945,5,0.352577,0.369569,7.875321,0.001617,0.001664,12,0.000131,0,10,0.735294,0.014163
46013,Brown County,,SD,2622,41597,44219,25,28,53,14857,15469,30326,5,0.376933,0.397743,28467.410816,0.002557,0.002575,50,0.000604,0,10,0.302419,0.025383
42059,Greene County,,PA,1930,42247,44177,7,7,14,14090,15390,29480,6,0.326704,0.340256,1.955422,0.000708,0.000596,41,0.0001,0,10,0.785714,0.005702
39071,Highland County,,OH,2903,41266,44169,16,16,32,36178,34745,70923,6,0.335664,0.350819,20.466755,0.00168,0.001484,42,0.000163,0,10,0.7125,0.014164
47017,Carroll County,,TN,2842,41282,44124,11,11,22,18921,20393,39314,6,0.333913,0.347965,20.669858,0.000789,0.001004,52,0.000177,0,10,0.69697,0.008332
39097,Madison County,,OH,3427,40691,44118,12,13,25,42277,39816,82093,6,0.333333,0.34796,4.034571,0.001146,0.001021,41,0.000131,0,10,0.788462,0.009797
22117,Washington Parish,,LA,2052,41961,44013,15,15,30,20852,20020,40872,5,0.369098,0.388466,137.649831,0.002269,0.002584,12,0.000143,0,10,0.753676,0.020396
18083,Knox County,,IN,2257,41748,44005,14,16,30,14107,15749,29856,6,0.327157,0.341319,2178.649564,0.000629,0.00083,42,0.000211,0,10,0.459559,0.005903
42119,Union County,,PA,2535,41462,43997,15,13,28,22203,22411,44614,6,0.32972,0.344032,27.90836,0.002179,0.001609,47,0.000132,0,10,0.852381,0.018398
5005,Baxter County,,AR,2906,40924,43830,30,19,49,17947,15456,33403,5,0.37555,0.395519,6226.129651,0.006066,0.002179,52,0.000338,0,10,0.435484,0.058769
29213,Taney County,,MO,4403,39420,43823,44,33,77,33885,33502,67387,5,0.386756,0.409218,3303.488518,0.007723,0.005673,14,0.000451,0,10,0.502643,0.076198
47051,Franklin County,,TN,2330,41314,43644,14,13,27,20919,21530,42449,6,0.331678,0.345524,288.133248,0.001556,0.001334,51,0.000207,0,10,0.538095,0.016871
5091,Miller County,,AR,3736,39793,43529,21,21,42,45056,43124,88180,5,0.357833,0.376731,4845.028214,0.002812,0.003005,62,0.000242,0,10,0.514493,0.027852
31157,Scotts Bluff County,,NE,2934,40411,43345,25,27,52,14121,15906,30027,5,0.370344,0.390375,17317.653862,0.00316,0.003722,35,0.000403,0,10,0.46164,0.03218
23023,Sagadahoc County,,ME,3908,39436,43344,20,18,38,36865,35415,72280,5,0.360352,0.378819,121.70735,0.003332,0.003261,33,0.00017,0,10,0.678571,0.030692
48397,Rockwall County,,TX,4300,39036,43336,40,26,66,113688,77295,190983,5,0.382042,0.403711,185.333165,0.01023,0.006818,62,0.000323,0,10,0.763462,0.101145
17137,Morgan County,,IL,2471,40842,43313,14,15,29,16159,17705,33864,5,0.357959,0.375022,4883.851041,0.000785,0.001277,8,0.000223,0,10,0.415441,0.007332
55019,Clark County,,WI,2298,41015,43313,11,15,26,17210,21519,38729,5,0.336768,0.351297,5.384345,0.000716,0.001146,8,0.000132,0,10,0.8,0.006938
18107,Montgomery County,,IN,2345,40941,43286,14,16,30,20152,21373,41525,5,0.360056,0.377734,248.392251,0.00141,0.001816,42,0.000164,0,10,0.555556,0.012824
18001,Adams County,,IN,1836,41357,43193,7,9,16,11974,14220,26194,6,0.326392,0.339638,21.639619,0.000561,0.000755,42,0.000102,0,10,0.597222,0.005077
31111,Lincoln County,,NE,2577,40615,43192,24,21,45,12504,14149,26653,5,0.367508,0.386523,12021.578495,0.001871,0.002497,50,0.000412,0,10,0.350769,0.019508
55083,Oconto County,,WI,2324,40755,43079,15,14,29,29110,26198,55308,5,0.328451,0.340929,44.965488,0.001531,0.000877,8,0.000156,0,10,0.712418,0.013947
45029,Colleton County,,SC,2140,40921,43061,13,18,31,19254,20383,39637,6,0.342551,0.359516,37.448824,0.001797,0.003887,37,0.000152,0,10,0.79085,0.019847
56005,Campbell County,,WY,3251,39806,43057,44,33,77,25075,23387,48462,5,0.375688,0.396756,5103.894638,0.006112,0.004533,35,0.000504,0,10,0.37766,0.061385
26035,Clare County,,MI,2835,40148,42983,23,23,46,22696,19487,42183,6,0.332864,0.349078,10.193005,0.002526,0.001762,43,0.000164,0,10,0.743077,0.019096
40097,Mayes County,,OK,2857,40124,42981,15,17,32,27272,28290,55562,6,0.328205,0.341737,25.860232,0.000959,0.001048,52,0.000202,0,10,0.735294,0.010754
8043,Fremont County,,CO,3137,39816,42953,21,19,40,23596,21427,45023,5,0.367376,0.386334,120.455708,0.004506,0.004384,35,0.000226,0,10,0.790043,0.046362
50001,Addison County,,VT,2393,40544,42937,11,13,24,18589,19372,37961,5,0.333587,0.34828,43.616504,0.001023,0.001834,33,0.000121,0,10,0.675824,0.009084
51083,Halifax County,,VA,1748,41180,42928,11,14,25,8056,9742,17798,6,0.330181,0.345155,682.287868,0.001412,0.001744,13,0.000134,0,10,0.628571,0.013906
28011,Bolivar County,,MS,2655,40265,42920,14,19,33,15285,19381,34666,5,0.371643,0.391895,297.578993,0.001205,0.002798,52,0.00016,0,10,0.638095,0.011565
18103,Miami County,,IN,2937,39968,42905,15,16,31,23204,25375,48579,6,0.326878,0.34113,17.561075,0.001034,0.001098,42,0.000158,0,10,0.632353,0.009329
16069,Nez Perce County,,ID,3519,39374,42893,19,19,38,30055,31567,61622,5,0.365323,0.384082,5768.552782,0.002997,0.003295,45,0.000245,0,10,0.670996,0.030786
51073,Gloucester County,,VA,2625,40265,42890,21,18,39,26914,21076,47990,6,0.336215,0.352664,134.421273,0.003517,0.002497,13,0.00021,0,10,0.593074,0.033067
45023,Chester County,,SC,2184,40702,42886,9,12,21,19556,22895,42451,6,0.329649,0.344358,11.471131,0.001238,0.001997,37,0.000131,0,10,0.818182,0.01414
42035,Clinton County,,PA,1957,40856,42813,10,12,22,14749,15662,30411,6,0.329684,0.343869,1.042656,0.001353,0.001612,47,0.0001,0,10,0.916667,0.01135
13157,Jackson County,,GA,3600,39153,42753,28,21,49,74237,53529,127766,6,0.337249,0.352409,274.03025,0.004274,0.002174,6,0.000292,0,10,0.583744,0.043859
53047,Okanogan County,,WA,3003,39733,42736,20,23,43,21605,21913,43518,5,0.370165,0.389497,68.042307,0.003548,0.003691,45,0.000178,0,10,0.790598,0.035159
39075,Holmes County,,OH,1624,41102,42726,10,11,21,18183,20928,39111,6,0.334058,0.349018,2.054865,0.001318,0.001484,41,0.000098,0,10,0.790909,0.010596
35039,Rio Arriba County,,NM,2748,39894,42642,10,11,21,20690,27355,48045,5,0.366019,0.383784,2.871626,0.001732,0.001805,35,0.00012,0,10,0.854545,0.017476
37111,McDowell County,,NC,2085,40494,42579,11,14,25,16651,16817,33468,6,0.331356,0.346484,153.958725,0.001153,0.001677,37,0.000161,0,10,0.681319,0.012855
21083,Graves County,,KY,2188,40359,42547,13,13,26,16016,16449,32465,6,0.341637,0.358784,4769.332196,0.00039,0.001336,52,0.000272,0,10,0.333333,0.004814
56013,Fremont County,,WY,2859,39672,42531,27,27,54,12710,13551,26261,5,0.373768,0.393962,2009.776779,0.004351,0.003901,35,0.000283,0,10,0.560215,0.044483
47123,Monroe County,,TN,2237,40284,42521,18,12,30,25358,24854,50212,6,0.330607,0.343896,112.71132,0.00323,0.001101,51,0.000224,0,10,0.646199,0.031583
17075,Iroquois County,,IL,2346,40155,42501,9,11,20,18599,18471,37070,5,0.355186,0.371251,27.400114,0.001118,0.001317,8,0.000106,0,10,0.672727,0.009614
23027,Waldo County,,ME,2379,40122,42501,19,12,31,25394,23494,48888,5,0.325183,0.338992,10.032875,0.002141,0.000927,33,0.000172,0,10,0.792398,0.018336
51185,Tazewell County,,VA,2444,39997,42441,10,16,26,16710,16216,32926,6,0.330429,0.345844,1231.213307,0.000167,0.000718,51,0.000186,0,10,0.35,0.001784
51171,Shenandoah County,,VA,2206,40175,42381,20,15,35,28216,22016,50232,6,0.334713,0.350331,369.783028,0.002218,0.001455,13,0.000221,0,10,0.583333,0.021578
29029,Camden County,,MO,3840,38535,42375,38,31,69,34541,31026,65567,5,0.369987,0.390413,905.311221,0.005311,0.003415,14,0.000368,0,10,0.514103,0.050636
48097,Cooke County,,TX,2970,39338,42308,13,12,25,30670,29758,60428,5,0.357667,0.375049,31.099719,0.002495,0.002842,62,0.000157,0,10,0.813187,0.026306
40081,Lincoln County,,OK,3495,38687,42182,10,10,20,30523,30055,60578,6,0.327122,0.339459,2.367532,0.000831,0.000831,52,0.000147,0,10,0.822222,0.00858
42109,Snyder County,,PA,1966,40183,42149,12,14,26,19612,19184,38796,6,0.326774,0.341216,25.153071,0.00084,0.001279,47,0.000133,0,10,0.763736,0.007503
20079,Harvey County,,KS,2844,39264,42108,13,14,27,21450,22993,44443,5,0.3665,0.384326,63.343433,0.001143,0.001531,14,0.000162,0,10,0.8,0.010182
1021,Chilton County,,AL,2081,39932,42013,15,16,31,25770,23094,48864,5,0.348023,0.365142,39.984253,0.001289,0.001997,6,0.000158,0,10,0.653595,0.012852
27041,Douglas County,,MN,2184,39820,42004,26,23,49,22636,20031,42667,5,0.366631,0.385818,391.750601,0.00173,0.001623,39,0.000285,0,10,0.544335,0.017085
32019,Lyon County,,NV,4163,37757,41920,44,29,73,77241,53561,130802,5,0.37097,0.391623,455.079785,0.0099,0.006151,45,0.000332,0,10,0.702128,0.092778
13277,Tift County,,GA,3029,38856,41885,34,33,67,25637,26095,51732,5,0.368345,0.389654,2437.361942,0.006322,0.006279,5,0.000333,0,10,0.548799,0.061442
27147,Steele County,,MN,2412,39451,41863,15,20,35,21718,22708,44426,5,0.366981,0.385981,165.920127,0.001468,0.001854,39,0.000169,0,10,0.645238,0.014482
33007,Coos County,,NH,2244,39494,41738,20,13,33,13858,15602,29460,5,0.325114,0.3391,209.186417,0.002588,0.001364,33,0.000166,0,10,0.710526,0.02116
37003,Alexander County,,NC,2476,39258,41734,8,9,17,23103,22346,45449,6,0.328275,0.342274,0.450328,0.000652,0.001299,37,0.000113,0,10,0.922222,0.007677
18051,Gibson County,,IN,2039,39693,41732,14,12,26,18576,18961,37537,6,0.326809,0.340343,305.219998,0.000524,0.000446,42,0.000223,0,10,0.467033,0.005022
18073,Jasper County,,IN,2615,39096,41711,12,12,24,26928,22798,49726,5,0.357542,0.374316,69.762973,0.001536,0.001389,8,0.000129,0,10,0.711538,0.013254
23015,Lincoln County,,ME,2258,39413,41671,20,12,32,21896,21116,43012,5,0.326288,0.339996,2.261079,0.002856,0.001245,33,0.000167,0,10,0.784211,0.024438
37165,Scotland County,,NC,2440,39190,41630,10,15,25,17706,22428,40134,6,0.334969,0.350749,3.257208,0.00179,0.002875,37,0.000119,0,10,0.828571,0.018583
39019,Carroll County,,OH,2402,39149,41551,10,11,21,25480,26057,51537,6,0.335958,0.351541,3.911662,0.001467,0.0016,41,0.000099,0,10,0.9,0.011423
24041,Talbot County,,MD,2521,39004,41525,19,18,37,27086,23635,50721,6,0.341713,0.358767,18.97788,0.003651,0.003819,13,0.000156,0,10,0.847368,0.033296
21071,Floyd County,,KY,1922,39586,41508,9,12,21,12803,15016,27819,6,0.325596,0.338574,1648.887075,0.000248,0.000545,42,0.000162,0,10,0.434066,0.002609
18169,Wabash County,,IN,2203,39290,41493,11,15,26,15317,18284,33601,6,0.32747,0.34145,5.469286,0.000757,0.001012,42,0.000128,0,10,0.771429,0.006593
45071,Newberry County,,SC,1823,39616,41439,12,14,26,16782,17889,34671,6,0.330536,0.345714,18.112815,0.001317,0.002136,37,0.000161,0,10,0.758242,0.01539
18023,Clinton County,,IN,2481,38951,41432,12,11,23,18465,21677,40142,6,0.326011,0.339258,7.09799,0.000855,0.000779,42,0.000144,0,10,0.681818,0.007983
20035,Cowley County,,KS,2672,38717,41389,19,16,35,15443,18661,34104,6,0.337212,0.351704,240.491219,0.001416,0.001355,14,0.000228,0,10,0.439394,0.013688
16017,Bonner County,,ID,2940,38439,41379,29,22,51,24744,22731,47475,5,0.371598,0.391558,694.774107,0.006707,0.004615,45,0.000254,0,10,0.671402,0.065131
51195,Wise County,,VA,1918,39454,41372,10,11,21,13984,16381,30365,6,0.295697,0.306863,5696.043993,0.000124,0.000174,51,0.000226,0,10,0.327273,0.001941
37197,Yadkin County,,NC,2285,39055,41340,10,10,20,24282,24154,48436,6,0.330928,0.345399,2.232697,0.001409,0.001634,37,0.000133,0,10,0.944444,0.01543
5055,Greene County,,AR,2225,39037,41262,15,16,31,24787,20954,45741,6,0.334896,0.349978,781.850677,0.000802,0.00095,52,0.000223,0,10,0.418129,0.008276
29009,Barry County,,MO,2935,38314,41249,14,14,28,26732,28351,55083,6,0.33384,0.347683,38.440738,0.001273,0.001319,14,0.000195,0,10,0.771429,0.01345
48189,Hale County,,TX,3694,37554,41248,15,25,40,19520,26334,45854,5,0.379353,0.400184,1791.842773,0.002774,0.00468,62,0.000198,0,10,0.576667,0.028609
39131,Pike County,,OH,2550,38673,41223,10,9,19,20361,20410,40771,6,0.332036,0.346088,3.430743,0.00078,0.00049,41,0.000133,0,10,0.8,0.007165
28107,Panola County,,MS,2219,38942,41161,13,11,24,21214,21692,42906,6,0.331642,0.345258,104.95604,0.00107,0.000571,52,0.000192,0,10,0.596154,0.010682
13103,Effingham County,,GA,2736,38410,41146,17,12,29,48015,33860,81875,6,0.339148,0.354731,91.85521,0.003428,0.002487,5,0.000177,0,10,0.696078,0.034062
20125,Montgomery County,,KS,2888,38234,41122,16,21,37,15060,19597,34657,6,0.339185,0.354677,387.683792,0.001239,0.001651,14,0.000225,0,10,0.459524,0.011905
51047,Culpeper County,,VA,2719,38362,41081,22,24,46,46473,32515,78988,6,0.335591,0.35261,144.587783,0.003075,0.002914,13,0.000209,0,10,0.62963,0.030248
48249,Jim Wells County,,TX,2629,38443,41072,15,16,31,28728,30487,59215,5,0.359551,0.377707,69.329863,0.002814,0.003005,62,0.000164,0,10,0.75,0.02902
51155,Pulaski County,,VA,2227,38842,41069,10,10,20,19209,18075,37284,6,0.295726,0.306749,48.346462,0.000243,0.000151,37,0.000161,0,10,0.536364,0.002093
27059,Isanti County,,MN,2750,38288,41038,16,17,33,47251,36705,83956,5,0.333659,0.347439,2.16697,0.001148,0.001,39,0.000175,0,10,0.856209,0.010652
37059,Davie County,,NC,2284,38739,41023,13,14,27,28924,24255,53179,6,0.331142,0.346159,12.349029,0.001618,0.00214,37,0.000156,0,10,0.766667,0.017627
26007,Alpena County,,MI,1753,39265,41018,16,17,33,9171,9421,18592,6,0.333442,0.34924,14.726573,0.002252,0.001921,43,0.000141,0,10,0.719298,0.017253
20111,Lyon County,,KS,3213,37800,41013,27,40,67,14239,22843,37082,5,0.388517,0.411713,8000.144412,0.002406,0.004741,14,0.000355,0,10,0.3223,0.02309
36031,Essex County,,NY,2383,38625,41008,18,14,32,17593,18389,35982,6,0.331142,0.345714,25.900241,0.002858,0.001656,36,0.000136,0,10,0.736842,0.022728
27021,Cass County,,MN,2937,38042,40979,23,20,43,28059,24913,52972,5,0.366412,0.385221,75.158955,0.001268,0.001584,39,0.000258,0,10,0.757246,0.012237
21049,Clark County,,KY,2708,38227,40935,18,13,31,25446,23733,49179,6,0.325183,0.338167,129.715012,0.000589,0.000556,42,0.000344,0,10,0.405229,0.00625
37093,Hoke County,,NC,4846,36067,40913,33,39,72,65165,52771,117936,5,0.38832,0.411768,383.063359,0.007546,0.010088,37,0.000251,0,10,0.69186,0.074007
1053,Escambia County,,AL,2049,38826,40875,12,14,26,17345,19084,36429,5,0.327925,0.341775,8.144905,0.001527,0.001766,6,0.000135,0,10,0.824176,0.015285
1039,Covington County,,AL,2229,38634,40863,18,19,37,15822,16236,32058,5,0.328381,0.342942,66.501149,0.001813,0.001995,6,0.000192,0,10,0.666667,0.018764
39159,Union County,,OH,2731,38041,40772,17,14,31,46371,38592,84963,5,0.365453,0.383404,128.762717,0.00178,0.001535,41,0.000158,0,10,0.611111,0.01472
51173,Smyth County,,VA,1613,39104,40717,6,8,14,8994,10058,19052,6,0.298108,0.309098,237.715386,0.000061,0.000189,51,0.000141,0,10,0.517857,0.000959
47013,Campbell County,,TN,1938,38739,40677,9,8,17,14139,15165,29304,6,0.330039,0.342622,84.842155,0.001012,0.000834,51,0.000164,0,10,0.436364,0.00933
18047,Franklin County,,IN,2550,38028,40578,11,13,24,19714,18608,38322,6,0.330181,0.3442,87.933991,0.000901,0.000958,42,0.000142,0,10,0.50641,0.008062
18151,Steuben County,,IN,2708,37790,40498,14,13,27,23605,22451,46056,6,0.334276,0.350233,115.356586,0.00157,0.001199,42,0.000134,0,10,0.503268,0.013541
26033,Chippewa County,,MI,2370,38104,40474,19,19,38,8659,8647,17306,5,0.36541,0.384082,1857.41459,0.002338,0.002529,43,0.000164,0,10,0.720779,0.017693
48241,Jasper County,,TX,2759,37660,40419,18,18,36,25936,26861,52797,5,0.357292,0.375293,52.272738,0.002618,0.002966,62,0.000188,0,10,0.739474,0.0279
47177,Warren County,,TN,1874,38544,40418,15,14,29,16007,16781,32788,6,0.330749,0.344331,826.282269,0.001231,0.001188,51,0.000245,0,10,0.529167,0.013435
40135,Sequoyah County,,OK,2607,37794,40401,15,15,30,22547,22917,45464,6,0.328802,0.342198,21.764539,0.001068,0.001126,52,0.0002,0,10,0.691667,0.011655
27005,Becker County,,MN,2056,38338,40394,18,19,37,19340,19117,38457,5,0.3665,0.385221,2238.620258,0.001121,0.001531,39,0.000242,0,10,0.710526,0.010761
51001,Accomack County,,VA,1997,38278,40275,20,16,36,10902,12498,23400,5,0.363163,0.381679,161.983124,0.005337,0.003886,47,0.000164,0,10,0.724615,0.048644
45089,Williamsburg County,,SC,2010,38229,40239,11,14,25,14641,20847,35488,6,0.330678,0.345822,8.405328,0.001764,0.002291,37,0.000131,0,10,0.857143,0.018515
13275,Thomas County,,GA,2843,37363,40206,23,24,47,24811,24698,49509,5,0.363809,0.383279,885.226244,0.00556,0.005672,5,0.000235,0,10,0.686154,0.053602
27017,Carlton County,,MN,1976,38230,40206,13,15,28,21520,18543,40063,5,0.350925,0.367312,30.598625,0.001061,0.001454,39,0.000158,0,10,0.733333,0.00976
22069,Natchitoches Parish,,LA,2840,37300,40140,22,20,42,18661,22695,41356,5,0.356629,0.374886,587.998991,0.003304,0.002635,12,0.000219,0,10,0.592885,0.031038
18183,Whitley County,,IN,2193,37935,40128,12,8,20,26004,24277,50281,6,0.326878,0.339822,4.065419,0.000731,0.000591,42,0.000135,0,10,0.689394,0.006433
37141,Pender County,,NC,3028,37094,40122,24,22,46,50685,39737,90422,5,0.371463,0.392193,177.774626,0.005572,0.005166,37,0.000203,0,10,0.722222,0.055575
5063,Independence County,,AR,2444,37674,40118,17,17,34,18342,19526,37868,6,0.335591,0.351063,539.186654,0.000985,0.001066,52,0.000252,0,10,0.519608,0.010959
48325,Medina County,,TX,3085,36995,40080,18,16,34,38565,33415,71980,5,0.358167,0.376134,17.694174,0.003015,0.002893,62,0.00021,0,10,0.774854,0.032825
31141,Platte County,,NE,2455,37592,40047,17,16,33,17571,19775,37346,5,0.351005,0.366759,2898.699389,0.001588,0.000982,50,0.000276,0,10,0.46732,0.015117
19179,Wapello County,,IA,2453,37574,40027,26,23,49,14880,17615,32495,5,0.37345,0.393376,7524.700513,0.002594,0.00171,8,0.00033,0,10,0.321573,0.025138
18077,Jefferson County,,IN,2092,37903,39995,17,17,34,15546,16362,31908,6,0.330252,0.345155,193.618617,0.001274,0.001133,42,0.000219,0,10,0.496732,0.011948
1079,Lawrence County,,AL,2044,37927,39971,8,9,17,20659,22843,43502,6,0.319767,0.331597,1.255063,0.000549,0.000578,6,0.000123,0,10,0.875,0.005869
21089,Greenup County,,KY,2309,37643,39952,12,12,24,23665,21861,45526,6,0.337175,0.353158,1401.743354,0.001002,0.000969,41,0.000195,0,10,0.538462,0.009427
55069,Lincoln County,,WI,1829,38068,39897,14,14,28,13018,14347,27365,5,0.328626,0.3412,7.792901,0.001025,0.000934,8,0.000155,0,10,0.804762,0.00926
45067,Marion County,,SC,2135,37761,39896,8,12,20,14372,18438,32810,6,0.333225,0.348264,3.278616,0.000776,0.002245,37,0.000106,0,10,0.762821,0.008253
40021,Cherokee County,,OK,3142,36729,39871,24,22,46,29823,30571,60394,6,0.329119,0.343446,77.400933,0.00161,0.001233,52,0.000292,0,10,0.612319,0.017677
28003,Alcorn County,,MS,2133,37734,39867,16,12,28,16632,16469,33101,6,0.331606,0.34534,41.528168,0.000547,0.000558,52,0.000229,0,10,0.45098,0.006078
27047,Freeborn County,,MN,1805,37959,39764,13,17,30,12066,14162,26228,5,0.33424,0.34828,746.995556,0.000908,0.000939,39,0.000161,0,10,0.584559,0.008743
30093,Silver Bow County,,MT,2921,36730,39651,17,19,36,14887,16385,31272,5,0.366631,0.385563,1907.782152,0.002504,0.002607,45,0.000233,0,10,0.644737,0.025533
53065,Stevens County,,WA,2770,36813,39583,24,19,43,30403,28738,59141,5,0.365627,0.38438,170.674296,0.005243,0.003272,45,0.000223,0,10,0.745,0.051307
13213,Murray County,,GA,3100,36428,39528,13,13,26,35482,34560,70042,6,0.328908,0.342887,46.223135,0.001518,0.001012,51,0.000163,0,10,0.590476,0.014692
19015,Boone County,,IA,2281,37137,39418,10,11,21,17916,17228,35144,5,0.364067,0.381559,69.197245,0.000368,0.001033,8,0.000169,0,10,0.698718,0.003596
5009,Boone County,,AR,2468,36874,39342,15,17,32,18828,19527,38355,6,0.326322,0.339204,523.590736,0.001118,0.000888,52,0.000231,0,10,0.382353,0.012739
47029,Cocke County,,TN,1779,37543,39322,11,9,20,14754,15660,30414,6,0.316473,0.328185,39.019431,0.001022,0.000554,51,0.000192,0,10,0.672727,0.011849
39079,Jackson County,,OH,2050,37251,39301,12,11,23,17733,17105,34838,6,0.332108,0.346414,12.647208,0.000518,0.000501,41,0.000171,0,10,0.628788,0.005219
54051,Marshall County,,WV,1638,37630,39268,10,11,21,13968,14760,28728,6,0.336731,0.352615,275.354337,0.000952,0.000979,41,0.00014,0,10,0.575758,0.008533
37109,Lincoln County,,NC,2861,36386,39247,27,21,48,58842,51506,110348,5,0.363766,0.382878,109.900395,0.006285,0.004242,37,0.00023,0,10,0.778495,0.063604
54099,Wayne County,,WV,2193,37027,39220,11,11,22,21414,22519,43933,6,0.33337,0.347895,97.164566,0.00058,0.000533,41,0.000173,0,10,0.545455,0.005423
37145,Person County,,NC,2020,37165,39185,10,10,20,19711,17478,37189,6,0.330785,0.345209,5.689127,0.001134,0.001912,37,0.000124,0,10,0.704545,0.012049
23029,Washington County,,ME,2048,37102,39150,12,9,21,8254,11295,19549,6,0.302541,0.314415,0,0.00149,0.000516,33,0.000122,0,10,0.969697,0.012744
48049,Brown County,,TX,2699,36351,39050,26,27,53,19698,20332,40030,5,0.360394,0.380203,6437.644052,0.004014,0.004572,62,0.000338,0,10,0.581281,0.042856
13233,Polk County,,GA,1960,37054,39014,16,16,32,25516,25525,51041,5,0.349727,0.36664,67.525867,0.002152,0.002699,6,0.000169,0,10,0.663399,0.022161
36099,Seneca County,,NY,2461,36527,38988,11,13,24,18916,19755,38671,6,0.320067,0.333632,6.299011,0.001257,0.001074,36,0.000105,0,10,0.762821,0.009557
48053,Burnet County,,TX,3322,35533,38855,35,26,61,42071,34878,76949,5,0.37624,0.397309,116.507395,0.006889,0.005583,62,0.000329,0,10,0.768254,0.07241
51187,Warren County,,VA,2512,36317,38829,20,18,38,35042,27629,62671,6,0.334095,0.349761,26.636223,0.002639,0.001462,13,0.000198,0,10,0.598814,0.025536
20037,Crawford County,,KS,2725,36029,38754,23,24,47,20407,23015,43422,6,0.338923,0.354867,553.116128,0.00159,0.002014,14,0.000277,0,10,0.428775,0.015382
28113,Pike County,,MS,2460,36213,38673,23,23,46,21282,22191,43473,5,0.357085,0.375863,2888.234573,0.002582,0.002288,12,0.000234,0,10,0.55,0.023228
39001,Adams County,,OH,1950,36674,38624,14,14,28,18316,16993,35309,6,0.335628,0.350548,31.646012,0.001626,0.001445,42,0.000153,0,10,0.71978,0.013696
19167,Sioux County,,IA,1736,36834,38570,11,12,23,8348,10972,19320,5,0.329225,0.342003,893.675302,0.001397,0.000706,8,0.000168,0,10,0.5375,0.013871
17203,Woodford County,,IL,2381,36137,38518,8,11,19,29464,25475,54939,5,0.369408,0.387462,17.500973,0.001001,0.001804,8,0.0001,0,10,0.9,0.00865
47055,Giles County,,TN,2012,36482,38494,11,12,23,16466,18272,34738,6,0.329791,0.342893,7.01905,0.000944,0.001144,51,0.000159,0,10,0.719697,0.011128
13137,Habersham County,,GA,2223,36129,38352,15,16,31,28225,24448,52673,6,0.337138,0.351704,21.324696,0.001945,0.002157,6,0.00019,0,10,0.725,0.020128
39069,Henry County,,OH,2053,36294,38347,9,9,18,19304,20917,40221,6,0.332216,0.34636,14.393734,0.00075,0.000636,43,0.000104,0,10,0.777778,0.006172
30081,Ravalli County,,MT,2758,35521,38279,25,21,46,21700,19772,41472,5,0.372816,0.392779,273.261364,0.00642,0.004254,45,0.000227,0,10,0.80291,0.061983
8085,Montrose County,,CO,2730,35528,38258,31,22,53,24855,21470,46325,5,0.370791,0.390511,1407.570407,0.007178,0.004894,35,0.000275,0,10,0.742944,0.071262
39065,Hardin County,,OH,2422,35827,38249,12,14,26,19125,20507,39632,6,0.33337,0.348123,11.266667,0.000604,0.000901,43,0.000128,0,10,0.604762,0.00545
28105,Oktibbeha County,,MS,3822,34381,38203,37,39,76,25488,28682,54170,5,0.382327,0.406109,11601.272741,0.003166,0.005624,52,0.000376,0,10,0.419056,0.029458
13069,Coffee County,,GA,2333,35855,38188,20,21,41,14298,14222,28520,5,0.365062,0.384245,10752.376611,0.002905,0.002904,5,0.000283,0,10,0.440217,0.029101
21211,Shelby County,,KY,2747,35380,38127,15,14,29,36463,31095,67558,6,0.325665,0.338927,140.510174,0.001192,0.000631,42,0.000227,0,10,0.463235,0.01196
48067,Cass County,,TX,2566,35558,38124,17,17,34,19904,21191,41095,5,0.357625,0.375618,48.926287,0.002816,0.002994,62,0.000185,0,10,0.728758,0.029397
51149,Prince George County,,VA,5255,32826,38081,35,38,73,47480,44934,92414,5,0.377025,0.399832,1134.393074,0.007204,0.008705,13,0.000277,0,10,0.662237,0.068681
45027,Clarendon County,,SC,2136,35918,38054,12,13,25,16892,18676,35568,6,0.330394,0.345307,8.698989,0.001447,0.002071,37,0.000136,0,10,0.852564,0.015541
29105,Laclede County,,MO,2361,35660,38021,15,14,29,17555,17486,35041,6,0.333261,0.34732,104.088198,0.001065,0.001079,14,0.000208,0,10,0.633333,0.010737
39053,Gallia County,,OH,1949,36061,38010,9,11,20,12186,13631,25817,6,0.333189,0.347678,25.885523,0.000497,0.000553,41,0.000147,0,10,0.554545,0.004694
47131,Obion County,,TN,2285,35708,37993,12,15,27,17416,18378,35794,6,0.334786,0.349674,4152.181956,0.000787,0.001042,52,0.000226,0,10,0.452381,0.00835
18129,Posey County,,IN,2249,35736,37985,5,6,11,17596,19094,36690,6,0.326531,0.339258,36.099397,0.000108,0.000411,42,0.000113,0,10,0.733333,0.001017
51035,Carroll County,,VA,1554,36421,37975,11,11,22,13085,12105,25190,6,0.310491,0.32238,1248.184134,0.00032,0.000319,37,0.000204,0,10,0.356061,0.003577
27097,Morrison County,,MN,1825,36115,37940,14,16,30,20038,19806,39844,5,0.334641,0.348714,3.918206,0.001002,0.000971,39,0.000166,0,10,0.895833,0.009512
19125,Marion County,,IA,2086,35827,37913,14,13,27,15762,16811,32573,5,0.337657,0.351964,435.449597,0.001064,0.000835,8,0.000224,0,10,0.483333,0.010566
18021,Clay County,,IN,2250,35637,37887,12,12,24,19773,20128,39901,6,0.325838,0.339149,10.069152,0.000652,0.00077,42,0.000157,0,10,0.679487,0.006329
37189,Watauga County,,NC,3349,34534,37883,36,32,68,24447,28752,53199,6,0.348932,0.36849,982.580154,0.005257,0.005477,37,0.000346,0,10,0.537805,0.056081
18055,Greene County,,IN,2262,35601,37863,12,14,26,21529,22454,43983,6,0.326878,0.340668,20.653383,0.00061,0.00063,42,0.000163,0,10,0.631868,0.005835
28001,Adams County,,MS,2097,35733,37830,18,20,38,11062,14671,25733,5,0.358502,0.377257,2659.944202,0.002119,0.002362,12,0.000206,0,10,0.533333,0.019126
40111,Okmulgee County,,OK,2818,34971,37789,18,17,35,26686,28750,55436,5,0.345868,0.362424,69.832289,0.001322,0.001337,52,0.000226,0,10,0.676471,0.014003
26031,Cheboygan County,,MI,1927,35679,37606,18,16,34,14816,13163,27979,6,0.350725,0.367394,57.480935,0.002746,0.00198,43,0.000149,0,10,0.736842,0.021808
12131,Walton County,,FL,3012,34578,37590,47,31,78,54456,39238,93694,5,0.385494,0.407943,651.322315,0.013122,0.008733,5,0.000349,0,10,0.77305,0.126418
55029,Door County,,WI,1598,35941,37539,14,11,25,12729,11480,24209,5,0.369764,0.387896,55.450946,0.00225,0.001858,8,0.000129,0,10,0.8625,0.019248
17133,Monroe County,,IL,1659,35830,37489,7,7,14,26046,19576,45622,6,0.331106,0.343186,0.512225,0.001037,0.00097,14,0.000095,0,10,0.928571,0.009249
17157,Randolph County,,IL,1812,35632,37444,11,13,24,14461,16493,30954,6,0.331749,0.344732,31.235651,0.0009,0.001007,14,0.000144,0,10,0.60989,0.008057
53017,Douglas County,,WA,3671,33682,37353,19,16,35,48075,43967,92042,5,0.36892,0.387744,5.092509,0.004119,0.003526,45,0.000165,0,10,0.982456,0.041386
28083,Leflore County,,MS,2495,34802,37297,16,22,38,13476,18678,32154,5,0.374451,0.39534,1130.660562,0.00192,0.003196,52,0.000178,0,10,0.56917,0.018279
41007,Clatsop County,,OR,3104,34114,37218,28,28,56,24234,24564,48798,5,0.370791,0.391298,32.132853,0.004849,0.005622,45,0.000237,0,10,0.854839,0.049958
18133,Putnam County,,IN,2411,34802,37213,13,13,26,28041,27298,55339,6,0.32608,0.339638,6.415076,0.001016,0.00095,42,0.000156,0,10,0.775641,0.009345
16057,Latah County,,ID,4160,33019,37179,29,35,64,26659,32321,58980,5,0.373768,0.39541,1279.581664,0.004487,0.006082,45,0.000293,0,10,0.558704,0.045211
51730,Petersburg city,,VA,3623,33528,37151,25,24,49,39656,46540,86196,5,0.360521,0.379915,625.14294,0.005508,0.005477,13,0.000221,0,10,0.626847,0.051615
54029,Hancock County,,WV,1766,35356,37122,8,9,17,17204,16750,33954,6,0.336326,0.351801,8.525083,0.000658,0.000945,41,0.000101,0,10,0.763889,0.005288
51093,Isle of Wight County,,VA,2393,34722,37115,15,17,32,35528,27314,62842,6,0.336179,0.352501,128.050541,0.002686,0.002613,13,0.000145,0,10,0.738562,0.025193
39161,Van Wert County,,OH,1593,35510,37103,9,11,20,13840,15466,29306,6,0.334386,0.349262,46.354424,0.000676,0.001023,43,0.000109,0,10,0.674242,0.006014
29109,Lawrence County,,MO,2794,34289,37083,12,13,25,29245,30276,59521,6,0.323573,0.336024,44.741658,0.001052,0.000748,14,0.000178,0,10,0.631868,0.011165
24011,Caroline County,,MD,2256,34719,36975,14,12,26,30335,27233,57568,6,0.327505,0.341195,1.214006,0.002514,0.001907,13,0.000129,0,10,0.945055,0.022756
29107,Lafayette County,,MO,2473,34490,36963,13,14,27,24533,25686,50219,6,0.329472,0.342339,22.21268,0.000982,0.001076,14,0.000162,0,10,0.719048,0.00945
54025,Greenbrier County,,WV,1600,35315,36915,12,11,23,9162,8457,17619,6,0.300323,0.311876,3291.222979,0.000253,0.000164,41,0.00022,0,10,0.378788,0.002261
22047,Iberville Parish,,LA,1964,34917,36881,11,10,21,22509,26457,48966,5,0.35193,0.368142,11.98589,0.001512,0.00133,12,0.000118,0,10,0.918182,0.013299
26061,Houghton County,,MI,2255,34546,36801,15,24,39,7496,9036,16532,5,0.380669,0.401568,10793.999879,0.002271,0.004111,8,0.000228,0,10,0.442029,0.018937
2110,Juneau City and Borough,,AK,2957,33805,36762,27,28,55,14268,16460,30728,5,0.371463,0.392112,18857.258533,0.005366,0.005299,45,0.000347,0,10,0.522581,0.052964
27079,Le Sueur County,,MN,2210,34496,36706,14,13,27,26508,23048,49556,5,0.333623,0.346951,3.424284,0.00106,0.000965,39,0.000158,0,10,0.818681,0.009995
26009,Antrim County,,MI,2482,34182,36664,15,13,28,18905,16599,35504,6,0.332792,0.34783,2.3212,0.00225,0.001811,43,0.000132,0,10,0.85,0.017244
6005,Amador County,,CA,2171,34481,36652,23,21,44,30399,20191,50590,5,0.368257,0.387527,0.06805,0.005718,0.005039,45,0.000155,0,10,0.996667,0.051898
17135,Montgomery County,,IL,1684,34912,36596,7,9,16,13246,14205,27451,6,0.332324,0.344813,25.430866,0.000594,0.000678,14,0.000102,0,10,0.791667,0.004996
12051,Hendry County,,FL,3331,33260,36591,15,22,37,31334,33006,64340,5,0.362392,0.381407,22.33721,0.004481,0.006644,5,0.000139,0,10,0.788538,0.043621
31001,Adams County,,NE,2250,34335,36585,17,17,34,13533,15827,29360,5,0.365584,0.383784,10749.452188,0.001084,0.001055,50,0.000284,0,10,0.368421,0.010291
45033,Dillon County,,SC,1501,35072,36573,10,14,24,12015,14562,26577,5,0.348695,0.366064,25.767227,0.001745,0.003125,37,0.000118,0,10,0.8,0.017465
28071,Lafayette County,,MS,3444,33025,36469,39,30,69,27316,25246,52562,5,0.380716,0.403369,3869.719959,0.004814,0.004641,52,0.000373,0,10,0.41115,0.045244
53075,Whitman County,,WA,4639,31830,36469,35,37,72,34800,41709,76509,5,0.372228,0.39401,74.86301,0.005863,0.00701,45,0.000283,0,10,0.75061,0.058882
48055,Caldwell County,,TX,3288,33168,36456,13,15,28,46080,40835,86915,5,0.359551,0.377599,6.957829,0.003096,0.003727,62,0.000154,0,10,0.938095,0.033211
20057,Ford County,,KS,3262,33098,36360,27,31,58,13396,15674,29070,5,0.391587,0.41326,26285.041849,0.003496,0.00457,14,0.000445,0,10,0.387395,0.033446
12121,Suwannee County,,FL,2375,33882,36257,33,27,60,30649,25315,55964,5,0.361369,0.380865,2567.581901,0.007795,0.006757,5,0.000298,0,10,0.695187,0.077211
37139,Pasquotank County,,NC,2932,33309,36241,23,22,45,25866,23735,49601,6,0.344163,0.362782,291.1335,0.004267,0.00409,13,0.000224,0,10,0.582512,0.04014
18031,Decatur County,,IN,2147,34072,36219,13,15,28,17792,18671,36463,6,0.330394,0.344716,39.7823,0.000481,0.001076,42,0.00017,0,10,0.529167,0.005055
54009,Brooke County,,WV,1743,34448,36191,9,9,18,12593,12669,25262,6,0.336326,0.351801,7.726121,0.000643,0.000901,41,0.000116,0,10,0.788889,0.005301
12075,Levy County,,FL,2960,33174,36134,29,22,51,35865,31553,67418,5,0.355473,0.373052,28.825102,0.007898,0.00629,5,0.000238,0,10,0.888506,0.078605
18027,Daviess County,,IN,1560,34444,36004,12,10,22,10476,11558,22034,6,0.32667,0.339909,230.046007,0.001089,0.000529,42,0.000164,0,10,0.636364,0.009874
21177,Muhlenberg County,,KY,1295,34708,36003,10,12,22,8902,10196,19098,6,0.32667,0.340034,487.393178,0.000536,0.000715,42,0.000169,0,10,0.55303,0.005342
40123,Pontotoc County,,OK,2869,33097,35966,22,23,45,21531,23160,44691,5,0.348655,0.366498,1666.91571,0.001759,0.002527,52,0.000297,0,10,0.5,0.018549
32023,Nye County,,NV,3714,32213,35927,30,20,50,45883,30303,76186,5,0.37021,0.38967,121.167916,0.008262,0.005061,45,0.000243,0,10,0.694296,0.078326
39047,Fayette County,,OH,2293,33607,35900,12,14,26,22359,22758,45117,6,0.351769,0.368343,96.991949,0.001419,0.001726,41,0.000137,0,10,0.714286,0.012563
27119,Polk County,,MN,2264,33620,35884,17,18,35,18289,19141,37430,5,0.335921,0.35026,4601.71218,0.000881,0.000925,39,0.000275,0,10,0.54386,0.008594
20113,McPherson County,,KS,2096,33773,35869,13,15,28,12817,15676,28493,5,0.365149,0.382943,101.476754,0.000795,0.001285,14,0.000176,0,10,0.738095,0.007301
50017,Orange County,,VT,2250,33581,35831,12,13,25,23003,22549,45552,5,0.325011,0.339046,3.974074,0.001022,0.000833,33,0.000124,0,10,0.769231,0.009152
21035,Calloway County,,KY,2265,33455,35720,17,14,31,14442,15169,29611,6,0.340199,0.356868,977.184069,0.002248,0.001697,52,0.000236,0,10,0.459064,0.021242
17107,Logan County,,IL,1970,33741,35711,11,12,23,13797,15324,29121,5,0.355432,0.371685,172.62362,0.001131,0.000959,8,0.000134,0,10,0.628788,0.009446
47079,Henry County,,TN,2029,33666,35695,14,13,27,13751,12943,26694,6,0.335628,0.350521,117.761812,0.001641,0.001229,52,0.000199,0,10,0.571429,0.016773
13261,Sumter County,,GA,2080,33571,35651,17,20,37,10670,15539,26209,5,0.351126,0.368815,11506.352573,0.002243,0.003147,5,0.000285,0,10,0.492105,0.022332
49021,Iron County,,UT,3559,31978,35537,29,27,56,44237,39726,83963,5,0.37021,0.39043,348.661859,0.004943,0.004374,45,0.000272,0,10,0.496774,0.046581
27015,Brown County,,MN,1778,33739,35517,13,17,30,8952,10910,19862,5,0.338736,0.353261,55.759932,0.001018,0.001097,39,0.000161,0,10,0.584967,0.010069
47183,Weakley County,,TN,2343,33173,35516,14,16,30,16246,18174,34420,6,0.337508,0.353315,2606.015846,0.001731,0.00154,52,0.000207,0,10,0.477124,0.017508
51009,Amherst County,,VA,2027,33473,35500,8,8,16,19890,19724,39614,6,0.33424,0.34892,137.922409,0.000221,0.000898,37,0.000129,0,10,0.6,0.00251
45087,Union County,,SC,1427,34042,35469,8,9,17,8834,11585,20419,6,0.318738,0.331066,1.470367,0.000809,0.00117,37,0.000118,0,10,0.847222,0.009495
24019,Dorchester County,,MD,1609,33803,35412,15,12,27,20819,18466,39285,6,0.330181,0.344005,1.711975,0.002868,0.002064,13,0.000131,0,10,0.952381,0.026237
28027,Coahoma County,,MS,2122,33278,35400,12,14,26,10110,15152,25262,5,0.358795,0.376134,200.738853,0.001089,0.001135,52,0.000158,0,10,0.609524,0.010567
19011,Benton County,,IA,2027,33371,35398,8,10,18,21383,19500,40883,6,0.318937,0.329986,4.019178,0.000507,0.0005,8,0.00013,0,10,0.755556,0.004717
37055,Dare County,,NC,2527,32729,35256,26,24,50,14643,13848,28491,6,0.344704,0.364415,6260.04793,0.004996,0.00445,13,0.000271,0,10,0.553427,0.047751
48223,Hopkins County,,TX,2516,32718,35234,19,21,40,22535,21255,43790,5,0.358502,0.37711,65.128567,0.00228,0.003439,62,0.000214,0,10,0.687747,0.024625
47103,Lincoln County,,TN,1560,33672,35232,11,12,23,18006,17098,35104,6,0.32972,0.342784,53.191744,0.00079,0.000958,51,0.000178,0,10,0.643939,0.009114
29069,Dunklin County,,MO,2227,33000,35227,12,14,26,16921,19720,36641,6,0.342399,0.358502,536.571695,0.000623,0.001109,14,0.000181,0,10,0.494505,0.006323
50005,Caledonia County,,VT,2029,33189,35218,15,13,28,15570,15664,31234,5,0.325045,0.3391,181.248217,0.001341,0.000939,33,0.000163,0,10,0.652381,0.011921
26165,Wexford County,,MI,2518,32614,35132,22,20,42,23867,20671,44538,5,0.357708,0.375401,116.030416,0.002532,0.002229,43,0.000191,0,10,0.672101,0.0198
28029,Copiah County,,MS,1872,33212,35084,12,9,21,14819,16693,31512,6,0.300411,0.311621,183.752323,0.001372,0.00025,12,0.00015,0,10,0.685897,0.011932
21209,Scott County,,KY,2557,32496,35053,22,19,41,42409,31366,73775,5,0.338065,0.354731,274.18678,0.001069,0.001418,42,0.000343,0,10,0.376812,0.01057
51117,Mecklenburg County,,VA,1904,33132,35036,16,14,30,11574,12313,23887,6,0.333804,0.34974,984.889254,0.001916,0.00176,13,0.000188,0,10,0.452206,0.018683
40013,Bryan County,,OK,2734,32262,34996,20,20,40,27179,24396,51575,5,0.348576,0.366064,1799.095258,0.002319,0.002495,62,0.00026,0,10,0.516667,0.024414
48217,Hill County,,TX,2934,32008,34942,19,20,39,30356,28350,58706,5,0.367596,0.387174,36.177991,0.004408,0.005427,62,0.000186,0,10,0.78355,0.04478
22067,Morehouse Parish,,LA,1794,33146,34940,11,11,22,12377,15778,28155,5,0.35453,0.371414,606.914934,0.001616,0.001795,12,0.000146,0,10,0.598485,0.015268
1059,Franklin County,,AL,1973,32876,34849,15,14,29,16502,20521,37023,6,0.320434,0.333225,884.602451,0.00164,0.000651,6,0.00019,0,10,0.479167,0.016324
54045,Logan County,,WV,1892,32953,34845,12,11,23,9503,12256,21759,6,0.353306,0.369916,838.375763,0.001627,0.001431,41,0.00016,0,10,0.505495,0.015644
13299,Ware County,,GA,2329,32441,34770,21,20,41,19797,21859,41656,5,0.35185,0.369819,5196.147214,0.003586,0.002898,5,0.000256,0,10,0.512681,0.035354
51590,Danville city,,VA,2625,32124,34749,12,20,32,26155,30890,57045,6,0.336363,0.35389,83.666569,0.001332,0.003179,37,0.000139,0,10,0.639474,0.013762
26047,Emmet County,,MI,2104,32622,34726,24,21,45,22651,19451,42102,5,0.372228,0.391829,239.014161,0.003629,0.003042,43,0.000187,0,10,0.718333,0.030041
28085,Lincoln County,,MS,1890,32836,34726,17,16,33,15954,15591,31545,5,0.353347,0.370692,1120.021004,0.001399,0.001258,12,0.000197,0,10,0.594737,0.011586
29127,Marion County,,MO,2206,32511,34717,12,12,24,14971,15878,30849,6,0.33236,0.345936,1088.479024,0.000704,0.000898,14,0.000231,0,10,0.429487,0.006624
48459,Upshur County,,TX,2933,31701,34634,18,19,37,39011,36270,75281,5,0.357251,0.375347,171.766923,0.002434,0.003157,62,0.000205,0,10,0.640476,0.025659
40041,Delaware County,,OK,2598,31877,34475,23,18,41,31246,28119,59365,6,0.329402,0.343338,324.930704,0.002644,0.001173,52,0.000265,0,10,0.561594,0.0268
17109,McDonough County,,IL,2405,32043,34448,20,24,44,13079,14717,27796,5,0.37097,0.39069,4243.196989,0.001969,0.002816,8,0.000224,0,10,0.523333,0.016706
40089,McCurtain County,,OK,2027,32333,34360,17,20,37,8350,10150,18500,5,0.349568,0.367231,1243.864584,0.001803,0.00185,62,0.000219,0,10,0.419048,0.01857
40115,Ottawa County,,OK,2364,31956,34320,17,18,35,18747,22127,40874,6,0.331714,0.346457,304.011533,0.001401,0.001283,52,0.000214,0,10,0.471053,0.014683
24023,Garrett County,,MD,1348,32960,34308,16,11,27,8306,8086,16392,6,0.329366,0.344135,1510.806233,0.002498,0.001315,13,0.000166,0,10,0.566667,0.022177
46093,Meade County,,SD,4569,29701,34270,27,17,44,33842,35289,69131,5,0.377164,0.397201,5772.057726,0.004695,0.003591,50,0.000349,0,10,0.449735,0.045932
40015,Caddo County,,OK,2559,31567,34126,11,13,24,17167,19935,37102,6,0.328381,0.34152,17.981862,0.000907,0.000901,52,0.000159,0,10,0.685897,0.009065
26043,Dickinson County,,MI,1686,32415,34101,10,11,21,8770,9191,17961,6,0.325045,0.337348,85.137063,0.000943,0.000474,8,0.00015,0,10,0.643939,0.008812
26105,Mason County,,MI,1811,32283,34094,14,16,30,12692,11472,24164,5,0.3575,0.374696,83.511518,0.002396,0.002131,43,0.000129,0,10,0.801471,0.019477
45069,Marlboro County,,SC,1588,32486,34074,13,13,26,10192,13771,23963,6,0.333514,0.348834,11.537074,0.002091,0.001997,37,0.000138,0,10,0.708791,0.020798
47025,Claiborne County,,TN,1614,32418,34032,12,10,22,13358,13522,26880,6,0.316342,0.328076,424.122821,0.000326,0.000312,51,0.000238,0,10,0.401515,0.003936
21121,Knox County,,KY,2046,31929,33975,9,8,17,16623,17827,34450,6,0.325148,0.337489,38.916035,0.000889,0.000559,42,0.000153,0,10,0.688889,0.008136
49043,Summit County,,UT,3433,30527,33960,29,22,51,35680,36236,71916,5,0.378932,0.399479,156.865543,0.009012,0.006421,45,0.000213,0,10,0.747159,0.085197
53037,Kittitas County,,WA,3238,30701,33939,27,27,54,36766,32720,69486,5,0.370478,0.390809,10.109741,0.004683,0.005107,45,0.000221,0,10,0.87931,0.047798
48493,Wilson County,,TX,2541,31395,33936,21,15,36,39887,31257,71144,5,0.358167,0.376025,53.861052,0.004532,0.003107,62,0.000216,0,10,0.781385,0.047584
48143,Erath County,,TX,3308,30578,33886,26,30,56,24731,26557,51288,5,0.360479,0.380637,206.504426,0.004094,0.004699,62,0.000275,0,10,0.617944,0.04353
18015,Carroll County,,IN,2225,31640,33865,8,8,16,18488,18402,36890,6,0.325907,0.33877,1.247954,0.000553,0.0007,42,0.000112,0,10,0.805556,0.004955
22039,Evangeline Parish,,LA,1657,32163,33820,13,13,26,16639,19335,35974,5,0.352172,0.368793,4.930526,0.001593,0.001498,12,0.000139,0,10,0.857143,0.014071
56001,Albany County,,WY,4278,29503,33781,40,43,83,26272,32057,58329,5,0.388369,0.411838,6052.568473,0.007167,0.008124,35,0.000405,0,10,0.526365,0.072241
37175,Transylvania County,,NC,1928,31848,33776,14,11,25,10561,11754,22315,6,0.333804,0.349306,8.452954,0.003153,0.002084,37,0.000163,0,10,0.772059,0.032647
29207,Stoddard County,,MO,1939,31807,33746,10,11,21,16062,16282,32344,6,0.330465,0.343479,352.008458,0.000445,0.000559,14,0.000171,0,10,0.627273,0.004407
35017,Grant County,,NM,2498,31231,33729,19,22,41,11012,15450,26462,5,0.368743,0.388232,211.301244,0.003688,0.003606,35,0.000213,0,10,0.602767,0.037631
22011,Beauregard Parish,,LA,2595,31083,33678,17,15,32,25558,22791,48349,5,0.356215,0.373975,160.384415,0.002746,0.00268,12,0.000163,0,10,0.618421,0.025164
1025,Clarke County,,AL,1620,32057,33677,10,12,22,10071,12514,22585,6,0.325079,0.339003,30.723262,0.000828,0.001349,6,0.000136,0,10,0.659091,0.008035
46083,Lincoln County,,SD,2655,31022,33677,31,23,54,73059,48201,121260,5,0.377025,0.397363,4080.958156,0.002971,0.002194,50,0.000468,0,10,0.349798,0.028485
21157,Marshall County,,KY,1970,31690,33660,10,9,19,17154,16308,33462,6,0.333225,0.34726,2265.890981,0.000684,0.000922,52,0.000206,0,10,0.436364,0.007281
18135,Randolph County,,IN,2088,31517,33605,8,10,18,17309,18889,36198,6,0.326461,0.339855,13.592962,0.000476,0.000802,42,0.000106,0,10,0.666667,0.004354
39073,Hocking County,,OH,2113,31457,33570,8,10,18,23776,23195,46971,6,0.332,0.346143,2.434524,0.000551,0.000534,41,0.000119,0,10,0.777778,0.005139
22061,Lincoln Parish,,LA,3033,30460,33493,23,26,49,24967,29227,54194,5,0.382327,0.403955,593.303624,0.002932,0.005454,12,0.000219,0,10,0.594253,0.027132
22053,Jefferson Davis Parish,,LA,1933,31451,33384,15,11,26,19840,21449,41289,5,0.350285,0.366298,131.670566,0.001607,0.000902,12,0.00016,0,10,0.752381,0.014852
23007,Franklin County,,ME,2006,31365,33371,12,13,25,15948,17126,33074,5,0.325217,0.339155,0.525619,0.00139,0.000943,33,0.000118,0,10,0.8625,0.012064
37113,Macon County,,NC,1795,31568,33363,26,23,49,11906,7893,19799,5,0.35572,0.3743,3227.17802,0.007326,0.005601,37,0.000297,0,10,0.65121,0.072708
13145,Harris County,,GA,2521,30817,33338,13,11,24,33589,25848,59437,6,0.338103,0.352306,142.723766,0.002385,0.001696,6,0.000156,0,10,0.681319,0.023192
20009,Barton County,,KS,2090,31233,33323,19,20,39,9217,12019,21236,6,0.335628,0.350174,8152.366898,0.001844,0.001081,14,0.000315,0,10,0.435065,0.017678
54077,Preston County,,WV,1280,31967,33247,7,7,14,11851,10591,22442,6,0.292683,0.302799,1800.65314,0.00012,0.000075,41,0.000145,0,10,0.452381,0.001096
48477,Washington County,,TX,2070,31167,33237,20,20,40,21008,20378,41386,5,0.358502,0.377002,32.708528,0.003571,0.004083,62,0.000211,0,10,0.71645,0.038081
47117,Marshall County,,TN,1891,31342,33233,12,10,22,21818,19313,41131,6,0.333804,0.347694,13.385059,0.001007,0.001208,51,0.000176,0,10,0.775641,0.012246
46029,Codington County,,SD,2244,30828,33072,20,20,40,14575,15916,30491,5,0.369142,0.388368,6373.83765,0.001182,0.001322,50,0.000436,0,10,0.35,0.012365
18079,Jennings County,,IN,2012,30941,32953,11,10,21,21310,22425,43735,6,0.326115,0.339339,15.062626,0.000768,0.000592,42,0.000146,0,10,0.685897,0.007621
37033,Caswell County,,NC,2111,30818,32929,9,9,18,18467,19623,38090,6,0.328135,0.341602,6.004762,0.001136,0.00126,37,0.000112,0,10,0.791667,0.011892
48273,Kleberg County,,TX,3618,29288,32906,20,28,48,22588,29740,52328,5,0.371688,0.393142,336.006289,0.004285,0.006044,62,0.000195,0,10,0.61828,0.0439
54035,Jackson County,,WV,1465,31427,32892,10,9,19,11208,10270,21478,6,0.299766,0.310981,224.813084,0.000186,0.000159,41,0.000186,0,10,0.445455,0.001731
40049,Garvin County,,OK,2493,30327,32820,13,11,24,17279,18879,36158,6,0.327261,0.339784,29.57805,0.001673,0.000816,52,0.000177,0,10,0.839744,0.01719
51137,Orange County,,VA,2359,30426,32785,25,18,43,37087,27253,64340,6,0.334823,0.350819,99.687521,0.003573,0.0022,13,0.000221,0,10,0.667692,0.034495
48227,Howard County,,TX,2410,30362,32772,17,20,37,13468,16296,29764,5,0.360563,0.379525,1717.585315,0.003283,0.003862,62,0.000219,0,10,0.649351,0.033513
40065,Jackson County,,OK,3950,28755,32705,33,37,70,13489,18139,31628,5,0.388467,0.411388,10509.909192,0.006587,0.007654,52,0.000338,0,10,0.542973,0.06443
47143,Rhea County,,TN,1917,30732,32649,9,9,18,14623,15273,29896,6,0.317323,0.329351,33.351689,0.000522,0.000591,51,0.000177,0,10,0.625,0.00609
55121,Trempealeau County,,WI,1855,30768,32623,14,15,29,19695,19057,38752,5,0.336768,0.351324,143.051134,0.001141,0.001105,39,0.00016,0,10,0.629167,0.010828
27083,Lyon County,,MN,2158,30392,32550,19,25,44,10366,14607,24973,5,0.337175,0.353,1263.825155,0.000972,0.00111,39,0.000247,0,10,0.361111,0.009658
12093,Okeechobee County,,FL,2432,30080,32512,18,19,37,21862,19083,40945,5,0.354571,0.371615,4.118952,0.004906,0.005634,5,0.000153,0,10,0.897368,0.048298
27103,Nicollet County,,MN,2957,29529,32486,21,22,43,34196,35562,69758,5,0.365453,0.384326,184.626324,0.001088,0.001637,39,0.000229,0,10,0.536923,0.010653
28133,Sunflower County,,MS,2035,30331,32366,9,15,24,12494,16427,28921,5,0.366281,0.385221,225.147372,0.001084,0.001641,52,0.000115,0,10,0.738095,0.010271
22007,Assumption Parish,,LA,1763,30563,32326,10,12,22,15504,17312,32816,5,0.352011,0.368468,1.429365,0.001078,0.001383,12,0.000104,0,10,0.871795,0.008556
20051,Ellis County,,KS,2528,29777,32305,25,26,51,13123,15294,28417,5,0.369497,0.389019,67533.860526,0.000888,0.002692,14,0.000721,0,10,0.225806,0.008582
21021,Boyle County,,KY,2477,29809,32286,13,11,24,21824,21429,43253,6,0.325114,0.337788,77.16412,0.000907,0.000559,42,0.000223,0,10,0.56044,0.009096
18175,Washington County,,IN,1603,30612,32215,11,10,21,17608,17823,35431,6,0.329861,0.343799,28.341179,0.000721,0.000716,42,0.000162,0,10,0.654545,0.007242
51167,Russell County,,VA,1547,30615,32162,8,9,17,11550,11738,23288,6,0.291351,0.301373,206.302997,0.000063,0.000135,51,0.000177,0,10,0.611111,0.001084
56029,Park County,,WY,2635,29507,32142,25,23,48,11531,12277,23808,5,0.376701,0.397,3808.20619,0.004524,0.003768,45,0.000285,0,10,0.533333,0.045826
56033,Sheridan County,,WY,2324,29711,32035,24,21,45,13560,12774,26334,5,0.373178,0.39266,1919.487294,0.00367,0.003415,35,0.000286,0,10,0.610769,0.037489
42131,Wyoming County,,PA,1889,30138,32027,4,4,8,18231,19836,38067,6,0.294225,0.304867,0,0.000303,0.000255,47,0.000072,0,10,1,0.002315
37123,Montgomery County,,NC,1774,30203,31977,13,14,27,14295,16059,30354,6,0.331106,0.346077,2.574686,0.001817,0.002036,37,0.000147,0,10,0.814286,0.020187
28091,Marion County,,MS,1525,30447,31972,16,14,30,10532,12876,23408,5,0.32,0.33259,22.345629,0.001358,0.000659,12,0.00017,0,10,0.702206,0.011569
38059,Morton County,,ND,2433,29466,31899,15,15,30,28055,26689,54744,5,0.369186,0.387934,6880.298855,0.001091,0.001694,39,0.000361,0,10,0.455882,0.011297
26069,Iosco County,,MI,2115,29735,31850,15,17,32,17207,13893,31100,5,0.364802,0.383133,52.42407,0.002047,0.00236,43,0.000122,0,10,0.777778,0.015362
54083,Randolph County,,WV,1346,30387,31733,7,8,15,7255,7824,15079,6,0.299182,0.309814,1977.746567,0.000088,0.000125,41,0.000168,0,10,0.517857,0.000851
31025,Cass County,,NE,2526,29178,31704,6,7,13,25016,22777,47793,5,0.326913,0.337419,4.938552,0.000554,0.000486,50,0.000118,0,10,0.714286,0.004931
55057,Juneau County,,WI,1952,29735,31687,18,15,33,19771,18143,37914,5,0.355968,0.372716,64.707765,0.001917,0.001352,8,0.000169,0,10,0.710526,0.017069
29007,Audrain County,,MO,1918,29704,31622,12,15,27,12772,14441,27213,6,0.332612,0.346642,215.434686,0.000714,0.001063,14,0.000198,0,10,0.5,0.006775
16039,Elmore County,,ID,4995,26614,31609,26,40,66,17849,23912,41761,5,0.387341,0.410547,1229.604086,0.005922,0.00858,45,0.000233,0,10,0.60518,0.056983
8087,Morgan County,,CO,2437,29136,31573,14,16,30,14287,16898,31185,5,0.368566,0.387202,673.370194,0.003311,0.003552,35,0.000159,0,10,0.716912,0.033843
54057,Mineral County,,WV,1554,29976,31530,7,9,16,12695,12277,24972,6,0.294253,0.305311,51.058241,0.000129,0.000202,13,0.000138,0,10,0.611111,0.00144
18041,Fayette County,,IN,1786,29711,31497,9,13,22,12255,13540,25795,6,0.326496,0.340234,51.198258,0.00057,0.000844,42,0.000127,0,10,0.634615,0.005341
36095,Schoharie County,,NY,1699,29778,31477,14,11,25,16186,14877,31063,6,0.318144,0.333084,3.476048,0.00225,0.000958,36,0.000111,0,10,0.828571,0.017067
18179,Wells County,,IN,1730,29745,31475,8,9,17,17582,16606,34188,6,0.326219,0.339366,2.244963,0.000622,0.000555,42,0.000109,0,10,0.763889,0.005463
50019,Orleans County,,VT,1384,29978,31362,11,10,21,9721,9684,19405,5,0.324873,0.338504,163.342318,0.001197,0.000689,33,0.000136,0,10,0.660256,0.010608
5103,Ouachita County,,AR,1940,29369,31309,12,15,27,9261,12799,22060,5,0.348774,0.365766,1013.618238,0.000801,0.001409,52,0.000171,0,10,0.616667,0.00842
39127,Perry County,,OH,1825,29483,31308,7,8,15,27892,27027,54919,6,0.331929,0.345817,0.909524,0.000548,0.000521,41,0.000107,0,10,0.875,0.005023
37099,Jackson County,,NC,2409,28808,31217,19,13,32,17997,17352,35349,6,0.331714,0.346918,1564.381652,0.004317,0.002039,37,0.000238,0,10,0.655844,0.044173
47115,Marion County,,TN,1619,29588,31207,9,11,20,14266,15637,29903,6,0.329155,0.341943,131.580793,0.000566,0.000843,51,0.000162,0,10,0.490909,0.006329
5023,Cleburne County,,AR,2033,29123,31156,15,13,28,16118,15520,31638,6,0.334568,0.349192,84.595358,0.001037,0.001023,52,0.000198,0,10,0.679167,0.010723
13293,Upson County,,GA,1503,29482,30985,14,16,30,11069,10910,21979,6,0.339185,0.354205,56.75975,0.002202,0.002646,6,0.00016,0,10,0.732026,0.022504
21235,Whitley County,,KY,2013,28964,30977,12,10,22,20340,19553,39893,6,0.32768,0.34126,682.993511,0.00125,0.000844,42,0.000196,0,10,0.557692,0.011288
39117,Morrow County,,OH,2230,28732,30962,9,8,17,34102,29376,63478,6,0.331965,0.345871,1.584957,0.000669,0.000613,41,0.000105,0,10,0.805556,0.006065
31047,Dawson County,,NE,2322,28597,30919,22,21,43,10956,14812,25768,5,0.370344,0.390186,8869.059292,0.003673,0.001988,50,0.000272,0,10,0.362069,0.035081
21141,Logan County,,KY,1622,29294,30916,12,13,25,13508,13828,27336,6,0.334713,0.349734,126.556304,0.001146,0.001419,42,0.000176,0,10,0.602564,0.01197
22075,Plaquemines Parish,,LA,2421,28438,30859,20,39,59,23024,28884,51908,5,0.376933,0.400521,141.004871,0.004697,0.006122,12,0.000161,0,10,0.571951,0.043732
46011,Brookings County,,SD,2594,28253,30847,26,26,52,16032,18970,35002,5,0.37772,0.398286,5790.703083,0.002089,0.002026,50,0.000468,0,10,0.336782,0.020642
29225,Webster County,,MO,2157,28560,30717,15,15,30,30044,28953,58997,5,0.364456,0.3824,663.816674,0.001458,0.001065,14,0.000221,0,10,0.474265,0.014947
53031,Jefferson County,,WA,2087,28517,30604,22,17,39,21080,18023,39103,5,0.365497,0.384055,0.473686,0.005708,0.003967,45,0.000175,0,10,0.944664,0.056035
48147,Fannin County,,TX,2355,28246,30601,9,10,19,26146,23708,49854,5,0.353754,0.370247,5.884781,0.00207,0.002265,62,0.000119,0,10,0.9,0.021735
41045,Malheur County,,OR,2569,28024,30593,15,16,31,14863,19358,34221,5,0.362478,0.380284,744.806443,0.001583,0.002056,45,0.000207,0,10,0.606618,0.017144
21043,Carter County,,KY,1229,29334,30563,10,9,19,9196,9823,19019,6,0.334786,0.349723,4168.825839,0.00064,0.000615,41,0.000197,0,10,0.466667,0.006186
45001,Abbeville County,,SC,1644,28818,30462,6,10,16,14349,16349,30698,6,0.322249,0.334977,12.929527,0.000476,0.001264,37,0.000108,0,10,0.677778,0.005831
54005,Boone County,,WV,1553,28870,30423,7,8,15,9537,11048,20585,6,0.297588,0.30772,4.372973,0.000184,0.000131,41,0.000123,0,10,0.638889,0.001647
21005,Anderson County,,KY,1642,28634,30276,12,12,24,18580,16245,34825,6,0.325045,0.337815,18.192491,0.000587,0.000565,42,0.000211,0,10,0.628205,0.005927
29209,Stone County,,MO,3019,27199,30218,20,13,33,25154,27343,52497,5,0.367992,0.386361,217.80113,0.004105,0.001846,14,0.000226,0,10,0.721429,0.040554
19149,Plymouth County,,IA,1514,28661,30175,9,13,22,12727,12640,25367,5,0.329437,0.342437,169.380604,0.000622,0.000746,8,0.00015,0,10,0.583333,0.005842
8029,Delta County,,CO,2084,27957,30041,21,16,37,18079,15351,33430,5,0.364629,0.382742,62.126376,0.004525,0.003213,35,0.000196,0,10,0.758893,0.04646
1005,Barbour County,,AL,1939,28101,30040,13,13,26,11992,15262,27254,6,0.322046,0.335048,6242.583913,0.001414,0.000931,6,0.000199,0,10,0.571429,0.013872
35055,Taos County,,NM,1993,28033,30026,16,16,32,10269,12736,23005,5,0.370522,0.389535,141.483667,0.004442,0.004565,35,0.000158,0,10,0.807018,0.044985
36049,Lewis County,,NY,1470,28533,30003,6,7,13,12719,11828,24547,6,0.319567,0.332395,0.183333,0.000712,0.000866,36,0.000075,0,10,0.952381,0.005316
28023,Clarke County,,MS,1782,28216,29998,8,11,19,11720,13593,25313,5,0.319003,0.330908,17.902279,0.000446,0.000485,12,0.000115,0,10,0.717949,0.003784
55123,Vernon County,,WI,1546,28401,29947,11,10,21,16035,16444,32479,5,0.336621,0.35051,39.575498,0.001187,0.000985,39,0.000134,0,10,0.795455,0.011197
13131,Grady County,,GA,2110,27804,29914,12,10,22,15454,15501,30955,5,0.352092,0.367301,227.826539,0.002,0.001394,5,0.000144,0,10,0.712121,0.018734
5059,Hot Spring County,,AR,1766,28062,29828,8,9,17,20741,20784,41525,6,0.321037,0.33221,6.800431,0.000369,0.000634,52,0.000134,0,10,0.777778,0.003973
26101,Manistee County,,MI,1708,28120,29828,15,15,30,11543,10599,22142,5,0.357459,0.374533,58.787654,0.002111,0.001918,43,0.000139,0,10,0.767974,0.016269
6021,Glenn County,,CA,1759,28045,29804,14,11,25,15503,15921,31424,5,0.360902,0.378087,18.545892,0.003483,0.002077,45,0.00012,0,10,0.9375,0.031718
48463,Uvalde County,,TX,2038,27751,29789,16,18,34,11883,14268,26151,5,0.360014,0.378521,163.676142,0.002959,0.003357,62,0.000202,0,10,0.644737,0.030597
51197,Wythe County,,VA,1397,28392,29789,10,11,21,10743,10188,20931,6,0.296812,0.308317,471.537961,0.000129,0.00016,37,0.000185,0,10,0.416667,0.001298
28073,Lamar County,,MS,2259,27435,29694,41,35,76,60492,50655,111147,5,0.362778,0.384055,1607.978484,0.003813,0.003707,12,0.000385,0,10,0.427061,0.035613
22031,De Soto Parish,,LA,1851,27837,29688,10,9,19,21247,19912,41159,5,0.352698,0.368837,124.574825,0.00117,0.001213,12,0.000145,0,10,0.644444,0.012193
26109,Menominee County,,MI,1438,28247,29685,8,8,16,11222,12307,23529,5,0.355186,0.370898,32.03868,0.000925,0.000631,8,0.000113,0,10,0.875,0.008637
18149,Starke County,,IN,4255,25389,29644,10,16,26,18679,19647,38326,5,0.35775,0.375022,40.084556,0.001054,0.001422,42,0.000109,0,10,0.7,0.009101
47071,Hardin County,,TN,1447,28180,29627,12,12,24,11132,10704,21836,6,0.335481,0.350054,93.906384,0.000795,0.001102,52,0.000196,0,10,0.474359,0.008359
13033,Burke County,,GA,1856,27733,29589,13,12,25,16705,18315,35020,5,0.349091,0.365544,365.173403,0.002346,0.002011,37,0.000168,0,10,0.628205,0.02348
51139,Page County,,VA,1144,28441,29585,10,8,18,8890,8295,17185,6,0.333406,0.3477,3.771466,0.000874,0.000852,13,0.000137,0,10,0.755556,0.008578
13087,Decatur County,,GA,1873,27688,29561,14,12,26,11968,12169,24137,6,0.33814,0.353917,6695.24124,0.00228,0.001362,5,0.000192,0,10,0.541667,0.021491
1093,Marion County,,AL,1699,27781,29480,12,12,24,13997,14676,28673,6,0.320133,0.332612,67.086663,0.000404,0.000618,6,0.000178,0,10,0.5,0.004313
42067,Juniata County,,PA,1133,28338,29471,9,8,17,9841,9045,18886,6,0.306403,0.318777,0.924342,0.00081,0.000828,47,0.000105,0,10,0.888889,0.007192
28099,Neshoba County,,MS,1693,27763,29456,12,12,24,13641,13448,27089,5,0.32,0.332427,163.423503,0.000413,0.000514,12,0.000176,0,10,0.631868,0.004023
17083,Jersey County,,IL,1622,27773,29395,7,9,16,16128,15165,31293,6,0.332288,0.344759,85.745499,0.000808,0.001001,14,0.000116,0,10,0.722222,0.007253
17085,Jo Daviess County,,IL,1473,27883,29356,13,11,24,12708,11647,24355,5,0.35572,0.371902,71.494571,0.001982,0.001403,8,0.000126,0,10,0.626374,0.016313
20059,Franklin County,,KS,2017,27306,29323,14,14,28,18712,18737,37449,6,0.332612,0.345779,64.732356,0.001081,0.001089,14,0.000179,0,10,0.616667,0.009913
48015,Austin County,,TX,1947,27375,29322,13,14,27,24534,22276,46810,5,0.357002,0.374571,4.07421,0.002141,0.002873,62,0.00015,0,10,0.884615,0.023554
51163,Rockbridge County,,VA,1542,27766,29308,11,8,19,10016,9313,19329,6,0.291378,0.301416,9282.929715,0.000705,0.000115,13,0.000221,0,10,0.409091,0.007096
19123,Mahaska County,,IA,1977,27322,29299,9,10,19,11254,11972,23226,6,0.318904,0.329905,11.798602,0.000326,0.000454,8,0.000166,0,10,0.663636,0.003523
20121,Miami County,,KS,2124,27109,29233,14,14,28,27624,24625,52249,6,0.331965,0.344965,44.440617,0.001178,0.00116,14,0.000175,0,10,0.633333,0.010991
51033,Caroline County,,VA,1963,27269,29232,16,16,32,35181,26214,61395,6,0.335188,0.351145,36.939834,0.002005,0.002076,13,0.000171,0,10,0.741667,0.019513
54053,Mason County,,WV,1157,28025,29182,8,7,15,11128,10117,21245,6,0.333008,0.346973,57.501252,0.000573,0.000509,41,0.000133,0,10,0.732143,0.005148
37007,Anson County,,NC,1338,27762,29100,7,9,16,10747,12959,23706,6,0.330678,0.344938,2.42533,0.000894,0.001783,37,0.000106,0,10,0.847222,0.010472
28093,Marshall County,,MS,1999,27061,29060,9,12,21,29771,30373,60144,6,0.331714,0.345475,105.549489,0.000953,0.000585,52,0.000145,0,10,0.564103,0.009533
13029,Bryan County,,GA,3138,25840,28978,33,25,58,38242,30740,68982,5,0.369586,0.390039,618.1088,0.007849,0.006613,5,0.000264,0,10,0.694168,0.076426
16031,Cassia County,,ID,2322,26580,28902,13,13,26,17499,20525,38024,5,0.363121,0.38061,426.755102,0.001989,0.001522,45,0.000155,0,10,0.752381,0.019879
48499,Wood County,,TX,2241,26657,28898,23,20,43,36562,29596,66158,5,0.357376,0.375618,50.110108,0.002876,0.002999,62,0.000237,0,10,0.690217,0.03112
48363,Palo Pinto County,,TX,2222,26562,28784,16,14,30,20040,19046,39086,5,0.354857,0.372092,53.398057,0.002359,0.002182,62,0.000189,0,10,0.757353,0.024817
21095,Harlan County,,KY,1401,27349,28750,7,10,17,3337,5670,9007,6,0.322283,0.335069,294.895229,0.000249,0.000523,51,0.000145,0,10,0.5,0.002571
28163,Yazoo County,,MS,1664,27084,28748,9,10,19,9763,12420,22183,5,0.366762,0.385194,188.593549,0.001317,0.001701,12,0.000116,0,10,0.788889,0.012206
27093,Meeker County,,MN,1651,27067,28718,12,13,25,15519,15221,30740,5,0.333587,0.346897,2.636061,0.000966,0.000922,39,0.000139,0,10,0.878205,0.009188
47069,Hardeman County,,TN,1580,27106,28686,10,13,23,12410,14312,26722,6,0.33384,0.348074,55.157975,0.000839,0.000896,52,0.000156,0,10,0.557692,0.008774
54067,Nicholas County,,WV,1409,27277,28686,8,9,17,7109,7421,14530,6,0.299474,0.310303,4690.384519,0.000192,0.000139,41,0.000174,0,10,0.458333,0.001755
4009,Graham County,,AZ,2085,26581,28666,14,11,25,19476,19795,39271,5,0.361114,0.37806,4.320489,0.002538,0.001631,45,0.000149,0,10,0.82967,0.026484
17165,Saline County,,IL,1445,27151,28596,11,11,22,8531,9049,17580,6,0.302481,0.313173,13344.535416,0.000648,0.000128,14,0.000245,0,10,0.363636,0.006273
8117,Summit County,,CO,4252,24335,28587,35,33,68,25869,32089,57958,5,0.389848,0.412256,272.810931,0.009128,0.008748,35,0.00028,0,10,0.741463,0.089595
1109,Pike County,,AL,2157,26369,28526,18,17,35,16105,18240,34345,6,0.337249,0.35338,129.46421,0.001198,0.001775,6,0.000206,0,10,0.586842,0.01215
51540,Charlottesville city,,VA,5109,23296,28405,46,53,99,50772,63894,114666,5,0.405117,0.430268,5018.313234,0.01071,0.014741,13,0.000376,0,10,0.62688,0.102889
28057,Itawamba County,,MS,1754,26601,28355,10,11,21,18698,18532,37230,6,0.330928,0.3442,173.425726,0.0004,0.000402,52,0.000161,0,10,0.572727,0.004322
19027,Carroll County,,IA,1367,26986,28353,11,14,25,7042,8153,15195,5,0.366194,0.384218,394.946907,0.000547,0.00113,8,0.000186,0,10,0.457143,0.005241
12027,DeSoto County,,FL,2170,26173,28343,15,12,27,17616,17672,35288,5,0.353754,0.36977,0.57485,0.004467,0.004017,5,0.000135,0,10,0.952381,0.043773
31067,Gage County,,NE,1453,26877,28330,9,8,17,10955,11115,22070,5,0.327331,0.337967,111.187569,0.000421,0.000468,50,0.000226,0,10,0.366667,0.003914
41061,Union County,,OR,2286,26022,28308,21,22,43,11785,12976,24761,5,0.363766,0.382509,217.654128,0.002429,0.00312,45,0.000223,0,10,0.7,0.02594
6035,Lassen County,,CA,2432,25871,28303,25,26,51,14178,14641,28819,5,0.369453,0.389507,95.671947,0.005105,0.005408,45,0.000179,0,10,0.875862,0.046546
48233,Hutchinson County,,TX,2402,25901,28303,10,13,23,9238,12034,21272,5,0.356463,0.373882,570.002347,0.001601,0.002576,62,0.000168,0,10,0.642857,0.016493
55049,Iowa County,,WI,1605,26667,28272,9,8,17,18380,18119,36499,5,0.328381,0.340088,36.170917,0.00115,0.000617,8,0.000116,0,10,0.805556,0.01062
27091,Martin County,,MN,1441,26817,28258,10,11,21,5444,6856,12300,5,0.335811,0.349501,1458.968663,0.000825,0.000913,39,0.000142,0,10,0.484848,0.007945
27153,Todd County,,MN,1684,26542,28226,14,17,31,14392,16202,30594,5,0.334677,0.348877,2.023913,0.000964,0.000984,39,0.000171,0,10,0.897059,0.009335
38089,Stark County,,ND,1731,26462,28193,31,21,52,11667,12823,24490,5,0.378232,0.398926,23702.839452,0.003633,0.002355,39,0.000542,0,10,0.319073,0.037095
5027,Columbia County,,AR,1647,26521,28168,11,18,29,8100,11260,19360,5,0.355514,0.373503,805.591195,0.000748,0.00169,52,0.000156,0,10,0.571895,0.007735
28137,Tate County,,MS,2172,25920,28092,8,6,14,24589,22971,47560,6,0.330465,0.342952,6.414297,0.00067,0.000476,52,0.000137,0,10,0.660714,0.007162
13195,Madison County,,GA,1931,26148,28079,15,14,29,26411,24289,50700,6,0.335738,0.350016,74.677503,0.001452,0.001508,6,0.000202,0,10,0.719048,0.014837
5123,St. Francis County,,AR,2071,26006,28077,10,13,23,12752,18013,30765,5,0.350046,0.36696,68.559877,0.00078,0.001273,52,0.000135,0,10,0.737179,0.007732
45039,Fairfield County,,SC,1516,26555,28071,9,7,16,13475,15317,28792,6,0.329049,0.342974,3.26,0.001263,0.001121,37,0.000124,0,10,0.861111,0.014063
47077,Henderson County,,TN,1710,26323,28033,11,10,21,15290,14560,29850,6,0.333768,0.34764,32.281871,0.001011,0.000988,52,0.000178,0,10,0.598485,0.010731
37117,Martin County,,NC,1559,26408,27967,8,10,18,10906,13077,23983,6,0.32831,0.341981,7.26989,0.000571,0.0012,37,0.000128,0,10,0.733333,0.006106
28123,Scott County,,MS,1699,26257,27956,12,13,25,15306,17662,32968,5,0.349448,0.364925,269.145495,0.000851,0.000917,12,0.000158,0,10,0.637363,0.008135
1061,Geneva County,,AL,2020,25894,27914,13,11,24,17806,18144,35950,5,0.318342,0.330686,18.445769,0.001624,0.00089,6,0.000149,0,10,0.686813,0.016354
26029,Charlevoix County,,MI,1801,26107,27908,13,12,25,16230,15101,31331,6,0.333116,0.34821,12.253489,0.002339,0.001535,43,0.000118,0,10,0.885714,0.01863
29055,Crawford County,,MO,1847,26038,27885,13,13,26,17494,16311,33805,6,0.330643,0.343967,20.992625,0.001083,0.001033,14,0.000168,0,10,0.725275,0.010074
13257,Stephens County,,GA,1734,26149,27883,15,16,31,12452,13511,25963,6,0.337175,0.351758,23.008957,0.00182,0.001986,6,0.000193,0,10,0.698529,0.018501
51109,Louisa County,,VA,1680,26191,27871,21,17,38,29388,20262,49650,6,0.334713,0.350548,99.634447,0.002491,0.001902,13,0.000209,0,10,0.640693,0.024217
32001,Churchill County,,NV,3130,24723,27853,26,23,49,18520,18541,37061,5,0.373541,0.393674,414.470991,0.006195,0.00526,45,0.000232,0,10,0.658462,0.058803
17041,Douglas County,,IL,1551,26261,27812,7,9,16,12216,13383,25599,5,0.355268,0.371088,69.319592,0.00027,0.000792,8,0.00011,0,10,0.736111,0.002268
51053,Dinwiddie County,,VA,2053,25713,27766,11,12,23,26259,23391,49650,6,0.313533,0.326177,12.206638,0.000684,0.000744,13,0.000159,0,10,0.651515,0.00724
47097,Lauderdale County,,TN,1555,26197,27752,9,9,18,13204,14546,27750,6,0.333768,0.347531,10.739633,0.000782,0.000998,52,0.000146,0,10,0.777778,0.008191
29219,Warren County,,MO,1977,25774,27751,10,9,19,36150,27657,63807,6,0.329402,0.341743,1.757203,0.001043,0.00087,14,0.000128,0,10,0.836364,0.009323
13055,Chattooga County,,GA,1251,26483,27734,11,12,23,11809,12533,24342,6,0.335518,0.350087,24.933559,0.001142,0.001206,6,0.00014,0,10,0.719697,0.011712
27115,Pine County,,MN,1770,25939,27709,14,16,30,22326,19724,42050,5,0.364976,0.383078,50.630919,0.001083,0.001499,39,0.000161,0,10,0.820833,0.010005
18049,Fulton County,,IN,1741,25957,27698,14,13,27,14653,14968,29621,6,0.327401,0.341124,32.768674,0.00155,0.000881,42,0.000135,0,10,0.728571,0.013669
19019,Buchanan County,,IA,1653,26035,27688,9,11,20,11692,12678,24370,6,0.319003,0.330203,25.093003,0.000507,0.000497,8,0.000135,0,10,0.718182,0.004745
40039,Custer County,,OK,2629,25035,27664,19,17,36,17439,20885,38324,5,0.346805,0.363699,1790.558094,0.001388,0.00145,52,0.000277,0,10,0.469048,0.01424
18181,White County,,IN,1935,25686,27621,15,14,29,18010,19498,37508,5,0.357625,0.374642,136.893304,0.001316,0.001398,42,0.000166,0,10,0.566667,0.011837
20191,Sumner County,,KS,1999,25585,27584,5,10,15,15638,18581,34219,6,0.32972,0.34164,22.473247,0.000268,0.000668,14,0.000123,0,10,0.577778,0.002511
21193,Perry County,,KY,1265,26306,27571,7,10,17,8607,9569,18176,6,0.325596,0.338357,433.920262,0.000246,0.000546,42,0.00014,0,10,0.511111,0.00254
5107,Phillips County,,AR,1747,25799,27546,11,17,28,4982,10782,15764,6,0.33475,0.349897,234.604443,0.001223,0.001098,52,0.000152,0,10,0.565359,0.012124
13143,Haralson County,,GA,1925,25608,27533,11,11,22,26716,23246,49962,6,0.337101,0.351107,190.328213,0.001679,0.001981,6,0.000134,0,10,0.840909,0.017467
51075,Goochland County,,VA,2091,25421,27512,8,8,16,22437,15400,37837,6,0.334349,0.349029,12.372282,0.001174,0.001266,13,0.000115,0,10,0.892857,0.011838
21013,Bell County,,KY,1630,25878,27508,9,11,20,9685,12221,21906,6,0.327785,0.341531,394.53067,0.000527,0.000838,51,0.000175,0,10,0.554545,0.005383
20149,Pottawatomie County,,KS,2369,25124,27493,14,11,25,16948,15993,32941,6,0.329826,0.341857,89.22475,0.00099,0.00079,14,0.000191,0,10,0.571429,0.009009
50015,Lamoille County,,VT,1745,25746,27491,11,10,21,16009,15522,31531,5,0.324907,0.338558,21.108625,0.000933,0.000646,33,0.000128,0,10,0.790909,0.008397
27045,Fillmore County,,MN,1334,26142,27476,11,13,24,11297,12502,23799,5,0.33424,0.347873,92.134907,0.00052,0.000867,39,0.000149,0,10,0.641026,0.005216
18143,Scott County,,IN,1570,25885,27455,9,9,18,16816,17080,33896,6,0.329826,0.343636,6.279013,0.000738,0.000737,42,0.000134,0,10,0.819444,0.007237
22093,St. James Parish,,LA,1090,26326,27416,10,11,21,12470,14273,26743,5,0.351971,0.368305,0.3,0.001437,0.001321,12,0.000104,0,10,0.942308,0.012343
21163,Meade County,,KY,2045,25363,27408,22,28,50,28488,27753,56241,5,0.362692,0.382205,551.732199,0.004848,0.004448,42,0.000198,0,10,0.639205,0.04617
27039,Dodge County,,MN,1523,25859,27382,12,12,24,15885,14498,30383,5,0.333768,0.347059,4.228854,0.000714,0.000853,39,0.000148,0,10,0.833333,0.006944
28145,Union County,,MS,1672,25671,27343,13,13,26,18835,19041,37876,6,0.330892,0.344363,22.277147,0.000555,0.000535,52,0.000187,0,10,0.587912,0.00595
19017,Bremer County,,IA,1512,25742,27254,8,10,18,14445,14072,28517,6,0.318904,0.329932,72.188492,0.000367,0.000475,8,0.000126,0,10,0.666667,0.003669
1099,Monroe County,,AL,1346,25883,27229,9,11,20,7736,9292,17028,6,0.324222,0.337701,7.264556,0.001019,0.001199,6,0.00012,0,10,0.772727,0.010129
5003,Ashley County,,AR,1494,25723,27217,8,12,20,5890,7836,13726,5,0.344742,0.360959,63.840346,0.000359,0.000967,52,0.000127,0,10,0.590909,0.003628
37009,Ashe County,,NC,989,26200,27189,11,11,22,7312,6710,14022,6,0.331427,0.34624,2316.110615,0.001387,0.001711,37,0.000165,0,10,0.606061,0.015319
20021,Cherokee County,,KS,1747,25401,27148,5,8,13,13146,15276,28422,6,0.3329,0.34541,6.623745,0.000071,0.000823,14,0.000099,0,10,0.821429,0.001042
28043,Grenada County,,MS,1715,25387,27102,17,17,34,11231,12364,23595,6,0.332036,0.346506,1567.052059,0.001198,0.000705,52,0.000217,0,10,0.526144,0.011711
54059,Mingo County,,WV,1571,25437,27008,8,11,19,7742,10524,18266,6,0.335042,0.350146,185.681745,0.000565,0.000684,42,0.000128,0,10,0.345455,0.005176
27157,Wabasha County,,MN,1426,25510,26936,11,9,20,13125,13878,27003,5,0.333514,0.346354,105.366349,0.000893,0.000824,39,0.000142,0,10,0.736364,0.00849
1133,Winston County,,AL,1560,25356,26916,10,11,21,13379,14380,27759,6,0.319967,0.33214,4.499254,0.000631,0.000751,6,0.000141,0,10,0.80303,0.006596
26051,Gladwin County,,MI,1643,25260,26903,15,14,29,18163,15346,33509,6,0.33254,0.347613,2.355396,0.00177,0.001541,43,0.000124,0,10,0.870833,0.013332
24029,Kent County,,MD,1375,25515,26890,15,11,26,10702,9895,20597,6,0.324359,0.337413,1.016248,0.003018,0.001588,13,0.000127,0,10,0.908088,0.02679
5015,Carroll County,,AR,2059,24819,26878,14,13,27,12385,14226,26611,6,0.334131,0.348703,242.764924,0.002294,0.001218,52,0.000202,0,10,0.591912,0.023399
51683,Manassas city,,VA,3804,23066,26870,18,25,43,75732,77509,153241,5,0.372816,0.394027,88.407757,0.003691,0.005433,13,0.000155,0,10,0.721538,0.035294
41057,Tillamook County,,OR,1778,25059,26837,20,16,36,15451,14353,29804,5,0.362692,0.380556,0.155263,0.003303,0.002518,45,0.000182,0,10,0.986842,0.034489
35029,Luna County,,NM,2253,24567,26820,13,12,25,11135,12024,23159,5,0.364413,0.382102,13.834922,0.003316,0.002484,35,0.000139,0,10,0.757353,0.032603
17067,Hancock County,,IL,1434,25383,26817,6,6,12,7896,9286,17182,6,0.27559,0.284521,136.018149,0.000045,0.000034,8,0.00012,0,10,0.5,0.000671
30047,Lake County,,MT,1891,24911,26802,15,14,29,12534,12794,25328,5,0.364326,0.382308,307.52725,0.002275,0.001936,45,0.000186,0,10,0.768382,0.023339
47109,McNairy County,,TN,1658,25142,26800,9,8,17,14133,13546,27679,6,0.333623,0.347206,10.551391,0.00044,0.000803,52,0.000154,0,10,0.633333,0.004553
19031,Cedar County,,IA,1685,25098,26783,7,7,14,14322,13595,27917,6,0.319933,0.330632,3.90056,0.000472,0.000572,8,0.000107,0,10,0.875,0.004583
21003,Allen County,,KY,1647,25080,26727,15,12,27,12800,11497,24297,6,0.332216,0.346229,370.021106,0.00157,0.001024,42,0.000219,0,10,0.475,0.015402
5057,Hempstead County,,AR,1766,24927,26693,14,16,30,10822,13035,23857,5,0.346024,0.362587,1155.551527,0.000878,0.000956,62,0.000196,0,10,0.533088,0.009258
13305,Wayne County,,GA,1446,25237,26683,15,16,31,11556,10424,21980,5,0.349806,0.366081,243.379666,0.001884,0.002077,5,0.000198,0,10,0.55,0.018985
26137,Otsego County,,MI,1733,24943,26676,20,20,40,15172,12750,27922,6,0.334422,0.350461,29.406193,0.002289,0.00198,43,0.000176,0,10,0.62253,0.017908
48449,Titus County,,TX,2116,24550,26666,18,21,39,17043,19605,36648,5,0.359004,0.377626,61.537086,0.002267,0.003053,62,0.000201,0,10,0.680952,0.024155
48025,Bee County,,TX,2148,24502,26650,15,21,36,15481,17087,32568,5,0.359004,0.377653,55.864757,0.002138,0.00339,62,0.000173,0,10,0.685714,0.022962
20099,Labette County,,KS,1587,25059,26646,10,12,22,8177,10066,18243,6,0.335005,0.348546,145.271888,0.000869,0.001188,14,0.00014,0,10,0.626374,0.008323
41065,Wasco County,,OR,2109,24489,26598,14,16,30,14765,13970,28735,5,0.362906,0.380773,6172.239084,0.0017,0.002426,45,0.000191,0,10,0.75,0.018021
35047,San Miguel County,,NM,1864,24728,26592,12,15,27,11159,15616,26775,5,0.364197,0.382156,445.348764,0.002143,0.002582,35,0.000167,0,10,0.625,0.021591
28101,Newton County,,MS,1350,25224,26574,10,11,21,12140,11871,24011,5,0.319069,0.331017,38.516533,0.000779,0.000504,12,0.000133,0,10,0.666667,0.006551
5111,Poinsett County,,AR,1735,24818,26553,7,9,16,15045,16575,31620,6,0.3329,0.346587,78.145111,0.000438,0.000627,52,0.000117,0,10,0.694444,0.004341
1019,Cherokee County,,AL,1380,25163,26543,11,9,20,13586,12342,25928,6,0.319268,0.33093,12.543302,0.000903,0.000442,6,0.000132,0,10,0.636364,0.009371
29083,Henry County,,MO,1667,24839,26506,11,13,24,15440,15106,30546,6,0.329437,0.342204,14.431084,0.000908,0.001041,14,0.000148,0,10,0.769231,0.008985
49047,Uintah County,,UT,1626,24870,26496,20,21,41,20664,18689,39353,5,0.365149,0.383946,526.595358,0.002164,0.002775,45,0.00021,0,10,0.564615,0.021854
48259,Kendall County,,TX,2081,24381,26462,24,18,42,39046,27514,66560,5,0.358293,0.376514,59.360086,0.005213,0.003828,62,0.00025,0,10,0.807971,0.056203
47129,Morgan County,,TN,1395,25033,26428,7,7,14,11650,12408,24058,6,0.316147,0.327452,7.781915,0.000312,0.000425,51,0.000161,0,10,0.660714,0.003905
13107,Emanuel County,,GA,1364,25043,26407,12,14,26,9077,10113,19190,6,0.337027,0.351758,1368.628221,0.000541,0.001347,5,0.000211,0,10,0.445055,0.005784
55001,Adams County,,WI,2014,24388,26402,24,15,39,18912,14462,33374,5,0.369942,0.388547,71.475224,0.002626,0.001852,8,0.000194,0,10,0.735385,0.022475
38093,Stutsman County,,ND,1568,24804,26372,11,12,23,6481,8789,15270,5,0.366412,0.384408,4239.285223,0.000245,0.001082,39,0.000263,0,10,0.434066,0.002891
21239,Woodford County,,KY,2103,24257,26360,11,10,21,20549,20213,40762,6,0.324907,0.337408,14.088542,0.000583,0.000553,42,0.000204,0,10,0.809091,0.005844
31043,Dakota County,,NE,2668,23672,26340,14,15,29,17758,21738,39496,5,0.38001,0.399951,1010.133727,0.001541,0.002469,8,0.000187,0,10,0.473856,0.014161
18075,Jay County,,IN,1416,24814,26230,9,10,19,10016,11751,21767,6,0.326565,0.33999,41.320566,0.00063,0.000575,42,0.000116,0,10,0.536364,0.005549
37079,Greene County,,NC,1885,24257,26142,8,7,15,17055,17620,34675,6,0.329296,0.342367,0.0625,0.000855,0.000908,37,0.000103,0,10,0.964286,0.008935
29167,Polk County,,MO,2076,24005,26081,14,13,27,21417,20129,41546,6,0.328345,0.34082,283.651485,0.001122,0.000851,14,0.000212,0,10,0.558333,0.012185
13225,Peach County,,GA,2423,23577,26000,10,12,22,27171,25990,53161,6,0.337731,0.352002,117.961764,0.001166,0.002024,6,0.000145,0,10,0.636364,0.011923
8083,Montezuma County,,CO,2109,23858,25967,24,18,42,13414,12229,25643,5,0.364716,0.383105,5492.724226,0.00524,0.003734,35,0.000268,0,10,0.756667,0.053146
51027,Buchanan County,,VA,1264,24701,25965,6,7,13,5339,9080,14419,6,0.288993,0.298991,118.254097,0.000018,0.000065,51,0.000131,0,10,0.452381,0.000464
39175,Wyandot County,,OH,1453,24483,25936,8,9,17,15464,16559,32023,6,0.33218,0.346305,1.202723,0.000576,0.000756,43,0.000095,0,10,0.822222,0.005047
22049,Jackson Parish,,LA,1772,24109,25881,9,10,19,10809,11446,22255,5,0.353022,0.369379,24.381966,0.000618,0.001199,12,0.000122,0,10,0.719697,0.005191
46135,Yankton County,,SD,1844,24014,25858,15,18,33,9659,10304,19963,5,0.37097,0.389996,1128.034657,0.000553,0.001482,50,0.000292,0,10,0.426901,0.005499
18013,Brown County,,IN,2105,23732,25837,9,7,16,16264,16083,32347,6,0.325631,0.338254,0.810618,0.000821,0.000614,42,0.000117,0,10,0.902778,0.007983
18147,Spencer County,,IN,1878,23948,25826,6,7,13,13044,15286,28330,6,0.326913,0.339855,1.40858,0.000128,0.000422,42,0.000114,0,10,0.880952,0.001195
22121,West Baton Rouge Parish,,LA,1940,23885,25825,11,11,22,27362,25420,52782,5,0.351971,0.368305,0.543651,0.001517,0.001364,12,0.000119,0,10,0.916667,0.013385
29195,Saline County,,MO,1789,24034,25823,11,19,30,8080,10628,18708,5,0.366718,0.385259,506.762455,0.00137,0.002326,14,0.000154,0,10,0.508772,0.013078
48331,Milam County,,TX,1612,24196,25808,15,16,31,16322,16040,32362,5,0.358753,0.376893,24.898326,0.002863,0.003589,62,0.000173,0,10,0.768382,0.031056
46081,Lawrence County,,SD,2600,23194,25794,20,16,36,16930,17333,34263,5,0.37555,0.394721,2128.437839,0.002504,0.001921,50,0.000338,0,10,0.426667,0.025221
12049,Hardee County,,FL,2021,23734,25755,11,13,24,13041,16331,29372,5,0.353795,0.369933,0.306728,0.003295,0.004045,5,0.000116,0,10,0.967033,0.032781
13227,Pickens County,,GA,1682,24054,25736,14,13,27,28862,20224,49086,6,0.336953,0.351107,4.457098,0.002026,0.002227,6,0.000172,0,10,0.813187,0.021332
37039,Cherokee County,,NC,1367,24369,25736,25,9,34,8268,6323,14591,6,0.307169,0.3183,3451.89512,0.006146,0.00036,6,0.000347,0,10,0.578333,0.060977
55137,Waushara County,,WI,1620,24046,25666,18,15,33,18025,16502,34527,5,0.328521,0.341146,3.731858,0.001616,0.000926,8,0.000171,0,10,0.839869,0.014716
21027,Breckinridge County,,KY,1381,24272,25653,8,8,16,13270,12022,25292,6,0.325011,0.33724,507.938304,0.000462,0.000514,42,0.000136,0,10,0.5,0.004731
13119,Franklin County,,GA,1533,24097,25630,17,13,30,19626,18301,37927,6,0.333732,0.348101,23.21578,0.001996,0.001191,6,0.000208,0,10,0.705882,0.02083
45061,Lee County,,SC,1673,23933,25606,6,9,15,12938,14895,27833,6,0.329543,0.343788,0.257576,0.000486,0.001296,37,0.000093,0,10,0.930556,0.004837
48219,Hockley County,,TX,2096,23504,25600,10,12,22,14193,17488,31681,5,0.355885,0.373069,529.053831,0.001157,0.001808,62,0.000173,0,10,0.634615,0.012205
48149,Fayette County,,TX,1363,24229,25592,18,16,34,13657,12525,26182,5,0.35498,0.372374,16.104344,0.002868,0.002572,62,0.0002,0,10,0.751462,0.032067
21183,Ohio County,,KY,1189,24386,25575,10,8,18,12005,12209,24214,6,0.324016,0.33597,1028.083309,0.000682,0.000382,42,0.00017,0,10,0.388889,0.006515
13279,Toombs County,,GA,1764,23796,25560,15,17,32,12128,12789,24917,6,0.340576,0.356803,8444.55903,0.001305,0.002062,5,0.000244,0,10,0.412281,0.01329
27055,Houston County,,MN,1256,24298,25554,7,9,16,9306,10107,19413,5,0.335042,0.348524,41.284455,0.000494,0.001109,39,0.000109,0,10,0.677778,0.004787
48365,Panola County,,TX,1688,23866,25554,11,12,23,13404,15038,28442,5,0.353876,0.370654,2.649518,0.001749,0.001833,62,0.000134,0,10,0.840909,0.018112
27105,Nobles County,,MN,1607,23934,25541,14,16,30,6273,9095,15368,5,0.340917,0.355838,3978.613117,0.001517,0.001078,39,0.000182,0,10,0.368421,0.014981
48473,Waller County,,TX,2274,23198,25472,14,15,29,46339,40697,87036,5,0.359298,0.377273,8.283469,0.003295,0.00387,62,0.000153,0,10,0.8875,0.035058
55067,Langlade County,,WI,1172,24291,25463,14,11,25,8137,8537,16674,5,0.32824,0.340305,26.803721,0.001492,0.000747,8,0.000154,0,10,0.846154,0.013622
19065,Fayette County,,IA,1481,23952,25433,9,12,21,9271,11051,20322,6,0.318937,0.330333,68.727344,0.000368,0.000471,8,0.000136,0,10,0.659091,0.00375
13199,Meriwether County,,GA,1892,23527,25419,16,17,33,20805,22148,42953,5,0.349687,0.366509,192.114001,0.002393,0.002677,6,0.000181,0,10,0.683007,0.024414
55047,Green Lake County,,WI,1489,23930,25419,12,12,24,14021,15157,29178,5,0.328416,0.340658,1.311474,0.001471,0.000888,8,0.00013,0,10,0.897436,0.013306
29131,Miller County,,MO,1605,23791,25396,12,13,25,17898,17148,35046,6,0.333008,0.346859,21.275863,0.00121,0.001149,14,0.000153,0,10,0.730769,0.0114
13123,Gilmer County,,GA,1669,23724,25393,19,16,35,16456,13199,29655,6,0.338214,0.353196,32.800514,0.003753,0.002384,6,0.000205,0,10,0.695238,0.037624
48419,Shelby County,,TX,1375,23990,25365,14,12,26,10915,11333,22248,5,0.353795,0.370546,28.129123,0.001883,0.001746,62,0.000168,0,10,0.714286,0.020151
26143,Roscommon County,,MI,1704,23614,25318,24,21,45,17577,12959,30536,6,0.337249,0.354389,23.537614,0.002592,0.002324,43,0.000174,0,10,0.68661,0.019606
27095,Mille Lacs County,,MN,1567,23740,25307,16,17,33,25775,22387,48162,5,0.333659,0.347439,3.255758,0.001066,0.000996,39,0.000182,0,10,0.871324,0.010148
51670,Hopewell city,,VA,2706,22568,25274,14,11,25,29838,30555,60393,6,0.336879,0.352686,74.254489,0.001638,0.001789,13,0.000157,0,10,0.616667,0.016105
8019,Clear Creek County,,CO,2904,22369,25273,11,12,23,10704,10437,21141,5,0.362307,0.379552,19.265829,0.002289,0.002711,35,0.000132,0,10,0.897436,0.024023
21081,Grant County,,KY,2019,23239,25258,13,13,26,28982,28287,57269,6,0.329968,0.343566,124.675657,0.001315,0.001036,42,0.000188,0,10,0.593407,0.011563
47133,Overton County,,TN,1289,23898,25187,8,8,16,11641,12008,23649,6,0.328662,0.340831,652.169793,0.000376,0.00049,51,0.000207,0,10,0.553571,0.005043
17051,Fayette County,,IL,1337,23794,25131,9,14,23,8795,9554,18349,5,0.358,0.37494,339.318117,0.000194,0.001182,8,0.000129,0,10,0.615385,0.001762
5019,Clark County,,AR,1823,23209,25032,14,16,30,10274,13753,24027,5,0.348813,0.365929,852.459403,0.000826,0.001562,52,0.000196,0,10,0.552288,0.008809
40087,McClain County,,OK,2544,22485,25029,15,9,24,41515,35811,77326,5,0.343624,0.359006,16.95683,0.001897,0.001239,52,0.000182,0,10,0.780952,0.019076
13189,McDuffie County,,GA,1412,23599,25011,8,11,19,12661,12835,25496,6,0.337212,0.351541,2214.155035,0.000379,0.001591,37,0.000167,0,10,0.5,0.004244
28025,Clay County,,MS,1282,23726,25008,8,9,17,9288,10702,19990,6,0.33236,0.345855,123.233088,0.000235,0.000551,52,0.000117,0,10,0.655556,0.001937
1091,Marengo County,,AL,1447,23556,25003,12,14,26,8529,10541,19070,6,0.321945,0.335324,38.945667,0.000751,0.001053,6,0.000171,0,10,0.554945,0.007034
40133,Seminole County,,OK,2009,22957,24966,10,10,20,17115,18458,35573,6,0.327157,0.339513,3.059964,0.000776,0.000789,52,0.000151,0,10,0.790909,0.008041
22077,Pointe Coupee Parish,,LA,1411,23544,24955,12,12,24,12869,14173,27042,5,0.352011,0.368468,18.064836,0.001525,0.00135,12,0.000126,0,10,0.814103,0.01351
17145,Perry County,,IL,1359,23574,24933,8,9,17,10331,10944,21275,6,0.331463,0.343837,3.355507,0.000363,0.000641,14,0.00012,0,10,0.847222,0.003284
13205,Mitchell County,,GA,1610,23288,24898,8,10,18,12031,14146,26177,6,0.316636,0.328613,57.268269,0.000146,0.000464,5,0.000172,0,10,0.622222,0.001779
36123,Yates County,,NY,1399,23488,24887,8,9,17,12473,13453,25926,6,0.316538,0.329291,1.260947,0.000775,0.000741,36,0.00009,0,10,0.888889,0.005863
21017,Bourbon County,,KY,1748,23129,24877,10,10,20,15644,16784,32428,6,0.316277,0.327214,11.607456,0.000257,0.000232,42,0.000219,0,10,0.655556,0.002804
17033,Crawford County,,IL,1114,23742,24856,8,9,17,3766,4463,8229,6,0.313373,0.324566,2162.655322,0.000392,0.000251,8,0.000147,0,10,0.427273,0.003777
18045,Fountain County,,IN,1658,23182,24840,9,8,17,13453,14939,28392,6,0.325976,0.338932,28.872906,0.000576,0.000493,42,0.000133,0,10,0.638889,0.005019
19087,Henry County,,IA,1461,23364,24825,12,10,22,10324,10484,20808,6,0.319069,0.33017,765.758468,0.00108,0.000426,8,0.00018,0,10,0.643939,0.010621
48171,Gillespie County,,TX,1496,23283,24779,13,13,26,13074,10268,23342,5,0.358042,0.375646,14.469072,0.002726,0.002919,62,0.000167,0,10,0.895604,0.029555
37091,Hertford County,,NC,1915,22857,24772,11,14,25,9387,10910,20297,6,0.331785,0.34687,45.978704,0.001454,0.001792,37,0.000137,0,10,0.557143,0.014326
19183,Washington County,,IA,1364,23375,24739,11,10,21,12722,12137,24859,6,0.320167,0.331255,19.859042,0.00048,0.00058,8,0.000175,0,10,0.674242,0.004819
21133,Letcher County,,KY,1037,23701,24738,7,8,15,4626,5743,10369,6,0.317028,0.328054,228.059092,0.000245,0.00022,42,0.000135,0,10,0.535714,0.00248
28039,George County,,MS,1312,23368,24680,8,6,14,13500,10736,24236,5,0.317947,0.329698,9.826885,0.000644,0.000499,12,0.00012,0,10,0.732143,0.006418
20175,Seward County,,KS,2841,21822,24663,18,21,39,11937,13958,25895,5,0.378465,0.399045,13373.634741,0.002076,0.003173,14,0.00036,0,10,0.41453,0.02025
22003,Allen Parish,,LA,1546,23106,24652,13,11,24,14102,15171,29273,5,0.350725,0.366895,47.343191,0.001367,0.001007,12,0.000147,0,10,0.769231,0.012804
29001,Adair County,,MO,1979,22672,24651,16,19,35,8788,10987,19775,5,0.375504,0.395014,23621.606482,0.001753,0.002637,14,0.000308,0,10,0.391775,0.016311
28017,Chickasaw County,,MS,1293,23289,24582,8,10,18,11078,13523,24601,6,0.331785,0.345367,95.503186,0.000054,0.00056,52,0.000139,0,10,0.609091,0.000865
39125,Paulding County,,OH,1279,23295,24574,8,9,17,10881,13367,24248,6,0.333189,0.34777,6.627495,0.000473,0.000759,43,0.000101,0,10,0.791667,0.00366
19021,Buena Vista County,,IA,2053,22502,24555,17,23,40,7503,9711,17214,5,0.380905,0.401432,4610.195191,0.002846,0.002515,8,0.000187,0,10,0.388889,0.026463
28115,Pontotoc County,,MS,1662,22884,24546,12,14,26,22992,21272,44264,6,0.331142,0.344851,308.776334,0.000593,0.000545,52,0.000177,0,10,0.57619,0.006094
55125,Vilas County,,WI,1397,23115,24512,18,15,33,12815,9695,22510,5,0.370076,0.38871,2913.913206,0.002459,0.001916,8,0.000175,0,10,0.666667,0.020856
38105,Williams County,,ND,1336,23164,24500,49,25,74,15533,13896,29429,5,0.384,0.405599,12488.009777,0.0069,0.004013,39,0.000637,0,10,0.425714,0.070128
37149,Polk County,,NC,1525,22964,24489,6,7,13,11854,12251,24105,6,0.32817,0.341949,0,0.001024,0.001274,37,0.000097,0,10,1,0.011855
13177,Lee County,,GA,2632,21819,24451,14,17,31,33226,25195,58421,6,0.342742,0.359115,818.418629,0.002036,0.002991,5,0.000173,0,10,0.636842,0.019417
22085,Sabine Parish,,LA,1285,23166,24451,10,8,18,8022,8647,16669,5,0.350605,0.366314,2.354379,0.001249,0.000908,12,0.000119,0,10,0.888889,0.011664
21137,Lincoln County,,KY,1449,22999,24448,9,10,19,17954,17865,35819,6,0.325045,0.337571,18.109768,0.000254,0.000551,42,0.000183,0,10,0.777778,0.002792
48179,Gray County,,TX,1862,22586,24448,16,15,31,8685,10513,19198,5,0.356753,0.374615,8345.014321,0.002115,0.002409,62,0.000313,0,10,0.423684,0.022021
20041,Dickinson County,,KS,1878,22520,24398,14,14,28,12005,12939,24944,6,0.330039,0.34248,868.194762,0.00126,0.000809,14,0.000181,0,10,0.579167,0.011869
5083,Logan County,,AR,1592,22802,24394,10,11,21,11767,14171,25938,6,0.321104,0.332536,50.565371,0.000447,0.000607,52,0.000157,0,10,0.809091,0.004881
41027,Hood River County,,OR,1846,22544,24390,12,11,23,12340,14841,27181,5,0.337582,0.351383,13.712599,0.002099,0.001729,45,0.000136,0,10,0.840909,0.021631
12129,Wakulla County,,FL,1702,22656,24358,14,10,24,24679,17517,42196,5,0.353632,0.369309,145.243353,0.00358,0.002267,5,0.000157,0,10,0.725275,0.033842
5029,Conway County,,AR,1509,22821,24330,7,7,14,13175,13778,26953,6,0.319003,0.329807,2.981842,0.000314,0.000384,52,0.00013,0,10,0.821429,0.003376
19043,Clayton County,,IA,1168,23158,24326,10,12,22,8298,9696,17994,6,0.319368,0.331038,58.958748,0.000206,0.000483,8,0.000146,0,10,0.568182,0.002342
56041,Uinta County,,WY,2093,22222,24315,15,19,34,9925,11893,21818,5,0.364326,0.382753,52.782432,0.00303,0.002269,45,0.00015,0,10,0.627706,0.02954
17173,Shelby County,,IL,1404,22909,24313,9,9,18,13943,14187,28130,6,0.314175,0.324571,745.719224,0.000678,0.000268,8,0.000127,0,10,0.688889,0.00612
37015,Bertie County,,NC,1202,23072,24274,9,8,17,8539,10239,18778,6,0.32831,0.341764,14.561731,0.00053,0.000888,37,0.000143,0,10,0.527273,0.005806
13147,Hart County,,GA,1320,22908,24228,12,13,25,14083,12986,27069,6,0.336289,0.350722,13.168506,0.001829,0.001882,6,0.00016,0,10,0.774725,0.018358
18153,Sullivan County,,IN,1343,22842,24185,6,8,14,10846,11307,22153,6,0.32667,0.339692,8.878132,0.000395,0.000544,42,0.000103,0,10,0.680556,0.003719
12003,Baker County,,FL,1511,22658,24169,10,12,22,17884,15654,33538,5,0.353103,0.368902,62.338183,0.001568,0.002634,5,0.000127,0,10,0.765152,0.015921
26127,Oceana County,,MI,1599,22540,24139,8,8,16,16947,17738,34685,6,0.324907,0.337397,9.241844,0.00138,0.000713,43,0.000092,0,10,0.911111,0.011645
1013,Butler County,,AL,1199,22939,24138,10,13,23,6552,8388,14940,6,0.324222,0.337918,42.304781,0.001044,0.001195,6,0.000133,0,10,0.705128,0.010475
54109,Wyoming County,,WV,1143,22975,24118,6,7,13,4379,6839,11218,6,0.29805,0.308279,21.921705,0.000144,0.000115,41,0.000111,0,10,0.547619,0.00143
53003,Asotin County,,WA,2279,21834,24113,15,16,31,21197,19124,40321,5,0.363809,0.381912,6279.205538,0.001819,0.002421,45,0.000216,0,10,0.7125,0.01868
51169,Scott County,,VA,1119,22988,24107,7,8,15,9636,11223,20859,6,0.290826,0.300662,17.029955,0.000122,0.000137,51,0.000156,0,10,0.678571,0.001762
45011,Barnwell County,,SC,1221,22810,24031,9,9,18,9324,11285,20609,6,0.322927,0.335574,16.844281,0.001258,0.001383,37,0.000123,0,10,0.754545,0.012934
5071,Johnson County,,AR,1541,22481,24022,11,10,21,10391,11086,21477,6,0.32107,0.332373,9.00309,0.000597,0.000606,52,0.000164,0,10,0.845455,0.006698
8119,Teller County,,CO,2929,21088,24017,16,13,29,21697,21886,43583,5,0.364413,0.382129,6.456948,0.004534,0.003566,35,0.000163,0,10,0.948529,0.046199
19097,Jackson County,,IA,1188,22823,24011,6,7,13,9709,10865,20574,6,0.320033,0.330794,10.716368,0.000267,0.000583,8,0.000099,0,10,0.732143,0.00299
5001,Arkansas County,,AR,1230,22778,24008,7,11,18,6746,8816,15562,6,0.319833,0.33138,7.955533,0.00032,0.000546,52,0.000115,0,10,0.75,0.003435
1107,Pickens County,,AL,1138,22828,23966,5,5,10,8100,9891,17991,6,0.319667,0.330539,13.350414,0.0004,0.000339,6,0.000096,0,10,0.85,0.003489
35006,Cibola County,,NM,2040,21868,23908,9,8,17,15429,16651,32080,5,0.362392,0.379281,0,0.001692,0.001634,35,0.000111,0,10,1,0.017236
21167,Mercer County,,KY,1393,22514,23907,13,13,26,13654,13718,27372,6,0.333514,0.34936,134.738388,0.000584,0.000898,42,0.000231,0,10,0.576923,0.005955
47075,Haywood County,,TN,1224,22672,23896,9,10,19,11854,14031,25885,6,0.333732,0.347586,11.375128,0.000781,0.000831,52,0.000146,0,10,0.766667,0.008156
26011,Arenac County,,MI,1367,22527,23894,10,10,20,11184,10165,21349,6,0.33236,0.346908,0.493106,0.001417,0.001142,43,0.000097,0,10,0.955556,0.010828
17045,Edgar County,,IL,1160,22733,23893,8,7,15,7619,8362,15981,6,0.312005,0.322434,65.964549,0.000267,0.000205,8,0.000125,0,10,0.482143,0.002314
48057,Calhoun County,,TX,1808,22074,23882,12,13,25,11006,13133,24139,5,0.356257,0.373432,16.567848,0.002587,0.002425,62,0.000138,0,10,0.796703,0.027679
1111,Randolph County,,AL,1135,22744,23879,13,13,26,11258,10721,21979,6,0.335152,0.350054,154.035039,0.001239,0.001024,6,0.000167,0,10,0.614286,0.012795
37131,Northampton County,,NC,1451,22423,23874,8,12,20,10420,13009,23429,6,0.328662,0.342741,49.544054,0.000926,0.001206,37,0.000116,0,10,0.525641,0.00918
29175,Randolph County,,MO,1545,22304,23849,13,13,26,11931,12316,24247,6,0.33254,0.346316,229.021897,0.000805,0.001004,14,0.00022,0,10,0.471429,0.007636
49007,Carbon County,,UT,2050,21799,23849,13,15,28,10564,13609,24173,5,0.350445,0.367247,31.897249,0.001543,0.001606,45,0.000144,0,10,0.6875,0.015046
21173,Montgomery County,,KY,1516,22302,23818,16,12,28,17992,16644,34636,6,0.325114,0.33795,801.107053,0.000572,0.00054,42,0.000314,0,10,0.433333,0.006051
6015,Del Norte County,,CA,1828,21977,23805,21,18,39,9998,10004,20002,5,0.361582,0.379688,1.631602,0.004244,0.002975,45,0.000156,0,10,0.905138,0.038973
40001,Adair County,,OK,1580,22116,23696,8,8,16,12440,13782,26222,6,0.328521,0.341005,0.897194,0.000546,0.00089,52,0.00013,0,10,0.916667,0.006179
54027,Hampshire County,,WV,1111,22554,23665,18,11,29,12057,10546,22603,6,0.292795,0.30376,1204.178712,0.00197,0.000175,13,0.000225,0,10,0.493464,0.018583
28139,Tippah County,,MS,1225,22436,23661,10,13,23,11104,11975,23079,6,0.336805,0.352127,48.642972,0.000463,0.000945,52,0.00016,0,10,0.538462,0.005032
41015,Curry County,,OR,1911,21749,23660,32,21,53,14466,12969,27435,5,0.369364,0.388829,10.710505,0.007012,0.004147,45,0.000234,0,10,0.901515,0.067612
8075,Logan County,,CO,1661,21989,23650,16,17,33,9680,10437,20117,5,0.36355,0.381532,3606.5934,0.002166,0.003042,35,0.00025,0,10,0.568627,0.023121
27161,Waseca County,,MN,1552,22090,23642,11,13,24,11565,13053,24618,5,0.338624,0.352664,30.131989,0.000866,0.001071,39,0.000137,0,10,0.775641,0.008521
17125,Mason County,,IL,1530,22099,23629,7,8,15,9751,11077,20828,6,0.310115,0.319976,15.01062,0.000282,0.000302,8,0.000118,0,10,0.642857,0.00226
48341,Moore County,,TX,1977,21602,23579,21,18,39,10718,15063,25781,5,0.374908,0.394705,5881.248855,0.00337,0.002706,62,0.000264,0,10,0.421667,0.033857
13081,Crisp County,,GA,1325,22250,23575,16,17,33,10300,10948,21248,5,0.349647,0.366791,2323.604523,0.002618,0.002176,6,0.00019,0,10,0.578947,0.02563
16051,Jefferson County,,ID,2069,21506,23575,11,13,24,25166,24585,49751,5,0.363163,0.380664,55.352632,0.001479,0.001522,45,0.000129,0,10,0.846154,0.014535
13027,Brooks County,,GA,2248,21267,23515,8,7,15,14830,15008,29838,6,0.33236,0.34592,179.757407,0.001018,0.00059,5,0.000155,0,10,0.652778,0.010434
26019,Benzie County,,MI,1485,21979,23464,10,7,17,14195,11876,26071,6,0.331785,0.345958,0.347222,0.001779,0.000975,43,0.000105,0,10,0.922222,0.013735
13219,Oconee County,,GA,2266,21181,23447,15,12,27,31042,24787,55829,6,0.336916,0.350944,73.206261,0.001926,0.001887,6,0.000179,0,10,0.795238,0.019504
47111,Macon County,,TN,1103,22274,23377,12,11,23,13122,11572,24694,6,0.328767,0.341319,498.61236,0.000644,0.000778,51,0.000229,0,10,0.537879,0.008114
22041,Franklin Parish,,LA,1267,22082,23349,11,7,18,7137,8552,15689,5,0.344665,0.359928,378.24754,0.001329,0.00071,12,0.000171,0,10,0.518182,0.011746
13105,Elbert County,,GA,973,22349,23322,10,8,18,7293,8475,15768,6,0.33236,0.345313,44.026021,0.000609,0.000982,6,0.000155,0,10,0.6,0.006502
55061,Kewaunee County,,WI,1035,22285,23320,6,7,13,10947,11821,22768,5,0.3281,0.339654,0.125,0.000462,0.000702,8,0.000093,0,10,0.964286,0.004103
22111,Union Parish,,LA,1376,21924,23300,8,9,17,13878,14463,28341,5,0.344317,0.359456,12.25075,0.000395,0.000667,12,0.000122,0,10,0.622222,0.003297
51145,Powhatan County,,VA,1402,21890,23292,7,7,14,23661,15890,39551,6,0.312195,0.32391,2,0.000626,0.00068,13,0.00012,0,10,0.809524,0.006511
19105,Jones County,,IA,1285,21995,23280,7,10,17,11235,11035,22270,6,0.318804,0.329926,8.970265,0.000285,0.000478,8,0.000118,0,10,0.677778,0.00267
51105,Lee County,,VA,980,22271,23251,6,6,12,4931,5096,10027,6,0.285741,0.29547,31.236076,0.00006,0.000062,51,0.000139,0,10,0.47619,0.00096
29186,Ste. Genevieve County,,MO,1362,21884,23246,11,10,21,13394,13996,27390,6,0.32926,0.341634,6.10417,0.000809,0.000784,14,0.000155,0,10,0.704545,0.007714
28079,Leake County,,MS,1309,21930,23239,9,8,17,12572,13192,25764,6,0.300205,0.311133,3.323562,0.000289,0.0002,12,0.000134,0,10,0.805556,0.002799
45049,Hampton County,,SC,1100,22124,23224,10,12,22,7341,9541,16882,6,0.332432,0.347559,49.023613,0.001701,0.001945,5,0.000129,0,10,0.74359,0.017779
21085,Grayson County,,KY,1189,22001,23190,10,10,20,10604,10003,20607,6,0.325079,0.337565,17.668213,0.000505,0.000499,42,0.000173,0,10,0.611111,0.005194
13035,Butts County,,GA,1627,21543,23170,16,14,30,26158,21362,47520,6,0.337323,0.351731,9.645264,0.002344,0.002297,6,0.000168,0,10,0.795833,0.023874
39105,Meigs County,,OH,1098,22046,23144,9,9,18,9761,10279,20040,6,0.332432,0.346604,72.762572,0.000465,0.000445,41,0.000153,0,10,0.569444,0.00452
1057,Fayette County,,AL,1202,21931,23133,6,6,12,8932,9574,18506,6,0.318375,0.329384,13.682805,0.000357,0.000328,6,0.000115,0,10,0.766667,0.003453
17131,Mercer County,,IL,1273,21812,23085,7,8,15,11150,11497,22647,5,0.355062,0.370736,83.19353,0.00025,0.000753,8,0.000108,0,10,0.638889,0.002875
48007,Aransas County,,TX,2417,20667,23084,20,15,35,20990,17884,38874,5,0.358543,0.376432,23.191442,0.003436,0.003566,62,0.000207,0,10,0.82381,0.037796
1087,Macon County,,AL,1510,21534,23044,11,11,22,11956,15612,27568,6,0.338289,0.35306,76.307902,0.001245,0.00159,6,0.000141,0,10,0.705128,0.012073
21217,Taylor County,,KY,1337,21692,23029,10,11,21,10138,10620,20758,6,0.326045,0.338976,56.922946,0.000651,0.000683,42,0.000187,0,10,0.55303,0.00647
55053,Jackson County,,WI,1198,21829,23027,11,10,21,10755,10816,21571,5,0.33651,0.350401,4.821023,0.000739,0.001007,39,0.000128,0,10,0.825758,0.00702
29003,Andrew County,,MO,1811,21210,23021,10,11,21,20566,19579,40145,6,0.32796,0.340088,465.365599,0.00049,0.000767,14,0.000176,0,10,0.590909,0.005102
6063,Plumas County,,CA,1735,21230,22965,22,19,41,11697,11110,22807,5,0.368257,0.38731,280.645436,0.004975,0.004514,45,0.000172,0,10,0.899209,0.046034
28007,Attala County,,MS,1232,21731,22963,9,11,20,6974,7327,14301,6,0.331749,0.345421,401.988406,0.000573,0.000579,12,0.000145,0,10,0.530303,0.005131
54097,Upshur County,,WV,1059,21900,22959,9,7,16,7315,7693,15008,6,0.299153,0.309652,1535.162102,0.000185,0.000125,41,0.000192,0,10,0.541667,0.001711
49039,Sanpete County,,UT,1645,21311,22956,11,13,24,17314,18261,35575,5,0.363206,0.380773,61.623868,0.001423,0.001947,45,0.00014,0,10,0.813187,0.013749
29177,Ray County,,MO,1631,21304,22935,9,10,19,18562,18962,37524,6,0.328205,0.340224,17.769961,0.000807,0.000803,14,0.00014,0,10,0.7,0.007878
22043,Grant Parish,,LA,1756,21138,22894,9,9,18,17575,17069,34644,5,0.350685,0.366623,228.770357,0.000899,0.000899,12,0.00012,0,10,0.677778,0.008413
13169,Jones County,,GA,1645,21245,22890,10,12,22,24947,21126,46073,6,0.335115,0.349957,149.430296,0.000684,0.000963,6,0.000154,0,10,0.537879,0.007079
48185,Grimes County,,TX,1810,21068,22878,11,12,23,24666,21331,45997,5,0.355844,0.372917,9.876148,0.002012,0.002423,62,0.000137,0,10,0.886364,0.021983
55119,Taylor County,,WI,1161,21715,22876,9,11,20,7722,8926,16648,5,0.336473,0.350456,61.102585,0.000401,0.000996,8,0.000119,0,10,0.754545,0.004017
36097,Schuyler County,,NY,1394,21478,22872,7,8,15,12432,12584,25016,6,0.316179,0.328586,0.84368,0.000551,0.000501,36,0.000088,0,10,0.892857,0.004392
8089,Otero County,,CO,1712,21079,22791,12,11,23,7482,9779,17261,5,0.341106,0.354617,304.913959,0.001888,0.00208,35,0.000186,0,10,0.666667,0.01991
47081,Hickman County,,TN,1559,21196,22755,10,11,21,17802,16700,34502,6,0.340992,0.356548,37.316726,0.000752,0.001473,51,0.000167,0,10,0.659091,0.009197
55023,Crawford County,,WI,1585,21154,22739,9,8,17,8926,10103,19029,6,0.322181,0.333529,118.995972,0.001113,0.000325,8,0.000123,0,10,0.6,0.010462
24039,Somerset County,,MD,1388,21339,22727,9,9,18,13972,14532,28504,6,0.330003,0.343462,0.463636,0.001878,0.001901,47,0.000097,0,10,0.916667,0.017038
16075,Payette County,,ID,1922,20770,22692,7,5,12,19240,18443,37683,6,0.313565,0.324143,2.361111,0.00027,0.000283,45,0.000144,0,10,0.714286,0.003225
1007,Bibb County,,AL,1329,21358,22687,5,6,11,15816,15190,31006,6,0.318342,0.329329,1.057299,0.000463,0.000446,6,0.000091,0,10,0.8,0.004381
26129,Ogemaw County,,MI,1436,21201,22637,12,14,26,13422,10904,24326,6,0.332504,0.347559,4.468229,0.001403,0.001394,43,0.000116,0,10,0.8,0.010948
48089,Colorado County,,TX,1527,21096,22623,11,14,25,12649,12636,25285,5,0.354898,0.372049,2.016068,0.001825,0.00263,62,0.000137,0,10,0.852381,0.019693
19191,Winneshiek County,,IA,1033,21583,22616,10,13,23,5630,6868,12498,5,0.336621,0.351074,322.82545,0.000669,0.000867,8,0.000141,0,10,0.512821,0.00629
55103,Richland County,,WI,1314,21289,22603,9,9,18,10909,11574,22483,5,0.328345,0.340251,5.865316,0.000646,0.00063,8,0.000128,0,10,0.791667,0.006243
19041,Clay County,,IA,1521,21079,22600,8,13,21,7010,7547,14557,5,0.340199,0.355284,411.470138,0.00027,0.000953,8,0.000131,0,10,0.461538,0.002722
13303,Washington County,,GA,960,21619,22579,9,11,20,3780,5252,9032,6,0.337471,0.352002,1056.326889,0.001094,0.001539,6,0.000147,0,10,0.6,0.010615
13311,White County,,GA,1537,21026,22563,16,12,28,20893,16724,37617,6,0.336842,0.350836,28.809056,0.002668,0.001917,6,0.000195,0,10,0.716667,0.026898
12007,Bradford County,,FL,1519,21038,22557,12,12,24,19494,18097,37591,5,0.352415,0.36798,26.454239,0.002696,0.002896,5,0.000131,0,10,0.858974,0.02691
47041,DeKalb County,,TN,1195,21361,22556,9,10,19,14324,13323,27647,6,0.328591,0.340967,4.025954,0.000634,0.000793,51,0.000165,0,10,0.777778,0.007816
29119,McDonald County,,MO,2036,20517,22553,11,11,22,19473,20901,40374,6,0.335298,0.349599,98.322785,0.000767,0.001078,14,0.000156,0,10,0.538462,0.008478
28127,Simpson County,,MS,1683,20847,22530,14,13,27,17181,17744,34925,5,0.318804,0.3308,23.980198,0.000538,0.000463,12,0.000181,0,10,0.692308,0.005312
19055,Delaware County,,IA,1200,21308,22508,7,8,15,8539,10050,18589,6,0.318639,0.329438,2.466292,0.000192,0.000464,8,0.000114,0,10,0.819444,0.002013
19109,Kossuth County,,IA,1181,21326,22507,8,12,20,3297,4073,7370,5,0.336731,0.350998,560.08446,0.00023,0.00064,8,0.000137,0,10,0.492424,0.002452
8107,Routt County,,CO,2273,20216,22489,21,20,41,13075,13965,27040,5,0.377071,0.397092,28.978813,0.005311,0.005322,35,0.000189,0,10,0.893939,0.053625
46035,Davison County,,SD,1742,20736,22478,22,21,43,10694,11555,22249,5,0.368125,0.387283,15078.182669,0.000715,0.001113,50,0.000498,0,10,0.28,0.007595
48293,Limestone County,,TX,1633,20823,22456,12,15,27,13355,14361,27716,5,0.357584,0.375347,8.193384,0.002018,0.003118,62,0.000145,0,10,0.761905,0.021334
31177,Washington County,,NE,1525,20892,22417,7,7,14,16062,14961,31023,5,0.326913,0.337419,8.44339,0.000558,0.000491,50,0.00013,0,10,0.785714,0.00506
18123,Perry County,,IN,1171,21155,22326,7,9,16,7855,8189,16044,6,0.327052,0.340289,264.240611,0.000128,0.000426,42,0.000136,0,10,0.5,0.001242
48123,DeWitt County,,TX,1241,21040,22281,9,10,19,10998,11129,22127,5,0.354775,0.371452,13.552533,0.001543,0.002021,62,0.000134,0,10,0.736364,0.016167
5037,Cross County,,AR,1404,20840,22244,9,12,21,10366,11651,22017,6,0.33424,0.348676,53.550593,0.000699,0.000842,52,0.000135,0,10,0.674242,0.006955
56039,Teton County,,WY,2784,19328,22112,31,26,57,9826,13772,23598,5,0.381805,0.402913,598.878774,0.008064,0.006431,45,0.000265,0,10,0.659524,0.078871
55003,Ashland County,,WI,1304,20798,22102,9,13,22,5306,6808,12114,5,0.336731,0.351025,841.867194,0.001055,0.001086,39,0.000119,0,10,0.570513,0.009723
48225,Houston County,,TX,1496,20596,22092,13,13,26,10491,11004,21495,5,0.357043,0.374425,6.655897,0.001652,0.002445,62,0.00015,0,10,0.890476,0.018055
26133,Osceola County,,MI,1710,20367,22077,16,14,30,16314,16206,32520,6,0.332144,0.347233,8.045601,0.001936,0.001274,43,0.00015,0,10,0.7875,0.015373
27127,Redwood County,,MN,1153,20923,22076,8,13,21,5759,7738,13497,5,0.335664,0.349528,12.50911,0.000601,0.000887,39,0.000113,0,10,0.692308,0.005903
5149,Yell County,,AR,1734,20335,22069,12,13,25,12819,16337,29156,6,0.328626,0.341515,324.574792,0.001216,0.000915,52,0.000176,0,10,0.642857,0.012166
28117,Prentiss County,,MS,1220,20816,22036,10,9,19,13557,13942,27499,6,0.330714,0.343658,3.855132,0.000464,0.000394,52,0.000158,0,10,0.788889,0.005001
16053,Jerome County,,ID,2164,19853,22017,13,11,24,21058,22827,43885,5,0.350605,0.366895,347.959026,0.001734,0.001215,45,0.000162,0,10,0.717949,0.017284
19157,Poweshiek County,,IA,1388,20605,21993,13,13,26,8552,9993,18545,5,0.357959,0.374778,251.049359,0.001071,0.000974,8,0.000185,0,10,0.60989,0.009943
6011,Colusa County,,CA,1110,20871,21981,11,9,20,10808,11689,22497,5,0.329014,0.340875,0.51404,0.002148,0.001046,45,0.000105,0,10,0.939394,0.019302
29221,Washington County,,MO,1283,20690,21973,10,8,18,15579,14691,30270,6,0.328943,0.340929,2.191491,0.000915,0.000596,14,0.000134,0,10,0.844444,0.008384
17015,Carroll County,,IL,1236,20703,21939,10,11,21,7826,8650,16476,5,0.355062,0.371088,39.740526,0.001266,0.001045,8,0.00011,0,10,0.643939,0.010968
47057,Grainger County,,TN,1341,20596,21937,9,10,19,16819,15895,32714,6,0.31631,0.328022,430.733297,0.000347,0.000482,51,0.000191,0,10,0.572727,0.004253
29049,Clinton County,,MO,1899,20031,21930,14,12,26,22881,21320,44201,6,0.328521,0.340956,50.683627,0.000842,0.000878,14,0.000209,0,10,0.585714,0.008484
53039,Klickitat County,,WA,1686,20206,21892,15,14,29,14842,12764,27606,5,0.340124,0.354937,11.172614,0.002261,0.002448,45,0.000155,0,10,0.804167,0.023393
55013,Burnett County,,WI,1162,20697,21859,14,13,27,10287,7725,18012,5,0.333877,0.347331,4.693933,0.001055,0.000958,39,0.000163,0,10,0.813187,0.009949
21115,Johnson County,,KY,1119,20732,21851,6,9,15,9379,8169,17548,6,0.316864,0.327946,1515.336239,0.000232,0.000229,42,0.000125,0,10,0.541667,0.002262
22029,Concordia Parish,,LA,1286,20557,21843,8,9,17,8797,9554,18351,5,0.352172,0.368359,67.41676,0.000936,0.001074,12,0.000122,0,10,0.677778,0.007614
38077,Richland County,,ND,1671,20157,21828,11,11,22,8406,11028,19434,5,0.336215,0.349854,486.26926,0.000593,0.000559,39,0.000251,0,10,0.463636,0.006028
17039,De Witt County,,IL,1402,20425,21827,8,8,16,10675,10429,21104,5,0.355103,0.370817,2.048228,0.001004,0.000867,8,0.000101,0,10,0.892857,0.008469
53049,Pacific County,,WA,1654,20135,21789,17,15,32,14339,12173,26512,5,0.339898,0.354774,150.275915,0.002994,0.002583,45,0.000168,0,10,0.830065,0.030588
18117,Orange County,,IN,1216,20541,21757,11,12,23,9489,9713,19202,6,0.330465,0.344803,48.646372,0.000853,0.000883,42,0.00016,0,10,0.643939,0.008141
29155,Pemiscot County,,MO,1475,20253,21728,7,11,18,7694,9965,17659,6,0.33736,0.352083,90.408233,0.000446,0.000884,14,0.00012,0,10,0.590909,0.004469
20087,Jefferson County,,KS,1529,20185,21714,8,9,17,15924,15721,31645,6,0.329472,0.341515,15.74992,0.0006,0.000868,14,0.000117,0,10,0.777778,0.005472
29147,Nodaway County,,MO,1462,20240,21702,13,16,29,6735,9900,16635,6,0.335481,0.349902,9481.390595,0.001024,0.00129,14,0.000254,0,10,0.391667,0.009953
42105,Potter County,,PA,1367,20324,21691,8,9,17,5977,6573,12550,6,0.327401,0.341678,1868.591654,0.000732,0.000894,36,0.00011,0,10,0.5,0.006189
16013,Blaine County,,ID,1725,19941,21666,19,17,36,9266,10003,19269,5,0.370612,0.389752,7260.312345,0.004137,0.003859,45,0.00024,0,10,0.623684,0.041128
40139,Texas County,,OK,2508,19092,21600,16,22,38,8212,9629,17841,6,0.356133,0.373774,16276.542355,0.002745,0.001765,14,0.000257,0,10,0.332308,0.027209
13111,Fannin County,,GA,1171,20425,21596,16,10,26,11058,8303,19361,6,0.334896,0.348893,157.691245,0.003707,0.001566,6,0.000213,0,10,0.625,0.036875
22083,Richland Parish,,LA,1327,20241,21568,9,9,18,12282,13030,25312,5,0.350925,0.366857,448.447191,0.000776,0.000884,12,0.000162,0,10,0.477778,0.007854
29217,Vernon County,,MO,1425,20141,21566,9,11,20,9011,9446,18457,6,0.32831,0.340549,18.402564,0.000494,0.000788,14,0.000142,0,10,0.628788,0.00512
29143,New Madrid County,,MO,1480,20078,21558,9,8,17,11505,13730,25235,6,0.329331,0.341498,212.802108,0.000403,0.00037,14,0.000153,0,10,0.694444,0.003907
48117,Deaf Smith County,,TX,1760,19780,21540,9,11,20,8515,11848,20363,5,0.356463,0.373611,164.924287,0.00123,0.002144,62,0.000134,0,10,0.686813,0.011598
6027,Inyo County,,CA,1513,20019,21532,13,14,27,10837,9397,20234,5,0.369009,0.387663,8.459559,0.004317,0.00428,45,0.000115,0,10,0.8625,0.040293
27043,Faribault County,,MN,1133,20372,21505,8,10,18,5234,7074,12308,5,0.333732,0.346761,32.026916,0.000484,0.000834,39,0.000118,0,10,0.755556,0.004725
13207,Monroe County,,GA,1461,20034,21495,14,15,29,20897,16555,37452,6,0.337879,0.353,104.87964,0.001796,0.002161,6,0.000168,0,10,0.657143,0.018313
19059,Dickinson County,,IA,1301,20193,21494,16,14,30,8179,7211,15390,5,0.371463,0.390186,3734.761115,0.001063,0.001493,8,0.000213,0,10,0.441176,0.009879
22037,East Feliciana Parish,,LA,1376,20057,21433,8,8,16,15821,16699,32520,6,0.313405,0.324235,4.745952,0.000627,0.000293,12,0.000125,0,10,0.680556,0.005602
31155,Saunders County,,NE,1335,20093,21428,6,6,12,16330,15534,31864,5,0.326878,0.337256,2.891108,0.000539,0.000471,50,0.000121,0,10,0.8,0.004811
39115,Morgan County,,OH,1078,20327,21405,9,7,16,9274,9458,18732,6,0.331965,0.345763,1.927474,0.000566,0.00052,41,0.000122,0,10,0.791667,0.00525
13163,Jefferson County,,GA,1104,20295,21399,7,9,16,5911,8441,14352,6,0.331749,0.344721,949.853673,0.000331,0.000793,37,0.000152,0,10,0.541667,0.003439
29157,Perry County,,MO,1114,20233,21347,10,11,21,9153,8464,17617,6,0.329331,0.341851,281.888233,0.000625,0.000774,14,0.00015,0,10,0.690909,0.00602
51099,King George County,,VA,2406,18913,21319,21,20,41,27549,20803,48352,5,0.362778,0.381885,96.718687,0.005074,0.004077,13,0.000161,0,10,0.686154,0.046867
18009,Blackford County,,IN,1284,20024,21308,8,9,17,8057,9362,17419,6,0.326253,0.339421,2.595694,0.000622,0.00058,42,0.000108,0,10,0.819444,0.005461
27129,Renville County,,MN,1262,20025,21287,11,17,28,6654,9320,15974,5,0.338811,0.353369,65.038585,0.000607,0.001036,39,0.000138,0,10,0.595588,0.00631
48285,Lavaca County,,TX,1294,19944,21238,10,11,21,10799,10468,21267,5,0.354734,0.371506,2.175108,0.0017,0.001961,62,0.000134,0,10,0.825758,0.018596
20139,Osage County,,KS,1654,19570,21224,7,9,16,12296,12912,25208,6,0.328416,0.34005,41.021714,0.000497,0.000629,14,0.00012,0,10,0.680556,0.004401
28159,Winston County,,MS,974,20229,21203,11,11,22,5438,6739,12177,6,0.301176,0.312815,268.202536,0.000471,0.000243,12,0.00018,0,10,0.55303,0.004278
17023,Clark County,,IL,1031,20163,21194,5,6,11,7528,7706,15234,6,0.326011,0.338688,175.793416,0.000062,0.000374,8,0.000112,0,10,0.533333,0.000653
47151,Scott County,,TN,692,20491,21183,5,5,10,3709,4532,8241,6,0.316017,0.327018,172.397542,0.000292,0.000302,51,0.000129,0,10,0.5,0.003112
49041,Sevier County,,UT,1395,19766,21161,12,11,23,11268,12277,23545,5,0.349607,0.365674,20.35059,0.001757,0.001393,45,0.000141,0,10,0.725275,0.016597
46005,Beadle County,,SD,1222,19918,21140,13,13,26,4539,6595,11134,5,0.322689,0.335156,5333.728242,0.000444,0.00042,50,0.0003,0,10,0.428571,0.004682
5113,Polk County,,AR,1410,19709,21119,9,11,20,3172,5163,8335,6,0.321507,0.33316,376.347184,0.000644,0.000617,52,0.000145,0,10,0.507576,0.007056
32013,Humboldt County,,NV,2419,18700,21119,12,12,24,8360,9269,17629,5,0.364067,0.381722,87.206619,0.001987,0.002017,45,0.000156,0,10,0.703297,0.020118
51077,Grayson County,,VA,1068,20049,21117,7,7,14,5864,6788,12652,7,0.250816,0.25889,40.345868,0.000025,0.000022,37,0.000159,0,10,0.357143,0.000644
46065,Hughes County,,SD,1704,19381,21085,16,17,33,9099,10385,19484,5,0.353836,0.37015,10210.36271,0.000731,0.001156,50,0.000361,0,10,0.419118,0.007564
29215,Texas County,,MO,1565,19513,21078,12,11,23,10941,11994,22935,6,0.312417,0.323264,536.361535,0.000627,0.000287,14,0.000192,0,10,0.544872,0.00625
54043,Lincoln County,,WV,1089,19983,21072,6,6,12,10694,11742,22436,6,0.297271,0.307042,0.831213,0.000164,0.000115,41,0.000113,0,10,0.866667,0.001436
27135,Roseau County,,MN,985,20086,21071,10,12,22,3472,5295,8767,5,0.335371,0.348931,6200.135843,0.000508,0.000519,39,0.000208,0,10,0.519231,0.005088
47185,White County,,TN,983,20068,21051,11,10,21,13578,13007,26585,6,0.328732,0.341184,579.772774,0.001343,0.000723,51,0.000211,0,10,0.530303,0.014524
21079,Garrard County,,KY,1566,19477,21043,8,9,17,18028,15907,33935,6,0.316375,0.327214,3.391371,0.000254,0.000238,42,0.000168,0,10,0.819444,0.002722
51065,Fluvanna County,,VA,1578,19461,21039,14,13,27,19925,16267,36192,6,0.334568,0.349897,84.056461,0.001916,0.001337,13,0.000165,0,10,0.652381,0.018207
40153,Woodward County,,OK,1496,19534,21030,13,13,26,7259,9083,16342,6,0.32754,0.340435,3954.234659,0.001224,0.000829,52,0.000248,0,10,0.409524,0.012714
37115,Madison County,,NC,1316,19695,21011,4,6,10,12548,11816,24364,6,0.306648,0.317025,4.326752,0.00027,0.000382,37,0.0001,0,10,0.466667,0.003658
28031,Covington County,,MS,1301,19690,20991,11,11,22,13991,14049,28040,5,0.318871,0.330691,12.571431,0.000806,0.000545,12,0.000141,0,10,0.820513,0.00694
55011,Buffalo County,,WI,1132,19849,20981,8,9,17,7789,9105,16894,5,0.333659,0.346707,98.880828,0.000102,0.000456,39,0.000129,0,10,0.638889,0.001503
48489,Willacy County,,TX,1545,19401,20946,7,7,14,8824,11918,20742,5,0.358125,0.37506,0,0.002205,0.002349,62,0.000095,0,10,1,0.022637
13237,Putnam County,,GA,1398,19536,20934,17,16,33,14856,12342,27198,6,0.337917,0.352707,19.938883,0.002418,0.002328,6,0.000178,0,10,0.761029,0.024424
12059,Holmes County,,FL,1427,19487,20914,10,9,19,13557,14040,27597,5,0.325458,0.337815,2.308234,0.001486,0.001158,5,0.000128,0,10,0.871212,0.015345
16065,Madison County,,ID,2156,18755,20911,28,30,58,28560,42943,71503,5,0.375458,0.396886,289.262645,0.005683,0.005976,45,0.000244,0,10,0.695076,0.055557
54047,McDowell County,,WV,1208,19626,20834,5,7,12,3957,8100,12057,6,0.300881,0.311903,210.669579,0.0001,0.00025,51,0.000107,0,10,0.428571,0.00169
18165,Vermillion County,,IN,1437,19389,20826,7,10,17,11036,11371,22407,6,0.325872,0.338987,29.930633,0.000408,0.000454,42,0.000121,0,10,0.611111,0.003886
17159,Richland County,,IL,1173,19631,20804,11,12,23,5126,4981,10107,6,0.30159,0.312771,574.172437,0.000039,0.000114,14,0.000203,0,10,0.307692,0.000919
29141,Morgan County,,MO,1571,19179,20750,16,14,30,13978,13618,27596,6,0.328943,0.341743,34.820217,0.001475,0.000995,14,0.000188,0,10,0.69883,0.014001
29013,Bates County,,MO,1371,19347,20718,11,12,23,10981,10851,21832,6,0.328732,0.341146,22.749093,0.000897,0.000924,14,0.000152,0,10,0.643939,0.00896
17181,Union County,,IL,1004,19701,20705,7,7,14,5821,6598,12419,6,0.292182,0.302013,719.80122,0.000574,0.000077,14,0.000126,0,10,0.660714,0.005596
41013,Crook County,,OR,1439,19247,20686,17,13,30,17945,14002,31947,5,0.322723,0.335059,65.159488,0.001988,0.001389,45,0.000174,0,10,0.792398,0.021546
18119,Owen County,,IN,1582,19092,20674,11,10,21,21113,19981,41094,6,0.325734,0.33877,1.915745,0.000841,0.000617,42,0.000138,0,10,0.872727,0.008116
13187,Lumpkin County,,GA,1776,18884,20660,18,14,32,23965,21036,45001,6,0.337064,0.351378,23.027673,0.003701,0.002212,6,0.000197,0,10,0.695906,0.037059
19095,Iowa County,,IA,1020,19627,20647,7,7,14,9788,9649,19437,6,0.318408,0.32895,1.6,0.000453,0.000407,8,0.000123,0,10,0.833333,0.004236
19083,Hardin County,,IA,1305,19234,20539,8,10,18,6968,7750,14718,6,0.318838,0.329823,39.342854,0.000335,0.000483,8,0.00014,0,10,0.633333,0.003154
5053,Grant County,,AR,1270,19214,20484,9,8,17,13759,12926,26685,6,0.318012,0.328586,4.879834,0.000385,0.000387,52,0.000146,0,10,0.708333,0.004314
8039,Elbert County,,CO,2132,18343,20475,10,10,20,29371,21543,50914,5,0.362906,0.380013,39.95841,0.002522,0.002778,35,0.000125,0,10,0.866667,0.026394
21097,Harrison County,,KY,1265,19192,20457,7,9,16,9346,10080,19426,6,0.324942,0.337326,1651.116088,0.000233,0.000543,42,0.000162,0,10,0.455556,0.002376
28051,Holmes County,,MS,1345,19107,20452,11,10,21,8560,11978,20538,5,0.358334,0.375103,251.485377,0.001438,0.001052,12,0.000135,0,10,0.663636,0.012939
21155,Marion County,,KY,829,19604,20433,7,7,14,7937,8238,16175,6,0.3257,0.338026,9.732104,0.000539,0.000628,42,0.00014,0,10,0.642857,0.005225
13017,Ben Hill County,,GA,1379,19035,20414,8,11,19,8105,8465,16570,5,0.345946,0.362516,672.470243,0.00069,0.001279,5,0.000133,0,10,0.563636,0.007049
47171,Unicoi County,,TN,1166,19235,20401,6,6,12,10219,11086,21305,6,0.318144,0.330084,11.632334,0.000301,0.000672,51,0.000132,0,10,0.761905,0.004059
12123,Taylor County,,FL,1164,19224,20388,14,12,26,4738,5237,9975,5,0.352011,0.367464,917.040616,0.003126,0.001955,5,0.000175,0,10,0.671429,0.029714
48177,Gonzales County,,TX,1217,19145,20362,14,13,27,9610,10787,20397,5,0.354857,0.371886,5.479093,0.001841,0.002079,62,0.000178,0,10,0.752747,0.020999
51175,Southampton County,,VA,1160,19201,20361,15,13,28,12682,9584,22266,6,0.328205,0.342942,632.369876,0.00163,0.001439,13,0.000161,0,10,0.519048,0.015216
48407,San Jacinto County,,TX,1798,18552,20350,9,7,16,29875,23833,53708,5,0.349806,0.365213,0.111111,0.001186,0.001021,62,0.00012,0,10,0.944444,0.013971
18139,Rush County,,IN,1363,18983,20346,8,8,16,12906,13719,26625,6,0.325596,0.338336,2.337155,0.00043,0.000424,42,0.000114,0,10,0.785714,0.004306
20005,Atchison County,,KS,1084,19226,20310,12,14,26,6519,8536,15055,6,0.330003,0.34279,246.161524,0.000962,0.001083,14,0.00016,0,10,0.675824,0.008975
53001,Adams County,,WA,1701,18608,20309,9,10,19,10579,14279,24858,5,0.364326,0.381776,0.269059,0.002112,0.001884,45,0.000105,0,10,0.945455,0.021102
40009,Beckham County,,OK,1481,18771,20252,16,12,28,11104,11754,22858,5,0.344279,0.360227,5228.999136,0.001363,0.001344,52,0.000242,0,10,0.504167,0.013916
1129,Washington County,,AL,1163,19049,20212,6,7,13,8626,10006,18632,6,0.308744,0.320367,7.440576,0.000297,0.000389,6,0.000105,0,10,0.619048,0.003297
54103,Wetzel County,,WV,1047,19165,20212,6,9,15,5320,7004,12324,6,0.292711,0.303331,215.571357,0.000091,0.000073,41,0.000134,0,10,0.402778,0.000853
51600,Fairfax city,,VA,3118,17061,20179,12,14,26,40342,44920,85262,5,0.361624,0.37946,4.16141,0.003608,0.003534,13,0.000111,0,10,0.947619,0.034281
13321,Worth County,,GA,1483,18690,20173,10,9,19,15458,16282,31740,5,0.342094,0.357292,161.35996,0.001123,0.000725,5,0.000135,0,10,0.744444,0.011317
28153,Wayne County,,MS,857,19315,20172,12,13,25,7746,8350,16096,5,0.318408,0.331217,58.855176,0.000534,0.00057,12,0.000158,0,10,0.576923,0.005151
30053,Lincoln County,,MT,1494,18675,20169,10,11,21,5465,6459,11924,5,0.363938,0.381467,76.256883,0.001982,0.001835,45,0.000127,0,10,0.774725,0.020004
17123,Marshall County,,IL,1319,18848,20167,10,9,19,9974,9919,19893,5,0.354857,0.3706,325.805068,0.001076,0.000743,8,0.000126,0,10,0.7,0.009328
47085,Humphreys County,,TN,1063,19060,20123,8,9,17,8103,7696,15799,6,0.330287,0.343142,10.733032,0.000863,0.000996,51,0.000134,0,10,0.597222,0.009623
17005,Bond County,,IL,1233,18834,20067,6,8,14,9643,9860,19503,6,0.331249,0.343457,26.75084,0.000639,0.000592,14,0.000092,0,10,0.732143,0.005601
19079,Hamilton County,,IA,1322,18735,20057,8,8,16,8214,9119,17333,6,0.318507,0.329253,31.094893,0.000727,0.000382,8,0.000132,0,10,0.588889,0.006527
28141,Tishomingo County,,MS,1118,18919,20037,10,11,21,9575,9007,18582,6,0.33107,0.344417,35.772948,0.000482,0.000495,52,0.000165,0,10,0.472727,0.005232
51071,Giles County,,VA,849,19175,20024,5,7,12,7350,7134,14484,6,0.295982,0.3065,204.690793,0.000117,0.000114,37,0.000111,0,10,0.52381,0.000925
47159,Smith County,,TN,1376,18647,20023,9,9,18,13220,12788,26008,6,0.328591,0.340858,4.396181,0.000631,0.000772,51,0.000171,0,10,0.791667,0.00775
55113,Sawyer County,,WI,1050,18937,19987,15,11,26,6071,5255,11326,5,0.335042,0.348741,383.78217,0.001913,0.001067,39,0.00017,0,10,0.719048,0.018058
30041,Hill County,,MT,1468,18491,19959,13,9,22,6433,8621,15054,6,0.295897,0.307411,76.809649,0.000394,0.000381,45,0.000229,0,10,0.472527,0.004662
12133,Washington County,,FL,1523,18434,19957,12,9,21,18338,17379,35717,5,0.34579,0.360113,10.503815,0.002848,0.001627,5,0.000131,0,10,0.909091,0.027526
19047,Crawford County,,IA,1087,18870,19957,13,14,27,5064,7431,12495,6,0.325838,0.338205,498.08192,0.00106,0.000553,8,0.000182,0,10,0.466667,0.010243
23021,Piscataquis County,,ME,1205,18734,19939,8,8,16,7341,9039,16380,6,0.302362,0.31409,0,0.000549,0.000475,33,0.000098,0,10,1,0.004837
17147,Piatt County,,IL,1335,18601,19936,7,8,15,13533,11820,25353,5,0.355103,0.370763,100.433715,0.000857,0.000778,8,0.0001,0,10,0.785714,0.007467
48337,Montague County,,TX,1449,18486,19935,11,11,22,13307,12680,25987,5,0.346923,0.362755,139.268879,0.001836,0.00185,62,0.000142,0,10,0.596154,0.019487
39067,Harrison County,,OH,1219,18695,19914,9,8,17,10076,11060,21136,6,0.332,0.345926,1.090992,0.001261,0.000757,41,0.000102,0,10,0.902778,0.01027
1065,Hale County,,AL,1071,18831,19902,5,5,10,10429,11615,22044,6,0.318276,0.329112,0.5,0.000353,0.000323,6,0.000103,0,10,0.9,0.003336
51775,Salem city,,VA,2166,17711,19877,8,9,17,28645,29495,58140,6,0.31229,0.324105,24.498576,0.000237,0.000589,37,0.000139,0,10,0.677778,0.002104
35028,Los Alamos County,,NM,2027,17828,19855,12,12,24,8407,10005,18412,5,0.36932,0.387717,12.356277,0.003536,0.003584,35,0.000128,0,10,0.909524,0.036009
31159,Seward County,,NE,1438,18382,19820,5,7,12,9444,10570,20014,5,0.327052,0.337636,7.337626,0.000177,0.000474,50,0.000134,0,10,0.619048,0.001587
28013,Calhoun County,,MS,1001,18759,19760,8,8,16,5166,6048,11214,6,0.289811,0.300445,34.580268,0.000053,0.000125,52,0.000143,0,10,0.472222,0.001043
17149,Pike County,,IL,952,18787,19739,8,7,15,4024,4865,8889,6,0.306832,0.317112,127.389501,0.000137,0.00018,14,0.000161,0,10,0.347222,0.001366
19171,Tama County,,IA,1177,18558,19735,7,9,16,9243,10481,19724,6,0.318804,0.32966,2.03785,0.000369,0.000483,8,0.000119,0,10,0.847222,0.003692
21065,Estill County,,KY,920,18799,19719,4,5,9,6123,6838,12961,6,0.316114,0.3264,0,0.000236,0.000217,42,0.000114,0,10,1,0.002266
37199,Yancey County,,NC,917,18799,19716,4,4,8,6176,6091,12267,6,0.306464,0.316509,1.666667,0.000192,0.000249,37,0.000096,0,10,0.666667,0.002544
19023,Butler County,,IA,1065,18649,19714,7,9,16,8062,7846,15908,6,0.316701,0.327675,6.465518,0.000069,0.00035,8,0.000126,0,10,0.633333,0.000951
29229,Wright County,,MO,1559,18151,19710,8,8,16,10521,13578,24099,6,0.309459,0.31945,1.720891,0.000183,0.000249,14,0.000152,0,10,0.805556,0.002546
19067,Floyd County,,IA,1124,18577,19701,8,11,19,6245,7468,13713,5,0.358042,0.374669,1100.533601,0.000756,0.000962,8,0.000127,0,10,0.636364,0.007339
17191,Wayne County,,IL,847,18847,19694,6,8,14,4693,5903,10596,6,0.298281,0.308545,274.770558,0.000018,0.00007,14,0.000132,0,10,0.388889,0.000493
51025,Brunswick County,,VA,1248,18397,19645,12,11,23,6949,8073,15022,6,0.312767,0.32532,263.929236,0.000662,0.000712,13,0.000166,0,10,0.469697,0.007126
40091,McIntosh County,,OK,1419,18221,19640,14,15,29,13771,13109,26880,6,0.327401,0.340435,11.740872,0.001046,0.000866,52,0.000186,0,10,0.617647,0.010784
37053,Currituck County,,NC,1508,18124,19632,8,11,19,23076,15852,38928,6,0.332648,0.347705,5.177539,0.001017,0.001543,13,0.000109,0,10,0.818182,0.009394
26039,Crawford County,,MI,1342,18283,19625,12,12,24,7313,5355,12668,6,0.332504,0.347342,2.473656,0.001706,0.001523,43,0.000116,0,10,0.824176,0.012895
55065,Lafayette County,,WI,1030,18584,19614,7,7,14,10749,11575,22324,6,0.322486,0.333708,3.706938,0.000376,0.000349,8,0.000103,0,10,0.738095,0.003558
21213,Simpson County,,KY,1322,18282,19604,9,8,17,13313,12791,26104,6,0.331714,0.345063,381.290316,0.00081,0.000884,42,0.000158,0,10,0.680556,0.008713
55099,Price County,,WI,1143,18452,19595,11,11,22,3672,4701,8373,5,0.328275,0.340413,96.24729,0.000851,0.000679,8,0.000131,0,10,0.719697,0.007867
5067,Jackson County,,AR,1428,18122,19550,9,8,17,6944,9363,16307,6,0.318474,0.329183,33.718549,0.000289,0.000307,52,0.000154,0,10,0.644444,0.003178
18137,Ripley County,,IN,1413,18127,19540,13,16,29,19953,19812,39765,6,0.330358,0.344797,95.997936,0.001022,0.001249,42,0.000165,0,10,0.520833,0.009318
19085,Harrison County,,IA,1198,18314,19512,7,8,15,7929,8139,16068,5,0.327052,0.337636,10.746973,0.000402,0.000404,50,0.000128,0,10,0.625,0.003912
21231,Wayne County,,KY,764,18748,19512,6,5,11,5604,6294,11898,6,0.316245,0.326563,1850.762053,0.000741,0.000212,42,0.000138,0,10,0.428571,0.006896
26089,Leelanau County,,MI,1270,18222,19492,13,10,23,14148,14011,28159,5,0.357251,0.37372,23.015277,0.002779,0.002031,43,0.000116,0,10,0.912088,0.021914
48051,Burleson County,,TX,1327,18158,19485,12,9,21,12284,11710,23994,5,0.354653,0.371181,4.265203,0.00233,0.001828,62,0.000144,0,10,0.839744,0.02537
48019,Bandera County,,TX,1654,17826,19480,10,9,19,17098,14179,31277,5,0.354734,0.371289,0.232665,0.002035,0.002034,62,0.000138,0,10,0.945455,0.021606
37011,Avery County,,NC,1318,18143,19461,9,9,18,6271,6938,13209,6,0.331177,0.345643,79.117388,0.001066,0.001458,37,0.000139,0,10,0.663636,0.011218
47023,Chester County,,TN,1371,18084,19455,7,9,16,11661,11448,23109,6,0.333659,0.347369,2.12619,0.000433,0.000812,52,0.000132,0,10,0.791667,0.004355
47033,Crockett County,,TN,1327,18027,19354,8,8,16,11559,11516,23075,6,0.335188,0.348937,43.464313,0.000607,0.000618,52,0.000135,0,10,0.660714,0.006258
29163,Pike County,,MO,1199,18120,19319,9,9,18,7976,8246,16222,6,0.329614,0.342014,90.90314,0.000685,0.000633,14,0.000157,0,10,0.652778,0.006302
17189,Washington County,,IL,1016,18288,19304,8,8,16,9444,10326,19770,6,0.331249,0.343457,8.211392,0.000655,0.000594,14,0.000113,0,10,0.821429,0.005872
47005,Benton County,,TN,1061,18187,19248,10,10,20,6686,6758,13444,6,0.328556,0.34094,13.16723,0.000792,0.000643,52,0.000162,0,10,0.659091,0.008298
27023,Chippewa County,,MN,1080,18165,19245,8,11,19,6293,6696,12989,5,0.333587,0.346734,1059.79698,0.00042,0.000617,39,0.000118,0,10,0.636364,0.004183
17053,Ford County,,IL,1224,18019,19243,8,8,16,11457,11221,22678,5,0.355021,0.370709,0.428047,0.001113,0.000991,8,0.000095,0,10,0.964286,0.009518
48457,Tyler County,,TX,1557,17652,19209,11,9,20,13923,13081,27004,5,0.349926,0.365592,0.312935,0.001173,0.001169,62,0.000129,0,10,0.963636,0.013353
29015,Benton County,,MO,1465,17705,19170,15,12,27,12493,10276,22769,6,0.32926,0.341851,13.209622,0.001069,0.001024,14,0.000181,0,10,0.745833,0.010697
48035,Bosque County,,TX,1623,17539,19162,15,14,29,15848,14522,30370,5,0.357584,0.375239,35.480479,0.002775,0.002925,62,0.000167,0,10,0.804762,0.029052
51840,Winchester city,,VA,2584,16557,19141,15,16,31,38608,42273,80881,6,0.334641,0.350195,295.457973,0.001962,0.001976,13,0.000178,0,10,0.653595,0.018784
29121,Macon County,,MO,1193,17945,19138,7,7,14,6118,6997,13115,6,0.321911,0.333257,35.340232,0.000422,0.000383,14,0.000139,0,10,0.690476,0.003984
45037,Edgefield County,,SC,1333,17730,19063,8,8,16,18125,18091,36216,6,0.318838,0.330887,8.62341,0.000801,0.000874,37,0.00012,0,10,0.785714,0.008541
47173,Union County,,TN,1147,17916,19063,7,7,14,16193,15691,31884,6,0.316049,0.327317,1.900975,0.000387,0.000462,51,0.000147,0,10,0.785714,0.00479
13267,Tattnall County,,GA,1347,17653,19000,10,10,20,11195,10784,21979,6,0.317454,0.329036,18.009976,0.000522,0.000542,5,0.000153,0,10,0.588889,0.00555
19101,Jefferson County,,IA,1162,17836,18998,8,9,17,5941,7111,13052,6,0.319567,0.330507,421.697073,0.000383,0.000427,8,0.000151,0,10,0.477778,0.003779
5075,Lawrence County,,AR,1241,17749,18990,8,7,15,9537,11133,20670,6,0.318474,0.329074,4.549827,0.000067,0.000251,52,0.000153,0,10,0.722222,0.001164
21051,Clay County,,KY,670,18315,18985,5,6,11,4749,6935,11684,6,0.316407,0.326796,307.937344,0.000231,0.000228,42,0.000117,0,10,0.666667,0.002265
1067,Henry County,,AL,1331,17649,18980,5,6,11,13228,12872,26100,6,0.309148,0.320117,0.4,0.000348,0.000305,6,0.000087,0,10,0.928571,0.003474
48133,Eastland County,,TX,1612,17368,18980,14,13,27,8144,9145,17289,5,0.347747,0.363911,41.755777,0.002055,0.001608,62,0.000175,0,10,0.719048,0.021429
18159,Tipton County,,IN,1224,17754,18978,6,7,13,11988,12294,24282,6,0.325769,0.338498,0.410714,0.000608,0.000711,42,0.000093,0,10,0.928571,0.0058
5043,Drew County,,AR,1468,17496,18964,9,13,22,9958,10347,20305,6,0.319534,0.331299,21.478238,0.000277,0.000485,52,0.00015,0,10,0.589744,0.002937
5121,Randolph County,,AR,1124,17839,18963,6,8,14,7503,8061,15564,6,0.31854,0.329291,563.61167,0.000038,0.000287,52,0.00016,0,10,0.517857,0.000761
48161,Freestone County,,TX,1387,17522,18909,13,14,27,12859,12312,25171,5,0.353591,0.370492,2.162305,0.001931,0.002456,62,0.000149,0,10,0.868132,0.02063
21161,Mason County,,KY,1281,17625,18906,10,10,20,10112,9838,19950,6,0.350205,0.365712,1558.317621,0.000754,0.001031,42,0.000157,0,10,0.463636,0.00645
42093,Montour County,,PA,1222,17683,18905,10,7,17,13194,12690,25884,6,0.299941,0.311447,3.604663,0.001305,0.000374,47,0.000103,0,10,0.911111,0.011011
13001,Appling County,,GA,1034,17806,18840,9,10,19,5652,5900,11552,6,0.31729,0.32895,455.024522,0.000395,0.000438,5,0.000163,0,10,0.566667,0.004419
47139,Polk County,,TN,1318,17515,18833,9,7,16,13166,13506,26672,6,0.310052,0.320736,52.291865,0.000628,0.00032,51,0.000171,0,10,0.458333,0.007451
13091,Dodge County,,GA,975,17834,18809,6,6,12,6846,7897,14743,6,0.302303,0.313249,66.881144,0.000256,0.000255,6,0.000132,0,10,0.7,0.002775
51193,Westmoreland County,,VA,1196,17605,18801,15,16,31,13456,11907,25363,6,0.334932,0.350819,1234.025081,0.002161,0.00186,13,0.000164,0,10,0.569853,0.020422
19141,O'Brien County,,IA,1061,17737,18798,9,11,20,5949,6710,12659,5,0.320267,0.332346,95.508184,0.000081,0.000354,8,0.000155,0,10,0.480769,0.001101
21045,Casey County,,KY,824,17968,18792,9,11,20,6094,6816,12910,6,0.316668,0.327919,120.358487,0.000242,0.000243,42,0.000189,0,10,0.462121,0.002653
28061,Jasper County,,MS,992,17795,18787,10,10,20,12104,12783,24887,6,0.301029,0.312543,10.867208,0.000678,0.000245,12,0.000129,0,10,0.765152,0.005859
21205,Rowan County,,KY,1533,17246,18779,15,16,31,11108,12125,23233,6,0.325838,0.339388,6204.947065,0.000553,0.000555,42,0.000303,0,10,0.349673,0.005781
31131,Otoe County,,NE,1153,17624,18777,7,8,15,10377,10849,21226,5,0.326982,0.337636,28.694482,0.00054,0.00047,50,0.000146,0,10,0.571429,0.004829
20133,Neosho County,,KS,1187,17550,18737,8,10,18,7673,8518,16191,6,0.32831,0.340131,33.02486,0.000544,0.000669,14,0.000137,0,10,0.609091,0.005226
20011,Bourbon County,,KS,1129,17533,18662,8,10,18,4830,5731,10561,6,0.331034,0.343566,34.778045,0.00085,0.000947,14,0.000122,0,10,0.663636,0.007969
48503,Young County,,TX,1430,17226,18656,12,13,25,7308,8286,15594,5,0.34826,0.364535,3109.123423,0.001553,0.001726,62,0.000194,0,10,0.598901,0.016226
29053,Cooper County,,MO,1275,17339,18614,10,9,19,11100,10084,21184,6,0.32296,0.334722,42.824708,0.000705,0.000556,14,0.000146,0,10,0.733333,0.006952
47049,Fentress County,,TN,784,17816,18600,6,6,12,3920,4754,8674,6,0.316505,0.327832,238.170332,0.000305,0.000379,51,0.00016,0,10,0.6,0.003908
16067,Minidoka County,,ID,1848,16747,18595,11,12,23,14849,18017,32866,5,0.363121,0.380501,421.786736,0.001708,0.001473,45,0.000145,0,10,0.807692,0.017542
17187,Warren County,,IL,1290,17305,18595,10,13,23,7652,9438,17090,5,0.355473,0.371821,766.817623,0.00074,0.000881,8,0.000143,0,10,0.596154,0.006949
12079,Madison County,,FL,1064,17523,18587,13,11,24,5978,6962,12940,5,0.353063,0.368685,33.450759,0.003129,0.002251,5,0.000147,0,10,0.775641,0.029566
17193,White County,,IL,822,17740,18562,8,9,17,5107,5262,10369,6,0.296668,0.306868,1733.024264,0.00009,0.000068,14,0.000198,0,10,0.347222,0.001084
1075,Lamar County,,AL,1072,17487,18559,6,7,13,6178,7485,13663,6,0.3199,0.331136,12.499469,0.00015,0.000345,6,0.000114,0,10,0.642857,0.00135
29073,Gasconade County,,MO,1130,17384,18514,12,13,25,10603,10560,21163,6,0.330607,0.343913,59.055068,0.000969,0.000865,14,0.000162,0,10,0.697802,0.008937
41031,Jefferson County,,OR,1249,17209,18458,14,14,28,14305,13369,27674,5,0.366587,0.384787,31.668836,0.001889,0.002491,45,0.000146,0,10,0.904167,0.019724
5021,Clay County,,AR,1243,17204,18447,6,6,12,7942,9588,17530,6,0.284155,0.293831,62.202232,0.000049,0.000044,52,0.000147,0,10,0.633333,0.000813
13011,Banks County,,GA,1600,16841,18441,10,10,20,21970,20330,42300,6,0.326809,0.339936,1.419837,0.000662,0.000688,6,0.000149,0,10,0.855556,0.006991
51141,Patrick County,,VA,853,17575,18428,7,8,15,6538,6579,13117,6,0.309459,0.320562,23.891727,0.000038,0.00027,37,0.000131,0,10,0.410714,0.000689
51820,Waynesboro city,,VA,1671,16743,18414,12,12,24,22960,21628,44588,6,0.336032,0.351742,219.56056,0.000653,0.001548,13,0.000178,0,10,0.647619,0.006553
5047,Franklin County,,AR,1203,17176,18379,7,8,15,11649,12362,24011,6,0.308961,0.319439,0.795832,0.000315,0.000394,52,0.000125,0,10,0.982143,0.003818
13085,Dawson County,,GA,1839,16536,18375,12,10,22,27825,21131,48956,6,0.336805,0.350564,1.616014,0.002321,0.002055,6,0.000148,0,10,0.893939,0.023436
26053,Gogebic County,,MI,1014,17357,18371,7,8,15,2688,3125,5813,5,0.335152,0.34866,1401.196922,0.000542,0.000478,8,0.000143,0,10,0.366667,0.00534
25007,Dukes County,,MA,1030,17327,18357,11,10,21,4850,5185,10035,5,0.338401,0.353516,0,0.003147,0.002647,33,0.000092,0,10,1,0.026294
13025,Brantley County,,GA,1194,17154,18348,7,8,15,12965,11455,24420,6,0.331642,0.345161,3.091568,0.00057,0.000647,5,0.000115,0,10,0.785714,0.005797
17061,Greene County,,IL,964,17379,18343,7,6,13,6749,7650,14399,6,0.306373,0.316298,414.043937,0.000239,0.000169,14,0.000126,0,10,0.571429,0.001995
56007,Carbon County,,WY,1808,16521,18329,15,14,29,6596,9216,15812,5,0.36892,0.387028,267.841602,0.00208,0.001658,35,0.000176,0,10,0.713235,0.021549
21001,Adair County,,KY,878,17442,18320,9,10,19,5960,6899,12859,6,0.325148,0.337733,223.859289,0.000383,0.00059,42,0.000183,0,10,0.509091,0.004053
22013,Bienville Parish,,LA,1246,17036,18282,9,11,20,10531,11506,22037,5,0.353185,0.369705,63.24615,0.000348,0.001269,12,0.000132,0,10,0.727273,0.003456
19005,Allamakee County,,IA,1222,17042,18264,9,10,19,4430,5685,10115,6,0.313405,0.324452,46.126945,0.000411,0.000313,8,0.000129,0,10,0.445455,0.003833
17127,Massac County,,IL,986,17261,18247,5,7,12,5576,6069,11645,6,0.279883,0.289339,457.277261,0.000033,0.000045,52,0.000143,0,10,0.404762,0.000669
35027,Lincoln County,,NM,1905,16328,18233,21,13,34,11680,11442,23122,5,0.369408,0.388232,6.784042,0.005691,0.003015,35,0.000191,0,10,0.878788,0.056363
8015,Chaffee County,,CO,1555,16647,18202,19,17,36,9921,8301,18222,5,0.363593,0.381586,1206.051942,0.003067,0.003278,35,0.00021,0,10,0.760234,0.032485
47015,Cannon County,,TN,1237,16932,18169,6,7,13,12594,11734,24328,6,0.328345,0.340289,0.309524,0.000551,0.000655,51,0.000119,0,10,0.928571,0.006339
56023,Lincoln County,,WY,1428,16739,18167,19,19,38,9466,8590,18056,5,0.363335,0.381559,137.861648,0.00265,0.001802,45,0.000192,0,10,0.630952,0.026344
40117,Pawnee County,,OK,1595,16554,18149,7,8,15,14744,15410,30154,6,0.327122,0.339242,1.346037,0.000651,0.000665,52,0.000117,0,10,0.875,0.006658
48395,Robertson County,,TX,1459,16679,18138,12,12,24,12312,12923,25235,5,0.35696,0.374208,13.567299,0.002621,0.00239,62,0.000145,0,10,0.788462,0.027466
27065,Kanabec County,,MN,1204,16928,18132,13,14,27,13977,12459,26436,5,0.33355,0.346951,0.386742,0.001087,0.000967,39,0.000148,0,10,0.928571,0.01
37173,Swain County,,NC,1039,17088,18127,5,5,10,7011,8342,15353,6,0.306617,0.316889,1574.724774,0.000239,0.000335,37,0.000149,0,10,0.65,0.003412
13075,Cook County,,GA,1199,16909,18108,6,6,12,11448,11128,22576,6,0.296239,0.306966,2.214903,0.000176,0.000167,5,0.000141,0,10,0.8,0.001947
35041,Roosevelt County,,NM,1773,16330,18103,14,13,27,10781,12564,23345,5,0.368081,0.386768,259.426921,0.002049,0.002048,35,0.000165,0,10,0.661765,0.021029
48353,Nolan County,,TX,1647,16450,18097,10,14,24,6861,8983,15844,5,0.348536,0.365104,271.149951,0.001216,0.001759,62,0.000152,0,10,0.736264,0.012284
55107,Rusk County,,WI,1003,17077,18080,7,10,17,5402,6403,11805,6,0.322013,0.333529,4.12411,0.000075,0.000365,39,0.000114,0,10,0.7,0.001202
42057,Fulton County,,PA,716,17354,18070,5,6,11,6451,6657,13108,6,0.295073,0.306055,5.670065,0.000141,0.0003,47,0.000093,0,10,0.7,0.001546
17101,Lawrence County,,IL,980,17056,18036,4,5,9,5609,6064,11673,6,0.29664,0.306326,2.066683,0.000006,0.000066,42,0.00011,0,10,0.7,0.000294
51660,Harrisonburg city,,VA,3206,14819,18025,26,29,55,32878,40364,73242,5,0.361242,0.381082,3796.150901,0.004226,0.006359,13,0.000263,0,10,0.57041,0.039346
13171,Lamar County,,GA,1403,16592,17995,11,10,21,17384,15340,32724,6,0.335225,0.348931,2.40592,0.001388,0.00138,6,0.000134,0,10,0.890909,0.014247
27001,Aitkin County,,MN,1152,16838,17990,18,13,31,10150,7496,17646,5,0.33355,0.346842,3.366693,0.001127,0.000901,39,0.0002,0,10,0.836601,0.010669
19035,Cherokee County,,IA,952,17018,17970,7,7,14,4087,4398,8485,6,0.31693,0.327734,73.2022,0.000266,0.000265,8,0.000119,0,10,0.625,0.002642
6043,Mariposa County,,CA,1661,16305,17966,18,13,31,13374,10277,23651,5,0.361029,0.378467,0.027027,0.004558,0.002814,45,0.000128,0,10,0.989474,0.040875
8105,Rio Grande County,,CO,1525,16440,17965,8,13,21,5261,7414,12675,5,0.363335,0.380827,1013.798318,0.001269,0.002639,35,0.000138,0,10,0.717949,0.013185
19121,Madison County,,IA,1224,16734,17958,7,8,15,12288,10993,23281,6,0.31644,0.32711,5.922454,0.000223,0.00025,8,0.000159,0,10,0.660714,0.002507
17017,Cass County,,IL,1201,16741,17942,10,8,18,6589,7919,14508,6,0.301442,0.31135,1355.155853,0.001074,0.00009,8,0.000158,0,10,0.366667,0.010044
54041,Lewis County,,WV,912,17021,17933,6,6,12,7009,7250,14259,6,0.291433,0.301101,1673.800359,0.000086,0.000046,41,0.00015,0,10,0.566667,0.000797
19145,Page County,,IA,1177,16755,17932,9,9,18,5882,6061,11943,6,0.325527,0.337256,1060.735564,0.000487,0.000455,50,0.000186,0,10,0.444444,0.004793
41001,Baker County,,OR,1450,16476,17926,14,12,26,5997,6405,12402,5,0.325769,0.338167,3.961776,0.00167,0.001472,45,0.000153,0,10,0.847619,0.018076
51063,Floyd County,,VA,865,17055,17920,8,7,15,7230,6592,13822,6,0.295356,0.305773,65.354497,0.000229,0.000148,37,0.000135,0,10,0.625,0.001929
5041,Desha County,,AR,1270,16627,17897,7,8,15,6235,8503,14738,6,0.319169,0.33016,19.30163,0.000629,0.000438,52,0.000117,0,10,0.666667,0.005504
17025,Clay County,,IL,1043,16835,17878,6,8,14,5358,5860,11218,6,0.29014,0.300353,38.357598,0.000024,0.000056,14,0.000117,0,10,0.416667,0.000484
28077,Lawrence County,,MS,957,16921,17878,12,11,23,6405,7709,14114,6,0.30044,0.311892,8.188111,0.0006,0.000231,12,0.000161,0,10,0.75,0.005362
18121,Parke County,,IN,1189,16627,17816,8,8,16,10710,11140,21850,6,0.325665,0.338444,2.485714,0.000453,0.000441,42,0.000123,0,10,0.785714,0.004456
29059,Dallas County,,MO,1366,16449,17815,8,7,15,12128,12716,24844,6,0.309397,0.319233,2.284288,0.000458,0.000233,14,0.000145,0,10,0.785714,0.00513
39111,Monroe County,,OH,845,16968,17813,7,7,14,5096,6839,11935,6,0.332216,0.346115,171.692871,0.000696,0.000431,41,0.000108,0,10,0.607143,0.006032
40035,Craig County,,OK,1358,16455,17813,7,7,14,9482,9804,19286,6,0.327087,0.339079,4.883364,0.000334,0.00062,52,0.000124,0,10,0.839286,0.003716
19115,Louisa County,,IA,1012,16766,17778,9,9,18,7055,8685,15740,6,0.328697,0.34215,143.899233,0.001196,0.000702,8,0.00013,0,10,0.655556,0.011391
26113,Missaukee County,,MI,1230,16546,17776,12,7,19,8799,8178,16977,6,0.327157,0.340815,1.113167,0.001682,0.00064,43,0.000121,0,10,0.856061,0.013436
30067,Park County,,MT,1732,16031,17763,8,6,14,7101,7766,14867,6,0.293494,0.304525,64.176609,0.000795,0.000281,45,0.000139,0,10,0.535714,0.008051
13291,Union County,,GA,999,16714,17713,22,12,34,10481,5981,16462,6,0.334896,0.34911,708.414698,0.005672,0.001587,6,0.000281,0,10,0.642292,0.056042
21103,Henry County,,KY,1396,16268,17664,8,6,14,14810,13946,28756,6,0.323539,0.335021,12.107431,0.000582,0.000344,42,0.000151,0,10,0.642857,0.005729
45009,Bamberg County,,SC,1056,16589,17645,7,8,15,6085,8784,14869,6,0.321406,0.333431,25.241497,0.000996,0.000947,37,0.000102,0,10,0.791667,0.010065
13019,Berrien County,,GA,1619,16009,17628,14,10,24,12962,12499,25461,6,0.297559,0.309353,704.478386,0.001138,0.000221,5,0.000227,0,10,0.362637,0.011874
27071,Koochiching County,,MN,907,16713,17620,5,6,11,1952,2949,4901,5,0.333116,0.345513,1.356825,0.000428,0.000575,39,0.0001,0,10,0.833333,0.004088
28005,Amite County,,MS,1229,16377,17606,11,12,23,7252,8363,15615,6,0.329155,0.343349,563.003782,0.000971,0.000871,12,0.00015,0,10,0.621795,0.00819
28135,Tallahatchie County,,MS,1095,16498,17593,10,12,22,6694,8861,15555,6,0.330785,0.344092,8.849734,0.000483,0.000508,52,0.000149,0,10,0.643939,0.005066
19129,Mills County,,IA,1287,16256,17543,7,6,13,11389,10330,21719,5,0.32608,0.336117,7.435231,0.000404,0.000372,50,0.000144,0,10,0.714286,0.003913
48253,Jones County,,TX,1690,15846,17536,9,10,19,11988,12787,24775,5,0.34826,0.36429,282.065067,0.001195,0.001261,62,0.000147,0,10,0.633333,0.012009
31185,York County,,NE,1222,16293,17515,9,8,17,6131,7560,13691,6,0.324016,0.334776,48.695497,0.00046,0.000377,50,0.000201,0,10,0.555556,0.004211
1027,Clay County,,AL,934,16541,17475,7,8,15,7151,8089,15240,6,0.318904,0.330295,32.815429,0.000334,0.000401,6,0.000115,0,10,0.732143,0.003359
37121,Mitchell County,,NC,759,16688,17447,5,6,11,5548,5569,11117,6,0.307231,0.317866,6.577576,0.000214,0.000339,37,0.000109,0,10,0.6,0.002776
51011,Appomattox County,,VA,823,16547,17370,7,6,13,8593,7684,16277,6,0.278589,0.287918,10.85651,0.00009,0.000069,37,0.000124,0,10,0.47619,0.001081
18131,Pulaski County,,IN,1149,16204,17353,11,12,23,9566,9563,19129,6,0.326496,0.33999,21.59187,0.000979,0.000722,42,0.000121,0,10,0.698718,0.008573
54065,Morgan County,,WV,885,16460,17345,14,8,22,9211,7250,16461,6,0.284418,0.295193,158.538768,0.002054,0.000222,13,0.000157,0,10,0.72381,0.019088
28129,Smith County,,MS,1024,16294,17318,9,9,18,9763,10260,20023,6,0.300293,0.311404,3.138107,0.000458,0.000214,12,0.000126,0,10,0.833333,0.004207
48145,Falls County,,TX,1421,15872,17293,8,10,18,9992,12360,22352,5,0.357376,0.374533,0.57737,0.001793,0.002472,62,0.000109,0,10,0.933333,0.01836
1023,Choctaw County,,AL,777,16481,17258,8,10,18,2719,3894,6613,6,0.319933,0.332232,26.478324,0.000342,0.000538,6,0.00012,0,10,0.555556,0.003243
49013,Duchesne County,,UT,1193,16016,17209,11,10,21,13727,12541,26268,5,0.349607,0.365565,0.533502,0.001448,0.001383,45,0.000129,0,10,0.939394,0.014056
29115,Linn County,,MO,927,16272,17199,8,13,21,3930,5428,9358,6,0.328873,0.341526,46.950456,0.000545,0.000886,14,0.00014,0,10,0.544872,0.005325
29011,Barton County,,MO,1055,16143,17198,8,8,16,7045,8179,15224,6,0.32235,0.333773,16.4677,0.000473,0.00047,14,0.000134,0,10,0.75,0.004935
27057,Hubbard County,,MN,1228,15967,17195,16,15,31,12564,11627,24191,5,0.334677,0.34866,623.276554,0.001088,0.000953,39,0.000198,0,10,0.805147,0.010386
19029,Cass County,,IA,953,16211,17164,7,9,16,4486,5358,9844,5,0.328943,0.340484,78.071302,0.000478,0.000587,50,0.000139,0,10,0.527778,0.004598
51570,Colonial Heights city,,VA,1658,15493,17151,9,8,17,25129,25529,50658,6,0.313182,0.325146,8.054978,0.001092,0.000743,13,0.000122,0,10,0.811111,0.010805
2150,Kodiak Island Borough,,AK,2076,15028,17104,14,14,28,4893,9332,14225,5,0.36615,0.384869,119.017163,0.003309,0.003424,45,0.000144,0,10,0.5625,0.031585
21099,Hart County,,KY,1090,16010,17100,10,9,19,10136,10489,20625,6,0.32477,0.336995,131.928335,0.000493,0.000486,42,0.000179,0,10,0.611111,0.005133
13133,Greene County,,GA,895,16180,17075,11,12,23,7850,7579,15429,6,0.335738,0.349799,2334.145577,0.001818,0.001441,6,0.00013,0,10,0.686813,0.017941
53051,Pend Oreille County,,WA,1512,15560,17072,7,5,12,10772,11370,22142,5,0.337471,0.350353,0.1,0.001305,0.000758,45,0.0001,0,10,0.97619,0.013394
20085,Jackson County,,KS,1068,15989,17057,8,9,17,8914,9624,18538,6,0.326357,0.337538,6.579467,0.000289,0.000501,14,0.000134,0,10,0.763889,0.002568
21225,Union County,,KY,977,16078,17055,6,7,13,5087,6852,11939,6,0.324598,0.336594,227.369309,0.000119,0.000395,42,0.000126,0,10,0.714286,0.001149
55077,Marquette County,,WI,1247,15784,17031,15,11,26,13426,12132,25558,5,0.328065,0.340088,1.3235,0.001516,0.000682,8,0.000147,0,10,0.883333,0.01374
48415,Scurry County,,TX,1560,15450,17010,13,12,25,5921,7711,13632,5,0.353673,0.370877,501.31744,0.001801,0.001832,62,0.000177,0,10,0.67033,0.018676
13229,Pierce County,,GA,1301,15694,16995,9,9,18,14023,11657,25680,6,0.332576,0.346463,419.210192,0.000635,0.000641,5,0.000149,0,10,0.666667,0.006456
19197,Wright County,,IA,1057,15874,16931,9,9,18,4873,5838,10711,6,0.316734,0.327707,380.25677,0.000335,0.000286,8,0.000152,0,10,0.477778,0.003277
20001,Allen County,,KS,1124,15772,16896,9,12,21,4685,6590,11275,6,0.328662,0.340755,4876.732471,0.000614,0.000642,14,0.00019,0,10,0.545455,0.005765
51005,Alleghany County,,VA,744,16151,16895,6,8,14,4976,5772,10748,6,0.292321,0.302403,3521.328602,0.000078,0.000101,37,0.00016,0,10,0.357143,0.000875
48281,Lampasas County,,TX,1645,15209,16854,11,12,23,19406,16391,35797,5,0.360733,0.378483,80.900268,0.002934,0.003643,62,0.000139,0,10,0.833333,0.030854
48287,Lee County,,TX,1029,15823,16852,10,11,21,10053,9494,19547,5,0.354162,0.370882,2.455997,0.001392,0.001885,62,0.00014,0,10,0.772727,0.015562
16045,Gem County,,ID,1323,15513,16836,5,6,11,12053,12845,24898,6,0.313629,0.32436,3.110985,0.000259,0.0003,45,0.000123,0,10,0.642857,0.003013
55129,Washburn County,,WI,1075,15751,16826,13,12,25,9051,8681,17732,5,0.334969,0.348796,12.654933,0.000869,0.000936,39,0.000163,0,10,0.846154,0.008706
45017,Calhoun County,,SC,957,15860,16817,4,3,7,11170,11318,22488,6,0.31657,0.327252,0,0.000747,0.000494,37,0.000077,0,10,1,0.007815
51101,King William County,,VA,1016,15775,16791,11,11,22,15594,12366,27960,6,0.317093,0.330132,8.988323,0.000946,0.001012,13,0.000148,0,10,0.754545,0.00971
13231,Pike County,,GA,1304,15458,16762,11,10,21,18912,14317,33229,6,0.332864,0.346647,1.889103,0.001399,0.00115,6,0.000132,0,10,0.881818,0.0145
8093,Park County,,CO,2066,14695,16761,15,15,30,19429,15753,35182,5,0.363163,0.380881,6.90747,0.002908,0.003192,35,0.000164,0,10,0.8875,0.031013
48289,Leon County,,TX,1426,15335,16761,14,12,26,12335,10759,23094,5,0.35351,0.370166,10.501073,0.002051,0.002087,62,0.000162,0,10,0.769231,0.0221
49051,Wasatch County,,UT,1265,15488,16753,13,11,24,26584,21167,47751,5,0.363121,0.380447,19.517107,0.003386,0.001939,45,0.000134,0,10,0.901099,0.03249
51125,Nelson County,,VA,1031,15699,16730,8,8,16,8285,8368,16653,6,0.296439,0.306961,33.21395,0.000694,0.000259,13,0.000123,0,10,0.638889,0.006743
19037,Chickasaw County,,IA,742,15977,16719,7,10,17,4757,5732,10489,6,0.316832,0.328,19.674322,0.000081,0.000349,8,0.000119,0,10,0.622222,0.001053
51790,Staunton city,,VA,1509,15093,16602,11,9,20,21302,21219,42521,6,0.334204,0.348975,102.874408,0.001442,0.000936,13,0.00015,0,10,0.809091,0.013878
22027,Claiborne Parish,,LA,828,15763,16591,9,10,19,6696,8036,14732,5,0.344626,0.359972,11.739356,0.000354,0.000764,12,0.000123,0,10,0.722222,0.003458
47091,Johnson County,,TN,746,15836,16582,6,6,12,4011,4473,8484,6,0.29124,0.301242,17.397907,0.000156,0.00017,51,0.000126,0,10,0.5,0.002047
1041,Crenshaw County,,AL,940,15635,16575,7,6,13,8935,9076,18011,6,0.308496,0.319249,0.9594,0.000322,0.000258,6,0.000103,0,10,0.738095,0.003201
21233,Webster County,,KY,1155,15414,16569,5,6,11,8556,9957,18513,6,0.296726,0.306624,25.507778,0.00012,0.000082,42,0.000104,0,10,0.766667,0.001089
40073,Kingfisher County,,OK,1037,15523,16560,6,8,14,7982,9373,17355,6,0.327157,0.339296,1.695929,0.000522,0.000834,52,0.000106,0,10,0.892857,0.005505
51127,New Kent County,,VA,1094,15456,16550,12,10,22,20078,12941,33019,6,0.317028,0.329915,2.851155,0.001204,0.001075,13,0.000145,0,10,0.818182,0.012004
37041,Chowan County,,NC,922,15627,16549,10,7,17,5441,5277,10718,6,0.327995,0.341168,26.135781,0.001353,0.000569,13,0.000145,0,10,0.633333,0.012999
48063,Camp County,,TX,1477,15064,16541,12,12,24,9946,10270,20216,5,0.34657,0.36231,2.960807,0.001414,0.001148,62,0.000147,0,10,0.833333,0.014903
21025,Breathitt County,,KY,737,15797,16534,6,9,15,2207,3025,5232,6,0.316407,0.327322,6815.637156,0.000223,0.000216,42,0.000165,0,10,0.402778,0.00218
13211,Morgan County,,GA,1099,15432,16531,14,12,26,13896,11137,25033,6,0.336879,0.351188,7.283677,0.002032,0.001682,6,0.000157,0,10,0.82967,0.020067
51630,Fredericksburg city,,VA,3359,13160,16519,22,24,46,52837,55515,108352,5,0.361965,0.381613,63.695898,0.004731,0.005028,13,0.000184,0,10,0.751667,0.045371
26001,Alcona County,,MI,1124,15381,16505,8,8,16,7515,5144,12659,6,0.332288,0.346582,1.167857,0.001348,0.001102,43,0.00009,0,10,0.875,0.010354
48239,Jackson County,,TX,1133,15339,16472,8,9,17,8524,9245,17769,5,0.354653,0.371181,0.20202,0.001603,0.001914,62,0.000111,0,10,0.972222,0.017256
17129,Menard County,,IL,1127,15341,16468,5,5,10,9629,9116,18745,6,0.301117,0.310482,33.385671,0.000597,0.000084,8,0.000098,0,10,0.733333,0.005555
13241,Rabun County,,GA,865,15590,16455,9,7,16,4674,4269,8943,6,0.333478,0.34707,3.456284,0.001853,0.000997,6,0.000118,0,10,0.744444,0.018494
21191,Pendleton County,,KY,1050,15395,16445,7,7,14,13693,12950,26643,6,0.324564,0.335954,15.24854,0.000492,0.000451,42,0.000122,0,10,0.714286,0.004435
16049,Idaho County,,ID,1157,15251,16408,12,9,21,5613,6540,12153,5,0.319302,0.330718,815.400407,0.000982,0.000573,45,0.000194,0,10,0.598485,0.010424
19165,Shelby County,,IA,839,15566,16405,6,10,16,5097,5747,10844,5,0.328978,0.340647,32.475088,0.000281,0.000596,50,0.000122,0,10,0.644444,0.002807
13083,Dade County,,GA,1136,15235,16371,6,6,12,10831,11255,22086,6,0.30999,0.320464,1.67348,0.00023,0.000235,51,0.000109,0,10,0.8,0.002601
29117,Livingston County,,MO,1064,15305,16369,10,13,23,5937,6180,12117,6,0.32926,0.342041,51.7338,0.000551,0.001021,14,0.00017,0,10,0.608974,0.005514
5089,Marion County,,AR,1371,14995,16366,6,5,11,7537,8917,16454,6,0.308589,0.318408,248.182878,0.000721,0.000312,52,0.000115,0,10,0.589286,0.00719
27113,Pennington County,,MN,1147,15213,16360,11,11,22,7472,8508,15980,5,0.335664,0.349121,1522.453139,0.000706,0.000859,39,0.000177,0,10,0.659091,0.006869
54001,Barbour County,,WV,806,15540,16346,6,6,12,6528,6709,13237,6,0.291378,0.300993,1.566667,0.000086,0.000046,41,0.000144,0,10,0.866667,0.000802
51135,Nottoway County,,VA,1000,15341,16341,8,9,17,7438,7761,15199,6,0.312481,0.324615,4.230379,0.000607,0.000671,13,0.000134,0,10,0.791667,0.006406
27143,Sibley County,,MN,1021,15293,16314,10,11,21,9006,9719,18725,5,0.333478,0.346517,2.936224,0.000665,0.00083,39,0.000128,0,10,0.836364,0.006469
17139,Moultrie County,,IL,1026,15282,16308,6,9,15,10846,10253,21099,6,0.314143,0.324517,4.237282,0.000256,0.000275,8,0.000101,0,10,0.722222,0.002098
55007,Bayfield County,,WI,1034,15246,16280,7,7,14,6365,6536,12901,5,0.334604,0.347792,0.575,0.000724,0.000698,39,0.000106,0,10,0.928571,0.006881
48093,Comanche County,,TX,1271,14993,16264,7,8,15,6244,6639,12883,5,0.346923,0.362229,2.758334,0.001025,0.001089,62,0.00011,0,10,0.821429,0.010479
21207,Russell County,,KY,740,15517,16257,8,6,14,5517,5292,10809,6,0.316799,0.327566,50.03542,0.000878,0.000265,42,0.000154,0,10,0.638889,0.008377
13251,Screven County,,GA,925,15329,16254,6,6,12,6743,7883,14626,6,0.317684,0.328847,9.562691,0.000514,0.000535,5,0.00011,0,10,0.766667,0.005268
8071,Las Animas County,,CO,1183,15069,16252,9,11,20,4703,6260,10963,5,0.341903,0.355811,66.869468,0.002086,0.001912,35,0.000133,0,10,0.704545,0.02146
53055,San Juan County,,WA,1076,15147,16223,10,8,18,7500,6583,14083,5,0.338998,0.352968,0,0.003062,0.00184,45,0.000105,0,10,1,0.030206
5133,Sevier County,,AR,1191,15029,16220,6,11,17,5135,6530,11665,6,0.319967,0.331706,58.802946,0.000069,0.000477,62,0.000114,0,10,0.654545,0.000981
29135,Moniteau County,,MO,978,15227,16205,8,9,17,9025,9096,18121,6,0.322825,0.334559,1.169048,0.000449,0.000563,14,0.00013,0,10,0.875,0.004408
45081,Saluda County,,SC,819,15373,16192,9,9,18,12019,13859,25878,6,0.320167,0.3331,15.2691,0.00065,0.001043,37,0.000126,0,10,0.566667,0.007281
27033,Cottonwood County,,MN,856,15324,16180,9,11,20,3133,3892,7025,5,0.335481,0.349094,266.833625,0.000388,0.000686,39,0.000145,0,10,0.5,0.004038
31013,Box Butte County,,NE,1144,15033,16177,4,9,13,2011,3109,5120,5,0.328135,0.339497,93.937246,0.000178,0.000484,35,0.000105,0,10,0.555556,0.001534
48131,Duval County,,TX,943,15209,16152,6,7,13,6158,8454,14612,5,0.35282,0.368712,0,0.001252,0.001391,62,0.00009,0,10,1,0.012912
35053,Socorro County,,NM,1465,14681,16146,7,8,15,6471,9242,15713,5,0.361072,0.377653,0,0.001127,0.001262,35,0.000099,0,10,1,0.011585
21069,Fleming County,,KY,720,15412,16132,7,7,14,5846,5812,11658,6,0.316342,0.326969,243.828639,0.00023,0.000207,42,0.000168,0,10,0.547619,0.002341
2130,Ketchikan Gateway Borough,,AK,1577,14530,16107,9,13,22,3588,5570,9158,5,0.36355,0.381315,102.536632,0.001468,0.002721,45,0.00013,0,10,0.704762,0.014571
48343,Morris County,,TX,1124,14983,16107,11,13,24,11030,11378,22408,5,0.353713,0.370546,15.241005,0.001555,0.002006,62,0.000137,0,10,0.852564,0.016256
8003,Alamosa County,,CO,1762,14336,16098,11,14,25,9732,11206,20938,5,0.363507,0.381152,4348.007651,0.002093,0.002903,35,0.000167,0,10,0.620879,0.021559
48165,Gaines County,,TX,1281,14805,16086,9,9,18,6152,6851,13003,6,0.30452,0.316667,18.811727,0.000302,0.000375,62,0.00016,0,10,0.533333,0.003679
12065,Jefferson County,,FL,1197,14865,16062,8,7,15,8873,9260,18133,6,0.331821,0.345296,2.33349,0.001256,0.00075,5,0.000119,0,10,0.805556,0.011948
35007,Colfax County,,NM,1193,14869,16062,7,12,19,2135,4740,6875,5,0.362563,0.37985,2822.379001,0.000826,0.001705,35,0.000115,0,10,0.545455,0.00835
19075,Grundy County,,IA,900,15111,16011,6,8,14,7830,7399,15229,6,0.316962,0.327789,29.589575,0.000266,0.000368,8,0.000111,0,10,0.785714,0.002687
2050,Bethel Census Area,,AK,905,15097,16002,5,7,12,5137,8999,14136,5,0.322384,0.333588,3.297588,0.000491,0.000497,45,0.000093,0,10,0.690476,0.004781
31037,Colfax County,,NE,1134,14797,15931,12,8,20,5494,8671,14165,6,0.324051,0.334804,80.107477,0.001469,0.000406,50,0.000179,0,10,0.651515,0.013757
21119,Knott County,,KY,835,15086,15921,4,6,10,5511,6139,11650,6,0.316636,0.327241,0.869048,0.000223,0.000219,42,0.000094,0,10,0.9,0.002084
4012,La Paz County,,AZ,1567,14329,15896,12,12,24,10864,11977,22841,5,0.368611,0.386957,0,0.004096,0.003833,45,0.000118,0,10,0.99359,0.040003
48279,Lamb County,,TX,1282,14614,15896,5,10,15,7162,9796,16958,5,0.347787,0.363813,103.404132,0.000156,0.00121,62,0.000106,0,10,0.688889,0.00154
16047,Gooding County,,ID,1376,14479,15855,8,8,16,10832,13740,24572,6,0.315045,0.326177,210.9999,0.000866,0.000376,45,0.000124,0,10,0.763889,0.009204
47061,Grundy County,,TN,731,15097,15828,5,6,11,6067,6016,12083,6,0.312417,0.3234,1.088034,0.000217,0.000406,51,0.00011,0,10,0.833333,0.002467
19119,Lyon County,,IA,771,15044,15815,5,5,10,3933,4933,8866,6,0.300528,0.31071,120.519458,0.00012,0.000109,50,0.000116,0,10,0.533333,0.001389
1035,Conecuh County,,AL,939,14867,15806,8,9,17,5906,7273,13179,6,0.323982,0.337104,0.869048,0.000769,0.001043,6,0.000109,0,10,0.916667,0.007899
1119,Sumter County,,AL,935,14867,15802,7,9,16,3613,6193,9806,6,0.322046,0.334945,25.025049,0.000732,0.00093,6,0.000108,0,10,0.7,0.006201
47087,Jackson County,,TN,962,14839,15801,9,8,17,7464,7996,15460,6,0.328521,0.340641,244.936504,0.000409,0.000449,51,0.000201,0,10,0.527778,0.005247
28065,Jefferson Davis County,,MS,920,14874,15794,10,10,20,7273,9239,16512,5,0.318672,0.330257,7.873874,0.000593,0.000406,12,0.000136,0,10,0.863636,0.005122
51007,Amelia County,,VA,964,14802,15766,8,8,16,10897,9122,20019,6,0.31229,0.324181,2.961193,0.000606,0.000663,13,0.000135,0,10,0.785714,0.006409
22091,St. Helena Parish,,LA,1102,14655,15757,8,7,15,12687,13939,26626,5,0.351769,0.3676,49.88245,0.001488,0.001156,12,0.000102,0,10,0.875,0.013255
38099,Walsh County,,ND,945,14752,15697,4,5,9,3742,5440,9182,5,0.335188,0.3479,63.693077,0.000298,0.000478,39,0.000105,0,10,0.633333,0.003073
48487,Wilbarger County,,TX,1176,14491,15667,6,8,14,4763,5912,10675,5,0.347669,0.36346,3162.943379,0.001017,0.001509,62,0.0001,0,10,0.571429,0.010297
48371,Pecos County,,TX,1505,14142,15647,13,12,25,5497,7016,12513,5,0.357209,0.374571,399.77054,0.002399,0.00218,62,0.000185,0,10,0.690476,0.024876
46127,Union County,,SD,1635,14003,15638,11,8,19,14921,11535,26456,5,0.328873,0.340647,55.407456,0.001361,0.000485,8,0.000164,0,10,0.537879,0.012585
56009,Converse County,,WY,1591,14046,15637,10,11,21,7593,8334,15927,5,0.31693,0.328098,11.968811,0.000291,0.000571,35,0.000156,0,10,0.827273,0.003675
51051,Dickenson County,,VA,617,15013,15630,5,6,11,3623,4400,8023,6,0.284919,0.29439,896.818221,0.000007,0.00006,51,0.000145,0,10,0.5,0.000351
54087,Roane County,,WV,842,14780,15622,5,5,10,5183,6093,11276,6,0.297357,0.307123,198.219754,0.000114,0.000086,41,0.000123,0,10,0.6,0.001098
21203,Rockcastle County,,KY,753,14833,15586,7,7,14,6505,7607,14112,6,0.31657,0.327121,67.21645,0.000254,0.000239,42,0.000148,0,10,0.738095,0.002663
31151,Saline County,,NE,1239,14328,15567,8,6,14,7377,9259,16636,6,0.323505,0.333946,236.26196,0.000958,0.000351,50,0.000156,0,10,0.472222,0.008934
16043,Fremont County,,ID,1421,14144,15565,9,11,20,8658,10998,19656,5,0.332144,0.345475,4.87544,0.000879,0.000974,45,0.000121,0,10,0.845455,0.008515
19007,Appanoose County,,IA,915,14649,15564,7,9,16,3037,3816,6853,6,0.316407,0.327268,722.566437,0.000211,0.000216,8,0.000172,0,10,0.411111,0.002345
21033,Caldwell County,,KY,860,14647,15507,6,8,14,5708,5648,11356,6,0.325389,0.337728,400.53992,0.000157,0.000463,52,0.000137,0,10,0.553571,0.001706
19069,Franklin County,,IA,858,14636,15494,7,7,14,4033,5346,9379,6,0.316636,0.327327,125.702379,0.000709,0.000276,8,0.000119,0,10,0.642857,0.006621
26097,Mackinac County,,MI,1229,14261,15490,11,12,23,4127,4999,9126,6,0.353022,0.370025,3246.339529,0.002326,0.002005,43,0.000119,0,10,0.527473,0.019196
47181,Wayne County,,TN,657,14813,15470,6,7,13,4170,4726,8896,6,0.328521,0.34056,8.416781,0.000376,0.000467,51,0.000127,0,10,0.535714,0.004189
8099,Prowers County,,CO,1308,14153,15461,6,12,18,2205,4448,6653,5,0.341144,0.35478,12324.150204,0.000486,0.002086,35,0.000207,0,10,0.590909,0.005068
21147,McCreary County,,KY,696,14734,15430,4,5,9,3087,4260,7347,6,0.316245,0.326563,31.758136,0.000013,0.000219,42,0.000127,0,10,0.5,0.00045
51079,Greene County,,VA,1154,14272,15426,10,10,20,14316,12655,26971,6,0.296754,0.307612,9.73399,0.00099,0.000285,13,0.000133,0,10,0.69697,0.009784
8081,Moffat County,,CO,1253,14164,15417,10,15,25,4776,6004,10780,5,0.364543,0.382563,474.433342,0.001733,0.003246,35,0.000134,0,10,0.775,0.018305
17185,Wabash County,,IL,800,14600,15400,7,6,13,3803,4380,8183,6,0.296611,0.30638,1499.784082,0.00009,0.000064,42,0.000158,0,10,0.5,0.001028
48163,Frio County,,TX,1016,14305,15321,6,10,16,5935,7831,13766,5,0.356877,0.373975,64.130771,0.001363,0.002153,62,0.000111,0,10,0.777778,0.014227
48003,Andrews County,,TX,1198,14091,15289,8,8,16,6513,7438,13951,5,0.353632,0.370193,79.981441,0.001434,0.001321,62,0.000124,0,10,0.9,0.01479
29151,Osage County,,MO,758,14508,15266,9,7,16,6006,6334,12340,6,0.32926,0.341309,31.517478,0.000565,0.000491,14,0.000136,0,10,0.791667,0.005208
37187,Washington County,,NC,809,14451,15260,7,7,14,3852,5818,9670,6,0.32789,0.341005,631.776499,0.000527,0.000557,37,0.00015,0,10,0.589286,0.005688
29067,Douglas County,,MO,990,14237,15227,8,8,16,6352,8227,14579,6,0.30949,0.319504,2.648368,0.000205,0.000245,14,0.000151,0,10,0.803571,0.002869
5087,Madison County,,AR,1081,14132,15213,4,3,7,11727,11417,23144,6,0.308001,0.31735,0,0.000248,0.000288,52,0.000093,0,10,1,0.003049
51037,Charlotte County,,VA,801,14378,15179,6,9,15,4185,5507,9692,6,0.308093,0.320486,36.202027,0.000041,0.000468,13,0.00012,0,10,0.625,0.000676
28161,Yalobusha County,,MS,950,14226,15176,7,7,14,8355,9049,17404,6,0.330607,0.343278,106.248135,0.000461,0.000476,52,0.000125,0,10,0.809524,0.004861
29065,Dent County,,MO,963,14200,15163,10,7,17,5102,5334,10436,6,0.330394,0.342936,297.422357,0.000658,0.000605,14,0.000145,0,10,0.618182,0.006406
38079,Rolette County,,ND,685,14465,15150,6,8,14,3361,4826,8187,5,0.304822,0.315446,1611.067161,0.000215,0.000187,39,0.000138,0,10,0.553571,0.002249
51147,Prince Edward County,,VA,1218,13918,15136,12,12,24,10145,10682,20827,6,0.334568,0.349788,519.457008,0.000737,0.001135,13,0.000183,0,10,0.489011,0.007987
1029,Cleburne County,,AL,930,14185,15115,7,6,13,9923,9443,19366,6,0.283657,0.293674,5.304585,0.000232,0.000122,6,0.00011,0,10,0.571429,0.002827
31041,Custer County,,NE,916,14186,15102,6,7,13,2466,3868,6334,6,0.324256,0.334966,81.424799,0.000223,0.0004,50,0.000127,0,10,0.803571,0.002089
37185,Warren County,,NC,991,14084,15075,8,9,17,10668,12491,23159,6,0.328275,0.341819,3.32653,0.000709,0.001115,37,0.000115,0,10,0.805556,0.007745
5081,Little River County,,AR,1087,13972,15059,6,6,12,6368,7152,13520,6,0.280522,0.290207,2.89537,0.000073,0.000063,62,0.000107,0,10,0.766667,0.000994
13159,Jasper County,,GA,1122,13936,15058,12,12,24,14095,11356,25451,6,0.335958,0.350098,2.690973,0.001766,0.001682,6,0.000139,0,10,0.858974,0.018029
20115,Marion County,,KS,812,14231,15043,6,10,16,5456,6202,11658,6,0.329649,0.341531,182.611711,0.000279,0.000614,14,0.000106,0,10,0.755556,0.002629
48387,Red River County,,TX,1026,14017,15043,7,6,13,6821,7282,14103,5,0.346063,0.361236,1.183611,0.000957,0.000981,62,0.000104,0,10,0.833333,0.009817
48115,Dawson County,,TX,1204,13820,15024,6,11,17,4567,6483,11050,5,0.350165,0.366895,182.899246,0.000257,0.001696,62,0.000132,0,10,0.645455,0.002985
1037,Coosa County,,AL,1219,13792,15011,7,8,15,11684,11900,23584,6,0.319933,0.331624,2.822194,0.000601,0.000652,6,0.000103,0,10,0.875,0.005722
13161,Jeff Davis County,,GA,881,14126,15007,7,6,13,5651,5442,11093,6,0.26818,0.276411,43.834878,0.000028,0.000023,5,0.000166,0,10,0.428571,0.000636
19081,Hancock County,,IA,900,14086,14986,5,7,12,5246,5944,11190,6,0.318474,0.329091,2.452808,0.000219,0.000343,8,0.000101,0,10,0.714286,0.002228
29133,Mississippi County,,MO,940,14021,14961,4,5,9,5269,6600,11869,6,0.328978,0.340658,0,0.000033,0.000361,14,0.000097,0,10,1,0.000507
26141,Presque Isle County,,MI,801,14145,14946,6,7,13,5001,4545,9546,6,0.331821,0.346012,0.154762,0.001251,0.001155,43,0.000079,0,10,0.946429,0.00976
51735,Poquoson city,,VA,1295,13648,14943,4,7,11,9388,8891,18279,6,0.335225,0.350005,0,0.000868,0.00138,13,0.000069,0,10,1,0.007789
54007,Braxton County,,WV,617,14312,14929,5,8,13,3148,3478,6626,6,0.299182,0.309814,3504.352818,0.000101,0.000123,41,0.000146,0,10,0.5,0.001045
30035,Glacier County,,MT,1050,13850,14900,9,11,20,3878,5490,9368,6,0.295954,0.307737,92.920778,0.000359,0.000394,45,0.000158,0,10,0.7,0.004114
48299,Llano County,,TX,1310,13554,14864,13,12,25,15013,12025,27038,5,0.357126,0.374517,76.539994,0.0029,0.002714,62,0.000172,0,10,0.774725,0.031014
54091,Taylor County,,WV,674,14172,14846,5,5,10,9166,8603,17769,6,0.291323,0.300776,0.5,0.000085,0.000046,41,0.00012,0,10,0.9,0.000737
29039,Cedar County,,MO,1035,13808,14843,8,9,17,6926,7609,14535,6,0.322249,0.333746,16.491441,0.000461,0.000498,14,0.00014,0,10,0.680556,0.004796
38071,Ramsey County,,ND,1061,13772,14833,9,7,16,4771,6229,11000,5,0.304792,0.315283,1580.695122,0.000217,0.000187,39,0.000222,0,10,0.472222,0.002433
51029,Buckingham County,,VA,669,14162,14831,8,9,17,6115,6009,12124,6,0.31264,0.324832,89.255149,0.000636,0.000859,13,0.000127,0,10,0.588889,0.00666
40023,Choctaw County,,OK,1084,13743,14827,7,7,14,6826,7345,14171,5,0.345091,0.360308,36.274349,0.001035,0.000797,62,0.000113,0,10,0.732143,0.010457
28015,Carroll County,,MS,1130,13691,14821,7,7,14,7845,7856,15701,6,0.331499,0.344607,65.020209,0.000502,0.000519,52,0.000111,0,10,0.732143,0.004797
22059,La Salle Parish,,LA,782,14030,14812,6,6,12,4884,4997,9881,6,0.292488,0.302734,6.92281,0.000125,0.000099,12,0.000119,0,10,0.633333,0.001304
16079,Shoshone County,,ID,1248,13552,14800,5,10,15,5346,7171,12517,5,0.338923,0.353011,25.439797,0.000724,0.000992,45,0.000086,0,10,0.466667,0.007371
19189,Winnebago County,,IA,978,13818,14796,7,11,18,4607,5491,10098,5,0.341561,0.35625,304.47564,0.000224,0.000825,8,0.000123,0,10,0.445455,0.002392
5017,Chicot County,,AR,1228,13564,14792,8,9,17,4972,6864,11836,5,0.345285,0.360905,200.468741,0.000329,0.000751,52,0.00013,0,10,0.5,0.003322
51043,Clarke County,,VA,1220,13567,14787,9,10,19,15401,12462,27863,6,0.333659,0.348242,0.511596,0.001132,0.001181,13,0.000116,0,10,0.933333,0.010984
51103,Lancaster County,,VA,711,14046,14757,9,8,17,3741,3571,7312,6,0.334167,0.348812,734.850329,0.001267,0.000963,13,0.000135,0,10,0.677778,0.012537
29139,Montgomery County,,MO,970,13747,14717,10,10,20,8419,8861,17280,6,0.329472,0.34196,4.389111,0.000713,0.00066,14,0.000148,0,10,0.755556,0.006625
54031,Hardy County,,WV,648,14067,14715,10,9,19,5526,5366,10892,6,0.278261,0.288222,60.313747,0.000125,0.000123,13,0.000175,0,10,0.488889,0.001805
27075,Lake County,,MN,749,13959,14708,4,6,10,4651,4783,9434,5,0.333261,0.345649,1.522092,0.000621,0.000772,39,0.000094,0,10,0.833333,0.005767
1085,Lowndes County,,AL,994,13713,14707,5,6,11,9210,12155,21365,6,0.319534,0.330849,0.424296,0.000275,0.000485,6,0.000085,0,10,0.9,0.002605
26071,Iron County,,MI,729,13972,14701,5,5,10,1786,2137,3923,6,0.291655,0.302078,25.426438,0.000593,0.000098,8,0.000101,0,10,0.633333,0.005702
21031,Butler County,,KY,766,13934,14700,7,8,15,6363,6821,13184,6,0.324016,0.33597,5.820268,0.000385,0.000391,42,0.000138,0,10,0.714286,0.003917
5141,Van Buren County,,AR,1010,13677,14687,10,9,19,7457,8011,15468,6,0.318078,0.328803,64.148765,0.000356,0.000321,52,0.000165,0,10,0.666667,0.004066
19137,Montgomery County,,IA,956,13723,14679,6,7,13,4006,4485,8491,6,0.325286,0.336659,1768.704271,0.00028,0.000448,50,0.000141,0,10,0.595238,0.002769
18111,Newton County,,IN,1257,13387,14644,9,10,19,12119,11751,23870,5,0.357459,0.373991,53.076328,0.000969,0.001178,8,0.000112,0,10,0.688889,0.008242
8051,Gunnison County,,CO,1869,12770,14639,15,17,32,6156,8009,14165,5,0.367025,0.385683,4.884233,0.003225,0.004052,35,0.000161,0,10,0.931373,0.033689
22127,Winn Parish,,LA,949,13670,14619,7,9,16,4650,6215,10865,5,0.350565,0.366368,74.30165,0.00026,0.000746,12,0.000116,0,10,0.736111,0.002591
19025,Calhoun County,,IA,927,13691,14618,5,7,12,4314,4956,9270,6,0.31644,0.327002,90.594406,0.000217,0.00023,8,0.000101,0,10,0.642857,0.002178
21127,Lawrence County,,KY,767,13844,14611,10,8,18,6715,6072,12787,6,0.33475,0.349561,94.651192,0.000475,0.000615,42,0.000164,0,10,0.545455,0.004623
13023,Bleckley County,,GA,817,13757,14574,6,6,12,6609,6077,12686,6,0.302184,0.313086,3.306466,0.000256,0.000256,6,0.000131,0,10,0.8,0.002786
26085,Lake County,,MI,1188,13368,14556,12,10,22,8523,7471,15994,6,0.330358,0.344341,1.719648,0.001419,0.000748,43,0.00012,0,10,0.856061,0.011471
51131,Northampton County,,VA,736,13802,14538,3,4,7,4955,5083,10038,6,0.326045,0.338894,0,0.000673,0.000845,47,0.000067,0,10,0.916667,0.005968
21087,Green County,,KY,692,13823,14515,8,8,16,5038,5064,10102,6,0.32477,0.33686,39.855608,0.000431,0.000487,42,0.000156,0,10,0.694444,0.004456
21221,Trigg County,,KY,935,13537,14472,5,5,10,6037,5713,11750,6,0.326253,0.338569,7.693066,0.000356,0.000667,51,0.0001,0,10,0.8,0.00359
17035,Cumberland County,,IL,855,13616,14471,5,5,10,7258,7673,14931,6,0.273115,0.281315,6.919595,0.000028,0.000022,8,0.00011,0,10,0.55,0.00049
5061,Howard County,,AR,994,13458,14452,8,9,17,6379,7828,14207,6,0.3196,0.330919,142.083813,0.000284,0.000422,62,0.000132,0,10,0.644444,0.00297
48059,Callahan County,,TX,1342,13104,14446,6,8,14,11774,10827,22601,5,0.347551,0.363097,1.476984,0.001001,0.001144,62,0.000103,0,10,0.821429,0.010212
56015,Goshen County,,WY,1098,13322,14420,10,10,20,4784,5627,10411,5,0.316832,0.327854,3111.477207,0.000519,0.000508,35,0.000188,0,10,0.598485,0.00615
27165,Watonwan County,,MN,918,13479,14397,7,6,13,3587,4841,8428,5,0.333044,0.345459,15.375185,0.000571,0.000384,39,0.00011,0,10,0.642857,0.005814
8097,Pitkin County,,CO,1856,12522,14378,17,16,33,11228,14416,25644,5,0.380716,0.400374,5.411447,0.0053,0.005412,35,0.000151,0,10,0.909357,0.052142
21061,Edmonson County,,KY,758,13583,14341,6,7,13,8192,7758,15950,6,0.323675,0.335346,2.567763,0.000381,0.000386,42,0.000128,0,10,0.714286,0.003844
21135,Lewis County,,KY,699,13581,14280,6,6,12,4043,4750,8793,7,0.263623,0.271922,18.808084,0.000024,0.000022,42,0.00014,0,10,0.366667,0.000557
18125,Pike County,,IN,780,13493,14273,6,6,12,7825,8200,16025,6,0.296411,0.306109,0.581981,0.000116,0.000084,42,0.000117,0,10,0.9,0.001162
48389,Reeves County,,TX,1272,12993,14265,7,8,15,4398,6809,11207,5,0.339673,0.353906,13.811431,0.000463,0.001011,62,0.000126,0,10,0.736111,0.005131
38003,Barnes County,,ND,856,13406,14262,4,5,9,3486,4924,8410,5,0.301442,0.311583,11.991417,0.000098,0.000126,39,0.000137,0,10,0.7,0.001112
13221,Oglethorpe County,,GA,911,13336,14247,9,7,16,11743,9894,21637,6,0.298687,0.309218,7.882833,0.000564,0.000177,6,0.000142,0,10,0.625,0.005825
5135,Sharp County,,AR,1294,12898,14192,11,11,22,10229,10872,21101,6,0.318738,0.329915,527.669979,0.000664,0.000297,52,0.00019,0,10,0.5,0.006669
30027,Fergus County,,MT,936,13250,14186,6,7,13,3179,4283,7462,6,0.295925,0.307221,6189.640056,0.000326,0.000379,45,0.000118,0,10,0.738095,0.003432
21123,Larue County,,KY,984,13197,14181,7,8,15,11131,11134,22265,6,0.32477,0.33686,2.851297,0.00043,0.000489,42,0.000136,0,10,0.75,0.004414
51113,Madison County,,VA,894,13276,14170,9,7,16,8318,7267,15585,6,0.296582,0.307069,0.891391,0.001094,0.000275,13,0.000111,0,10,0.866667,0.010399
54023,Grant County,,WV,613,13549,14162,6,6,12,4632,4094,8726,6,0.291074,0.300857,66.003648,0.000027,0.000062,13,0.000136,0,10,0.571429,0.000718
48255,Karnes County,,TX,861,13296,14157,8,9,17,5214,6148,11362,5,0.354693,0.371235,0.942435,0.001614,0.001748,62,0.000112,0,10,0.847222,0.017032
8049,Grand County,,CO,1624,12519,14143,12,14,26,8894,8526,17420,5,0.363292,0.380935,0,0.002881,0.00331,35,0.000131,0,10,0.990476,0.030297
26079,Kalkaska County,,MI,1152,12971,14123,12,10,22,11597,10277,21874,6,0.33236,0.346908,4.440175,0.001789,0.001114,43,0.000126,0,10,0.856061,0.013967
19175,Union County,,IA,1005,13091,14096,8,9,17,5214,5453,10667,6,0.31657,0.327409,1660.409594,0.000214,0.000246,8,0.000187,0,10,0.344444,0.002362
20117,Marshall County,,KS,662,13425,14087,7,7,14,2182,3092,5274,6,0.32667,0.337755,177.309215,0.000473,0.000432,14,0.000133,0,10,0.52381,0.004421
22065,Madison Parish,,LA,905,13173,14078,10,9,19,3785,5386,9171,6,0.315984,0.32825,301.796956,0.001022,0.000363,12,0.00017,0,10,0.439394,0.009276
51081,Greensville County,,VA,819,13247,14066,8,10,18,5473,5052,10525,6,0.312735,0.325157,150.602253,0.000411,0.00071,13,0.000126,0,10,0.5,0.004392
1131,Wilcox County,,AL,757,13289,14046,7,7,14,4096,5541,9637,6,0.320601,0.332558,0.934524,0.000659,0.000596,6,0.000103,0,10,0.857143,0.005991
31039,Cuming County,,NE,888,13136,14024,7,8,15,3056,4261,7317,6,0.323914,0.334587,166.605311,0.000444,0.000387,50,0.000143,0,10,0.607143,0.004074
49027,Millard County,,UT,929,13074,14003,7,10,17,4978,6969,11947,5,0.349568,0.365511,56.95785,0.00163,0.001304,45,0.0001,0,10,0.863636,0.016121
19089,Howard County,,IA,701,13295,13996,6,8,14,2781,3349,6130,6,0.304732,0.315625,54.215614,0.000101,0.000221,8,0.000105,0,10,0.5,0.001104
31027,Cedar County,,NE,761,13219,13980,7,8,15,2300,3910,6210,6,0.32429,0.335075,99.793596,0.000446,0.000376,50,0.000133,0,10,0.714286,0.003959
28103,Noxubee County,,MS,613,13353,13966,3,5,8,2558,4280,6838,6,0.291876,0.302045,7.24802,0.000081,0.000075,52,0.000075,0,10,0.7,0.000559
29181,Ripley County,,MO,933,13018,13951,6,4,10,5108,5007,10115,7,0.254241,0.261299,86.767187,0.000055,0.000006,14,0.000166,0,10,0.266667,0.000844
31089,Holt County,,NE,773,13122,13895,4,6,10,1172,2729,3901,6,0.323982,0.334478,3092.934318,0.000434,0.000386,50,0.000087,0,10,0.566667,0.003723
28155,Webster County,,MS,821,13061,13882,6,8,14,4909,4965,9874,6,0.289729,0.3,32.153714,0.000038,0.000045,52,0.000125,0,10,0.375,0.000588
37137,Pamlico County,,NC,874,12999,13873,5,5,10,4939,6134,11073,6,0.32817,0.341032,0,0.000675,0.000731,37,0.000087,0,10,1,0.006951
48399,Runnels County,,TX,1194,12677,13871,5,6,11,4607,5860,10467,5,0.350165,0.366059,328.761341,0.000258,0.001117,62,0.000132,0,10,0.535714,0.002786
5011,Bradley County,,AR,801,13063,13864,7,8,15,3294,4311,7605,6,0.318111,0.328749,122.947359,0.000272,0.000289,52,0.000117,0,10,0.625,0.002784
46027,Clay County,,SD,1814,12041,13855,13,13,26,7656,10551,18207,5,0.369898,0.388205,349.725109,0.000662,0.001344,50,0.000242,0,10,0.62381,0.006609
30017,Custer County,,MT,1091,12743,13834,7,6,13,2819,3492,6311,6,0.290882,0.301991,3075.849172,0.000236,0.000293,45,0.000172,0,10,0.486111,0.002712
21011,Bath County,,KY,766,13051,13817,8,7,15,7500,7035,14535,6,0.316179,0.326725,237.590148,0.000229,0.000206,42,0.000196,0,10,0.678571,0.002417
51520,Bristol city,,VA,1495,12303,13798,7,5,12,20043,19745,39788,6,0.290359,0.299642,9.192952,0.000122,0.000133,51,0.000143,0,10,0.785714,0.001735
31145,Red Willow County,,NE,954,12841,13795,7,7,14,2716,4205,6921,6,0.324153,0.334885,6742.535402,0.000437,0.000382,50,0.000198,0,10,0.446429,0.003876
48455,Trinity County,,TX,1209,12575,13784,10,10,20,12482,11452,23934,5,0.352374,0.368604,3.747897,0.001033,0.001514,62,0.000132,0,10,0.881818,0.011977
19107,Keokuk County,,IA,763,12981,13744,8,9,17,5353,6225,11578,6,0.318672,0.329519,5.132873,0.000458,0.000421,8,0.000142,0,10,0.736111,0.004385
19161,Sac County,,IA,789,12940,13729,6,8,14,3595,3954,7549,6,0.316603,0.327382,44.350121,0.000222,0.000243,8,0.000113,0,10,0.589286,0.002355
19091,Humboldt County,,IA,721,13003,13724,4,6,10,3039,3727,6766,6,0.316407,0.326839,3.052118,0.000017,0.000227,8,0.000094,0,10,0.666667,0.000323
22123,West Carroll Parish,,LA,946,12739,13685,6,6,12,4686,6067,10753,6,0.290058,0.30032,15.242689,0.000093,0.000075,12,0.000131,0,10,0.466667,0.001064
20013,Brown County,,KS,804,12875,13679,8,10,18,3794,5287,9081,6,0.327017,0.338569,162.110592,0.000409,0.000519,14,0.00014,0,10,0.566667,0.00399
28053,Humphreys County,,MS,880,12771,13651,6,9,15,2842,4140,6982,6,0.300646,0.31173,2.468753,0.000176,0.000237,12,0.000096,0,10,0.75,0.001579
21197,Powell County,,KY,880,12746,13626,7,7,14,6481,7762,14243,6,0.316245,0.326834,1546.004511,0.000241,0.000218,42,0.000171,0,10,0.642857,0.002479
27089,Marshall County,,MN,719,12896,13615,7,9,16,4798,5459,10257,5,0.335261,0.348443,3106.856781,0.000496,0.00048,39,0.000131,0,10,0.819444,0.00481
29123,Madison County,,MO,852,12755,13607,9,9,18,6602,6672,13274,6,0.32919,0.341417,177.895741,0.000441,0.00042,14,0.000152,0,10,0.722222,0.004385
28111,Perry County,,MS,804,12798,13602,8,8,16,7315,8169,15484,5,0.31566,0.326796,7.069275,0.000394,0.000268,12,0.000121,0,10,0.75,0.003874
13099,Early County,,GA,717,12872,13589,5,7,12,3723,4429,8152,6,0.283316,0.294168,219.081424,0.000129,0.000136,5,0.000121,0,10,0.452381,0.001459
47039,Decatur County,,TN,723,12807,13530,7,7,14,5502,5202,10704,6,0.333587,0.347043,30.100777,0.000764,0.0008,52,0.000136,0,10,0.666667,0.00782
54063,Monroe County,,WV,627,12883,13510,4,4,8,5434,5259,10693,7,0.255277,0.263208,5.158772,0.000015,0.000009,41,0.00011,0,10,0.666667,0.000328
17087,Johnson County,,IL,914,12591,13505,10,9,19,6095,6294,12389,6,0.292627,0.302859,2908.531565,0.000578,0.000078,14,0.000199,0,10,0.488889,0.005823
35057,Torrance County,,NM,1476,12008,13484,5,5,10,10944,11753,22697,5,0.325114,0.33572,0,0.001025,0.000662,35,0.000085,0,10,1,0.010646
29017,Bollinger County,,MO,711,12762,13473,6,6,12,6995,7475,14470,6,0.279527,0.288428,2.285714,0.000048,0.000032,14,0.000116,0,10,0.642857,0.000755
27121,Pope County,,MN,730,12729,13459,8,7,15,5566,5382,10948,5,0.334276,0.347249,4.636353,0.000522,0.00065,39,0.000115,0,10,0.833333,0.004979
13093,Dooly County,,GA,806,12644,13450,5,6,11,6067,7004,13071,6,0.302184,0.31314,4.135171,0.000166,0.00026,6,0.000114,0,10,0.766667,0.00195
16041,Franklin County,,ID,877,12570,13447,8,7,15,6530,6409,12939,5,0.330785,0.342828,60.023819,0.000901,0.000822,45,0.000113,0,10,0.821429,0.008222
12041,Gilchrist County,,FL,1180,12262,13442,14,7,21,14810,12173,26983,5,0.344202,0.357807,0.618427,0.004002,0.001151,5,0.000142,0,10,0.950549,0.038535
12029,Dixie County,,FL,918,12519,13437,15,10,25,7407,7003,14410,5,0.347551,0.3625,4.509452,0.00376,0.002046,5,0.000158,0,10,0.866667,0.036671
48445,Terry County,,TX,1206,12183,13389,6,4,10,4989,6782,11771,6,0.301324,0.31205,19.256068,0.000569,0.000185,62,0.000116,0,10,0.690476,0.005792
18007,Benton County,,IN,1028,12329,13357,7,7,14,6891,7809,14700,6,0.325803,0.338553,29.975741,0.000525,0.000466,42,0.000111,0,10,0.535714,0.00463
21109,Jackson County,,KY,424,12895,13319,4,5,9,4238,4988,9226,6,0.316375,0.326633,1.028088,0.000028,0.000226,42,0.000109,0,10,0.85,0.000546
12045,Gulf County,,FL,1058,12253,13311,5,5,10,6218,7191,13409,6,0.316114,0.327203,1.083333,0.000471,0.000442,5,0.000105,0,10,0.8,0.004387
46079,Lake County,,SD,864,12437,13301,6,6,12,4462,5835,10297,6,0.300469,0.31071,13.408531,0.000171,0.000119,50,0.000155,0,10,0.47619,0.00202
28097,Montgomery County,,MS,775,12517,13292,5,9,14,4006,4910,8916,6,0.331678,0.345095,67.980915,0.000075,0.000581,52,0.000101,0,10,0.722222,0.00096
47161,Stewart County,,TN,970,12312,13282,5,5,10,7941,7382,15323,6,0.33011,0.342437,2.160289,0.000687,0.000739,51,0.000099,0,10,0.7,0.00707
18025,Crawford County,,IN,872,12399,13271,8,8,16,7560,7737,15297,6,0.323846,0.335699,41.613013,0.000373,0.00037,42,0.000137,0,10,0.660714,0.003873
19063,Emmet County,,IA,673,12571,13244,5,8,13,2474,3451,5925,6,0.316864,0.327762,20.263061,0.000021,0.000232,8,0.000104,0,10,0.5,0.000415
17079,Jasper County,,IL,632,12589,13221,4,6,10,3134,3948,7082,6,0.273529,0.282075,10.258664,0.000012,0.000021,8,0.000105,0,10,0.6,0.00032
51690,Martinsville city,,VA,1041,12173,13214,7,9,16,11445,12446,23891,6,0.328697,0.342871,151.826134,0.000333,0.000821,37,0.000106,0,10,0.666667,0.003507
30003,Big Horn County,,MT,742,12467,13209,4,4,8,4410,5661,10071,6,0.291849,0.302311,1.148125,0.000172,0.000176,45,0.000102,0,10,0.833333,0.002005
40063,Hughes County,,OK,1153,12037,13190,9,9,18,7447,8308,15755,6,0.327122,0.33935,1.668755,0.000753,0.00075,52,0.000139,0,10,0.861111,0.007708
54085,Ritchie County,,WV,582,12597,13179,5,5,10,3505,4551,8056,7,0.259372,0.26827,33.426119,0.000025,0.00001,41,0.000164,0,10,0.4,0.000381
27063,Jackson County,,MN,706,12472,13178,6,7,13,3566,3897,7463,5,0.335371,0.348497,31.147809,0.000032,0.000474,39,0.000111,0,10,0.5,0.000607
28069,Kemper County,,MS,781,12368,13149,4,3,7,4561,5038,9599,6,0.278085,0.287533,0.25,0.000051,0.000039,12,0.000093,0,10,0.75,0.000604
51133,Northumberland County,,VA,758,12386,13144,9,6,15,5813,4796,10609,6,0.310648,0.321739,875.844056,0.001525,0.000439,13,0.000128,0,10,0.666667,0.014683
31023,Butler County,,NE,744,12344,13088,8,8,16,4748,5533,10281,6,0.323573,0.334272,22.879569,0.000428,0.000375,50,0.000171,0,10,0.607143,0.004015
19131,Mitchell County,,IA,582,12491,13073,5,7,12,2829,2772,5601,6,0.316701,0.32762,39.544498,0.000026,0.000253,8,0.000103,0,10,0.428571,0.000496
40095,Marshall County,,OK,1006,12067,13073,11,11,22,8414,7929,16343,5,0.347629,0.36384,47.762306,0.001694,0.002154,52,0.00015,0,10,0.787879,0.017782
5049,Fulton County,,AR,1060,11991,13051,7,6,13,6551,6463,13014,6,0.284734,0.294634,42.663331,0.000055,0.000074,52,0.000153,0,10,0.380952,0.001189
27159,Wadena County,,MN,892,12155,13047,13,13,26,8380,9225,17605,5,0.334276,0.347982,6.311678,0.000626,0.000556,39,0.000172,0,10,0.838095,0.006235
40005,Atoka County,,OK,851,12169,13020,10,9,19,6246,6837,13083,6,0.327331,0.339676,371.788822,0.000643,0.00065,62,0.000168,0,10,0.577778,0.006849
13193,Macon County,,GA,857,12159,13016,8,8,16,4927,7027,11954,6,0.333478,0.347271,1210.843696,0.000661,0.000675,6,0.00015,0,10,0.553571,0.006728
48031,Blanco County,,TX,1249,11686,12935,10,9,19,8640,6887,15527,5,0.345518,0.3609,0.604798,0.001716,0.00147,62,0.000144,0,10,0.922222,0.019302
40011,Blaine County,,OK,1025,11898,12923,8,9,17,4958,6178,11136,6,0.325079,0.336784,38.159645,0.000386,0.00056,52,0.000146,0,10,0.555556,0.004354
19077,Guthrie County,,IA,861,12057,12918,6,7,13,7209,7489,14698,6,0.316342,0.326839,2.820736,0.000223,0.000248,8,0.000137,0,10,0.738095,0.002426
37103,Jones County,,NC,852,12037,12889,6,7,13,9495,8922,18417,6,0.332324,0.346267,0.180556,0.000628,0.001117,37,0.000088,0,10,0.910714,0.005873
21041,Carroll County,,KY,979,11893,12872,11,9,20,8201,8718,16919,6,0.323914,0.335943,58.566995,0.000471,0.000479,42,0.000201,0,10,0.454545,0.00507
49015,Emery County,,UT,899,11923,12822,3,8,11,4747,6661,11408,5,0.330216,0.342448,0.337541,0.000566,0.000727,45,0.000067,0,10,0.732143,0.005049
40103,Noble County,,OK,966,11849,12815,7,7,14,7888,8513,16401,6,0.327157,0.339187,1.475798,0.000681,0.000681,52,0.000111,0,10,0.857143,0.006919
12047,Hamilton County,,FL,902,11900,12802,7,8,15,6470,7552,14022,5,0.346219,0.36052,0.518168,0.001537,0.001663,5,0.000101,0,10,0.888889,0.014801
18101,Martin County,,IN,730,12048,12778,7,8,15,4340,5540,9880,6,0.326011,0.338851,2.163737,0.0005,0.000472,42,0.000114,0,10,0.803571,0.004672
21175,Morgan County,,KY,576,12185,12761,5,8,13,1978,2777,4755,6,0.316342,0.327105,456.316346,0.000006,0.000204,42,0.000147,0,10,0.347222,0.000326
27133,Rock County,,MN,694,12054,12748,3,6,9,3648,4182,7830,5,0.335225,0.348199,1.661003,0.00011,0.000464,50,0.000085,0,10,0.633333,0.001132
27151,Swift County,,MN,984,11763,12747,7,10,17,3351,4483,7834,5,0.333732,0.346788,1100.889754,0.000414,0.000607,39,0.000117,0,10,0.544444,0.004065
30085,Roosevelt County,,MT,760,11965,12725,4,5,9,1643,2535,4178,6,0.288749,0.299072,5.960119,0.000098,0.000107,45,0.000111,0,10,0.55,0.001317
51111,Lunenburg County,,VA,701,11991,12692,7,8,15,4992,5096,10088,6,0.312449,0.324452,127.849918,0.000395,0.000666,13,0.000123,0,10,0.785714,0.004187
48159,Franklin County,,TX,1044,11604,12648,10,13,23,9422,9038,18460,5,0.34657,0.362446,3.30095,0.001584,0.001848,62,0.00013,0,10,0.791209,0.016768
40077,Latimer County,,OK,1052,11563,12615,4,6,10,5444,6667,12111,6,0.327087,0.33897,2.116576,0.000304,0.000594,52,0.000095,0,10,0.833333,0.003354
19073,Greene County,,IA,800,11785,12585,8,7,15,3723,4794,8517,6,0.316407,0.326948,3.125397,0.000306,0.000253,8,0.000145,0,10,0.732143,0.002917
20131,Nemaha County,,KS,722,11829,12551,8,8,16,3003,3798,6801,6,0.326357,0.337429,29.760783,0.000477,0.000494,14,0.000139,0,10,0.652778,0.004491
13273,Terrell County,,GA,820,11730,12550,4,5,9,5356,6437,11793,6,0.278816,0.288688,39.935767,0.000098,0.000079,5,0.000092,0,10,0.5,0.000968
37143,Perquimans County,,NC,810,11706,12516,9,7,16,8776,6909,15685,6,0.332432,0.346946,11.34401,0.000921,0.001122,13,0.00013,0,10,0.736364,0.008559
5065,Izard County,,AR,979,11521,12500,6,6,12,5754,6067,11821,6,0.283578,0.293202,4.960055,0.00005,0.00007,52,0.000135,0,10,0.7,0.001072
6051,Mono County,,CA,1521,10972,12493,13,17,30,10281,11390,21671,5,0.364802,0.383485,2.885237,0.003711,0.004517,45,0.000113,0,10,0.867647,0.033478
56003,Big Horn County,,WY,948,11521,12469,6,7,13,3495,4932,8427,6,0.292627,0.303602,8.74894,0.000209,0.000238,45,0.000109,0,10,0.904762,0.002443
31033,Cheyenne County,,NE,797,11654,12451,8,9,17,1826,2422,4248,5,0.326461,0.337706,4875.030137,0.000549,0.000482,35,0.000206,0,10,0.454545,0.005081
40061,Haskell County,,OK,771,11678,12449,9,9,18,5233,5910,11143,6,0.327575,0.33992,2.512578,0.000645,0.000675,52,0.000141,0,10,0.822222,0.006924
30083,Richland County,,MT,756,11681,12437,7,8,15,2698,3282,5980,6,0.292265,0.303722,36.352135,0.000307,0.00028,45,0.00014,0,10,0.555556,0.003726
31081,Hamilton County,,NE,852,11574,12426,8,7,15,5764,6125,11889,6,0.324119,0.334831,4.53956,0.000459,0.000382,50,0.000159,0,10,0.732143,0.004138
48077,Clay County,,TX,1299,11100,12399,5,5,10,9626,9495,19121,5,0.346688,0.361778,0.927995,0.000847,0.00103,62,0.000096,0,10,0.833333,0.008976
13317,Wilkes County,,GA,642,11753,12395,6,9,15,1571,2673,4244,6,0.331356,0.344206,824.353281,0.000692,0.000789,37,0.000111,0,10,0.416667,0.006444
27101,Murray County,,MN,629,11764,12393,5,6,11,2543,3171,5714,5,0.335188,0.348145,6.859557,0.000119,0.000455,39,0.000105,0,10,0.833333,0.001322
30043,Jefferson County,,MT,1049,11337,12386,6,7,13,9377,8853,18230,6,0.294761,0.306006,5.925268,0.000339,0.000322,45,0.00011,0,10,0.833333,0.003563
37005,Alleghany County,,NC,620,11750,12370,6,6,12,2703,2721,5424,6,0.309241,0.319992,594.716113,0.000622,0.000272,37,0.000114,0,10,0.666667,0.006774
48475,Ward County,,TX,1196,11158,12354,9,8,17,5152,6233,11385,5,0.342475,0.357677,134.334742,0.001078,0.000791,62,0.000147,0,10,0.722222,0.011101
31137,Phelps County,,NE,789,11550,12339,8,10,18,3809,4406,8215,6,0.324393,0.335509,3323.24382,0.00019,0.000397,50,0.000179,0,10,0.522222,0.001905
21215,Spencer County,,KY,904,11420,12324,5,6,11,19642,13570,33212,6,0.323471,0.334912,0.4,0.000327,0.000345,42,0.000109,0,10,0.866667,0.00342
20029,Cloud County,,KS,862,11452,12314,7,9,16,11469,3339,14808,6,0.322587,0.333355,2819.946984,0.000253,0.000353,14,0.000139,0,10,0.444444,0.002434
19133,Monona County,,IA,755,11544,12299,4,5,9,3531,3646,7177,6,0.322927,0.332997,0.945351,0.000304,0.000288,8,0.000088,0,10,0.9,0.002735
13079,Crawford County,,GA,906,11350,12256,6,6,12,11094,10671,21765,6,0.301976,0.31276,1.085965,0.000258,0.000252,6,0.000106,0,10,0.866667,0.00274
29033,Carroll County,,MO,591,11655,12246,7,7,14,2951,3693,6644,6,0.321171,0.332172,4.659296,0.000402,0.000396,14,0.000118,0,10,0.595238,0.004094
51057,Essex County,,VA,676,11561,12237,14,12,26,5952,4905,10857,6,0.31264,0.325212,365.211859,0.000898,0.000791,13,0.000184,0,10,0.549451,0.009369
20027,Clay County,,KS,779,11455,12234,5,9,14,3533,3844,7377,6,0.330003,0.341857,45.4496,0.000203,0.00068,14,0.000094,0,10,0.708333,0.001972
2261,Valdez-Cordova Census Area,,AK,1301,10893,12194,6,6,12,5019,7723,12742,5,0.33926,0.352913,9.544341,0.000909,0.000927,45,0.000103,0,10,0.866667,0.008945
5127,Scott County,,AR,936,11234,12170,6,8,14,4673,5981,10654,6,0.315045,0.327083,17.911376,0.000071,0.000375,52,0.000115,0,10,0.571429,0.001096
13271,Telfair County,,GA,751,11335,12086,5,6,11,4048,5206,9254,6,0.29959,0.310428,121.751695,0.000036,0.000184,6,0.000133,0,10,0.4,0.000652
38055,McLean County,,ND,761,11287,12048,6,6,12,4714,5695,10409,6,0.303858,0.314236,4.080014,0.000168,0.000148,39,0.000174,0,10,0.833333,0.00188
48009,Archer County,,TX,1268,10763,12031,4,5,9,8796,8417,17213,5,0.346688,0.361778,0.75,0.000551,0.00103,62,0.000091,0,10,0.85,0.005676
29093,Iron County,,MO,850,11134,11984,9,10,19,6429,7240,13669,6,0.329049,0.341309,172.11386,0.000608,0.000413,14,0.00015,0,10,0.627273,0.005855
48507,Zavala County,,TX,873,11107,11980,5,5,10,4375,5619,9994,5,0.345363,0.360248,0,0.000898,0.000974,62,0.000098,0,10,1,0.009461
40149,Washita County,,OK,1026,10949,11975,6,8,14,8743,9254,17997,6,0.326253,0.338156,0.787933,0.00034,0.000601,52,0.000121,0,10,0.910714,0.00381
29223,Wayne County,,MO,827,11130,11957,13,10,23,5823,5887,11710,6,0.329296,0.341688,1818.489998,0.000816,0.00042,14,0.000208,0,10,0.576923,0.007866
19147,Palo Alto County,,IA,708,11246,11954,6,7,13,3113,3815,6928,6,0.316668,0.327327,314.779018,0.000216,0.000227,8,0.00011,0,10,0.595238,0.002215
6105,Trinity County,,CA,950,10970,11920,11,5,16,4994,5027,10021,5,0.327226,0.338563,0,0.002782,0.00057,45,0.000102,0,10,1,0.025736
8125,Yuma County,,CO,853,11063,11916,7,12,19,2490,3298,5788,5,0.341106,0.354639,111.641643,0.000535,0.002046,35,0.000122,0,10,0.704545,0.006104
21131,Leslie County,,KY,544,11304,11848,3,5,8,2128,3609,5737,6,0.265491,0.274544,1.463032,0.000014,0.000032,42,0.000088,0,10,0.65,0.000317
47101,Lewis County,,TN,727,11120,11847,6,7,13,4554,4818,9372,6,0.328275,0.34018,3.784608,0.000533,0.000626,51,0.000123,0,10,0.690476,0.006151
29137,Monroe County,,MO,777,11069,11846,6,6,12,4688,5896,10584,6,0.308124,0.317567,3.435091,0.00015,0.000121,14,0.000141,0,10,0.7,0.001501
30087,Rosebud County,,MT,963,10872,11835,5,6,11,3346,4684,8030,6,0.294733,0.305843,6.477829,0.000235,0.000282,45,0.000126,0,10,0.733333,0.002592
29079,Grundy County,,MO,788,11042,11830,8,9,17,3108,3298,6406,6,0.321608,0.333013,6166.31904,0.000389,0.000413,14,0.000185,0,10,0.555556,0.004057
29089,Howard County,,MO,819,10997,11816,5,5,10,6366,6743,13109,6,0.308124,0.317459,2.097946,0.000156,0.000124,14,0.000106,0,10,0.6,0.001471
20031,Coffey County,,KS,816,10989,11805,8,10,18,3263,4188,7451,6,0.328451,0.340213,1305.281241,0.000501,0.00063,14,0.000129,0,10,0.666667,0.004497
40099,Murray County,,OK,912,10863,11775,6,6,12,8399,7690,16089,6,0.324942,0.336241,0.4,0.000458,0.00046,52,0.00011,0,10,0.933333,0.004765
29025,Caldwell County,,MO,862,10882,11744,9,8,17,6889,7157,14046,6,0.321406,0.332633,2.137366,0.000491,0.000417,14,0.000152,0,10,0.833333,0.005079
40107,Okfuskee County,,OK,772,10943,11715,8,9,17,6651,7528,14179,6,0.327087,0.339296,1.47619,0.000606,0.000749,52,0.000133,0,10,0.861111,0.006406
19001,Adair County,,IA,729,10975,11704,6,6,12,3918,4734,8652,6,0.316082,0.326508,6.02549,0.00022,0.000218,8,0.000136,0,10,0.633333,0.002417
22021,Caldwell Parish,,LA,809,10894,11703,3,5,8,4288,4398,8686,6,0.289811,0.299778,1.166667,0.000076,0.000067,12,0.000093,0,10,0.7,0.000746
45005,Allendale County,,SC,664,11023,11687,5,6,11,3101,4882,7983,6,0.317881,0.329422,0.77125,0.000361,0.00083,37,0.000095,0,10,0.833333,0.003898
48505,Zapata County,,TX,567,11110,11677,4,5,9,3658,4241,7899,5,0.352739,0.368387,0,0.000723,0.001223,62,0.000079,0,10,1,0.007692
22025,Catahoula Parish,,LA,675,10990,11665,8,6,14,4172,4966,9138,6,0.314207,0.325184,57.624073,0.000718,0.000293,12,0.000134,0,10,0.638889,0.005762
5137,Stone County,,AR,776,10881,11657,7,10,17,2211,2848,5059,6,0.319401,0.330729,120.839745,0.000282,0.00042,52,0.000142,0,10,0.6,0.003233
5077,Lee County,,AR,883,10768,11651,7,8,15,3502,5671,9173,6,0.333986,0.347862,25.666775,0.000643,0.000731,52,0.000106,0,10,0.839286,0.006234
21219,Todd County,,KY,839,10805,11644,4,6,10,6607,7234,13841,6,0.313373,0.32436,1.94355,0.000347,0.000415,51,0.000084,0,10,0.866667,0.003434
20159,Rice County,,KS,843,10800,11643,5,6,11,4218,5156,9374,6,0.327925,0.339019,5.249062,0.000252,0.000508,14,0.00011,0,10,0.8,0.002425
28021,Claiborne County,,MS,615,11025,11640,4,5,9,4708,6340,11048,6,0.300029,0.310482,2.44387,0.000132,0.000115,12,0.000094,0,10,0.65,0.001276
13005,Bacon County,,GA,775,10854,11629,5,5,10,4318,4595,8913,6,0.268391,0.276454,4.997188,0.000034,0.000037,5,0.000122,0,10,0.75,0.000656
27173,Yellow Medicine County,,MN,680,10936,11616,6,9,15,3713,4134,7847,5,0.336252,0.349989,1013.129128,0.000379,0.000514,39,0.0001,0,10,0.611111,0.00375
40105,Nowata County,,OK,806,10800,11606,5,5,10,7422,7437,14859,6,0.323232,0.334087,2.035184,0.000326,0.000326,52,0.000099,0,10,0.8,0.0034
48369,Parmer County,,TX,1295,10307,11602,11,8,19,6275,8462,14737,6,0.326948,0.339567,287.333574,0.001172,0.000582,35,0.000156,0,10,0.6,0.01179
41049,Morrow County,,OR,1139,10458,11597,4,6,10,6811,8434,15245,5,0.325769,0.337386,0.029412,0.000538,0.000838,45,0.000075,0,10,0.933333,0.005849
20151,Pratt County,,KS,834,10743,11577,9,8,17,3385,3537,6922,6,0.32817,0.339589,6325.323424,0.000284,0.000505,14,0.000192,0,10,0.488889,0.002842
1011,Bullock County,,AL,789,10765,11554,5,5,10,4339,5562,9901,6,0.307692,0.318652,0.67619,0.000312,0.000268,6,0.000095,0,10,0.85,0.002836
48297,Live Oak County,,TX,958,10592,11550,6,8,14,5668,6076,11744,5,0.354653,0.371072,0.2625,0.001125,0.001676,62,0.000091,0,10,0.892857,0.011517
26119,Montmorency County,,MI,712,10822,11534,8,7,15,5337,4082,9419,6,0.332288,0.346474,0.891667,0.001351,0.001052,43,0.000091,0,10,0.857143,0.01037
13149,Heard County,,GA,888,10644,11532,8,5,13,9979,9837,19816,6,0.33272,0.345888,0.111111,0.001276,0.000621,6,0.000105,0,10,0.928571,0.013189
20095,Kingman County,,KS,732,10790,11522,4,4,8,4216,5263,9479,6,0.320033,0.329622,2,0.000245,0.000213,14,0.000097,0,10,0.65,0.002253
48313,Madison County,,TX,1062,10453,11515,6,7,13,8328,8387,16715,5,0.352092,0.367898,0.291667,0.000813,0.00135,62,0.000101,0,10,0.952381,0.008928
1105,Perry County,,AL,630,10865,11495,7,7,14,3595,5824,9419,6,0.319667,0.331174,6.459621,0.000552,0.000494,6,0.000116,0,10,0.714286,0.00506
21229,Washington County,,KY,581,10903,11484,6,7,13,5845,5836,11681,6,0.324701,0.336757,1.6,0.00054,0.000525,42,0.000126,0,10,0.785714,0.00514
29111,Lewis County,,MO,743,10696,11439,4,4,8,4014,4370,8384,6,0.273091,0.281217,136.502977,0.00002,0.000019,14,0.000136,0,10,0.25,0.000408
39163,Vinton County,,OH,741,10693,11434,9,8,17,8950,9078,18028,6,0.331965,0.345871,3.338305,0.000503,0.000483,41,0.000137,0,10,0.777778,0.004915
26003,Alger County,,MI,678,10731,11409,2,3,5,2176,2647,4823,6,0.275788,0.284049,0,0.000037,0.000033,8,0.000067,0,10,1,0.0004
21149,McLean County,,KY,721,10659,11380,4,4,8,5696,6570,12266,6,0.276259,0.285026,0.871368,0.000031,0.000023,42,0.000099,0,10,0.833333,0.000468
35051,Sierra County,,NM,1050,10328,11378,9,6,15,4183,4291,8474,5,0.360945,0.377273,0.388034,0.00222,0.00101,35,0.00011,0,10,0.933333,0.022236
13319,Wilkinson County,,GA,596,10774,11370,5,6,11,5174,6299,11473,6,0.302273,0.313222,1.262867,0.000139,0.000271,6,0.000103,0,10,0.9,0.001487
38067,Pembina County,,ND,670,10686,11356,3,3,6,1977,3382,5359,5,0.301147,0.310824,0,0.000128,0.0001,39,0.000091,0,10,1,0.001216
19039,Clarke County,,IA,865,10481,11346,7,7,14,5424,5767,11191,6,0.316049,0.326563,9.173297,0.000224,0.000221,8,0.000161,0,10,0.547619,0.002502
38057,Mercer County,,ND,634,10692,11326,7,5,12,2474,3842,6316,6,0.298166,0.308225,23.781177,0.000179,0.000104,39,0.000184,0,10,0.738095,0.002114
54095,Tyler County,,WV,537,10769,11306,3,3,6,3170,3618,6788,7,0.256942,0.264858,2.573413,0.000014,0.000006,41,0.000097,0,10,0.5,0.00023
12013,Calhoun County,,FL,812,10457,11269,6,5,11,7416,7089,14505,6,0.316114,0.327203,3.443914,0.000495,0.000441,5,0.000115,0,10,0.833333,0.00465
19071,Fremont County,,IA,793,10470,11263,8,7,15,4736,5004,9740,5,0.353917,0.369607,555.969997,0.000872,0.000874,50,0.000155,0,10,0.5,0.00876
46019,Butte County,,SD,1017,10242,11259,5,5,10,7294,7249,14543,5,0.29684,0.306613,1.212041,0.000139,0.00014,50,0.000131,0,10,0.9,0.001692
13191,McIntosh County,,GA,713,10525,11238,6,4,10,6329,6340,12669,6,0.317061,0.327734,0,0.000896,0.00051,5,0.000098,0,10,0.9,0.009029
25019,Nantucket County,,MA,973,10242,11215,7,8,15,1977,3726,5703,5,0.333297,0.347304,0,0.002046,0.00237,33,0.000078,0,10,1,0.017957
12043,Glades County,,FL,1113,10093,11206,9,9,18,11248,9509,20757,5,0.353022,0.368549,0.108187,0.002576,0.00266,5,0.000099,0,10,0.972222,0.024482
22125,West Feliciana Parish,,LA,850,10347,11197,7,5,12,6467,6882,13349,6,0.327366,0.339958,7.379799,0.000839,0.000495,12,0.000106,0,10,0.738095,0.006946
51610,Falls Church city,,VA,1851,9344,11195,8,8,16,19335,19591,38926,6,0.334495,0.349137,0,0.002565,0.002749,13,0.00009,0,10,1,0.024605
27117,Pipestone County,,MN,684,10507,11191,6,7,13,2766,3482,6248,5,0.335152,0.348199,110.929641,0.000119,0.000457,50,0.000124,0,10,0.625,0.00136
53043,Lincoln County,,WA,790,10385,11175,7,4,11,6817,6715,13532,5,0.337138,0.349891,0,0.001273,0.000688,45,0.000096,0,10,0.97619,0.012888
51750,Radford city,,VA,1622,9552,11174,9,12,21,12112,14361,26473,6,0.339485,0.356543,522.64065,0.000645,0.001863,37,0.00015,0,10,0.570513,0.005888
46113,Shannon County,,SD,583,10537,11120,3,3,6,3320,4071,7391,5,0.295897,0.30529,1.2,0.000089,0.000075,50,0.000124,0,10,0.666667,0.00091
30009,Carbon County,,MT,886,10230,11116,4,5,9,5762,6416,12178,6,0.293522,0.304443,2.675467,0.000173,0.000254,45,0.000108,0,10,0.8,0.002073
51183,Sussex County,,VA,807,10308,11115,11,12,23,6653,7271,13924,6,0.315368,0.328548,177.230934,0.000483,0.000716,13,0.000151,0,10,0.519231,0.005139
28147,Walthall County,,MS,691,10419,11110,11,10,21,7054,7719,14773,5,0.331965,0.345768,20.627593,0.000976,0.000633,12,0.00013,0,10,0.775641,0.007811
47007,Bledsoe County,,TN,680,10424,11104,5,5,10,6204,6004,12208,6,0.309771,0.320058,117.082677,0.000205,0.00025,51,0.00014,0,10,0.5,0.002664
54089,Summers County,,WV,694,10404,11098,5,5,10,4120,5312,9432,6,0.269829,0.278483,20.269193,0.000037,0.000026,41,0.000125,0,10,0.8,0.000554
16073,Owyhee County,,ID,1201,9896,11097,4,3,7,11006,12505,23511,6,0.314819,0.325255,0,0.00033,0.000302,45,0.000076,0,10,1,0.003486
5095,Monroe County,,AR,890,10202,11092,7,11,18,2932,5075,8007,6,0.318606,0.329725,10.264692,0.000241,0.000348,52,0.00012,0,10,0.609091,0.002525
5109,Pike County,,AR,741,10327,11068,5,7,12,5606,5962,11568,6,0.318012,0.328505,15.511408,0.000054,0.00027,52,0.00011,0,10,0.666667,0.00091
30021,Dawson County,,MT,736,10332,11068,2,7,9,1070,2026,3096,6,0.292544,0.304069,3085.259505,0.000077,0.000202,45,0.000076,0,10,0.52381,0.000845
27149,Stevens County,,MN,706,10353,11059,6,9,15,1655,2739,4394,5,0.334386,0.347629,6.824606,0.000385,0.000659,39,0.000111,0,10,0.75,0.003845
21023,Bracken County,,KY,656,10396,11052,7,7,14,6023,5707,11730,6,0.32453,0.3359,4543.65175,0.000489,0.000447,42,0.000134,0,10,0.619048,0.004396
21153,Magoffin County,,KY,531,10514,11045,3,4,7,1788,2502,4290,6,0.316179,0.3264,4.023226,0.000005,0.000197,42,0.000088,0,10,0.583333,0.000197
31147,Richardson County,,NE,623,10397,11020,3,6,9,1644,2548,4192,6,0.323709,0.334272,37.621482,0.000161,0.000354,50,0.00009,0,10,0.333333,0.001338
20205,Wilson County,,KS,783,10219,11002,6,5,11,4471,4833,9304,6,0.320133,0.329921,4.232399,0.000251,0.000217,14,0.000116,0,10,0.733333,0.002442
47153,Sequatchie County,,TN,642,10358,11000,5,5,10,8926,7682,16608,6,0.309646,0.31984,2.902119,0.000225,0.000245,51,0.00012,0,10,0.65,0.002621
48403,Sabine County,,TX,841,10156,10997,9,8,17,5572,5355,10927,5,0.349767,0.365267,3.242675,0.000714,0.00073,62,0.000126,0,10,0.791667,0.007664
48377,Presidio County,,TX,1095,9881,10976,5,7,12,4589,8262,12851,6,0.325493,0.337343,269.068515,0.000433,0.000503,62,0.000107,0,10,0.619048,0.004721
37073,Gates County,,NC,600,10367,10967,8,9,17,6295,4864,11159,6,0.326253,0.339762,10.92137,0.001004,0.000735,13,0.00011,0,10,0.6,0.009258
5099,Nevada County,,AR,786,10162,10948,6,8,14,4408,5529,9937,6,0.31854,0.3294,3.384436,0.000044,0.000272,62,0.00011,0,10,0.666667,0.000665
19051,Davis County,,IA,526,10403,10929,3,4,7,2732,2626,5358,6,0.316017,0.326156,96.724579,0.00001,0.000204,8,0.000099,0,10,0.666667,0.000316
51119,Middlesex County,,VA,658,10252,10910,11,10,21,5936,3779,9715,6,0.317028,0.329915,11.903259,0.000938,0.000928,13,0.000155,0,10,0.7,0.009653
55041,Forest County,,WI,597,10297,10894,8,7,15,2432,2798,5230,6,0.324222,0.33584,0.716281,0.000493,0.000434,8,0.000113,0,10,0.821429,0.00456
40075,Kiowa County,,OK,813,10068,10881,8,9,17,4299,5062,9361,6,0.326843,0.338867,103.79195,0.000477,0.000592,52,0.000132,0,10,0.666667,0.004832
46109,Roberts County,,SD,628,10237,10865,8,8,16,2742,3345,6087,6,0.304249,0.315864,2536.925598,0.000183,0.000152,50,0.000227,0,10,0.303571,0.002026
21159,Martin County,,KY,570,10290,10860,6,8,14,2261,3503,5764,6,0.335079,0.34994,111.955997,0.000416,0.00061,42,0.000114,0,10,0.571429,0.004061
51049,Cumberland County,,VA,816,10040,10856,7,7,14,6772,6101,12873,6,0.312259,0.324018,1.92915,0.000604,0.000659,13,0.000123,0,10,0.833333,0.006318
12125,Union County,,FL,882,9972,10854,7,8,15,9972,9443,19415,6,0.332072,0.345703,1.009559,0.000937,0.001192,5,0.000102,0,10,0.857143,0.00923
21053,Clinton County,,KY,425,10417,10842,4,4,8,2776,2975,5751,7,0.250285,0.257078,526.112275,0.000008,0.000016,42,0.000134,0,10,0.166667,0.000381
30089,Sanders County,,MT,808,10025,10833,8,7,15,3001,3780,6781,5,0.31191,0.323638,0.926125,0.000839,0.000525,45,0.000118,0,10,0.861111,0.008909
16021,Boundary County,,ID,771,10038,10809,3,5,8,3605,4137,7742,5,0.309553,0.320627,0.111111,0.00027,0.000318,45,0.000073,0,10,0.8,0.002944
48127,Dimmit County,,TX,880,9921,10801,8,6,14,3999,4789,8788,5,0.345479,0.36052,9.477387,0.001601,0.001036,62,0.000119,0,10,0.857143,0.016868
19117,Lucas County,,IA,663,10130,10793,5,6,11,3542,4059,7601,6,0.316114,0.326508,6.24805,0.00021,0.000202,8,0.00013,0,10,0.6,0.002196
46023,Charles Mix County,,SD,601,10173,10774,3,4,7,1248,1729,2977,6,0.300558,0.310628,1.9,0.000109,0.000094,50,0.000114,0,10,0.833333,0.001102
39121,Noble County,,OH,585,10186,10771,6,7,13,5674,5977,11651,6,0.332036,0.345871,1.455717,0.000444,0.00044,41,0.000101,0,10,0.809524,0.004262
13155,Irwin County,,GA,900,9853,10753,6,5,11,7662,7811,15473,6,0.296353,0.30702,1.572438,0.000184,0.000157,5,0.000113,0,10,0.766667,0.001919
16087,Washington County,,ID,914,9820,10734,5,4,9,5826,6679,12505,6,0.313533,0.32398,0.416667,0.000268,0.000282,45,0.000111,0,10,0.85,0.003044
28143,Tunica County,,MS,807,9919,10726,11,8,19,12788,13755,26543,5,0.334969,0.348139,25.603718,0.000774,0.000651,52,0.000157,0,10,0.563636,0.007694
48429,Stephens County,,TX,956,9761,10717,6,8,14,2169,2845,5014,5,0.341941,0.3565,198.126019,0.000981,0.000647,62,0.000122,0,10,0.736111,0.010023
49037,San Juan County,,UT,1695,9022,10717,13,13,26,10895,10446,21341,5,0.362435,0.37985,54.84004,0.001572,0.001492,35,0.000149,0,10,0.67033,0.015548
16009,Benewah County,,ID,924,9769,10693,5,4,9,3802,5314,9116,5,0.309553,0.320519,0.209524,0.000298,0.00029,45,0.000089,0,10,0.9,0.003153
29173,Ralls County,,MO,669,10023,10692,7,6,13,7254,6590,13844,6,0.308589,0.318245,13.065113,0.00034,0.000135,14,0.000135,0,10,0.761905,0.003248
30023,Deer Lodge County,,MT,756,9906,10662,7,6,13,3096,3918,7014,6,0.290716,0.30172,25.612764,0.00028,0.00027,45,0.000143,0,10,0.690476,0.003119
56043,Washakie County,,WY,917,9745,10662,6,10,16,1570,3021,4591,6,0.298658,0.310243,13.698919,0.000136,0.000353,35,0.000112,0,10,0.811111,0.001771
13109,Evans County,,GA,780,9880,10660,5,8,13,6114,6403,12517,6,0.33254,0.34649,14.35107,0.000336,0.000823,5,0.000101,0,10,0.75,0.003669
31101,Keith County,,NE,896,9754,10650,5,6,11,2045,2923,4968,6,0.323743,0.334326,1927.732892,0.000449,0.000363,50,0.000119,0,10,0.47619,0.004226
20003,Anderson County,,KS,647,9997,10644,7,7,14,4141,3885,8026,6,0.324085,0.334755,3.4337,0.000403,0.000365,14,0.000121,0,10,0.714286,0.003786
19151,Pocahontas County,,IA,566,10073,10639,5,8,13,2282,3032,5314,6,0.31631,0.327051,19.739477,0.000027,0.000216,8,0.000104,0,10,0.410714,0.000497
17071,Henderson County,,IL,599,10027,10626,6,5,11,3337,3866,7203,6,0.273261,0.2815,5.093156,0.000043,0.000032,8,0.000112,0,10,0.633333,0.000656
29061,Daviess County,,MO,822,9803,10625,10,9,19,4196,5266,9462,6,0.321473,0.33285,8.412691,0.000419,0.000416,14,0.000174,0,10,0.711111,0.004486
5105,Perry County,,AR,872,9749,10621,6,7,13,8445,8419,16864,6,0.318012,0.328505,0.757576,0.000312,0.000353,52,0.000116,0,10,0.857143,0.003298
8007,Archuleta County,,CO,927,9690,10617,11,8,19,3529,3088,6617,5,0.36282,0.379688,0,0.003851,0.002014,35,0.000116,0,10,0.99359,0.038008
2220,Sitka City and Borough,,AK,1193,9421,10614,5,8,13,1765,2860,4625,5,0.355391,0.371994,618.326107,0.000723,0.001433,45,0.000105,0,10,0.633333,0.007215
21171,Monroe County,,KY,433,10176,10609,6,6,12,3064,3969,7033,6,0.293634,0.303255,80.850527,0.000075,0.000072,42,0.000152,0,10,0.466667,0.001064
40069,Johnston County,,OK,951,9655,10606,8,9,17,6315,7444,13759,6,0.325251,0.337055,3.659872,0.00048,0.00052,52,0.000138,0,10,0.75,0.005034
40127,Pushmataha County,,OK,689,9912,10601,9,8,17,4087,4937,9024,6,0.325217,0.336892,8.956397,0.00049,0.000353,62,0.000146,0,10,0.588889,0.005211
5025,Cleveland County,,AR,672,9921,10593,7,7,14,5234,4977,10211,6,0.317881,0.328261,4.383333,0.000259,0.000237,52,0.000129,0,10,0.666667,0.002662
48351,Newton County,,TX,905,9630,10535,8,9,17,9383,9462,18845,5,0.350046,0.365755,2.131353,0.000826,0.000824,62,0.000105,0,10,0.777778,0.008357
21139,Livingston County,,KY,723,9800,10523,4,6,10,6507,7249,13756,6,0.271786,0.280485,6.905441,0.000021,0.000032,52,0.000123,0,10,0.666667,0.00043
29041,Chariton County,,MO,561,9962,10523,7,8,15,2407,3202,5609,6,0.321776,0.333176,31.36471,0.000411,0.000495,14,0.000136,0,10,0.607143,0.003924
46051,Grant County,,SD,614,9890,10504,4,5,9,1800,2622,4422,6,0.300675,0.310981,3084.177214,0.00011,0.000107,50,0.000145,0,10,0.5,0.001186
1063,Greene County,,AL,624,9853,10477,5,5,10,3832,5564,9396,6,0.318276,0.329112,0.5,0.000356,0.000324,6,0.0001,0,10,0.9,0.003341
56031,Platte County,,WY,771,9683,10454,6,6,12,3311,4209,7520,6,0.292906,0.302989,6.068065,0.00039,0.000224,35,0.00011,0,10,0.952381,0.004619
21187,Owen County,,KY,700,9746,10446,9,8,17,8271,7565,15836,6,0.31657,0.327458,29.754618,0.000709,0.000359,42,0.000159,0,10,0.694444,0.006395
48175,Goliad County,,TX,831,9602,10433,6,5,11,5322,4570,9892,5,0.349647,0.364779,0.595238,0.000696,0.000709,62,0.000098,0,10,0.8,0.007316
13253,Seminole County,,GA,721,9708,10429,4,4,8,5337,5916,11253,6,0.279552,0.289041,106.888712,0.000069,0.00008,5,0.000105,0,10,0.666667,0.00098
13235,Pulaski County,,GA,645,9771,10416,7,6,13,4238,4913,9151,6,0.32796,0.340967,55.666838,0.000245,0.000624,6,0.000143,0,10,0.5,0.002754
37029,Camden County,,NC,799,9610,10409,7,6,13,10433,6974,17407,6,0.326184,0.339328,0.890079,0.000889,0.000612,13,0.000106,0,10,0.904762,0.008146
21007,Ballard County,,KY,632,9762,10394,4,4,8,4049,4580,8629,6,0.271642,0.279942,0.666667,0.000027,0.000021,52,0.000126,0,10,0.833333,0.000451
45065,McCormick County,,SC,614,9776,10390,7,7,14,3358,4318,7676,6,0.31693,0.329047,13.615864,0.000399,0.000747,37,0.000116,0,10,0.607143,0.004373
13287,Turner County,,GA,608,9751,10359,8,12,20,4320,6681,11001,5,0.357043,0.373985,983.273138,0.001326,0.002156,5,0.000116,0,10,0.576923,0.01332
20107,Linn County,,KS,813,9544,10357,8,9,17,6626,6113,12739,6,0.327505,0.339274,12.182962,0.00063,0.000622,14,0.000126,0,10,0.666667,0.00613
35037,Quay County,,NM,933,9418,10351,3,5,8,1928,3179,5107,5,0.326219,0.337348,1.265798,0.000367,0.00049,35,0.000073,0,10,0.8,0.003639
31095,Jefferson County,,NE,548,9801,10349,4,5,9,2981,3630,6611,6,0.323471,0.333784,1.283333,0.000162,0.000355,50,0.000128,0,10,0.8,0.001427
26013,Baraga County,,MI,505,9793,10298,2,2,4,1983,2411,4394,6,0.277482,0.285818,0,0.000047,0.000034,8,0.000065,0,10,1,0.000406
46125,Turner County,,SD,763,9504,10267,4,5,9,5148,5720,10868,6,0.300499,0.310628,0.5,0.000128,0.000109,50,0.000107,0,10,0.85,0.001327
51115,Mathews County,,VA,571,9672,10243,6,6,12,3495,3535,7030,6,0.315465,0.327474,0.498022,0.000848,0.000741,13,0.000095,0,10,0.928571,0.008306
51036,Charles City County,,VA,730,9509,10239,8,7,15,5370,5218,10588,6,0.316897,0.329373,0.052632,0.001,0.000977,13,0.000109,0,10,0.964286,0.009983
31021,Burt County,,NE,718,9515,10233,5,6,11,3396,4053,7449,5,0.326913,0.33731,1.561611,0.000419,0.000471,50,0.000112,0,10,0.866667,0.003706
48357,Ochiltree County,,TX,739,9487,10226,5,6,11,1736,2297,4033,6,0.304853,0.315544,6164.621818,0.000127,0.000227,62,0.000158,0,10,0.5,0.00159
5117,Prairie County,,AR,594,9629,10223,5,6,11,4286,5136,9422,6,0.317815,0.328071,0.866667,0.000265,0.000303,52,0.000095,0,10,0.866667,0.002799
16035,Clearwater County,,ID,1001,9209,10210,6,7,13,2883,4431,7314,6,0.313758,0.32474,111.460079,0.000314,0.000322,45,0.000112,0,10,0.809524,0.003489
28119,Quitman County,,MS,682,9528,10210,6,7,13,4152,5420,9572,6,0.330465,0.343061,0.533333,0.000443,0.000459,52,0.000115,0,10,0.880952,0.004595
32029,Storey County,,NV,924,9282,10206,7,4,11,7435,5865,13300,5,0.348339,0.363341,0,0.001516,0.000814,45,0.000095,0,10,0.97619,0.014885
30095,Stillwater County,,MT,975,9230,10205,8,5,13,5574,5709,11283,6,0.290964,0.302018,114.427958,0.000748,0.00019,45,0.000146,0,10,0.446429,0.007794
20143,Ottawa County,,KS,764,9380,10144,3,5,8,4031,3989,8020,6,0.297473,0.307064,1.85119,0.00003,0.000099,14,0.000084,0,10,0.55,0.000387
31107,Knox County,,NE,574,9567,10141,6,6,12,1338,2511,3849,6,0.324222,0.334749,3.746092,0.000444,0.000374,50,0.000129,0,10,0.866667,0.003903
47121,Meigs County,,TN,787,9274,10061,7,7,14,11541,10627,22168,6,0.317159,0.328863,0.416667,0.000514,0.000554,51,0.000131,0,10,0.928571,0.005625
12037,Franklin County,,FL,648,9378,10026,4,5,9,2726,3642,6368,6,0.316114,0.327203,3.860581,0.000457,0.000432,5,0.000092,0,10,0.65,0.004219
54075,Pocahontas County,,WV,536,9489,10025,2,4,6,658,1505,2163,6,0.324873,0.337581,35.893367,0.000001,0.000467,41,0.000083,0,10,0,0.000134
29149,Oregon County,,MO,719,9297,10016,4,4,8,3341,4597,7938,6,0.309584,0.319179,82.054121,0.000153,0.000153,14,0.000105,0,10,0.3,0.001754
48083,Coleman County,,TX,795,9202,9997,7,5,12,3641,3514,7155,5,0.347236,0.362337,3.548317,0.001091,0.001103,62,0.000118,0,10,0.785714,0.010989
13281,Towns County,,GA,605,9372,9977,8,4,12,4227,3483,7710,6,0.3266,0.338959,176.879326,0.002037,0.000449,6,0.000161,0,10,0.696429,0.019983
21055,Crittenden County,,KY,621,9352,9973,7,6,13,2762,2599,5361,6,0.269852,0.278407,22.273268,0.00003,0.000021,52,0.000155,0,10,0.392857,0.00065
4011,Greenlee County,,AZ,940,8994,9934,7,8,15,4587,7153,11740,5,0.361157,0.377789,2.205286,0.00129,0.001503,45,0.000102,0,10,0.785714,0.014194
32033,White Pine County,,NV,1002,8921,9923,5,6,11,4163,4050,8213,5,0.349607,0.365131,0.0625,0.001095,0.001204,45,0.000085,0,10,0.904762,0.010768
29185,St. Clair County,,MO,818,9086,9904,8,9,17,5109,5076,10185,6,0.32208,0.333502,4.342857,0.000456,0.00045,14,0.000137,0,10,0.680556,0.0047
31045,Dawes County,,NE,897,9002,9899,5,10,15,1909,3238,5147,5,0.328662,0.340175,274.428288,0.000266,0.000503,35,0.000116,0,10,0.4,0.002322
26153,Schoolcraft County,,MI,484,9413,9897,4,2,6,1010,1114,2124,6,0.275763,0.283887,1.101487,0.000047,0.000033,8,0.000095,0,10,0.5,0.000603
45053,Jasper County,,SC,762,9130,9892,7,7,14,17116,15802,32918,6,0.323777,0.336225,2.336904,0.001081,0.001217,5,0.000103,0,10,0.833333,0.011349
54015,Clay County,,WV,514,9367,9881,6,5,11,3052,3935,6987,6,0.297242,0.306906,8.334257,0.000104,0.000082,41,0.00014,0,10,0.5,0.001117
31127,Nemaha County,,NE,712,9168,9880,5,5,10,2756,3280,6036,6,0.323505,0.333838,21.034267,0.000415,0.000351,50,0.000114,0,10,0.7,0.003612
17003,Alexander County,,IL,723,9145,9868,3,6,9,3132,4805,7937,6,0.292071,0.301687,1.344048,0.000021,0.000076,14,0.000088,0,10,0.666667,0.000386
38097,Traill County,,ND,601,9260,9861,4,2,6,4170,4385,8555,5,0.301117,0.310661,21.018674,0.000126,0.000099,39,0.000115,0,10,0.416667,0.001265
30001,Beaverhead County,,MT,905,8950,9855,7,8,15,2505,3547,6052,6,0.295868,0.307248,11.194229,0.000301,0.000392,45,0.000132,0,10,0.847222,0.003417
13043,Candler County,,GA,774,9066,9840,6,6,12,6461,5995,12456,6,0.316832,0.327783,1.787615,0.000323,0.000339,5,0.000112,0,10,0.9,0.00346
48379,Rains County,,TX,884,8938,9822,10,10,20,11075,8519,19594,5,0.346102,0.361697,0,0.001671,0.001527,62,0.000128,0,10,1,0.017789
54071,Pendleton County,,WV,658,9163,9821,4,4,8,1024,1678,2702,6,0.266922,0.275038,258.780691,0.00029,0.000036,13,0.0001,0,10,0.4,0.003216
29081,Harrison County,,MO,642,9142,9784,5,8,13,1720,1976,3696,6,0.32144,0.332688,65.331377,0.000275,0.000412,14,0.000115,0,10,0.736111,0.002767
20067,Grant County,,KS,899,8877,9776,3,5,8,1021,1383,2404,6,0.320903,0.330789,3119.246491,0.000032,0.000233,14,0.000119,0,10,0.433333,0.000396
27107,Norman County,,MN,532,9210,9742,5,4,9,2830,3532,6362,6,0.297848,0.30752,0,0.000092,0.000073,39,0.000112,0,10,0.9,0.001078
21091,Hancock County,,KY,677,9047,9724,4,4,8,6070,6155,12225,6,0.27559,0.284207,2.905046,0.000023,0.000017,42,0.000103,0,10,0.5,0.000399
16085,Valley County,,ID,968,8754,9722,7,6,13,7418,7288,14706,6,0.313597,0.324306,121.052592,0.00121,0.000281,45,0.000111,0,10,0.597222,0.012118
19135,Monroe County,,IA,573,9133,9706,5,5,10,3090,3989,7079,6,0.316114,0.3264,1.251149,0.000214,0.00021,8,0.000114,0,10,0.9,0.002292
19093,Ida County,,IA,539,9160,9699,5,6,11,2307,2574,4881,6,0.316538,0.327186,2.578196,0.000064,0.000239,8,0.0001,0,10,0.833333,0.000764
47083,Houston County,,TN,629,9068,9697,5,5,10,4610,4808,9418,6,0.330039,0.342329,1.333333,0.000568,0.000622,51,0.000102,0,10,0.8,0.00601
13209,Montgomery County,,GA,674,9004,9678,4,5,9,5308,5302,10610,6,0.265148,0.273139,5.373285,0.000011,0.000028,5,0.000126,0,10,0.65,0.0003
13141,Hancock County,,GA,522,9155,9677,3,4,7,2380,3334,5714,6,0.329932,0.341786,0,0.000385,0.000476,6,0.000074,0,10,1,0.003726
29153,Ozark County,,MO,746,8930,9676,5,7,12,3357,5005,8362,6,0.309709,0.319694,11.034235,0.000191,0.000226,14,0.000112,0,10,0.619048,0.002456
27073,Lac qui Parle County,,MN,449,9215,9664,3,5,8,1086,1311,2397,5,0.33308,0.345405,1.253114,0.000009,0.000364,39,0.000077,0,10,0.8,0.000229
46067,Hutchinson County,,SD,536,9097,9633,4,5,9,1616,2440,4056,6,0.300587,0.310791,1.75,0.000116,0.000109,50,0.000112,0,10,0.733333,0.001192
28041,Greene County,,MS,624,8997,9621,7,8,15,5826,5956,11782,6,0.30949,0.321289,11.185874,0.000337,0.00033,12,0.00012,0,10,0.660714,0.003334
29057,Dade County,,MO,741,8860,9601,6,7,13,4587,5220,9807,6,0.309584,0.319531,1.729649,0.000197,0.000242,14,0.000119,0,10,0.738095,0.002315
22081,Red River Parish,,LA,516,9078,9594,5,5,10,4119,5416,9535,6,0.305854,0.315831,0.342857,0.000241,0.000235,12,0.000095,0,10,0.9,0.002502
54017,Doddridge County,,WV,595,8966,9561,2,2,4,3629,3198,6827,7,0.257826,0.265823,0,0.000012,0.000004,41,0.000089,0,10,1,0.000159
8047,Gilpin County,,CO,1457,8084,9541,7,6,13,7418,6565,13983,5,0.33107,0.342301,1.840276,0.001831,0.001524,35,0.000097,0,10,0.952381,0.018886
18171,Warren County,,IN,551,8988,9539,4,5,9,7110,6539,13649,6,0.325838,0.33839,1.239706,0.000181,0.000464,42,0.000088,0,10,0.85,0.001389
19195,Worth County,,IA,576,8956,9532,4,5,9,4502,4148,8650,6,0.290826,0.300505,3.640332,0.000021,0.000059,8,0.000089,0,10,0.55,0.000398
8063,Kit Carson County,,CO,740,8785,9525,5,9,14,694,1482,2176,5,0.341295,0.354275,3489.296727,0.000927,0.001729,35,0.000121,0,10,0.625,0.009329
48043,Brewster County,,TX,1135,8367,9502,12,10,22,4376,5033,9409,5,0.349051,0.365283,5983.284987,0.002716,0.001571,62,0.000212,0,10,0.711538,0.028048
13269,Taylor County,,GA,465,8994,9459,6,8,14,1580,2770,4350,6,0.312576,0.324273,23.38893,0.000442,0.000455,6,0.000111,0,10,0.5,0.004488
30105,Valley County,,MT,619,8834,9453,2,5,7,991,1519,2510,6,0.294479,0.305246,3.047943,0.000076,0.000211,45,0.00008,0,10,0.75,0.000832
13049,Charlton County,,GA,659,8789,9448,6,7,13,6325,6473,12798,6,0.332,0.345567,18.82263,0.000562,0.00059,5,0.000099,0,10,0.547619,0.005654
31003,Antelope County,,NE,579,8854,9433,3,6,9,1847,2863,4710,6,0.323914,0.33437,3.715898,0.000182,0.000372,50,0.00008,0,10,0.766667,0.001513
31035,Clay County,,NE,720,8698,9418,3,5,8,2251,3503,5754,6,0.323914,0.334288,0,0.000185,0.000374,50,0.000085,0,10,1,0.001557
40151,Woods County,,OK,804,8611,9415,5,6,11,1985,3058,5043,6,0.325217,0.336583,107.98432,0.000337,0.000355,52,0.000128,0,10,0.5,0.00366
5097,Montgomery County,,AR,635,8775,9410,4,5,9,3203,3940,7143,6,0.31798,0.328234,2.477841,0.000051,0.000267,52,0.000096,0,10,0.7,0.000825
53059,Skamania County,,WA,784,8611,9395,6,7,13,8149,6489,14638,5,0.336805,0.350146,0.194444,0.001031,0.001165,45,0.000093,0,10,0.904762,0.010728
13181,Lincoln County,,GA,568,8825,9393,4,5,9,3607,3872,7479,6,0.306159,0.317133,1.390816,0.000311,0.00031,37,0.000085,0,10,0.75,0.003098
19009,Audubon County,,IA,523,8865,9388,4,5,9,1660,2193,3853,6,0.316179,0.326563,8.500987,0.00021,0.000216,50,0.000092,0,10,0.7,0.002081
21223,Trimble County,,KY,558,8821,9379,5,5,10,8040,7363,15403,6,0.323539,0.334939,1.310399,0.000326,0.000336,42,0.00012,0,10,0.8,0.003361
6049,Modoc County,,CA,801,8571,9372,6,6,12,1766,2405,4171,5,0.32796,0.339676,0.279415,0.000738,0.000752,45,0.000085,0,10,0.904762,0.00708
22023,Cameron Parish,,LA,599,8773,9372,3,7,10,4951,8260,13211,6,0.295129,0.305935,0.35202,0.000174,0.000207,12,0.000073,0,10,0.714286,0.001809
5079,Lincoln County,,AR,827,8542,9369,5,5,10,5329,6380,11709,6,0.317782,0.327881,0.5,0.000256,0.000236,52,0.000101,0,10,0.9,0.002528
49023,Juab County,,UT,687,8672,9359,5,4,9,8134,6806,14940,5,0.329543,0.341146,0,0.000629,0.000597,45,0.000086,0,10,0.95,0.005953
27167,Wilkin County,,MN,679,8678,9357,4,5,9,4799,5301,10100,6,0.297934,0.307764,929.430955,0.00009,0.000075,39,0.000106,0,10,0.65,0.001048
20193,Thomas County,,KS,732,8624,9356,5,7,12,1543,1822,3365,6,0.322621,0.333138,15942.041123,0.000013,0.000281,14,0.000278,0,10,0.160714,0.000327
48391,Refugio County,,TX,674,8653,9327,6,8,14,3131,3947,7078,5,0.354653,0.371072,0.111111,0.00075,0.001696,62,0.000096,0,10,0.982143,0.007804
20043,Doniphan County,,KS,611,8709,9320,4,5,9,4652,4973,9625,6,0.324598,0.335243,1.665207,0.000038,0.000318,14,0.000094,0,10,0.75,0.000579
31059,Fillmore County,,NE,509,8794,9303,4,3,7,1727,2201,3928,6,0.31264,0.321913,1.416667,0.000162,0.000118,50,0.000125,0,10,0.5,0.001429
31121,Merrick County,,NE,781,8517,9298,7,8,15,4266,4892,9158,6,0.323948,0.334668,452.611887,0.000442,0.000378,50,0.000152,0,10,0.553571,0.003997
29085,Hickory County,,MO,674,8575,9249,9,7,16,4440,4676,9116,6,0.322013,0.333176,9.408932,0.000579,0.000443,14,0.000147,0,10,0.722222,0.006086
48307,McCulloch County,,TX,740,8503,9243,5,5,10,1301,1872,3173,5,0.351447,0.367524,0,0.001397,0.001484,62,0.000088,0,10,1,0.014314
40085,Love County,,OK,660,8567,9227,7,7,14,6034,5931,11965,5,0.342895,0.357921,1.320639,0.001481,0.00119,52,0.000109,0,10,0.946429,0.015462
47027,Clay County,,TN,495,8699,9194,6,5,11,2596,3103,5699,6,0.265767,0.274143,70.328743,0.000365,0.000049,51,0.000154,0,10,0.666667,0.004408
49019,Grand County,,UT,779,8405,9184,5,6,11,2914,3646,6560,5,0.331177,0.343235,0.427568,0.000699,0.000805,45,0.000086,0,10,0.933333,0.006665
17047,Edwards County,,IL,538,8643,9181,4,5,9,2885,3289,6174,6,0.296611,0.306272,3.352467,0.000002,0.000062,14,0.000118,0,10,0.75,0.000251
29045,Clark County,,MO,448,8694,9142,4,4,8,1782,1863,3645,6,0.274555,0.282937,53.480919,0.000006,0.000018,8,0.000131,0,10,0.4,0.000254
28009,Benton County,,MS,840,8299,9139,6,8,14,8008,8149,16157,6,0.3305,0.343224,1.166667,0.000443,0.000463,52,0.000107,0,10,0.785714,0.00457
19177,Van Buren County,,IA,482,8650,9132,6,5,11,2848,2879,5727,6,0.272655,0.280707,27.452456,0.000035,0.000023,8,0.000127,0,10,0.366667,0.000676
48069,Castro County,,TX,881,8249,9130,7,7,14,3578,5332,8910,6,0.304943,0.315706,7.997936,0.000281,0.000243,62,0.000122,0,10,0.785714,0.002863
51159,Richmond County,,VA,523,8566,9089,4,6,10,4737,5058,9795,6,0.310648,0.321739,1.385459,0.00002,0.000446,13,0.000103,0,10,0.733333,0.000499
37043,Clay County,,NC,570,8517,9087,5,4,9,4117,3798,7915,6,0.262991,0.270757,1.34316,0.000463,0.000105,6,0.000151,0,10,0.65,0.005068
48405,San Augustine County,,TX,729,8313,9042,5,5,10,4347,5032,9379,5,0.349607,0.364724,0.45,0.000544,0.000572,62,0.000096,0,10,0.9,0.005846
26131,Ontonagon County,,MI,503,8536,9039,3,3,6,726,1468,2194,6,0.277783,0.286361,0,0.00005,0.000037,8,0.00008,0,10,1,0.000489
2180,Nome Census Area,,AK,623,8414,9037,4,5,9,2470,4077,6547,5,0.322181,0.3331,0.333333,0.000444,0.000479,45,0.000082,0,10,0.9,0.004292
40141,Tillman County,,OK,629,8394,9023,4,6,10,2199,3825,6024,5,0.328345,0.340142,4.706827,0.000293,0.000562,52,0.000079,0,10,0.733333,0.002696
29125,Maries County,,MO,712,8301,9013,7,6,13,5283,5055,10338,6,0.291074,0.301194,1.626232,0.000487,0.000117,14,0.000112,0,10,0.857143,0.004554
22035,East Carroll Parish,,LA,647,8336,8983,5,4,9,2496,3735,6231,5,0.341713,0.356131,197.197268,0.000832,0.000513,12,0.0001,0,10,0.65,0.007576
31179,Wayne County,,NE,794,8189,8983,6,8,14,3325,4530,7855,6,0.323948,0.334641,252.089879,0.000438,0.000379,50,0.000127,0,10,0.660714,0.003872
54101,Webster County,,WV,389,8588,8977,1,2,3,1342,1867,3209,7,0.230631,0.235745,0.2,0.000001,0.000002,41,0.000065,0,10,0,0.000067
31139,Pierce County,,NE,532,8439,8971,8,5,13,3305,3558,6863,6,0.323846,0.334153,1.553846,0.000442,0.000371,50,0.000151,0,10,0.678571,0.004005
17065,Hamilton County,,IL,474,8470,8944,5,4,9,2595,3012,5607,6,0.27314,0.281125,8.100418,0.000019,0.000017,14,0.000121,0,10,0.55,0.000455
28131,Stone County,,MS,706,8236,8942,10,8,18,12124,9985,22109,5,0.315984,0.327203,46.732543,0.000996,0.000372,12,0.000126,0,10,0.655556,0.009002
48153,Floyd County,,TX,784,8150,8934,2,3,5,3224,4514,7738,6,0.301502,0.31205,0,0.000145,0.000171,62,0.000064,0,10,1,0.001288
49029,Morgan County,,UT,646,8286,8932,6,5,11,9066,7117,16183,5,0.330465,0.342204,0,0.000883,0.000776,45,0.000087,0,10,1,0.008048
13183,Long County,,GA,1448,7480,8928,9,7,16,17041,13208,30249,6,0.32972,0.342437,79.271093,0.001839,0.000828,5,0.000116,0,10,0.618182,0.018408
38009,Bottineau County,,ND,521,8396,8917,2,5,7,1847,2717,4564,6,0.303828,0.314073,0.5,0.000067,0.000142,39,0.000073,0,10,0.7,0.000718
19053,Decatur County,,IA,721,8193,8914,4,5,9,2300,2920,5220,6,0.325838,0.337674,50.475461,0.000202,0.00045,8,0.000125,0,10,0.4,0.002046
28157,Wilkinson County,,MS,425,8447,8872,7,7,14,3088,3722,6810,6,0.32747,0.340337,9.96303,0.000576,0.000493,12,0.000117,0,10,0.666667,0.004949
5039,Dallas County,,AR,628,8238,8866,6,9,15,2883,3854,6737,6,0.318045,0.328749,124.559473,0.000267,0.000244,52,0.000118,0,10,0.541667,0.002635
48437,Swisher County,,TX,798,8059,8857,4,4,8,4122,5693,9815,6,0.304853,0.315218,0,0.000262,0.00023,62,0.000086,0,10,1,0.002571
20073,Greenwood County,,KS,615,8241,8856,4,4,8,3116,3745,6861,6,0.320601,0.330355,3.296094,0.000269,0.000226,14,0.000093,0,10,0.666667,0.002378
27029,Clearwater County,,MN,530,8326,8856,3,2,5,3045,3091,6136,6,0.268625,0.276063,0.166667,0.000018,0.000013,39,0.000084,0,10,0.666667,0.000371
21169,Metcalfe County,,KY,464,8391,8855,6,7,13,4753,5649,10402,6,0.293606,0.303309,2614.276098,0.000072,0.000065,42,0.000145,0,10,0.571429,0.000972
40093,Major County,,OK,551,8296,8847,5,4,9,3307,3873,7180,6,0.324907,0.33597,62.488138,0.000336,0.000348,52,0.000117,0,10,0.75,0.003627
54073,Pleasants County,,WV,424,8410,8834,4,4,8,3483,3551,7034,6,0.273529,0.281906,23.215282,0.000026,0.000013,41,0.000123,0,10,0.5,0.000347
41023,Grant County,,OR,870,7959,8829,4,7,11,822,1541,2363,6,0.315303,0.326611,1.281325,0.000405,0.00051,45,0.000081,0,10,0.875,0.004637
48501,Yoakum County,,TX,769,8028,8797,5,6,11,2596,4208,6804,6,0.301413,0.312429,9.717136,0.000519,0.000283,62,0.0001,0,10,0.785714,0.005378
48107,Crosby County,,TX,855,7916,8771,1,1,2,4045,5436,9481,6,0.300734,0.31072,0,0.000121,0.000102,62,0.000057,0,10,0,0.001093
29075,Gentry County,,MO,538,8221,8759,5,8,13,2050,3061,5111,6,0.321541,0.332823,4.45235,0.00004,0.000415,14,0.000114,0,10,0.785714,0.000659
8021,Conejos County,,CO,589,8155,8744,4,4,8,1981,2711,4692,5,0.338326,0.350467,1.216447,0.000353,0.000513,35,0.000091,0,10,0.766667,0.003777
16029,Caribou County,,ID,567,8165,8732,3,4,7,1692,2501,4193,6,0.280933,0.290831,0.25,0.000104,0.000084,45,0.000081,0,10,0.833333,0.000966
5101,Newton County,,AR,681,8025,8706,3,4,7,3450,4542,7992,6,0.299795,0.309587,0.125,0.000126,0.000143,52,0.000082,0,10,0.916667,0.001494
48111,Dallam County,,TX,876,7778,8654,5,6,11,3762,4131,7893,6,0.290606,0.300494,352.69656,0.000133,0.000142,62,0.00012,0,10,0.6,0.001626
20123,Mitchell County,,KS,482,8165,8647,5,7,12,1318,1482,2800,6,0.322689,0.333219,6866.523318,0.000026,0.000296,14,0.000177,0,10,0.428571,0.000439
37075,Graham County,,NC,399,8235,8634,3,2,5,885,970,1855,7,0.23506,0.240079,1.334064,0.000014,0.000032,6,0.000122,0,10,0.666667,0.000682
54093,Tucker County,,WV,436,8184,8620,2,3,5,1431,1976,3407,6,0.290661,0.299799,0.9,0.000001,0.000038,41,0.000084,0,10,0.666667,0.000125
21075,Fulton County,,KY,689,7925,8614,4,5,9,4377,5597,9974,6,0.272075,0.280783,2.187222,0.00002,0.00003,52,0.000114,0,10,0.75,0.000386
41025,Harney County,,OR,779,7770,8549,2,5,7,942,1307,2249,6,0.297646,0.30887,0.212772,0.000096,0.000302,45,0.000067,0,10,0.85,0.001158
16059,Lemhi County,,ID,688,7844,8532,4,4,8,821,962,1783,6,0.313629,0.324197,0,0.000269,0.000279,45,0.000097,0,10,1,0.002953
50013,Grand Isle County,,VT,656,7876,8532,4,3,7,8054,7108,15162,6,0.295243,0.305816,0.166667,0.000231,0.00017,33,0.000075,0,10,0.833333,0.001941
19173,Taylor County,,IA,638,7859,8497,5,6,11,1778,2560,4338,6,0.316375,0.326969,47.383183,0.000012,0.000199,8,0.000144,0,10,0.466667,0.000379
13165,Jenkins County,,GA,454,8035,8489,5,5,10,3005,3852,6857,6,0.306068,0.316998,0.80202,0.000252,0.000228,5,0.000102,0,10,0.9,0.002423
17169,Schuyler County,,IL,497,7984,8481,6,8,14,2972,3622,6594,6,0.301561,0.311513,43.37565,0.000042,0.000108,8,0.000127,0,10,0.535714,0.000707
13167,Johnson County,,GA,383,8095,8478,3,3,6,4001,4460,8461,6,0.264508,0.272027,0.508824,0.000035,0.000029,6,0.000084,0,10,0.666667,0.000459
17175,Stark County,,IL,544,7927,8471,6,5,11,3353,3792,7145,6,0.303978,0.313314,0.833445,0.000205,0.000153,8,0.000094,0,10,0.8,0.001785
38061,Mountrail County,,ND,474,7991,8465,6,6,12,3187,4639,7826,6,0.304038,0.314535,25.072754,0.000179,0.000178,39,0.000182,0,10,0.766667,0.002187
51157,Rappahannock County,,VA,597,7843,8440,7,6,13,5182,4726,9908,6,0.333189,0.347157,1.178349,0.001395,0.000813,13,0.000092,0,10,0.821429,0.013471
29063,DeKalb County,,MO,659,7776,8435,10,9,19,7428,7866,15294,6,0.32144,0.332796,90.008015,0.00049,0.000483,14,0.000167,0,10,0.722222,0.00511
51620,Franklin city,,VA,706,7708,8414,7,8,15,7506,7256,14762,6,0.327261,0.340934,0,0.000992,0.001201,13,0.000093,0,10,1,0.009073
29203,Shannon County,,MO,499,7896,8395,2,3,5,2090,2658,4748,6,0.309272,0.318582,0,0.000008,0.000156,14,0.000075,0,10,1,0.000241
47135,Perry County,,TN,562,7814,8376,6,5,11,1638,1654,3292,6,0.328135,0.339746,4.666667,0.000362,0.000397,51,0.000129,0,10,0.5,0.004069
27051,Grant County,,MN,489,7868,8357,4,5,9,2765,3335,6100,5,0.333913,0.346571,0.611111,0.000379,0.000427,39,0.000086,0,10,0.85,0.003714
41063,Wallowa County,,OR,646,7703,8349,5,4,9,1073,1496,2569,5,0.321137,0.332167,0,0.00056,0.000472,45,0.000084,0,10,1,0.006148
51685,Manassas Park city,,VA,1302,7043,8345,12,14,26,32413,30663,63076,5,0.355268,0.372808,10.988871,0.002453,0.002849,13,0.000116,0,10,0.841667,0.023437
38005,Benson County,,ND,515,7822,8337,3,5,8,1930,3220,5150,5,0.301472,0.311637,22.812097,0.000126,0.000126,39,0.0001,0,10,0.7,0.001217
46115,Spink County,,SD,607,7722,8329,4,4,8,1461,2444,3905,6,0.300616,0.310764,0,0.000124,0.000108,50,0.000117,0,10,1,0.001337
13003,Atkinson County,,GA,605,7700,8305,3,4,7,3507,4250,7757,6,0.294846,0.305452,0.931152,0.00003,0.00014,5,0.00009,0,10,0.833333,0.000545
48047,Brooks County,,TX,622,7675,8297,5,5,10,3137,4626,7763,5,0.338699,0.352235,0,0.000842,0.000821,62,0.000084,0,10,1,0.008734
5073,Lafayette County,,AR,616,7644,8260,5,5,10,2513,3483,5996,6,0.280241,0.289714,2.217156,0.000077,0.000066,52,0.000094,0,10,0.7,0.000963
46047,Fall River County,,SD,780,7472,8252,3,4,7,2308,2776,5084,5,0.296611,0.306071,1.333333,0.000092,0.00011,50,0.000088,0,10,0.65,0.000924
5147,Woodruff County,,AR,577,7672,8249,5,6,11,2641,4032,6673,6,0.318342,0.328749,1.75,0.000247,0.000263,52,0.000101,0,10,0.766667,0.002513
30073,Pondera County,,MT,504,7741,8245,7,8,15,1890,2222,4112,6,0.293102,0.304156,15.293216,0.000198,0.000313,45,0.000144,0,10,0.763889,0.002351
48065,Carson County,,TX,822,7414,8236,4,4,8,5342,5623,10965,6,0.290332,0.299843,0,0.000142,0.000132,62,0.000099,0,10,1,0.001589
56019,Johnson County,,WY,667,7568,8235,4,5,9,3460,3463,6923,5,0.346766,0.360194,0,0.000136,0.000594,35,0.000089,0,10,1,0.00169
20167,Russell County,,KS,652,7564,8216,2,4,6,1662,2245,3907,6,0.325045,0.335558,0,0.000019,0.000311,14,0.000086,0,10,1,0.00026
13243,Randolph County,,GA,523,7691,8214,4,5,9,954,1807,2761,6,0.308744,0.319803,2798.4865,0.000264,0.000258,5,0.000092,0,10,0.35,0.002606
18155,Switzerland County,,IN,612,7601,8213,6,8,14,6521,6011,12532,6,0.324633,0.336198,7.800987,0.00041,0.000386,42,0.000105,0,10,0.589286,0.003735
46033,Custer County,,SD,801,7376,8177,4,5,9,4494,4493,8987,5,0.29664,0.306234,28.938178,0.00021,0.000111,50,0.000107,0,10,0.633333,0.002072
29205,Shelby County,,MO,439,7666,8105,5,5,10,1839,2317,4156,6,0.308032,0.317323,86.2945,0.000141,0.000118,14,0.000143,0,10,0.466667,0.001373
28019,Choctaw County,,MS,608,7488,8096,5,4,9,3754,4032,7786,6,0.276832,0.285867,39.110391,0.000061,0.000021,52,0.000103,0,10,0.4,0.000815
30099,Teton County,,MT,524,7572,8096,5,5,10,2138,2868,5006,6,0.29196,0.302588,1.892596,0.000252,0.000241,45,0.000103,0,10,0.9,0.002676
17153,Pulaski County,,IL,610,7481,8091,5,7,12,2204,3361,5565,6,0.29221,0.30204,31.125929,0.000022,0.000075,14,0.000122,0,10,0.666667,0.000531
31011,Boone County,,NE,436,7649,8085,5,5,10,752,1532,2284,6,0.323846,0.334153,280.569438,0.000284,0.000374,50,0.000113,0,10,0.666667,0.002726
13289,Twiggs County,,GA,418,7662,8080,6,6,12,7375,8380,15755,6,0.302184,0.313086,8.555211,0.000258,0.000258,6,0.000119,0,10,0.8,0.002801
53019,Ferry County,,WA,815,7262,8077,6,6,12,4150,4152,8302,5,0.337397,0.350488,0.076923,0.00124,0.000978,45,0.000089,0,10,0.97619,0.012461
48495,Winkler County,,TX,721,7328,8049,4,4,8,2700,3660,6360,6,0.282379,0.292356,0.309524,0.000146,0.000182,62,0.000097,0,10,0.833333,0.002104
21143,Lyon County,,KY,669,7379,8048,6,6,12,3994,3808,7802,6,0.27133,0.279937,6.010044,0.000032,0.000027,52,0.000145,0,10,0.666667,0.00062
41037,Lake County,,OR,652,7378,8030,5,4,9,1990,2037,4027,6,0.29753,0.308572,0,0.000402,0.000393,45,0.000084,0,10,1,0.004483
48237,Jack County,,TX,706,7314,8020,7,8,15,5047,5396,10443,5,0.342132,0.356836,0.727453,0.000628,0.001066,62,0.000114,0,10,0.875,0.00678
54105,Wirt County,,WV,531,7486,8017,3,3,6,3440,3513,6953,7,0.256878,0.264695,2.116667,0.000014,0.000006,41,0.000102,0,10,0.5,0.000226
46101,Moody County,,SD,456,7536,7992,3,4,7,3329,3819,7148,6,0.300381,0.31033,0,0.000113,0.000113,50,0.000098,0,10,1,0.00117
13315,Wilcox County,,GA,376,7598,7974,3,4,7,2020,2490,4510,6,0.299182,0.309478,1.867623,0.000028,0.000165,6,0.000077,0,10,0.5,0.000392
46009,Bon Homme County,,SD,489,7476,7965,4,3,7,1874,2457,4331,6,0.30044,0.310303,1,0.000111,0.000091,50,0.000117,0,10,0.75,0.001147
20145,Pawnee County,,KS,593,7366,7959,4,6,10,1781,2291,4072,6,0.321037,0.33125,230.834598,0.000241,0.000285,14,0.00013,0,10,0.633333,0.002254
48017,Bailey County,,TX,647,7301,7948,4,5,9,3983,4202,8185,6,0.302035,0.312891,4.504774,0.000181,0.000166,35,0.00009,0,10,0.6,0.00179
2185,North Slope Borough,,AK,710,7222,7932,2,4,6,2047,4360,6407,5,0.322148,0.332937,0,0.00041,0.000477,45,0.00006,0,10,1,0.003879
20127,Morris County,,KS,470,7462,7932,5,6,11,1749,1899,3648,6,0.323334,0.333735,0.926977,0.000306,0.00045,14,0.000088,0,10,0.866667,0.002678
31093,Howard County,,NE,586,7338,7924,4,5,9,3712,3582,7294,6,0.323948,0.334342,136.088741,0.000182,0.000375,50,0.000112,0,10,0.666667,0.001576
46121,Todd County,,SD,514,7408,7922,4,5,9,1415,2117,3532,5,0.304098,0.314762,3191.985559,0.000192,0.000163,50,0.000136,0,10,0.35,0.001843
28037,Franklin County,,MS,488,7429,7917,4,4,8,2723,3046,5769,6,0.264896,0.272727,0.148352,0.000034,0.000035,12,0.000087,0,10,0.833333,0.000546
8065,Lake County,,CO,980,6925,7905,7,10,17,3213,4239,7452,5,0.340841,0.354264,0.284149,0.001237,0.002121,35,0.000099,0,10,0.972727,0.01277
16077,Power County,,ID,626,7278,7904,2,3,5,4429,5195,9624,6,0.313565,0.32398,0,0.00005,0.000241,45,0.000065,0,10,1,0.000568
20053,Ellsworth County,,KS,480,7397,7877,4,4,8,1503,1892,3395,6,0.320367,0.330029,1.448052,0.000254,0.000223,14,0.000096,0,10,0.833333,0.002356
20147,Phillips County,,KS,496,7378,7874,3,3,6,334,774,1108,6,0.269924,0.277344,1690.082885,0.000014,0.000004,14,0.000163,0,10,0.166667,0.000226
56045,Weston County,,WY,637,7219,7856,6,5,11,1860,2094,3954,5,0.296926,0.307134,16.569958,0.000171,0.000179,35,0.000138,0,10,0.547619,0.002042
48315,Marion County,,TX,672,7179,7851,8,8,16,7885,7799,15684,5,0.353591,0.36984,0.372414,0.001555,0.00163,62,0.00011,0,10,0.964286,0.01601
55051,Iron County,,WI,444,7407,7851,3,3,6,1788,1566,3354,6,0.272703,0.280425,1.395896,0.000017,0.000032,8,0.000081,0,10,0.416667,0.000348
50009,Essex County,,VT,557,7287,7844,4,4,8,4982,4620,9602,6,0.286862,0.296257,0.361111,0.000101,0.000088,33,0.000086,0,10,0.833333,0.000988
31173,Thurston County,,NE,526,7307,7833,5,5,10,2074,2908,4982,6,0.323777,0.334245,2.274159,0.00047,0.000385,8,0.000099,0,10,0.8,0.003943
13263,Talbot County,,GA,548,7267,7815,4,4,8,4555,4840,9395,6,0.308248,0.31888,2.914517,0.00022,0.000225,6,0.000105,0,10,0.666667,0.002312
2275,Wrangell Petersburg,,AK,678,7135,7813,1,6,7,241,1166,1407,5,0.33926,0.352913,0,0.000026,0.000806,45,0.000059,0,10,0.866667,0.000316
20069,Gray County,,KS,618,7192,7810,3,4,7,2859,2640,5499,6,0.320668,0.33049,43.068779,0.000054,0.000239,14,0.000089,0,10,0.666667,0.000571
28063,Jefferson County,,MS,432,7329,7761,5,5,10,2835,3765,6600,6,0.300029,0.310482,15.613779,0.000474,0.000119,12,0.000092,0,10,0.733333,0.003789
31051,Dixon County,,NE,575,7137,7712,4,7,11,2463,2936,5399,6,0.324187,0.334885,3.595819,0.000063,0.000407,8,0.000094,0,10,0.833333,0.000609
13173,Lanier County,,GA,922,6789,7711,6,4,10,8926,7588,16514,6,0.294535,0.304937,22.5996,0.000493,0.000114,5,0.000138,0,10,0.566667,0.004887
31099,Kearney County,,NE,498,7180,7678,5,7,12,4147,4794,8941,6,0.324119,0.334831,373.303449,0.000179,0.000379,50,0.000124,0,10,0.738095,0.001566
46037,Day County,,SD,498,7179,7677,4,4,8,1556,2495,4051,6,0.300616,0.310764,2.216667,0.000123,0.000107,50,0.000121,0,10,0.833333,0.001321
48335,Mitchell County,,TX,681,6987,7668,8,8,16,3052,3502,6554,6,0.307231,0.319331,0.498833,0.000842,0.000442,62,0.000122,0,10,0.972222,0.008605
31031,Cherry County,,NE,537,7119,7656,3,3,6,611,557,1168,6,0.312863,0.322266,3118.583751,0.000157,0.000125,50,0.000123,0,10,0.166667,0.001305
17059,Gallatin County,,IL,473,7151,7624,2,3,5,1989,2643,4632,6,0.296353,0.305675,0,0.000001,0.000064,14,0.000086,0,10,1,0.000154
54013,Calhoun County,,WV,507,7094,7601,3,6,9,1074,1692,2766,6,0.297415,0.30734,1005.641754,0.000014,0.000085,41,0.000108,0,10,0.4,0.000229
51021,Bland County,,VA,380,7220,7600,3,3,6,2156,2290,4446,7,0.255744,0.263762,0.166667,0.000018,0.000009,51,0.000082,0,10,0.833333,0.000271
20181,Sherman County,,KS,732,6863,7595,4,3,7,667,720,1387,6,0.270327,0.277984,3133.547186,0.000023,0.000009,14,0.000159,0,10,0.166667,0.000319
48425,Somervell County,,TX,692,6899,7591,7,7,14,6325,5840,12165,5,0.345907,0.361127,0.160256,0.001016,0.001083,62,0.000108,0,10,0.952381,0.010766
16007,Bear Lake County,,ID,490,7100,7590,4,4,8,1081,1410,2491,5,0.329543,0.341119,73.566208,0.000444,0.00041,45,0.000086,0,10,0.833333,0.004052
20077,Harper County,,KS,506,7063,7569,3,2,5,1930,2235,4165,6,0.319867,0.329161,0.5,0.000227,0.0002,14,0.000087,0,10,0.833333,0.002071
27011,Big Stone County,,MN,366,7200,7566,2,2,4,332,280,612,6,0.29779,0.307167,7.26253,0.000001,0.000055,50,0.000099,0,10,0.166667,0.000116
21057,Cumberland County,,KY,308,7255,7563,2,5,7,468,1239,1707,6,0.293494,0.302875,132.473683,0,0.000061,42,0.000095,0,10,0.6,0.000119
19185,Wayne County,,IA,452,7096,7548,4,4,8,2058,1927,3985,6,0.315984,0.326101,3.333333,0.000203,0.000193,8,0.000113,0,10,0.583333,0.002047
51181,Surry County,,VA,515,7031,7546,5,8,13,2988,3223,6211,6,0.312037,0.32487,3.695099,0.000489,0.00076,13,0.000084,0,10,0.660714,0.00464
31169,Thayer County,,NE,510,7018,7528,4,5,9,883,1423,2306,6,0.323471,0.333784,18.440971,0.000159,0.000351,50,0.000138,0,10,0.466667,0.001368
30005,Blaine County,,MT,548,6978,7526,4,3,7,1808,2387,4195,6,0.292795,0.302913,2.320074,0.000137,0.000124,45,0.000108,0,10,0.75,0.001473
47169,Trousdale County,,TN,513,7013,7526,6,6,12,7725,6630,14355,6,0.328275,0.340072,0,0.00061,0.000725,51,0.00012,0,10,1,0.007106
46123,Tripp County,,SD,448,7068,7516,3,4,7,295,1106,1401,5,0.303978,0.314518,11.624355,0.000192,0.000165,50,0.000094,0,10,0.65,0.001793
20197,Wabaunsee County,,KS,586,6925,7511,4,4,8,4671,4788,9459,6,0.301857,0.311328,2.310521,0.000183,0.000146,14,0.000091,0,10,0.666667,0.001636
20201,Washington County,,KS,454,7055,7509,4,10,14,872,25363,26235,6,0.29779,0.308176,6893.425024,0.000102,0.000096,14,0.000095,0,10,0.266667,0.00101
19143,Osceola County,,IA,379,7118,7497,4,6,10,1763,2305,4068,6,0.300764,0.311171,6.350759,0.000015,0.000108,8,0.000103,0,10,0.566667,0.00037
26135,Oscoda County,,MI,441,7020,7461,7,8,15,2644,1226,3870,6,0.332288,0.346582,1.786998,0.00125,0.00085,43,0.000092,0,10,0.777778,0.009774
38049,McHenry County,,ND,520,6908,7428,2,3,5,2706,2927,5633,6,0.303737,0.313694,0,0.000136,0.000141,39,0.000072,0,10,1,0.001291
42023,Cameron County,,PA,290,7137,7427,3,3,6,674,1066,1740,7,0.246925,0.253318,0.833333,0.000012,0.000011,41,0.000078,0,10,0.666667,0.000261
31161,Sheridan County,,NE,644,6775,7419,4,4,8,1138,1498,2636,5,0.296268,0.305887,11.026684,0.000094,0.000076,35,0.000115,0,10,0.583333,0.000981
55091,Pepin County,,WI,438,6981,7419,4,4,8,3867,4127,7994,6,0.276458,0.285373,0.361957,0.000049,0.000047,39,0.000085,0,10,0.833333,0.000709
27081,Lincoln County,,MN,402,7015,7417,3,4,7,1894,1916,3810,6,0.300705,0.3109,0.333333,0.000018,0.000103,39,0.000087,0,10,0.916667,0.000343
29005,Atchison County,,MO,488,6909,7397,4,5,9,689,881,1570,6,0.280369,0.289442,8.935686,0.000035,0.000038,14,0.000112,0,10,0.5,0.000563
48193,Hamilton County,,TX,689,6658,7347,7,8,15,4110,4204,8314,5,0.346805,0.362429,1.887453,0.001086,0.001484,62,0.000104,0,10,0.839286,0.011217
56035,Sublette County,,WY,610,6733,7343,12,8,20,3409,2177,5586,6,0.299444,0.311046,13.131654,0.001271,0.000351,35,0.000139,0,10,0.576923,0.012558
30057,Madison County,,MT,571,6730,7301,4,4,8,2314,2573,4887,6,0.286969,0.297238,0.166667,0.000094,0.000172,45,0.000098,0,10,0.9,0.001255
48305,Lynn County,,TX,642,6658,7300,2,2,4,4136,5103,9239,6,0.300764,0.310883,0,0.00013,0.000104,62,0.000067,0,10,1,0.001163
29211,Sullivan County,,MO,676,6597,7273,7,7,14,1905,2717,4622,6,0.322418,0.333936,756.049975,0.000362,0.000309,14,0.000132,0,10,0.305556,0.003703
5129,Searcy County,,AR,554,6717,7271,5,7,12,1264,2352,3616,6,0.284576,0.294895,46.304914,0.000049,0.000101,52,0.000118,0,10,0.428571,0.000863
18115,Ohio County,,IN,640,6630,7270,4,5,9,6059,6282,12341,6,0.324359,0.335438,0,0.00034,0.000374,42,0.000082,0,10,1,0.002905
2240,Southeast Fairbanks Census Area,,AK,1125,6142,7267,5,4,9,3540,4780,8320,5,0.322148,0.332937,4.088494,0.000873,0.000452,45,0.00009,0,10,0.9,0.008533
32015,Lander County,,NV,855,6403,7258,4,4,8,1944,2884,4828,5,0.348418,0.363449,0,0.000738,0.000759,45,0.000081,0,10,1,0.00739
46129,Walworth County,,SD,609,6625,7234,5,5,10,1266,1360,2626,5,0.304671,0.315793,146.783941,0.000124,0.000199,50,0.000165,0,10,0.566667,0.001436
51097,King and Queen County,,VA,491,6708,7199,8,8,16,4514,3847,8361,6,0.31068,0.322011,1.282637,0.000496,0.000549,13,0.000127,0,10,0.839286,0.005404
16015,Boise County,,ID,737,6436,7173,2,3,5,6680,6580,13260,6,0.313469,0.323763,0,0.000255,0.000274,45,0.000064,0,10,1,0.00276
13065,Clinch County,,GA,407,6762,7169,2,3,5,1173,1790,2963,6,0.29462,0.304991,1.095635,0.000135,0.000122,5,0.000066,0,10,0.666667,0.001266
16081,Teton County,,ID,602,6507,7109,9,8,17,5258,4341,9599,5,0.33157,0.344211,3.719714,0.000692,0.000712,45,0.00012,0,10,0.688889,0.007161
8055,Huerfano County,,CO,687,6394,7081,6,3,9,2306,3051,5357,5,0.338177,0.350141,0,0.001382,0.000507,35,0.000095,0,10,1,0.01413
8113,San Miguel County,,CO,952,6110,7062,7,9,16,1846,3729,5575,5,0.364326,0.381695,1132.53453,0.001235,0.001875,35,0.000117,0,10,0.638889,0.013288
21039,Carlisle County,,KY,435,6612,7047,4,4,8,2277,2892,5169,6,0.271642,0.279942,0.666667,0.000023,0.000018,52,0.00013,0,10,0.833333,0.000417
38021,Dickey County,,ND,511,6536,7047,3,3,6,516,1124,1640,6,0.298281,0.308062,9.080641,0.000083,0.000067,39,0.000104,0,10,0.5,0.000888
13301,Warren County,,GA,441,6601,7042,3,4,7,2907,3957,6864,6,0.306007,0.316753,0.579253,0.000307,0.000306,37,0.000075,0,10,0.75,0.003012
26095,Luce County,,MI,402,6637,7039,2,3,5,682,1142,1824,6,0.279756,0.28826,0.661058,0.000022,0.000046,43,0.000064,0,10,0.666667,0.000293
20157,Republic County,,KS,414,6624,7038,2,3,5,6878,859,7737,6,0.297386,0.306684,0,0.000002,0.000092,14,0.00007,0,10,0.833333,0.000129
13197,Marion County,,GA,574,6448,7022,6,4,10,3059,3114,6173,6,0.308341,0.319016,315.16409,0.000247,0.000213,6,0.000136,0,10,0.333333,0.002604
8103,Rio Blanco County,,CO,750,6268,7018,4,4,8,1988,3109,5097,6,0.287291,0.297108,0.603333,0.000152,0.000142,35,0.00008,0,10,0.75,0.001619
38073,Ransom County,,ND,424,6579,7003,4,4,8,1874,2525,4399,6,0.297761,0.307357,1.583333,0.000074,0.000058,39,0.000146,0,10,0.666667,0.00085
46087,McCook County,,SD,452,6535,6987,3,4,7,2861,3203,6064,6,0.300469,0.310493,0,0.000119,0.000116,50,0.000098,0,10,1,0.001249
49001,Beaver County,,UT,548,6439,6987,5,5,10,2322,3345,5667,5,0.349329,0.364643,0,0.001113,0.001113,45,0.000083,0,10,1,0.010727
46041,Dewey County,,SD,438,6517,6955,3,6,9,991,1729,2720,5,0.296668,0.306999,6186.510191,0.000094,0.000103,50,0.000135,0,10,0.4,0.000945
29087,Holt County,,MO,473,6480,6953,4,4,8,1938,2477,4415,6,0.280215,0.289008,0.716667,0.000036,0.000033,14,0.000105,0,10,0.833333,0.000565
40067,Jefferson County,,OK,626,6326,6952,4,3,7,2864,3028,5892,5,0.293803,0.304574,0.893062,0.000152,0.000137,52,0.000085,0,10,0.5,0.001652
28125,Sharkey County,,MS,552,6376,6928,2,4,6,1188,1162,2350,6,0.300293,0.310536,2.43687,0.00005,0.000118,52,0.000064,0,10,0.666667,0.000453
30077,Powell County,,MT,607,6278,6885,4,5,9,1882,2738,4620,6,0.286996,0.297401,0,0.000127,0.000202,45,0.000098,0,10,1,0.001379
40033,Cotton County,,OK,594,6262,6856,3,3,6,3794,4002,7796,5,0.309117,0.319683,0,0.000263,0.000236,52,0.000069,0,10,1,0.002412
20163,Rooks County,,KS,426,6413,6839,1,2,3,1032,1339,2371,6,0.294648,0.303917,0,0.000013,0.000066,14,0.000072,0,10,1,0.000111
48075,Childress County,,TX,537,6281,6818,6,5,11,794,643,1437,5,0.343432,0.358165,219.441374,0.000242,0.000779,62,0.000132,0,10,0.482143,0.002542
31143,Polk County,,NE,459,6301,6760,5,5,10,2295,2544,4839,6,0.323471,0.333784,1.166667,0.000167,0.000359,50,0.000129,0,10,0.766667,0.001555
42113,Sullivan County,,PA,434,6314,6748,3,2,5,2131,2840,4971,6,0.279858,0.28877,0,0.000343,0.000043,36,0.000064,0,10,1,0.002779
13283,Treutlen County,,GA,425,6318,6743,4,4,8,2316,2162,4478,6,0.265102,0.272976,19.923435,0.000038,0.00003,6,0.000106,0,10,0.75,0.000532
13037,Calhoun County,,GA,462,6280,6742,3,5,8,1625,2587,4212,6,0.278715,0.288471,376.158488,0.000068,0.000059,5,0.000086,0,10,0.4,0.000715
48207,Haskell County,,TX,508,6204,6712,5,4,9,2277,2592,4869,6,0.304762,0.315527,87.953567,0.000657,0.000198,62,0.0001,0,10,0.7,0.006571
29035,Carter County,,MO,574,6106,6680,4,3,7,2196,2390,4586,7,0.253069,0.259758,2.561544,0.000009,0.00001,14,0.00013,0,10,0.583333,0.000349
49025,Kane County,,UT,618,6061,6679,6,7,13,3926,4406,8332,5,0.362863,0.379688,0,0.001202,0.001729,45,0.000088,0,10,1,0.011615
2188,Northwest Arctic Borough,,AK,519,6155,6674,3,5,8,2174,4131,6305,5,0.322181,0.3331,0,0.000412,0.000479,45,0.000074,0,10,0.95,0.003953
17155,Putnam County,,IL,470,6177,6647,4,3,7,4343,4420,8763,6,0.276408,0.284804,0,0.000528,0.000042,8,0.000079,0,10,1,0.005125
51580,Covington city,,VA,360,6282,6642,4,6,10,3239,3373,6612,6,0.291849,0.3014,2700.069405,0.000072,0.000057,37,0.000128,0,10,0.4,0.000692
2270,Wade Hampton Census Area,,AK,403,6225,6628,3,4,7,2708,3599,6307,5,0.322148,0.332937,0,0.000412,0.00045,45,0.000071,0,10,1,0.003956
46077,Kingsbury County,,SD,443,6180,6623,4,5,9,1462,2524,3986,6,0.300499,0.310655,0.535714,0.000122,0.000106,50,0.000114,0,10,0.9,0.001315
22107,Tensas Parish,,LA,492,6128,6620,6,5,11,1039,1906,2945,6,0.314175,0.325022,1.674104,0.000627,0.00026,12,0.000113,0,10,0.766667,0.005226
47095,Lake County,,TN,444,6152,6596,2,2,4,2882,3723,6605,7,0.251927,0.258282,0,0.000012,0.000012,52,0.000074,0,10,1,0.000235
46057,Hamlin County,,SD,482,6103,6585,4,3,7,2767,3100,5867,6,0.300381,0.310221,0,0.00012,0.000104,50,0.000114,0,10,1,0.001292
31065,Furnas County,,NE,527,6043,6570,3,5,8,816,1610,2426,6,0.312895,0.322564,127.284138,0.000019,0.000125,50,0.000102,0,10,0.7,0.000286
20007,Barber County,,KS,427,6142,6569,3,3,6,657,1101,1758,6,0.320167,0.329704,27.951726,0.000227,0.000202,14,0.000094,0,10,0.333333,0.002082
38019,Cavalier County,,ND,383,6168,6551,1,3,4,117,1088,1205,5,0.301176,0.310878,0,0.000055,0.0001,39,0.000059,0,10,1,0.000506
29179,Reynolds County,,MO,581,5957,6538,5,6,11,653,1482,2135,6,0.271115,0.279514,450.204184,0.00037,0.000026,14,0.000112,0,10,0.595238,0.003504
54021,Gilmer County,,WV,407,6109,6516,3,3,6,1660,1862,3522,7,0.230527,0.235755,4.424242,0.000001,0.000001,41,0.000101,0,10,0.333333,0.000178
27069,Kittson County,,MN,328,6185,6513,1,5,6,180,748,928,5,0.301354,0.31142,0,0.000002,0.000107,39,0.000061,0,10,1,0.00008
20137,Norton County,,KS,441,6069,6510,3,2,5,624,426,1050,6,0.2699,0.277181,3072,0,0.000004,14,0.000195,0,10,0.333333,0.000163
2290,Yukon-Koyukuk Census Area,,AK,630,5878,6508,2,3,5,3332,5221,8553,5,0.322114,0.332775,0,0.00041,0.000448,45,0.00006,0,10,1,0.003879
38103,Wells County,,ND,416,6079,6495,2,3,5,174,1004,1178,6,0.303737,0.313694,0,0.000136,0.000141,39,0.000072,0,10,1,0.001291
48195,Hansford County,,TX,549,5913,6462,4,5,9,605,1388,1993,6,0.290524,0.300222,2.492063,0.000127,0.000139,62,0.000103,0,10,0.766667,0.001538
21165,Menifee County,,KY,441,6012,6453,5,5,10,2629,3075,5704,6,0.316114,0.3264,1.443972,0.000013,0.000205,42,0.000135,0,10,0.690476,0.000415
46015,Brule County,,SD,532,5885,6417,3,5,8,1268,1826,3094,5,0.304038,0.314735,3085.62619,0.000109,0.000165,50,0.000101,0,10,0.45,0.001101
51017,Bath County,,VA,354,6052,6406,3,4,7,656,1087,1743,6,0.34544,0.359093,731.49995,0.000457,0.00046,37,0.000088,0,10,0.166667,0.004285
20189,Stevens County,,KS,610,5777,6387,5,1,6,1219,885,2104,6,0.27458,0.282069,0,0.000026,0.00001,14,0.000129,0,10,0.5,0.000518
56011,Crook County,,WY,599,5760,6359,5,5,10,3714,3666,7380,5,0.296125,0.305941,0.916667,0.000122,0.000118,35,0.000136,0,10,0.85,0.001474
31129,Nuckolls County,,NE,348,6003,6351,2,3,5,392,1008,1400,6,0.312735,0.322076,1.25,0.000006,0.000121,50,0.000081,0,10,0.583333,0.000166
17009,Brown County,,IL,360,5989,6349,5,5,10,1687,1916,3603,6,0.273018,0.281299,3.631361,0.000024,0.000026,14,0.000122,0,10,0.7,0.000533
27031,Cook County,,MN,450,5868,6318,4,3,7,1452,1360,2812,5,0.332828,0.344808,0,0.000623,0.000386,39,0.000083,0,10,1,0.005767
17013,Calhoun County,,IL,291,6023,6314,3,4,7,1243,1359,2602,6,0.30263,0.31199,44.143884,0.00047,0.000091,14,0.000071,0,10,0.55,0.004013
21129,Lee County,,KY,294,6010,6304,3,5,8,450,1212,1662,6,0.316147,0.326454,1775.821585,0.000017,0.000211,42,0.000114,0,10,0.5,0.00035
46039,Deuel County,,SD,368,5910,6278,3,3,6,1330,1971,3301,6,0.300381,0.310221,0,0.000119,0.000104,50,0.000094,0,10,1,0.001231
20171,Scott County,,KS,475,5754,6229,2,2,4,848,816,1664,6,0.284365,0.292622,6154,0.000032,0.000023,14,0.000156,0,10,0,0.000339
55037,Florence County,,WI,376,5840,6216,5,4,9,2191,2339,4530,6,0.290882,0.300624,1.194724,0.0004,0.000082,8,0.000097,0,10,0.8,0.003616
5013,Calhoun County,,AR,382,5819,6201,4,4,8,2187,2138,4325,6,0.317881,0.327962,1.405383,0.000021,0.000225,52,0.00009,0,10,0.75,0.000435
13259,Stewart County,,GA,411,5785,6196,3,2,5,1157,1848,3005,6,0.308093,0.318392,367.756515,0.000228,0.000201,6,0.000113,0,10,0.333333,0.002295
31123,Morrill County,,NE,491,5695,6186,2,2,4,2153,2660,4813,6,0.312895,0.322184,105.364656,0.000019,0.000131,35,0.000087,0,10,0.666667,0.000273
13201,Miller County,,GA,385,5783,6168,3,4,7,3399,3500,6899,7,0.25286,0.259611,1.188462,0.000008,0.000013,5,0.000099,0,10,0.5,0.000283
46053,Gregory County,,SD,331,5822,6153,2,2,4,226,434,660,6,0.300381,0.310113,0,0.000104,0.000091,50,0.00008,0,10,0.833333,0.001
21077,Gallatin County,,KY,660,5476,6136,8,5,13,9046,7820,16866,6,0.294422,0.303678,4.715216,0.000781,0.000149,42,0.000136,0,10,0.732143,0.007235
17171,Scott County,,IL,334,5757,6091,2,4,6,2937,3127,6064,6,0.301147,0.310428,0.458824,0.000007,0.000074,8,0.000079,0,10,0.833333,0.000164
36041,Hamilton County,,NY,422,5665,6087,3,4,7,606,944,1550,6,0.293354,0.304232,0.111111,0.000212,0.000216,36,0.000067,0,10,0.833333,0.001917
29171,Putnam County,,MO,333,5747,6080,3,4,7,936,1020,1956,6,0.274752,0.282758,31.840844,0.000016,0.000012,14,0.000095,0,10,0.333333,0.000281
42053,Forest County,,PA,373,5701,6074,5,6,11,2002,2389,4391,6,0.325734,0.338883,0.491667,0.000484,0.0004,41,0.000085,0,10,0.833333,0.004265
40007,Beaver County,,OK,606,5467,6073,3,4,7,2297,1921,4218,6,0.278337,0.286659,61.875554,0.000029,0.00003,14,0.000089,0,10,0.416667,0.00047
46091,Marshall County,,SD,346,5711,6057,2,2,4,845,944,1789,6,0.273943,0.281695,2.216667,0.000013,0.000014,50,0.000091,0,10,0,0.000258
48411,San Saba County,,TX,473,5565,6038,4,4,8,537,748,1285,5,0.340992,0.355284,1.130556,0.000499,0.000532,62,0.000088,0,10,0.5,0.005309
40003,Alfalfa County,,OK,471,5558,6029,3,4,7,2002,2395,4397,6,0.324942,0.336024,0.533333,0.00005,0.000349,52,0.0001,0,10,0.916667,0.000667
47067,Hancock County,,TN,243,5774,6017,4,4,8,1398,1624,3022,6,0.273724,0.281695,0,0.000022,0.000019,51,0.000115,0,10,1,0.000443
30101,Toole County,,MT,403,5589,5992,4,6,10,792,1590,2382,6,0.293046,0.30383,3072,0.000063,0.000283,45,0.000126,0,10,0.690476,0.000762
48283,La Salle County,,TX,372,5616,5988,3,3,6,2000,2467,4467,5,0.336436,0.349251,0.227709,0.000478,0.000515,62,0.000072,0,10,0.833333,0.004998
53013,Columbia County,,WA,494,5472,5966,2,3,5,1923,2121,4044,5,0.310994,0.321707,0,0.00011,0.000294,45,0.000063,0,10,1,0.001244
19003,Adams County,,IA,378,5550,5928,3,4,7,928,1063,1991,6,0.316082,0.326264,3.54246,0.000004,0.000192,8,0.000104,0,10,0.5,0.000197
48483,Wheeler County,,TX,504,5417,5921,4,4,8,802,1375,2177,6,0.290551,0.300195,15.337873,0.000136,0.000131,62,0.000105,0,10,0.5,0.00158
12077,Liberty County,,FL,358,5558,5916,5,5,10,3850,3745,7595,6,0.316114,0.327203,1,0.000308,0.000462,5,0.000107,0,10,0.766667,0.00281
35023,Hidalgo County,,NM,676,5239,5915,4,6,10,828,2229,3057,5,0.36086,0.377192,0,0.000941,0.00121,35,0.000075,0,10,1,0.009435
19159,Ringgold County,,IA,312,5591,5903,4,4,8,986,1282,2268,6,0.316017,0.326156,295.433273,0.000203,0.000192,8,0.000116,0,10,0.583333,0.00204
38045,LaMoure County,,ND,287,5608,5895,2,3,5,574,1245,1819,6,0.297761,0.307248,0.833333,0.000075,0.000056,39,0.000081,0,10,0.666667,0.000715
51045,Craig County,,VA,309,5574,5883,5,4,9,1750,1805,3555,6,0.295101,0.304959,0.565023,0.000217,0.000143,37,0.000097,0,10,0.75,0.001659
8011,Bent County,,CO,564,5318,5882,4,4,8,1847,2415,4262,5,0.338289,0.350412,1.368254,0.000274,0.000508,35,0.000094,0,10,0.95,0.00292
2198,Prince Of Wales Oute,,AK,726,5143,5869,4,3,7,1328,1774,3102,5,0.322114,0.332775,0,0.000733,0.000311,45,0.00008,0,10,1,0.007231
20019,Chautauqua County,,KS,480,5367,5847,3,4,7,1220,1755,2975,6,0.3202,0.329921,0.125,0.000237,0.000235,14,0.000077,0,10,0.833333,0.002185
21063,Elliott County,,KY,304,5527,5831,3,3,6,1769,1730,3499,7,0.252237,0.259167,8.118122,0.000007,0.000006,41,0.000099,0,10,0.833333,0.000236
38069,Pierce County,,ND,343,5488,5831,3,4,7,515,972,1487,6,0.303797,0.313911,1.75517,0.000068,0.000142,39,0.00009,0,10,0.75,0.000779
40043,Dewey County,,OK,428,5402,5830,3,3,6,1337,1803,3140,6,0.324839,0.335753,0,0.000295,0.000312,52,0.000086,0,10,1,0.003148
30015,Chouteau County,,MT,461,5355,5816,3,5,8,1319,1842,3161,6,0.294479,0.305246,0.142857,0.000064,0.000212,45,0.000091,0,10,0.95,0.000724
32021,Mineral County,,NV,573,5227,5800,4,3,7,1564,2096,3660,6,0.311593,0.322304,0,0.000756,0.000299,45,0.000078,0,10,1,0.007705
40053,Grant County,,OK,476,5317,5793,2,2,4,2072,2629,4701,6,0.280625,0.289567,0,0.000062,0.00006,52,0.000065,0,10,1,0.000708
38081,Sargent County,,ND,302,5441,5743,4,3,7,1276,1785,3061,6,0.297732,0.307194,1,0.000073,0.000057,39,0.000143,0,10,0.666667,0.000848
31097,Johnson County,,NE,408,5331,5739,4,5,9,2083,2369,4452,6,0.323471,0.333784,1.126263,0.000163,0.000354,50,0.000117,0,10,0.85,0.001418
48247,Jim Hogg County,,TX,412,5323,5735,3,4,7,787,454,1241,5,0.338699,0.352127,0,0.00024,0.000852,62,0.000069,0,10,1,0.002485
47127,Moore County,,TN,367,5337,5704,5,5,10,4825,4247,9072,6,0.304279,0.314513,0,0.000186,0.000219,51,0.000112,0,10,1,0.002375
56017,Hot Springs County,,WY,548,5115,5663,4,5,9,1018,1529,2547,6,0.283526,0.292974,0,0.000096,0.000142,35,0.000086,0,10,1,0.001293
40055,Greer County,,OK,521,5134,5655,3,5,8,1713,2057,3770,6,0.325527,0.336735,0.257576,0.000047,0.000347,52,0.000086,0,10,0.95,0.000581
55078,Menominee County,,WI,292,5363,5655,3,3,6,2271,3068,5339,6,0.324016,0.33508,0,0.000395,0.000356,8,0.000069,0,10,1,0.003428
38053,McKenzie County,,ND,359,5295,5654,8,4,12,2033,2148,4181,6,0.280727,0.289827,18.649247,0.000398,0.000078,39,0.000182,0,10,0.553571,0.004616
21181,Nicholas County,,KY,332,5278,5610,5,7,12,3248,3213,6461,6,0.316147,0.326671,4.178882,0.000224,0.000208,42,0.000133,0,10,0.714286,0.002176
20119,Meade County,,KS,433,5147,5580,2,2,4,820,764,1584,6,0.283395,0.291461,0,0.000038,0.000028,14,0.000075,0,10,1,0.000386
27087,Mahnomen County,,MN,330,5245,5575,2,5,7,1896,2155,4051,6,0.297876,0.307682,0,0.000012,0.000073,39,0.000072,0,10,1,0.000222
16063,Lincoln County,,ID,518,5015,5533,6,6,12,4462,4462,8924,6,0.313341,0.324034,0.948413,0.000074,0.000273,45,0.000113,0,10,0.857143,0.001192
29103,Knox County,,MO,349,5139,5488,3,3,6,1271,1401,2672,6,0.273285,0.280849,14.46566,0.000013,0.000009,14,0.000117,0,10,0.166667,0.000251
20185,Stafford County,,KS,339,5148,5487,3,4,7,1009,1703,2712,6,0.320267,0.329894,0,0.000024,0.000221,14,0.000093,0,10,1,0.000398
48119,Delta County,,TX,475,5009,5484,5,6,11,3810,4239,8049,5,0.346024,0.361155,0,0.000839,0.001351,62,0.000086,0,10,1,0.008682
37095,Hyde County,,NC,361,5104,5465,3,4,7,1196,1485,2681,6,0.289102,0.299235,35.405634,0.000135,0.000144,37,0.000075,0,10,0.666667,0.001525
49017,Garfield County,,UT,514,4906,5420,6,5,11,1668,2366,4034,5,0.349329,0.364643,0,0.00112,0.001113,45,0.000094,0,10,1,0.010864
40029,Coal County,,OK,390,5017,5407,4,4,8,2542,2910,5452,6,0.263194,0.27105,0,0.000042,0.000038,62,0.000098,0,10,1,0.000643
20141,Osborne County,,KS,340,5059,5399,1,2,3,214,470,684,6,0.270018,0.277371,0,0.000001,0.000005,14,0.00007,0,10,0.5,0.000058
31029,Chase County,,NE,349,5031,5380,0,1,1,0,237,237,6,0.312614,0.321646,0,0,0.000115,50,0.000049,0,40,0,0
51530,Buena Vista city,,VA,422,4958,5380,2,3,5,4069,4314,8383,7,0.2523,0.259291,90.867781,0.000001,0.000014,13,0.000117,0,10,0.666667,0.000148
30071,Phillips County,,MT,387,4991,5378,1,3,4,40,588,628,6,0.288532,0.298475,0,0.000075,0.000072,45,0.000061,0,10,1,0.000771
8073,Lincoln County,,CO,576,4771,5347,4,5,9,1194,1162,2356,5,0.339785,0.352338,0.324675,0.000626,0.001266,35,0.000084,0,10,0.904762,0.006361
47175,Van Buren County,,TN,319,5001,5320,5,4,9,2647,2785,5432,6,0.265354,0.273519,19.185293,0.000027,0.000056,51,0.000135,0,10,0.3,0.000862
29199,Scotland County,,MO,268,5039,5307,2,3,5,155,399,554,6,0.27331,0.280876,56.341745,0.000013,0.000009,14,0.00009,0,10,0.333333,0.000195
13309,Wheeler County,,GA,330,4859,5189,4,5,9,1881,1934,3815,6,0.265148,0.273139,22.36263,0.000032,0.000028,6,0.000112,0,10,0.65,0.000504
51830,Williamsburg city,,VA,928,4235,5163,11,12,23,12667,15332,27999,6,0.335921,0.351579,10.260853,0.002036,0.002399,13,0.000124,0,10,0.909091,0.019681
48197,Hardeman County,,TX,455,4701,5156,1,4,5,912,1670,2582,5,0.342055,0.356293,0.647619,0.000007,0.000569,62,0.000059,0,10,0.666667,0.000105
30091,Sheridan County,,MT,310,4834,5144,1,1,2,58,291,349,6,0.288424,0.298041,0,0.000075,0.000069,45,0.000061,0,10,0,0.000771
38029,Emmons County,,ND,250,4872,5122,1,3,4,553,1366,1919,6,0.297963,0.307628,0,0.000022,0.000085,39,0.000073,0,10,1,0.000337
32027,Pershing County,,NV,553,4555,5108,4,5,9,1973,3095,5068,5,0.348378,0.363504,0,0.000735,0.000807,45,0.00008,0,10,1,0.007355
8009,Baca County,,CO,293,4813,5106,1,1,2,63,221,284,6,0.254389,0.259706,0,0.00001,0.000002,35,0.000063,0,10,0,0.00008
20183,Smith County,,KS,303,4794,5097,2,0,2,4499,0,4499,0,0,0,0,0,0,14,0.000103,0,1,0.5,0.000116
46045,Edmunds County,,SD,255,4828,5083,1,1,2,1690,1991,3681,6,0.273772,0.281261,0,0.000013,0.000013,50,0.000067,0,10,0,0.00019
18161,Union County,,IN,320,4749,5069,5,5,10,5425,5357,10782,6,0.307908,0.318072,1.419916,0.000225,0.000197,42,0.000087,0,10,0.8,0.002023
20093,Kearny County,,KS,365,4704,5069,1,1,2,1792,1905,3697,6,0.284313,0.292405,0,0.000032,0.000023,14,0.000058,0,10,0,0.000285
31125,Nance County,,NE,353,4715,5068,3,4,7,1026,1211,2237,6,0.312735,0.322184,0.583333,0.000009,0.000127,50,0.000099,0,10,0.75,0.00028
48333,Mills County,,TX,360,4703,5063,1,1,2,608,751,1359,6,0.264942,0.272233,0,0.000023,0.00002,62,0.000059,0,10,0,0.000269
17069,Hardin County,,IL,281,4732,5013,1,2,3,628,1026,1654,7,0.23234,0.237171,0,0.000001,0.000003,14,0.000067,0,10,1,0.00009
31175,Valley County,,NE,267,4735,5002,2,4,6,121,503,624,6,0.31315,0.322689,48.267374,0.000026,0.000141,50,0.000076,0,10,0.6,0.000324
30065,Musselshell County,,MT,450,4538,4988,1,1,2,1838,2413,4251,6,0.288424,0.298041,0,0.000075,0.000069,45,0.000061,0,10,0,0.000771
27077,Lake of the Woods County,,MN,328,4645,4973,1,1,2,571,737,1308,6,0.251165,0.256532,0,0.000003,0.000003,39,0.000063,0,10,0,0.000084
48435,Sutton County,,TX,410,4559,4969,2,4,6,1223,1870,3093,6,0.292934,0.304253,1.506463,0.000143,0.000195,62,0.000063,0,10,0.666667,0.001312
40059,Harper County,,OK,425,4502,4927,2,2,4,609,1066,1675,6,0.324804,0.33559,88.204406,0.000004,0.000305,52,0.000084,0,10,0.666667,0.000178
20089,Jewell County,,KS,312,4598,4910,2,1,3,3951,369,4320,7,0.243984,0.248375,0,0.000002,0,14,0.000078,0,10,0.5,0.000119
48317,Martin County,,TX,463,4437,4900,3,2,5,3232,2548,5780,6,0.282171,0.291732,0,0.000134,0.000091,62,0.00008,0,10,1,0.001757
46025,Clark County,,SD,216,4680,4896,1,2,3,828,1159,1987,6,0.300323,0.310004,0,0.000007,0.000093,50,0.000067,0,10,1,0.000127
31181,Webster County,,NE,352,4541,4893,1,3,4,1025,1354,2379,6,0.312735,0.322076,0,0.000005,0.000121,50,0.000063,0,10,0.833333,0.000112
21105,Hickman County,,KY,352,4526,4878,5,5,10,1975,2034,4009,6,0.272051,0.280729,21.804506,0.000028,0.000021,52,0.000139,0,10,0.7,0.000515
51560,Clifton Forge,,VA,384,4487,4871,2,2,4,172,183,355,7,0.226232,0.2309,0,0.000001,0.000001,37,0.000084,0,10,1,0.00012
27125,Red Lake County,,MN,280,4583,4863,2,4,6,2064,2167,4231,5,0.301265,0.311149,0,0.000009,0.000107,39,0.000075,0,10,1,0.000198
30061,Mineral County,,MT,554,4304,4858,1,1,2,1873,2086,3959,6,0.285741,0.295264,0,0.000079,0.000071,45,0.000057,0,10,0,0.000763
27155,Traverse County,,MN,353,4497,4850,2,3,5,200,353,553,6,0.297905,0.307492,24.370739,0.000001,0.000055,50,0.000091,0,10,0.416667,0.000129
35033,Mora County,,NM,319,4518,4837,3,2,5,1819,2333,4152,5,0.324598,0.334717,0,0.000327,0.00033,35,0.000072,0,10,1,0.003219
12067,Lafayette County,,FL,362,4466,4828,3,3,6,2296,2428,4724,6,0.266482,0.274463,0.083333,0.000088,0.000099,5,0.000078,0,10,0.833333,0.001114
46059,Hand County,,SD,219,4609,4828,0,2,2,0,100,100,6,0.300391,0.31012,0,0,0.00009,50,0.000049,0,60,1,0
30007,Broadwater County,,MT,361,4459,4820,3,3,6,3225,2716,5941,6,0.290387,0.300743,0,0.000187,0.000186,45,0.000083,0,10,1,0.002053
2070,Dillingham Census Area,,AK,424,4387,4811,2,3,5,1324,2159,3483,5,0.322114,0.332775,0,0.000278,0.000448,45,0.000066,0,10,1,0.002726
20105,Lincoln County,,KS,288,4523,4811,2,1,3,801,856,1657,6,0.278842,0.286708,0,0.000025,0.000014,14,0.000074,0,10,1,0.000258
16037,Custer County,,ID,475,4331,4806,6,4,10,830,844,1674,6,0.313629,0.324197,25.936503,0.000301,0.000279,45,0.000114,0,10,0.666667,0.003395
31105,Kimball County,,NE,354,4451,4805,3,3,6,905,1088,1993,6,0.292126,0.301497,1.274342,0.000112,0.00011,35,0.000089,0,10,0.833333,0.001236
35059,Union County,,NM,460,4341,4801,2,4,6,142,579,721,5,0.325838,0.336697,22.739579,0.000009,0.000379,62,0.000074,0,10,0.5,0.000159
8121,Washington County,,CO,411,4387,4798,4,4,8,1227,1774,3001,5,0.296211,0.306028,0,0.000146,0.000137,35,0.000086,0,10,1,0.001574
48103,Crane County,,TX,386,4390,4776,2,2,4,1778,2208,3986,6,0.282197,0.291786,0,0.000114,0.000136,62,0.000071,0,10,1,0.001537
46085,Lyman County,,SD,302,4449,4751,3,4,7,631,916,1547,5,0.303978,0.314518,2.654762,0.000109,0.000165,50,0.000095,0,10,0.75,0.001096
20081,Haskell County,,KS,466,4284,4750,4,5,9,853,1302,2155,6,0.285131,0.293951,19.177449,0.00005,0.000034,14,0.000112,0,10,0.5,0.000557
48267,Kimble County,,TX,334,4402,4736,2,2,4,413,580,993,6,0.287748,0.29821,0,0.000439,0.000123,62,0.000067,0,10,1,0.004655
29197,Schuyler County,,MO,252,4464,4716,2,1,3,1259,1574,2833,6,0.273018,0.280143,0,0.000013,0.000009,14,0.000082,0,10,1,0.000194
2016,Aleutians West Census Area,,AK,793,3899,4692,7,8,15,2358,3566,5924,5,0.362563,0.379823,0.070197,0.002516,0.00254,45,0.000084,0,10,0.910714,0.023553
38031,Foster County,,ND,308,4366,4674,2,3,5,337,883,1220,6,0.297963,0.307628,0,0.000075,0.000081,39,0.000081,0,10,1,0.000715
16061,Lewis County,,ID,485,4182,4667,3,2,5,2568,3582,6150,6,0.267619,0.274702,0,0.000021,0.00002,45,0.000091,0,10,1,0.000391
35019,Guadalupe County,,NM,401,4243,4644,2,3,5,866,1507,2373,5,0.324976,0.335422,0,0.000319,0.000377,35,0.000064,0,10,0.833333,0.003124
16071,Oneida County,,ID,288,4345,4633,4,3,7,1017,1409,2426,6,0.280907,0.290668,0,0.000475,0.000089,45,0.000078,0,10,1,0.004564
31061,Franklin County,,NE,262,4353,4615,2,3,5,698,742,1440,6,0.270208,0.277854,0,0.000017,0.000013,50,0.000078,0,10,1,0.000207
38063,Nelson County,,ND,282,4302,4584,3,3,6,682,1114,1796,5,0.301176,0.310878,0,0.000126,0.0001,39,0.0001,0,10,1,0.001217
48151,Fisher County,,TX,414,4160,4574,4,4,8,1219,1142,2361,6,0.297099,0.306955,0.309524,0.000125,0.000111,62,0.00009,0,10,0.833333,0.001332
48275,Knox County,,TX,468,4085,4553,2,4,6,632,1098,1730,5,0.301946,0.312641,8.870272,0.000102,0.000201,62,0.000077,0,10,0.5,0.001037
47137,Pickett County,,TN,192,4326,4518,4,4,8,1195,1432,2627,6,0.265629,0.27379,104.039605,0.00002,0.000045,51,0.000137,0,10,0.5,0.000685
20165,Rush County,,KS,279,4230,4509,2,2,4,1064,1328,2392,6,0.270399,0.27781,0,0.000019,0.000014,14,0.000086,0,10,1,0.00026
20129,Morton County,,KS,470,4024,4494,1,3,4,88,490,578,6,0.27811,0.286117,0,0.000009,0.000024,14,0.000058,0,10,0.833333,0.000191
20135,Ness County,,KS,290,4193,4483,1,1,2,73,404,477,6,0.269829,0.27691,0,0.000013,0.000004,14,0.000072,0,10,0,0.000111
48137,Edwards County,,TX,315,4156,4471,1,2,3,123,95,218,5,0.336399,0.349089,0,0.00005,0.00048,62,0.000054,0,10,1,0.000432
40045,Ellis County,,OK,357,4088,4445,2,2,4,1647,1536,3183,6,0.324804,0.33559,0,0.000288,0.000305,52,0.000072,0,10,1,0.003017
46061,Hanson County,,SD,234,4205,4439,3,3,6,1266,1543,2809,6,0.30044,0.31033,25.016132,0.000155,0.000091,50,0.000087,0,10,0.25,0.001629
31083,Harlan County,,NE,313,4109,4422,2,3,5,425,785,1210,6,0.312799,0.322184,0,0.000003,0.000123,50,0.000081,0,10,0.916667,0.000124
31163,Sherman County,,NE,261,4148,4409,2,3,5,750,1295,2045,6,0.313086,0.322472,0,0.000039,0.000141,50,0.000075,0,10,1,0.0004
46105,Perkins County,,SD,273,4133,4406,0,1,1,0,42,42,6,0.273935,0.281321,0,0,0.000023,50,0.000049,0,64,0,0
13007,Baker County,,GA,343,4053,4396,5,2,7,1657,1422,3079,6,0.278564,0.28782,55.934657,0.00007,0.000057,5,0.000121,0,10,0.5,0.000828
17151,Pope County,,IL,334,4058,4392,4,3,7,1107,1754,2861,7,0.232886,0.238164,12.603799,0.000001,0.000006,14,0.000132,0,10,0.5,0.000291
20063,Gove County,,KS,275,4095,4370,0,1,1,0,187,187,6,0.269869,0.276982,0,0,0.000004,14,0.000049,0,20,0,0
46043,Douglas County,,SD,199,4169,4368,1,2,3,49,569,618,6,0.300381,0.310113,0,0.000006,0.000091,50,0.000069,0,10,1,0.000104
37177,Tyrrell County,,NC,306,4060,4366,3,2,5,949,858,1807,7,0.256449,0.264201,0.57549,0.000025,0.000027,37,0.000092,0,10,0.5,0.00043
48105,Crockett County,,TX,414,3951,4365,1,2,3,768,977,1745,6,0.289402,0.30032,0,0.000093,0.000157,62,0.000057,0,10,1,0.000881
31017,Brown County,,NE,260,4102,4362,0,1,1,0,43,43,1,1,1,0,0,0,50,0.000049,0,39,0,0
20039,Decatur County,,KS,279,4076,4355,1,1,2,54,151,205,7,0.21258,0.216157,4.35119,0.000001,0,14,0.000082,0,10,0,0.000058
51720,Norton city,,VA,361,3974,4335,2,2,4,3843,3874,7717,7,0.2283,0.233384,0,0.000001,0.000001,51,0.000087,0,10,1,0.000127
38011,Bowman County,,ND,288,4034,4322,1,2,3,93,356,449,6,0.278589,0.287093,0,0.000012,0.000043,39,0.00007,0,10,1,0.000249
8095,Phillips County,,CO,338,3951,4289,4,3,7,740,951,1691,5,0.315854,0.325456,0,0.000326,0.000377,35,0.000086,0,10,1,0.003795
46003,Aurora County,,SD,281,4002,4283,1,2,3,754,1116,1870,6,0.300381,0.310113,0,0.000006,0.000091,50,0.000069,0,10,1,0.000104
46031,Corson County,,SD,327,3950,4277,4,3,7,797,1236,2033,6,0.278614,0.287147,2.830303,0.000024,0.000026,50,0.000153,0,10,0.5,0.000515
48023,Baylor County,,TX,397,3845,4242,2,1,3,480,772,1252,5,0.293326,0.303461,0,0.000112,0.000108,62,0.000071,0,10,0.5,0.001147
51595,Emporia city,,VA,337,3904,4241,5,6,11,3464,3565,7029,6,0.30449,0.31664,4.04816,0.000035,0.000263,13,0.000101,0,10,0.666667,0.00061
38051,McIntosh County,,ND,180,4039,4219,1,2,3,48,514,562,6,0.297905,0.307411,0,0.000022,0.00008,39,0.000073,0,10,1,0.000337
29129,Mercer County,,MO,284,3924,4208,1,1,2,407,382,789,7,0.243365,0.248093,0,0.000002,0.000002,14,0.000066,0,10,0,0.000077
16003,Adams County,,ID,385,3808,4193,3,6,9,1652,1804,3456,6,0.313597,0.324306,0.25,0.000256,0.000286,45,0.00008,0,10,0.733333,0.002874
32017,Lincoln County,,NV,362,3818,4180,2,3,5,2707,1912,4619,5,0.348141,0.362961,0,0.000534,0.000597,45,0.000063,0,10,1,0.005522
20047,Edwards County,,KS,322,3845,4167,3,2,5,563,441,1004,6,0.281473,0.289285,2.533292,0.000025,0.000018,14,0.000089,0,10,0.166667,0.000348
48079,Cochran County,,TX,349,3789,4138,2,2,4,1374,2179,3553,6,0.300764,0.310883,0,0.00013,0.000108,62,0.000069,0,10,1,0.001209
38025,Dunn County,,ND,237,3896,4133,1,3,4,1127,1534,2661,6,0.278614,0.287256,0,0.000012,0.000044,39,0.00007,0,10,1,0.000249
30097,Sweet Grass County,,MT,391,3730,4121,4,4,8,696,1239,1935,6,0.290442,0.300933,0.613184,0.000156,0.000164,45,0.000117,0,10,0.833333,0.001884
53069,Wahkiakum County,,WA,351,3743,4094,3,3,6,1723,1726,3449,6,0.302422,0.313037,0,0.000218,0.00023,45,0.000071,0,10,1,0.002376
13249,Schley County,,GA,293,3785,4078,3,3,6,3058,2283,5341,6,0.260008,0.267063,1.151587,0.00002,0.000016,5,0.000106,0,10,0.666667,0.000323
48461,Upton County,,TX,485,3590,4075,2,3,5,782,1205,1987,6,0.282223,0.291949,0,0.000114,0.000148,62,0.000071,0,10,1,0.001537
2230,Skagway Hoonah Ango,,AK,482,3585,4067,2,2,4,499,706,1205,5,0.32208,0.332612,0,0.000301,0.000304,45,0.000065,0,10,1,0.002964
21237,Wolfe County,,KY,417,3644,4061,4,5,9,1434,1718,3152,6,0.316212,0.326563,5.173435,0.000004,0.0002,42,0.00012,0,10,0.533333,0.000251
48081,Coke County,,TX,372,3687,4059,2,2,4,1716,1854,3570,6,0.287506,0.297721,0,0.000099,0.000084,62,0.000076,0,10,1,0.00095
48383,Reagan County,,TX,337,3713,4050,2,2,4,757,951,1708,6,0.289402,0.30032,0,0.000143,0.000157,62,0.000063,0,10,1,0.001312
20097,Kiowa County,,KS,367,3657,4024,1,6,7,167,819,986,6,0.320401,0.330382,3086.811667,0.000003,0.000229,14,0.000069,0,10,0.433333,0.000072
51515,Bedford city,,VA,334,3685,4019,5,5,10,3568,4244,7812,6,0.292154,0.301742,0,0.000193,0.000151,37,0.00009,0,10,1,0.00172
31167,Stanton County,,NE,331,3658,3989,3,4,7,3208,3326,6534,6,0.323777,0.333936,0.25,0.000027,0.000369,50,0.000087,0,10,0.866667,0.000404
48169,Garza County,,TX,290,3696,3986,1,1,2,1833,2252,4085,6,0.300734,0.31072,0,0.000121,0.000102,62,0.000057,0,10,0,0.001093
31063,Frontier County,,NE,353,3608,3961,2,3,5,592,939,1531,6,0.274604,0.282753,0.564227,0.000022,0.00003,50,0.000076,0,10,0.666667,0.000389
20023,Cheyenne County,,KS,218,3738,3956,0,1,1,0,63,63,7,0.212856,0.21657,0,0,0,14,0.000049,0,19,0,0
8027,Custer County,,CO,404,3550,3954,5,3,8,1821,1776,3597,5,0.338177,0.350141,0,0.001072,0.000519,35,0.000087,0,10,1,0.010807
20065,Graham County,,KS,239,3702,3941,1,2,3,165,533,698,6,0.269876,0.277127,1470.952864,0.000013,0.000004,14,0.000072,0,10,0.5,0.000111
20109,Logan County,,KS,362,3578,3940,1,1,2,497,483,980,7,0.243945,0.248332,0,0.000001,0,14,0.000082,0,10,0,0.000058
48319,Mason County,,TX,230,3707,3937,1,0,1,41,0,41,0,0,0,0,0.000445,0,62,0.000056,0,8,0,0.004632
48417,Shackelford County,,TX,302,3621,3923,2,2,4,1011,1159,2170,6,0.297041,0.30663,0,0.000105,0.000095,62,0.000069,0,10,1,0.001054
48211,Hemphill County,,TX,424,3465,3889,3,3,6,204,582,786,6,0.290277,0.299626,0,0.000129,0.000124,62,0.000088,0,10,1,0.001452
48229,Hudspeth County,,TX,395,3490,3885,1,2,3,2800,1946,4746,6,0.324667,0.335525,0,0.000305,0.000312,35,0.000054,0,10,1,0.002912
20207,Woodson County,,KS,248,3625,3873,2,1,3,758,674,1432,7,0.247383,0.252244,0,0.000006,0.000003,14,0.000073,0,10,1,0.000165
31077,Greeley County,,NE,213,3655,3868,1,2,3,103,317,420,6,0.283029,0.291135,0,0.000024,0.00002,50,0.000061,0,10,1,0.000257
8025,Crowley County,,CO,440,3381,3821,3,2,5,1611,2032,3643,6,0.284497,0.293088,0,0.000395,0.000072,35,0.00008,0,10,1,0.004271
40129,Roger Mills County,,OK,303,3515,3818,1,2,3,1402,1600,3002,6,0.258869,0.265744,0,0.000007,0.000014,52,0.000066,0,10,1,0.000128
48191,Hall County,,TX,302,3507,3809,2,3,5,173,438,611,6,0.290222,0.299517,0,0.000117,0.000115,62,0.00007,0,10,1,0.001283
40025,Cimarron County,,OK,301,3477,3778,1,1,2,66,171,237,7,0.262631,0.269187,0,0.000009,0.000014,14,0.000058,0,10,0,0.000191
6091,Sierra County,,CA,299,3477,3776,4,3,7,1310,1749,3059,6,0.311562,0.322249,0,0.000444,0.000302,45,0.000072,0,10,1,0.004331
20195,Trego County,,KS,280,3494,3774,1,1,2,586,626,1212,6,0.269829,0.27691,0,0.000013,0.000004,14,0.000072,0,10,0,0.000111
31135,Perkins County,,NE,306,3461,3767,2,3,5,267,731,998,6,0.312767,0.32213,0,0.000014,0.000127,50,0.000082,0,10,1,0.000234
31087,Hitchcock County,,NE,249,3513,3762,1,1,2,1041,1015,2056,7,0.24482,0.249276,0,0.000002,0.000002,50,0.000073,0,10,0,0.000076
46117,Stanley County,,SD,389,3349,3738,1,2,3,3264,3334,6598,6,0.300411,0.31014,0,0.000006,0.000091,50,0.000067,0,10,1,0.0001
8023,Costilla County,,CO,355,3382,3737,1,3,4,245,866,1111,5,0.338065,0.350033,0,0.000014,0.000446,35,0.000059,0,10,0.833333,0.000159
38085,Sioux County,,ND,311,3425,3736,2,3,5,1162,1578,2740,6,0.278513,0.287039,1,0.000023,0.000031,39,0.000116,0,10,0.666667,0.000395
48129,Donley County,,TX,328,3400,3728,2,3,5,982,1324,2306,6,0.290277,0.299626,0,0.000117,0.000124,62,0.00007,0,10,1,0.001283
38095,Towner County,,ND,238,3477,3715,2,2,4,205,417,622,6,0.297732,0.307086,0,0.000002,0.000055,39,0.00009,0,10,0.833333,0.000139
21189,Owsley County,,KY,198,3495,3693,2,2,4,516,303,819,7,0.240394,0.245134,0,0.000002,0.000001,42,0.000084,0,10,1,0.000124
13061,Clay County,,GA,176,3483,3659,2,0,2,176,0,176,0,0,0,0,0.000002,0,5,0.000079,0,2,1,0.000125
8091,Ouray County,,CO,400,3254,3654,3,3,6,1903,2070,3973,6,0.287049,0.29662,0,0.000113,0.000121,35,0.000078,0,10,1,0.001353
20153,Rawlins County,,KS,184,3451,3635,1,1,2,66,175,241,7,0.243945,0.248332,0,0.000001,0,14,0.000082,0,10,0,0.000058
20017,Chase County,,KS,268,3357,3625,2,1,3,1005,903,1908,6,0.279832,0.287967,0.449663,0.000027,0.000012,14,0.000065,0,10,0,0.000248
30025,Fallon County,,MT,242,3382,3624,1,1,2,108,204,312,6,0.288424,0.298041,0,0.000075,0.000069,45,0.000061,0,10,0,0.000771
38037,Grant County,,ND,185,3386,3571,1,2,3,81,678,759,6,0.278488,0.286876,0,0.000008,0.000031,39,0.000069,0,10,1,0.000117
20179,Sheridan County,,KS,209,3341,3550,0,2,2,0,150,150,6,0.269964,0.277308,0,0,0.000004,14,0.000049,0,23,1,0
38041,Hettinger County,,ND,178,3368,3546,1,3,4,632,1013,1645,6,0.298079,0.307845,0,0.000012,0.000098,39,0.00007,0,10,1,0.000249
48087,Collingsworth County,,TX,319,3225,3544,0,2,2,0,175,175,6,0.280665,0.289701,0,0,0.000056,62,0.000049,0,68,1,0
38039,Griggs County,,ND,207,3308,3515,1,1,2,123,539,662,6,0.297674,0.306868,0,0.00007,0.000054,39,0.000063,0,10,0,0.00064
31133,Pawnee County,,NE,236,3233,3469,3,2,5,285,631,916,6,0.31264,0.321804,0.392157,0.00016,0.000117,50,0.000095,0,10,0.666667,0.001326
46107,Potter County,,SD,274,3185,3459,0,2,2,0,106,106,6,0.300509,0.310337,0,0,0.0001,50,0.000049,0,65,1,0
48271,Kinney County,,TX,252,3179,3431,2,2,4,769,818,1587,5,0.336399,0.349089,0,0.000459,0.00048,62,0.000061,0,10,1,0.004609
38075,Renville County,,ND,228,3201,3429,2,1,3,1763,1833,3596,6,0.292293,0.30102,0,0.000067,0.000061,39,0.000071,0,10,1,0.000708
13053,Chattahoochee County,,GA,363,3043,3406,28,32,60,16188,24424,40612,5,0.369898,0.390891,697.644006,0.006221,0.006113,6,0.000209,0,10,0.729412,0.058566
46007,Bennett County,,SD,246,3160,3406,2,2,4,504,535,1039,5,0.29584,0.305073,0,0.000089,0.000074,50,0.000095,0,10,1,0.000851
38043,Kidder County,,ND,206,3199,3405,1,2,3,642,936,1578,6,0.278538,0.286985,0,0.000022,0.000027,39,0.000073,0,10,1,0.000337
48385,Real County,,TX,313,3082,3395,3,3,6,838,662,1500,5,0.336326,0.349089,0,0.000899,0.000497,62,0.000072,0,10,1,0.009266
48109,Culberson County,,TX,367,3015,3382,2,2,4,218,617,835,6,0.325114,0.336203,2.423089,0.000307,0.000372,62,0.000077,0,10,0.666667,0.002978
48413,Schleicher County,,TX,260,3114,3374,2,2,4,1134,1158,2292,6,0.296039,0.30784,4.255781,0.000094,0.000192,62,0.00007,0,10,0.333333,0.000941
48295,Lipscomb County,,TX,362,3008,3370,1,1,2,588,580,1168,7,0.233648,0.238328,0,0.000001,0.000001,62,0.000071,0,10,0,0.000064
40057,Harmon County,,OK,322,3034,3356,1,1,2,459,804,1263,6,0.279807,0.28788,0,0.000038,0.000033,52,0.000056,0,10,0,0.000372
48205,Hartley County,,TX,318,3002,3320,4,4,8,1953,2644,4597,6,0.290469,0.300005,0,0.000131,0.000131,62,0.0001,0,10,1,0.001572
30039,Granite County,,MT,378,2919,3297,1,2,3,975,940,1915,6,0.285767,0.295426,0,0.000079,0.000073,45,0.000057,0,10,1,0.000763
16023,Butte County,,ID,278,3013,3291,0,3,3,0,736,736,6,0.27391,0.282677,0,0,0.000083,45,0.000049,0,17,1,0
8115,Sedgwick County,,CO,308,2982,3290,1,1,2,52,140,192,6,0.266667,0.273383,0,0.000192,0.000011,35,0.000055,0,10,1,0.002015
38091,Steele County,,ND,197,3092,3289,1,3,4,220,730,950,5,0.301147,0.310824,0,0.00007,0.0001,39,0.000063,0,10,1,0.00064
38013,Burke County,,ND,169,3066,3235,1,2,3,389,618,1007,6,0.292599,0.301644,0,0.000066,0.000095,39,0.000058,0,10,1,0.00065
38027,Eddy County,,ND,227,2978,3205,0,1,1,0,215,215,6,0.297714,0.306931,0,0,0.000054,39,0.000049,0,53,0,0
35003,Catron County,,NM,374,2830,3204,2,2,4,188,177,365,5,0.324736,0.334934,0,0.000528,0.000337,35,0.000063,0,10,1,0.005496
46111,Sanborn County,,SD,259,2919,3178,2,2,4,588,794,1382,6,0.269238,0.276541,0,0.000008,0.000006,50,0.000088,0,10,1,0.000188
20049,Elk County,,KS,273,2883,3156,2,3,5,419,690,1109,6,0.319933,0.329378,0,0.000231,0.000219,14,0.000065,0,10,0.833333,0.002056
13125,Glascock County,,GA,244,2904,3148,4,2,6,963,181,1144,7,0.252362,0.258293,0.25,0.000205,0.000004,37,0.000097,0,10,0.833333,0.001942
20075,Hamilton County,,KS,265,2862,3127,1,1,2,170,68,238,6,0.284313,0.292405,0,0.000032,0.000023,14,0.000058,0,10,0,0.000285
46089,McPherson County,,SD,158,2953,3111,1,1,2,166,608,774,6,0.273772,0.281261,0,0.000013,0.000013,50,0.000067,0,10,0,0.00019
46055,Haakon County,,SD,206,2874,3080,1,1,2,103,313,416,5,0.295811,0.30491,0,0.000088,0.000074,50,0.00006,0,10,0,0.000792
20203,Wichita County,,KS,246,2832,3078,1,1,2,41,73,114,7,0.221421,0.225329,0,0,0,14,0.000115,0,10,0,0.000056
48095,Concho County,,TX,332,2743,3075,1,2,3,1079,503,1582,6,0.287506,0.297721,0,0.000093,0.000084,62,0.000057,0,10,1,0.000881
46071,Jackson County,,SD,286,2788,3074,1,1,2,289,545,834,5,0.295811,0.30491,0,0.000088,0.000074,50,0.00006,0,10,0,0.000792
38001,Adams County,,ND,190,2862,3052,0,0,0,0,0,0,0,0,0,0,0,0,38,0.000049,29,52,0,0
2100,Haines Borough,,AK,291,2732,3023,1,2,3,250,556,806,5,0.32208,0.332612,0,0.000026,0.000304,45,0.000059,0,10,1,0.000316
31015,Boyd County,,NE,145,2829,2974,0,0,0,0,0,0,0,0,0,0,0,0,24,0.000049,19,38,0,0
38065,Oliver County,,ND,193,2770,2963,2,2,4,291,749,1040,6,0.278488,0.286876,0,0.000031,0.000031,39,0.000093,0,10,1,0.000454
56027,Niobrara County,,WY,230,2706,2936,1,1,2,68,80,148,6,0.240639,0.245285,0,0.000056,0.000003,35,0.000057,0,10,1,0.000667
13101,Echols County,,GA,256,2667,2923,1,1,2,2037,2334,4371,6,0.294366,0.304313,0,0.000121,0.000102,5,0.000056,0,10,0,0.001037
46049,Faulk County,,SD,178,2745,2923,1,1,2,60,262,322,6,0.273772,0.281261,0,0.000013,0.000013,50,0.000067,0,10,0,0.00019
20025,Clark County,,KS,205,2663,2868,1,1,2,672,573,1245,6,0.281422,0.289068,0,0.000023,0.000017,14,0.000061,0,10,0,0.000228
51091,Highland County,,VA,109,2755,2864,0,0,0,0,0,0,0,0,0,0,0,0,66,0.000049,47,81,0,0
38023,Divide County,,ND,157,2705,2862,1,1,2,155,181,336,6,0.277482,0.285265,0,0.00002,0.000034,39,0.00007,0,10,0,0.000413
38047,Logan County,,ND,142,2718,2860,1,1,2,70,155,225,6,0.278463,0.286713,0,0.000005,0.000025,39,0.000067,0,10,1,0.000075
46097,Miner County,,SD,202,2652,2854,2,2,4,191,497,688,6,0.300293,0.30995,0,0.000103,0.000088,50,0.000082,0,10,1,0.001003
20101,Lane County,,KS,185,2646,2831,0,0,0,0,0,0,0,0,0,0,0,0,10,0.000049,8,22,0,0
20187,Stanton County,,KS,205,2620,2825,0,1,1,0,156,156,7,0.243002,0.247232,0,0,0,14,0.000049,0,24,0,0
49055,Wayne County,,UT,304,2518,2822,1,3,4,405,481,886,5,0.32926,0.340658,0,0.000342,0.000415,45,0.000054,0,10,1,0.0031
51678,Lexington city,,VA,288,2515,2803,2,2,4,2392,2980,5372,7,0.225667,0.230325,0,0.000001,0.000003,13,0.000105,0,10,1,0.000148
48173,Glasscock County,,TX,282,2497,2779,2,1,3,389,41,430,6,0.28212,0.291515,0,0.000081,0.000075,62,0.000069,0,10,1,0.00106
48421,Sherman County,,TX,285,2478,2763,1,3,4,192,594,786,6,0.283134,0.292643,0,0.000013,0.000086,62,0.000061,0,10,1,0.000225
30019,Daniels County,,MT,133,2580,2713,0,1,1,0,86,86,6,0.288463,0.298107,0,0,0.000069,45,0.000049,0,27,0,0
31057,Dundy County,,NE,213,2496,2709,0,0,0,0,0,0,0,0,0,0,0,0,25,0.000049,20,41,0,0
46073,Jerauld County,,SD,150,2555,2705,1,2,3,301,388,689,6,0.269238,0.276541,0,0.000002,0.000006,50,0.000068,0,10,1,0.000084
31073,Gosper County,,NE,271,2426,2697,3,3,6,1248,1168,2416,6,0.275689,0.283914,0,0.000027,0.000026,50,0.000089,0,10,1,0.000441
30045,Judith Basin County,,MT,204,2480,2684,1,3,4,225,582,807,6,0.286487,0.295313,3083,0.000002,0.000054,45,0.000063,0,10,0.333333,0.000073
8017,Cheyenne County,,CO,213,2469,2682,0,0,0,0,0,0,0,0,0,0,0,0,1,0.000049,2,12,0,0
46021,Campbell County,,SD,130,2534,2664,0,1,1,0,50,50,6,0.278478,0.286728,0,0,0.000025,39,0.000049,0,59,0,0
31071,Garfield County,,NE,112,2548,2660,2,0,2,131,0,131,0,0,0,0,0.000006,0,50,0.000079,0,4,0,0.000168
13239,Quitman County,,GA,231,2400,2631,1,1,2,1264,1492,2756,7,0.243616,0.248921,0,0.000005,0.000007,6,0.000062,0,10,0,0.000125
31049,Deuel County,,NE,233,2379,2612,2,1,3,245,155,400,6,0.246134,0.250732,0.467816,0.000004,0.000003,35,0.000085,0,10,0,0.000157
31069,Garden County,,NE,221,2390,2611,0,0,0,0,0,0,0,0,0,0,0,0,26,0.000049,21,42,0,0
30107,Wheatland County,,MT,253,2313,2566,0,1,1,0,359,359,6,0.288463,0.298107,0,0,0.000069,45,0.000049,0,34,0,0
2068,Denali Borough,,AK,420,2132,2552,2,4,6,945,1531,2476,5,0.339523,0.352094,0,0.00041,0.000881,45,0.00006,0,10,1,0.003879
30051,Liberty County,,MT,188,2352,2540,0,1,1,0,81,81,7,0.226689,0.231559,0,0,0,45,0.000049,0,29,0,0
20083,Hodgeman County,,KS,150,2388,2538,1,1,2,521,472,993,6,0.281422,0.289068,0,0.000023,0.000017,14,0.000061,0,10,0,0.000228
48327,Menard County,,TX,193,2301,2494,1,1,2,90,97,187,6,0.287479,0.297559,0,0.000093,0.000082,62,0.000057,0,10,0,0.000881
48359,Oldham County,,TX,309,2161,2470,2,2,4,1214,1588,2802,6,0.290195,0.299354,0,0.000117,0.000114,62,0.00007,0,10,1,0.001283
30059,Meagher County,,MT,193,2271,2464,0,0,0,0,0,0,0,0,0,0,0,0,17,0.000049,12,30,0,0
29227,Worth County,,MO,143,2315,2458,1,1,2,255,419,674,7,0.251227,0.256866,0,0.000006,0.000005,14,0.000062,0,10,0,0.000107
35011,De Baca County,,NM,226,2211,2437,1,1,2,220,127,347,6,0.28199,0.290511,0,0.00005,0.000047,35,0.000056,0,10,0,0.000518
8109,Saguache County,,CO,261,2173,2434,4,3,7,1273,974,2247,6,0.266945,0.274116,1.058216,0.00029,0.000032,35,0.000085,0,10,0.333333,0.003219
48011,Armstrong County,,TX,257,2131,2388,2,2,4,1562,1329,2891,6,0.290195,0.299354,0,0.000117,0.000114,62,0.00007,0,10,1,0.001283
13307,Webster County,,GA,171,2205,2376,3,2,5,486,206,692,6,0.259942,0.266791,3.855711,0.000017,0.000012,5,0.000124,0,10,0.333333,0.00029
38033,Golden Valley County,,ND,164,2174,2338,0,1,1,0,201,201,6,0.274498,0.28207,0,0,0.000018,39,0.000049,0,54,0,0
48125,Dickens County,,TX,213,2124,2337,1,1,2,504,315,819,6,0.300734,0.31072,0,0.000121,0.000102,62,0.000057,0,10,0,0.001093
48243,Jeff Davis County,,TX,288,2018,2306,2,1,3,276,221,497,6,0.25876,0.265044,0,0.00001,0.000013,62,0.00008,0,10,1,0.000269
46095,Mellette County,,SD,181,2118,2299,1,2,3,201,171,372,5,0.295897,0.305181,0,0.000001,0.000075,50,0.000072,0,10,1,0.000064
26083,Keweenaw County,,MI,196,2080,2276,1,1,2,1182,1017,2199,6,0.275738,0.28329,0,0.00002,0.000011,8,0.000057,0,10,0,0.00015
41021,Gilliam County,,OR,175,2095,2270,0,0,0,0,0,0,0,0,0,0,0,0,44,0.000049,31,57,0,0
20033,Comanche County,,KS,116,2136,2252,1,0,1,47,0,47,0,0,0,0,0.000001,0,14,0.000058,0,6,0,0.000054
51640,Galax city,,VA,204,2032,2236,3,3,6,4679,4429,9108,7,0.249756,0.256709,0,0.000013,0.000011,37,0.000094,0,10,1,0.000303
48447,Throckmorton County,,TX,230,1999,2229,0,1,1,0,59,59,6,0.258366,0.264665,0,0,0.000008,62,0.000049,0,79,0,0
38083,Sheridan County,,ND,170,2049,2219,0,1,1,0,98,98,6,0.278478,0.286728,0,0,0.000025,39,0.000049,0,55,0,0
20199,Wallace County,,KS,154,2050,2204,0,0,0,0,0,0,0,0,0,0,0,0,11,0.000049,9,25,0,0
8033,Dolores County,,CO,220,1942,2162,2,1,3,558,482,1040,6,0.26727,0.274089,0.142857,0.000028,0.000026,35,0.000072,0,10,0,0.000433
49033,Rich County,,UT,182,1938,2120,2,2,4,418,432,850,5,0.329225,0.340495,0,0.000406,0.000376,45,0.000061,0,10,1,0.003593
48101,Cottle County,,TX,213,1904,2117,0,0,0,0,0,0,0,0,0,0,0,0,54,0.000049,36,69,0,0
21201,Robertson County,,KY,157,1942,2099,1,2,3,115,119,234,7,0.248283,0.253991,0.74906,0.000002,0.000004,42,0.000065,0,10,0,0.000077
8061,Kiowa County,,CO,226,1856,2082,1,1,2,74,149,223,6,0.254389,0.259706,0,0.00001,0.000002,35,0.000063,0,10,0,0.00008
46017,Buffalo County,,SD,162,1890,2052,1,0,1,113,0,113,0,0,0,0,0.000001,0,50,0.000066,0,0,0,0.00006
48045,Briscoe County,,TX,198,1853,2051,0,1,1,0,59,59,6,0.280639,0.289538,0,0,0.000055,62,0.000049,0,67,0,0
13265,Taliaferro County,,GA,144,1901,2045,2,0,2,362,0,362,0,0,0,0,0.000011,0,6,0.000068,0,5,0,0.000227
46069,Hyde County,,SD,139,1899,2038,0,0,0,0,0,0,0,0,0,0,0,0,48,0.000049,33,62,0,0
48235,Irion County,,TX,225,1786,2011,1,1,2,1434,843,2277,6,0.287479,0.297559,0,0.000093,0.000082,62,0.000057,0,10,0,0.000881
41055,Sherman County,,OR,197,1774,1971,1,1,2,245,431,676,6,0.266297,0.27296,0,0.000012,0.000008,45,0.000059,0,10,0,0.000144
8057,Jackson County,,CO,177,1788,1965,1,1,2,59,53,112,5,0.314368,0.323622,0,0.000197,0.000258,35,0.000057,0,10,0,0.002439
30055,McCone County,,MT,177,1783,1960,1,1,2,48,53,101,6,0.288478,0.298123,10.770355,0,0.000069,45,0.000066,0,10,0,0.000054
48433,Stonewall County,,TX,230,1702,1932,0,0,0,0,0,0,0,0,0,0,0,0,63,0.000049,44,77,0,0
2013,Aleutians East Borough,,AK,472,1443,1915,3,3,6,710,1488,2198,5,0.354939,0.370855,0,0.001197,0.001229,45,0.000066,0,10,1,0.011586
20071,Greeley County,,KS,151,1753,1904,0,0,0,0,0,0,0,0,0,0,0,0,9,0.000049,7,21,0,0
31149,Rock County,,NE,119,1777,1896,3,0,3,385,0,385,0,0,0,0,0.000002,0,50,0.000143,0,3,0,0.000178
32011,Eureka County,,NV,170,1685,1855,1,1,2,303,550,853,6,0.27133,0.278998,0,0.000029,0.000032,45,0.000058,0,10,0,0.000374
46119,Sully County,,SD,124,1690,1814,1,1,2,117,332,449,6,0.26138,0.267518,0,0.000006,0.000004,50,0.000067,0,10,0,0.0001
46063,Harding County,,SD,135,1678,1813,0,1,1,0,129,129,6,0.333514,0.346843,0,0,0.000447,5,0.000049,0,61,0,0
30075,Powder River County,,MT,143,1652,1795,0,0,0,0,0,0,0,0,0,0,0,0,19,0.000049,14,32,0,0
28055,Issaquena County,,MS,152,1626,1778,2,1,3,161,52,213,6,0.266922,0.274457,0,0.000029,0.000018,52,0.000068,0,10,1,0.000283
48155,Foard County,,TX,127,1642,1769,0,0,0,0,0,0,0,0,0,0,0,0,55,0.000049,37,70,0,0
2164,Lake and Peninsula Borough,,AK,262,1412,1674,1,1,2,529,868,1397,5,0.321911,0.332232,0,0.000275,0.000277,45,0.000055,0,10,0,0.002648
41069,Wheeler County,,OR,160,1388,1548,0,0,0,0,0,0,0,0,0,0,0,0,46,0.000049,32,58,0,0
46075,Jones County,,SD,127,1402,1529,0,0,0,0,0,0,0,0,0,0,0,0,49,0.000049,34,63,0,0
49031,Piute County,,UT,166,1362,1528,0,0,0,0,0,0,0,0,0,0,0,0,65,0.000049,46,80,0,0
2060,Bristol Bay Borough,,AK,217,1299,1516,1,1,2,87,272,359,5,0.321911,0.332232,0,0.000275,0.000277,45,0.000055,0,10,0,0.002648
30079,Prairie County,,MT,83,1416,1499,1,1,2,40,44,84,7,0.225385,0.230408,0,0.000001,0.000001,45,0.000058,0,10,0.5,0.000058
30033,Garfield County,,MT,116,1373,1489,0,0,0,0,0,0,0,0,0,0,0,0,16,0.000049,11,28,0,0
48431,Sterling County,,TX,160,1265,1425,1,0,1,148,0,148,0,0,0,0,0.000093,0,62,0.000057,0,7,0,0.000881
48345,Motley County,,TX,189,1229,1418,0,0,0,0,0,0,0,0,0,0,0,0,61,0.000049,43,76,0,0
53023,Garfield County,,WA,109,1261,1370,1,1,2,111,206,317,6,0.266782,0.27353,0,0.000012,0.000009,45,0.00006,0,10,0,0.000148
30011,Carter County,,MT,85,1275,1360,0,0,0,0,0,0,0,0,0,0,0,0,15,0.000049,10,26,0,0
31075,Grant County,,NE,142,1218,1360,0,0,0,0,0,0,0,0,0,0,0,0,27,0.000049,22,43,0,0
31085,Hayes County,,NE,69,1289,1358,0,0,0,0,0,0,0,0,0,0,0,0,28,0.000049,23,44,0,0
31103,Keya Paha County,,NE,125,1176,1301,0,1,1,0,72,72,1,1,1,0,0,0,50,0.000049,0,46,0,0
46137,Ziebach County,,SD,98,1182,1280,1,1,2,470,193,663,6,0.22881,0.233409,0,0.000001,0,50,0.000068,0,10,0,0.000059
30109,Wibaux County,,MT,99,1180,1279,0,0,0,0,0,0,0,0,0,0,0,0,21,0.000049,16,35,0,0
30037,Golden Valley County,,MT,133,1067,1200,1,1,2,291,268,559,6,0.288424,0.298041,0,0.000075,0.000069,45,0.000061,0,10,0,0.000771
31091,Hooker County,,NE,122,1076,1198,0,0,0,0,0,0,0,0,0,0,0,0,29,0.000049,24,45,0,0
6003,Alpine County,,CA,147,1038,1185,2,2,4,332,575,907,6,0.281138,0.290809,0,0.000118,0.000122,45,0.000061,0,10,1,0.00125
48263,Kent County,,TX,84,1032,1116,0,0,0,0,0,0,0,0,0,0,0,0,57,0.000049,39,72,0,0
31007,Banner County,,NE,100,1009,1109,1,2,3,41,237,278,6,0.270304,0.277707,0,0.000018,0.000016,35,0.000061,0,10,1,0.000219
16033,Clark County,,ID,142,958,1100,0,1,1,0,57,57,6,0.273156,0.281294,0,0,0.000048,45,0.000049,0,18,0,0
31171,Thomas County,,NE,110,982,1092,0,1,1,0,105,105,7,0.238365,0.242529,0,0,0.000001,50,0.000049,0,49,0,0
48443,Terrell County,,TX,119,963,1082,0,0,0,0,0,0,0,0,0,0,0,0,64,0.000049,45,78,0,0
31165,Sioux County,,NE,70,987,1057,2,1,3,121,118,239,6,0.27028,0.277544,0,0.000021,0.000016,35,0.000071,0,10,1,0.000286
16025,Camas County,,ID,109,905,1014,1,1,2,192,71,263,6,0.270423,0.27749,0,0.000019,0.00002,45,0.000061,0,10,0,0.000257
31113,Logan County,,NE,99,915,1014,1,1,2,226,68,294,6,0.268766,0.275754,0,0.000012,0.000009,50,0.000065,0,10,0,0.000159
32009,Esmeralda County,,NV,99,882,981,1,2,3,166,111,277,5,0.347984,0.362636,0,0.000479,0.000539,45,0.000054,0,10,1,0.004743
49009,Daggett County,,UT,119,855,974,1,0,1,61,0,61,0,0,0,0,0.000342,0,45,0.000054,0,9,0,0.0031
48393,Roberts County,,TX,87,856,943,1,1,2,42,93,135,6,0.262969,0.269721,0,0.000012,0.00001,62,0.000066,0,10,0,0.000169
31183,Wheeler County,,NE,71,852,923,0,0,0,0,0,0,0,0,0,0,0,0,32,0.000049,27,50,0,0
8079,Mineral County,,CO,124,779,903,0,0,0,0,0,0,0,0,0,0,0,0,3,0.000049,4,14,0,0
48311,McMullen County,,TX,61,809,870,0,0,0,0,0,0,0,0,0,0,0,0,60,0.000049,42,75,0,0
31115,Loup County,,NE,38,814,852,0,0,0,0,0,0,0,0,0,0,0,0,30,0.000049,25,47,0,0
8053,Hinsdale County,,CO,93,749,842,0,0,0,0,0,0,0,0,0,0,0,0,2,0.000049,3,13,0,0
48033,Borden County,,TX,104,693,797,0,0,0,0,0,0,0,0,0,0,0,0,53,0.000049,35,66,0,0
35021,Harding County,,NM,37,711,748,0,0,0,0,0,0,0,0,0,0,0,0,34,0.000049,28,51,0,0
2282,Yakutat City and Borough,,AK,125,605,730,0,0,0,0,0,0,0,0,0,0,0,0,0,0.000049,1,11,0,0
8111,San Juan County,,CO,95,552,647,0,0,0,0,0,0,0,0,0,0,0,0,4,0.000049,5,15,0,0
2105,Hoonah-Angoon Census Area,,AK,0,0,0,1,1,2,213,442,655,6,0.270876,0.278358,0,0.000026,0.000027,45,0.000059,0,10,0,0.000316
2195,Petersburg Census Area,,AK,0,0,0,1,2,3,64,308,372,6,0.270923,0.278575,0,0.000026,0.00003,45,0.000059,0,10,1,0.000316
8014,Broomfield County,,CO,0,0,0,52,34,86,128210,117316,245526,5,0.393846,0.416678,105.837875,0.016862,0.011104,35,0.000362,0,10,0.84102,0.161849
15005,Kalawao County,,HI,0,0,0,0,0,0,0,0,0,0,0,0,0,0,0,7,0.000049,6,16,0,0
30069,Petroleum County,,MT,0,0,0,0,0,0,0,0,0,0,0,0,0,0,0,18,0.000049,13,31,0,0
30103,Treasure County,,MT,0,0,0,0,0,0,0,0,0,0,0,0,0,0,0,20,0.000049,15,33,0,0
31005,Arthur County,,NE,0,0,0,0,0,0,0,0,0,0,0,0,0,0,0,22,0.000049,17,36,0,0
31009,Blaine County,,NE,0,0,0,0,0,0,0,0,0,0,0,0,0,0,0,23,0.000049,18,37,0,0
31117,McPherson County,,NE,0,0,0,0,0,0,0,0,0,0,0,0,0,0,0,31,0.000049,26,48,0,0
38007,Billings County,,ND,0,0,0,1,1,2,234,115,349,6,0.274457,0.281999,0,0.000012,0.000018,39,0.00007,0,10,0,0.000249
38087,Slope County,,ND,0,0,0,0,0,0,0,0,0,0,0,0,0,0,0,40,0.000049,30,56,0,0
48261,Kenedy County,,TX,0,0,0,0,0,0,0,0,0,0,0,0,0,0,0,56,0.000049,38,71,0,0
48269,King County,,TX,0,0,0,0,0,0,0,0,0,0,0,0,0,0,0,58,0.000049,40,73,0,0
48301,Loving County,,TX,0,0,0,0,0,0,0,0,0,0,0,0,0,0,0,59,0.000049,41,74,0,0
