id,label,timeset,state,totalMig,totalNonMig,population
1001,Autauga County,,AL,4715,50793,55508
1003,Baldwin County,,AL,9033,152298,161331
1005,Barbour County,,AL,1939,28101,30040
1007,Bibb County,,AL,1329,21358,22687
1009,Blount County,,AL,3154,54246,57400
1011,Bullock County,,AL,789,10765,11554
1013,Butler County,,AL,1199,22939,24138
1015,Calhoun County,,AL,7572,131785,139357
1017,Chambers County,,AL,2412,43723,46135
1019,Cherokee County,,AL,1380,25163,26543
1021,Chilton County,,AL,2081,39932,42013
1023,Choctaw County,,AL,777,16481,17258
1025,Clarke County,,AL,1620,32057,33677
1027,Clay County,,AL,934,16541,17475
1029,Cleburne County,,AL,930,14185,15115
1031,Coffee County,,AL,4986,45184,50170
1033,Colbert County,,AL,3262,60043,63305
1035,Conecuh County,,AL,939,14867,15806
1037,Coosa County,,AL,1219,13792,15011
1039,Covington County,,AL,2229,38634,40863
1041,Crenshaw County,,AL,940,15635,16575
1043,Cullman County,,AL,3928,83757,87685
1045,Dale County,,AL,7588,49359,56947
1047,Dallas County,,AL,2469,50698,53167
1049,DeKalb County,,AL,4146,75391,79537
1051,Elmore County,,AL,5557,70837,76394
1053,Escambia County,,AL,2049,38826,40875
1055,Etowah County,,AL,5532,105822,111354
1057,Fayette County,,AL,1202,21931,23133
1059,Franklin County,,AL,1973,32876,34849
1061,Geneva County,,AL,2020,25894,27914
1063,Greene County,,AL,624,9853,10477
1065,Hale County,,AL,1071,18831,19902
1067,Henry County,,AL,1331,17649,18980
1069,Houston County,,AL,6724,96513,103237
1071,Jackson County,,AL,2740,58224,60964
1073,Jefferson County,,AL,37708,735609,773317
1075,Lamar County,,AL,1072,17487,18559
1077,Lauderdale County,,AL,5091,94599,99690
1079,Lawrence County,,AL,2044,37927,39971
1081,Lee County,,AL,9840,104667,114507
1083,Limestone County,,AL,3793,72884,76677
1085,Lowndes County,,AL,994,13713,14707
1087,Macon County,,AL,1510,21534,23044
1089,Madison County,,AL,17601,315922,333523
1091,Marengo County,,AL,1447,23556,25003
1093,Marion County,,AL,1699,27781,29480
1095,Marshall County,,AL,5861,79310,85171
1097,Mobile County,,AL,18195,428010,446205
1099,Monroe County,,AL,1346,25883,27229
1101,Montgomery County,,AL,18436,238213,256649
1103,Morgan County,,AL,7238,124726,131964
1105,Perry County,,AL,630,10865,11495
1107,Pickens County,,AL,1138,22828,23966
1109,Pike County,,AL,2157,26369,28526
1111,Randolph County,,AL,1135,22744,23879
1113,Russell County,,AL,5507,51044,56551
1115,St. Clair County,,AL,4211,63343,67554
1117,Shelby County,,AL,13237,149943,163180
1119,Sumter County,,AL,935,14867,15802
1121,Talladega County,,AL,4281,79645,83926
1123,Tallapoosa County,,AL,2507,41839,44346
1125,Tuscaloosa County,,AL,10149,167935,178084
1127,Walker County,,AL,3214,68547,71761
1129,Washington County,,AL,1163,19049,20212
1131,Wilcox County,,AL,757,13289,14046
1133,Winston County,,AL,1560,25356,26916
2013,Aleutians East Borough,,AK,472,1443,1915
2016,Aleutians West Census Area,,AK,793,3899,4692
2020,Anchorage Municipality,,AK,24777,274631,299408
2050,Bethel Census Area,,AK,905,15097,16002
2060,Bristol Bay Borough,,AK,217,1299,1516
2068,Denali Borough,,AK,420,2132,2552
2070,Dillingham Census Area,,AK,424,4387,4811
2090,Fairbanks North Star Borough,,AK,11279,89538,100817
2100,Haines Borough,,AK,291,2732,3023
2105,Hoonah-Angoon Census Area,,AK,0,0,0
2110,Juneau City and Borough,,AK,2957,33805,36762
2122,Kenai Peninsula Borough,,AK,4092,51861,55953
2130,Ketchikan Gateway Borough,,AK,1577,14530,16107
2150,Kodiak Island Borough,,AK,2076,15028,17104
2164,Lake and Peninsula Borough,,AK,262,1412,1674
2170,Matanuska-Susitna Borough,,AK,4384,59426,63810
2180,Nome Census Area,,AK,623,8414,9037
2185,North Slope Borough,,AK,710,7222,7932
2188,Northwest Arctic Borough,,AK,519,6155,6674
2195,Petersburg Census Area,,AK,0,0,0
2220,Sitka City and Borough,,AK,1193,9421,10614
2240,Southeast Fairbanks Census Area,,AK,1125,6142,7267
2261,Valdez-Cordova Census Area,,AK,1301,10893,12194
2270,Wade Hampton Census Area,,AK,403,6225,6628
2282,Yakutat City and Borough,,AK,125,605,730
2290,Yukon-Koyukuk Census Area,,AK,630,5878,6508
4001,Apache County,,AZ,8675,57110,65785
4003,Cochise County,,AZ,13775,110811,124586
4005,Coconino County,,AZ,14154,117428,131582
4007,Gila County,,AZ,4118,52219,56337
4009,Graham County,,AZ,2085,26581,28666
4011,Greenlee County,,AZ,940,8994,9934
4012,La Paz County,,AZ,1567,14329,15896
4013,Maricopa County,,AZ,152544,3155314,3307858
4015,Mohave County,,AZ,12534,146508,159042
4017,Navajo County,,AZ,8326,85846,94172
4019,Pima County,,AZ,48517,865548,914065
4021,Pinal County,,AZ,12051,136351,148402
4023,Santa Cruz County,,AZ,2526,45107,47633
4025,Yavapai County,,AZ,12443,161596,174039
4027,Yuma County,,AZ,12015,164798,176813
5001,Arkansas County,,AR,1230,22778,24008
5003,Ashley County,,AR,1494,25723,27217
5005,Baxter County,,AR,2906,40924,43830
5007,Benton County,,AR,12663,168568,181231
5009,Boone County,,AR,2468,36874,39342
5011,Bradley County,,AR,801,13063,13864
5013,Calhoun County,,AR,382,5819,6201
5015,Carroll County,,AR,2059,24819,26878
5017,Chicot County,,AR,1228,13564,14792
5019,Clark County,,AR,1823,23209,25032
5021,Clay County,,AR,1243,17204,18447
5023,Cleburne County,,AR,2033,29123,31156
5025,Cleveland County,,AR,672,9921,10593
5027,Columbia County,,AR,1647,26521,28168
5029,Conway County,,AR,1509,22821,24330
5031,Craighead County,,AR,5935,83164,89099
5033,Crawford County,,AR,4145,56461,60606
5035,Crittenden County,,AR,3810,54718,58528
5037,Cross County,,AR,1404,20840,22244
5039,Dallas County,,AR,628,8238,8866
5041,Desha County,,AR,1270,16627,17897
5043,Drew County,,AR,1468,17496,18964
5045,Faulkner County,,AR,7434,90784,98218
5047,Franklin County,,AR,1203,17176,18379
5049,Fulton County,,AR,1060,11991,13051
5051,Garland County,,AR,5709,97520,103229
5053,Grant County,,AR,1270,19214,20484
5055,Greene County,,AR,2225,39037,41262
5057,Hempstead County,,AR,1766,24927,26693
5059,Hot Spring County,,AR,1766,28062,29828
5061,Howard County,,AR,994,13458,14452
5063,Independence County,,AR,2444,37674,40118
5065,Izard County,,AR,979,11521,12500
5067,Jackson County,,AR,1428,18122,19550
5069,Jefferson County,,AR,5652,84870,90522
5071,Johnson County,,AR,1541,22481,24022
5073,Lafayette County,,AR,616,7644,8260
5075,Lawrence County,,AR,1241,17749,18990
5077,Lee County,,AR,883,10768,11651
5079,Lincoln County,,AR,827,8542,9369
5081,Little River County,,AR,1087,13972,15059
5083,Logan County,,AR,1592,22802,24394
5085,Lonoke County,,AR,5135,57364,62499
5087,Madison County,,AR,1081,14132,15213
5089,Marion County,,AR,1371,14995,16366
5091,Miller County,,AR,3736,39793,43529
5093,Mississippi County,,AR,3652,55083,58735
5095,Monroe County,,AR,890,10202,11092
5097,Montgomery County,,AR,635,8775,9410
5099,Nevada County,,AR,786,10162,10948
5101,Newton County,,AR,681,8025,8706
5103,Ouachita County,,AR,1940,29369,31309
5105,Perry County,,AR,872,9749,10621
5107,Phillips County,,AR,1747,25799,27546
5109,Pike County,,AR,741,10327,11068
5111,Poinsett County,,AR,1735,24818,26553
5113,Polk County,,AR,1410,19709,21119
5115,Pope County,,AR,4065,53030,57095
5117,Prairie County,,AR,594,9629,10223
5119,Pulaski County,,AR,28841,398399,427240
5121,Randolph County,,AR,1124,17839,18963
5123,St. Francis County,,AR,2071,26006,28077
5125,Saline County,,AR,5366,73796,79162
5127,Scott County,,AR,936,11234,12170
5129,Searcy County,,AR,554,6717,7271
5131,Sebastian County,,AR,9570,118636,128206
5133,Sevier County,,AR,1191,15029,16220
5135,Sharp County,,AR,1294,12898,14192
5137,Stone County,,AR,776,10881,11657
5139,Union County,,AR,2602,49088,51690
5141,Van Buren County,,AR,1010,13677,14687
5143,Washington County,,AR,13120,147116,160236
5145,White County,,AR,4260,63203,67463
5147,Woodruff County,,AR,577,7672,8249
5149,Yell County,,AR,1734,20335,22069
6001,Alameda County,,CA,122829,1536146,1658975
6003,Alpine County,,CA,147,1038,1185
6005,Amador County,,CA,2171,34481,36652
6007,Butte County,,CA,12446,195803,208249
6009,Calaveras County,,CA,3189,41357,44546
6011,Colusa County,,CA,1110,20871,21981
6013,Contra Costa County,,CA,69029,1030151,1099180
6015,Del Norte County,,CA,1828,21977,23805
6017,El Dorado County,,CA,12638,170413,183051
6019,Fresno County,,CA,32516,800573,833089
6021,Glenn County,,CA,1759,28045,29804
6023,Humboldt County,,CA,7571,123227,130798
6025,Imperial County,,CA,11441,181103,192544
6027,Inyo County,,CA,1513,20019,21532
6029,Kern County,,CA,29415,650455,679870
6031,Kings County,,CA,9118,111616,120734
6033,Lake County,,CA,3525,51583,55108
6035,Lassen County,,CA,2432,25871,28303
6037,Los Angeles County,,CA,361769,9682175,10043944
6039,Madera County,,CA,7306,115679,122985
6041,Marin County,,CA,19721,251545,271266
6043,Mariposa County,,CA,1661,16305,17966
6045,Mendocino County,,CA,5056,89251,94307
6047,Merced County,,CA,11714,210911,222625
6049,Modoc County,,CA,801,8571,9372
6051,Mono County,,CA,1521,10972,12493
6053,Monterey County,,CA,30228,415902,446130
6055,Napa County,,CA,8425,138059,146484
6057,Nevada County,,CA,7386,103220,110606
6059,Orange County,,CA,169635,3072118,3241753
6061,Placer County,,CA,20962,270531,291493
6063,Plumas County,,CA,1735,21230,22965
6065,Riverside County,,CA,89234,1549400,1638634
6067,Sacramento County,,CA,69077,1278823,1347900
6069,San Benito County,,CA,5140,58651,63791
6071,San Bernardino County,,CA,111390,1691798,1803188
6073,San Diego County,,CA,174485,3069555,3244040
6075,San Francisco County,,CA,82214,837397,919611
6077,San Joaquin County,,CA,30509,566060,596569
6079,San Luis Obispo County,,CA,15041,245214,260255
6081,San Mateo County,,CA,73254,783330,856584
6083,Santa Barbara County,,CA,28130,407869,435999
6085,Santa Clara County,,CA,153731,1886312,2040043
6087,Santa Cruz County,,CA,19867,269240,289107
6089,Shasta County,,CA,8676,167456,176132
6091,Sierra County,,CA,299,3477,3776
6093,Siskiyou County,,CA,3066,43618,46684
6095,Solano County,,CA,33503,417128,450631
6097,Sonoma County,,CA,26638,500163,526801
6099,Stanislaus County,,CA,23288,462507,485795
6101,Sutter County,,CA,6442,81154,87596
6103,Tehama County,,CA,3212,48883,52095
6105,Trinity County,,CA,950,10970,11920
6107,Tulare County,,CA,17352,361474,378826
6109,Tuolumne County,,CA,3382,53525,56907
6111,Ventura County,,CA,43984,825664,869648
6113,Yolo County,,CA,14804,163500,178304
6115,Yuba County,,CA,6775,50730,57505
8001,Adams County,,CO,48695,404728,453423
8003,Alamosa County,,CO,1762,14336,16098
8005,Arapahoe County,,CO,72519,548666,621185
8007,Archuleta County,,CO,927,9690,10617
8009,Baca County,,CO,293,4813,5106
8011,Bent County,,CO,564,5318,5882
8013,Boulder County,,CO,35671,319331,355002
8014,Broomfield County,,CO,0,0,0
8015,Chaffee County,,CO,1555,16647,18202
8017,Cheyenne County,,CO,213,2469,2682
8019,Clear Creek County,,CO,2904,22369,25273
8021,Conejos County,,CO,589,8155,8744
8023,Costilla County,,CO,355,3382,3737
8025,Crowley County,,CO,440,3381,3821
8027,Custer County,,CO,404,3550,3954
8029,Delta County,,CO,2084,27957,30041
8031,Denver County,,CO,85802,526864,612666
8033,Dolores County,,CO,220,1942,2162
8035,Douglas County,,CO,21826,194959,216785
8037,Eagle County,,CO,6143,42471,48614
8039,Elbert County,,CO,2132,18343,20475
8041,El Paso County,,CO,54957,574827,629784
8043,Fremont County,,CO,3137,39816,42953
8045,Garfield County,,CO,4511,41183,45694
8047,Gilpin County,,CO,1457,8084,9541
8049,Grand County,,CO,1624,12519,14143
8051,Gunnison County,,CO,1869,12770,14639
8053,Hinsdale County,,CO,93,749,842
8055,Huerfano County,,CO,687,6394,7081
8057,Jackson County,,CO,177,1788,1965
8059,Jefferson County,,CO,59864,540355,600219
8061,Kiowa County,,CO,226,1856,2082
8063,Kit Carson County,,CO,740,8785,9525
8065,Lake County,,CO,980,6925,7905
8067,La Plata County,,CO,4355,44268,48623
8069,Larimer County,,CO,23689,271123,294812
8071,Las Animas County,,CO,1183,15069,16252
8073,Lincoln County,,CO,576,4771,5347
8075,Logan County,,CO,1661,21989,23650
8077,Mesa County,,CO,8231,127979,136210
8079,Mineral County,,CO,124,779,903
8081,Moffat County,,CO,1253,14164,15417
8083,Montezuma County,,CO,2109,23858,25967
8085,Montrose County,,CO,2730,35528,38258
8087,Morgan County,,CO,2437,29136,31573
8089,Otero County,,CO,1712,21079,22791
8091,Ouray County,,CO,400,3254,3654
8093,Park County,,CO,2066,14695,16761
8095,Phillips County,,CO,338,3951,4289
8097,Pitkin County,,CO,1856,12522,14378
8099,Prowers County,,CO,1308,14153,15461
8101,Pueblo County,,CO,7338,151572,158910
8103,Rio Blanco County,,CO,750,6268,7018
8105,Rio Grande County,,CO,1525,16440,17965
8107,Routt County,,CO,2273,20216,22489
8109,Saguache County,,CO,261,2173,2434
8111,San Juan County,,CO,95,552,647
8113,San Miguel County,,CO,952,6110,7062
8115,Sedgwick County,,CO,308,2982,3290
8117,Summit County,,CO,4252,24335,28587
8119,Teller County,,CO,2929,21088,24017
8121,Washington County,,CO,411,4387,4798
8123,Weld County,,CO,14961,184265,199226
8125,Yuma County,,CO,853,11063,11916
9001,Fairfield County,,CT,51176,974235,1025411
9003,Hartford County,,CT,43450,1010082,1053532
9005,Litchfield County,,CT,10924,218796,229720
9007,Middlesex County,,CT,12001,186454,198455
9009,New Haven County,,CT,40676,931788,972464
9011,New London County,,CT,19017,298783,317800
9013,Tolland County,,CT,10304,149487,159791
9015,Windham County,,CT,6638,124822,131460
10001,Kent County,,DE,8997,147961,156958
10003,New Castle County,,DE,26994,575921,602915
10005,Sussex County,,DE,7960,175189,183149
11001,District of Columbia,,DC,62410,554389,616799
12001,Alachua County,,FL,20689,203362,224051
12003,Baker County,,FL,1511,22658,24169
12005,Bay County,,FL,14164,160073,174237
12007,Bradford County,,FL,1519,21038,22557
12009,Brevard County,,FL,30113,534011,564124
12011,Broward County,,FL,108876,1702379,1811255
12013,Calhoun County,,FL,812,10457,11269
12015,Charlotte County,,FL,10535,147042,157577
12017,Citrus County,,FL,7662,121530,129192
12019,Clay County,,FL,16824,163671,180495
12021,Collier County,,FL,18079,264088,282167
12023,Columbia County,,FL,4150,53327,57477
12027,DeSoto County,,FL,2170,26173,28343
12029,Dixie County,,FL,918,12519,13437
12031,Duval County,,FL,61257,860847,922104
12033,Escambia County,,FL,32185,304156,336341
12035,Flagler County,,FL,4104,59893,63997
12037,Franklin County,,FL,648,9378,10026
12039,Gadsden County,,FL,3322,48674,51996
12041,Gilchrist County,,FL,1180,12262,13442
12043,Glades County,,FL,1113,10093,11206
12045,Gulf County,,FL,1058,12253,13311
12047,Hamilton County,,FL,902,11900,12802
12049,Hardee County,,FL,2021,23734,25755
12051,Hendry County,,FL,3331,33260,36591
12053,Hernando County,,FL,9207,136567,145774
12055,Highlands County,,FL,5620,82181,87801
12057,Hillsborough County,,FL,74707,1088813,1163520
12059,Holmes County,,FL,1427,19487,20914
12061,Indian River County,,FL,7419,123443,130862
12063,Jackson County,,FL,2895,43548,46443
12065,Jefferson County,,FL,1197,14865,16062
12067,Lafayette County,,FL,362,4466,4828
12069,Lake County,,FL,16371,236471,252842
12071,Lee County,,FL,26222,465890,492112
12073,Leon County,,FL,21489,228555,250044
12075,Levy County,,FL,2960,33174,36134
12077,Liberty County,,FL,358,5558,5916
12079,Madison County,,FL,1064,17523,18587
12081,Manatee County,,FL,20076,281746,301822
12083,Marion County,,FL,16148,268190,284338
12085,Martin County,,FL,11702,140282,151984
12087,Monroe County,,FL,10668,80396,91064
12089,Nassau County,,FL,5016,66679,71695
12091,Okaloosa County,,FL,21624,189913,211537
12093,Okeechobee County,,FL,2432,30080,32512
12095,Orange County,,FL,90130,970878,1061008
12097,Osceola County,,FL,21053,183878,204931
12099,Palm Beach County,,FL,69275,1201273,1270548
12101,Pasco County,,FL,24836,343904,368740
12103,Pinellas County,,FL,61956,989470,1051426
12105,Polk County,,FL,28854,508179,537033
12107,Putnam County,,FL,4722,68187,72909
12109,St. Johns County,,FL,11293,129774,141067
12111,St. Lucie County,,FL,13723,205296,219019
12113,Santa Rosa County,,FL,12297,124386,136683
12115,Sarasota County,,FL,23124,351871,374995
12117,Seminole County,,FL,43891,389230,433121
12119,Sumter County,,FL,3283,42620,45903
12121,Suwannee County,,FL,2375,33882,36257
12123,Taylor County,,FL,1164,19224,20388
12125,Union County,,FL,882,9972,10854
12127,Volusia County,,FL,28903,461873,490776
12129,Wakulla County,,FL,1702,22656,24358
12131,Walton County,,FL,3012,34578,37590
12133,Washington County,,FL,1523,18434,19957
13001,Appling County,,GA,1034,17806,18840
13003,Atkinson County,,GA,605,7700,8305
13005,Bacon County,,GA,775,10854,11629
13007,Baker County,,GA,343,4053,4396
13009,Baldwin County,,GA,2721,43384,46105
13011,Banks County,,GA,1600,16841,18441
13013,Barrow County,,GA,4356,48943,53299
13015,Bartow County,,GA,7238,92070,99308
13017,Ben Hill County,,GA,1379,19035,20414
13019,Berrien County,,GA,1619,16009,17628
13021,Bibb County,,GA,11425,175304,186729
13023,Bleckley County,,GA,817,13757,14574
13025,Brantley County,,GA,1194,17154,18348
13027,Brooks County,,GA,2248,21267,23515
13029,Bryan County,,GA,3138,25840,28978
13031,Bulloch County,,GA,3755,44237,47992
13033,Burke County,,GA,1856,27733,29589
13035,Butts County,,GA,1627,21543,23170
13037,Calhoun County,,GA,462,6280,6742
13039,Camden County,,GA,6821,44265,51086
13043,Candler County,,GA,774,9066,9840
13045,Carroll County,,GA,6117,92814,98931
13047,Catoosa County,,GA,4915,55512,60427
13049,Charlton County,,GA,659,8789,9448
13051,Chatham County,,GA,20549,238440,258989
13053,Chattahoochee County,,GA,363,3043,3406
13055,Chattooga County,,GA,1251,26483,27734
13057,Cherokee County,,GA,15104,170646,185750
13059,Clarke County,,GA,11862,87865,99727
13061,Clay County,,GA,176,3483,3659
13063,Clayton County,,GA,33700,237389,271089
13065,Clinch County,,GA,407,6762,7169
13067,Cobb County,,GA,75767,646434,722201
13069,Coffee County,,GA,2333,35855,38188
13071,Colquitt County,,GA,2478,42339,44817
13073,Columbia County,,GA,10529,109265,119794
13075,Cook County,,GA,1199,16909,18108
13077,Coweta County,,GA,7312,98049,105361
13079,Crawford County,,GA,906,11350,12256
13081,Crisp County,,GA,1325,22250,23575
13083,Dade County,,GA,1136,15235,16371
13085,Dawson County,,GA,1839,16536,18375
13087,Decatur County,,GA,1873,27688,29561
13089,DeKalb County,,GA,95362,666773,762135
13091,Dodge County,,GA,975,17834,18809
13093,Dooly County,,GA,806,12644,13450
13095,Dougherty County,,GA,8555,102885,111440
13097,Douglas County,,GA,10903,96129,107032
13099,Early County,,GA,717,12872,13589
13101,Echols County,,GA,256,2667,2923
13103,Effingham County,,GA,2736,38410,41146
13105,Elbert County,,GA,973,22349,23322
13107,Emanuel County,,GA,1364,25043,26407
13109,Evans County,,GA,780,9880,10660
13111,Fannin County,,GA,1171,20425,21596
13113,Fayette County,,GA,9524,101304,110828
13115,Floyd County,,GA,5266,95167,100433
13117,Forsyth County,,GA,10759,119642,130401
13119,Franklin County,,GA,1533,24097,25630
13121,Fulton County,,GA,108073,717439,825512
13123,Gilmer County,,GA,1669,23724,25393
13125,Glascock County,,GA,244,2904,3148
13127,Glynn County,,GA,5536,70964,76500
13129,Gordon County,,GA,3248,49329,52577
13131,Grady County,,GA,2110,27804,29914
13133,Greene County,,GA,895,16180,17075
13135,Gwinnett County,,GA,63480,621027,684507
13137,Habersham County,,GA,2223,36129,38352
13139,Hall County,,GA,9794,146612,156406
13141,Hancock County,,GA,522,9155,9677
13143,Haralson County,,GA,1925,25608,27533
13145,Harris County,,GA,2521,30817,33338
13147,Hart County,,GA,1320,22908,24228
13149,Heard County,,GA,888,10644,11532
13151,Henry County,,GA,11060,136779,147839
13153,Houston County,,GA,11402,125873,137275
13155,Irwin County,,GA,900,9853,10753
13157,Jackson County,,GA,3600,39153,42753
13159,Jasper County,,GA,1122,13936,15058
13161,Jeff Davis County,,GA,881,14126,15007
13163,Jefferson County,,GA,1104,20295,21399
13165,Jenkins County,,GA,454,8035,8489
13167,Johnson County,,GA,383,8095,8478
13169,Jones County,,GA,1645,21245,22890
13171,Lamar County,,GA,1403,16592,17995
13173,Lanier County,,GA,922,6789,7711
13175,Laurens County,,GA,2314,48293,50607
13177,Lee County,,GA,2632,21819,24451
13179,Liberty County,,GA,16876,57127,74003
13181,Lincoln County,,GA,568,8825,9393
13183,Long County,,GA,1448,7480,8928
13185,Lowndes County,,GA,9065,81042,90107
13187,Lumpkin County,,GA,1776,18884,20660
13189,McDuffie County,,GA,1412,23599,25011
13191,McIntosh County,,GA,713,10525,11238
13193,Macon County,,GA,857,12159,13016
13195,Madison County,,GA,1931,26148,28079
13197,Marion County,,GA,574,6448,7022
13199,Meriwether County,,GA,1892,23527,25419
13201,Miller County,,GA,385,5783,6168
13205,Mitchell County,,GA,1610,23288,24898
13207,Monroe County,,GA,1461,20034,21495
13209,Montgomery County,,GA,674,9004,9678
13211,Morgan County,,GA,1099,15432,16531
13213,Murray County,,GA,3100,36428,39528
13215,Muscogee County,,GA,24471,199110,223581
13217,Newton County,,GA,4826,69223,74049
13219,Oconee County,,GA,2266,21181,23447
13221,Oglethorpe County,,GA,911,13336,14247
13223,Paulding County,,GA,6765,82830,89595
13225,Peach County,,GA,2423,23577,26000
13227,Pickens County,,GA,1682,24054,25736
13229,Pierce County,,GA,1301,15694,16995
13231,Pike County,,GA,1304,15458,16762
13233,Polk County,,GA,1960,37054,39014
13235,Pulaski County,,GA,645,9771,10416
13237,Putnam County,,GA,1398,19536,20934
13239,Quitman County,,GA,231,2400,2631
13241,Rabun County,,GA,865,15590,16455
13243,Randolph County,,GA,523,7691,8214
13245,Richmond County,,GA,20636,186860,207496
13247,Rockdale County,,GA,8681,70023,78704
13249,Schley County,,GA,293,3785,4078
13251,Screven County,,GA,925,15329,16254
13253,Seminole County,,GA,721,9708,10429
13255,Spalding County,,GA,4827,58020,62847
13257,Stephens County,,GA,1734,26149,27883
13259,Stewart County,,GA,411,5785,6196
13261,Sumter County,,GA,2080,33571,35651
13263,Talbot County,,GA,548,7267,7815
13265,Taliaferro County,,GA,144,1901,2045
13267,Tattnall County,,GA,1347,17653,19000
13269,Taylor County,,GA,465,8994,9459
13271,Telfair County,,GA,751,11335,12086
13273,Terrell County,,GA,820,11730,12550
13275,Thomas County,,GA,2843,37363,40206
13277,Tift County,,GA,3029,38856,41885
13279,Toombs County,,GA,1764,23796,25560
13281,Towns County,,GA,605,9372,9977
13283,Treutlen County,,GA,425,6318,6743
13285,Troup County,,GA,3862,61919,65781
13287,Turner County,,GA,608,9751,10359
13289,Twiggs County,,GA,418,7662,8080
13291,Union County,,GA,999,16714,17713
13293,Upson County,,GA,1503,29482,30985
13295,Walker County,,GA,4644,64282,68926
13297,Walton County,,GA,3670,50374,54044
13299,Ware County,,GA,2329,32441,34770
13301,Warren County,,GA,441,6601,7042
13303,Washington County,,GA,960,21619,22579
13305,Wayne County,,GA,1446,25237,26683
13307,Webster County,,GA,171,2205,2376
13309,Wheeler County,,GA,330,4859,5189
13311,White County,,GA,1537,21026,22563
13313,Whitfield County,,GA,7425,97606,105031
13315,Wilcox County,,GA,376,7598,7974
13317,Wilkes County,,GA,642,11753,12395
13319,Wilkinson County,,GA,596,10774,11370
13321,Worth County,,GA,1483,18690,20173
15001,Hawaii County,,HI,6559,150332,156891
15003,Honolulu County,,HI,63801,971311,1035112
15005,Kalawao County,,HI,0,0,0
15007,Kauai County,,HI,2729,64748,67477
15009,Maui County,,HI,6356,142376,148732
16001,Ada County,,ID,22442,339569,362011
16003,Adams County,,ID,385,3808,4193
16005,Bannock County,,ID,6803,79833,86636
16007,Bear Lake County,,ID,490,7100,7590
16009,Benewah County,,ID,924,9769,10693
16011,Bingham County,,ID,3380,48346,51726
16013,Blaine County,,ID,1725,19941,21666
16015,Boise County,,ID,737,6436,7173
16017,Bonner County,,ID,2940,38439,41379
16019,Bonneville County,,ID,6743,90624,97367
16021,Boundary County,,ID,771,10038,10809
16023,Butte County,,ID,278,3013,3291
16025,Camas County,,ID,109,905,1014
16027,Canyon County,,ID,9407,136652,146059
16029,Caribou County,,ID,567,8165,8732
16031,Cassia County,,ID,2322,26580,28902
16033,Clark County,,ID,142,958,1100
16035,Clearwater County,,ID,1001,9209,10210
16037,Custer County,,ID,475,4331,4806
16039,Elmore County,,ID,4995,26614,31609
16041,Franklin County,,ID,877,12570,13447
16043,Fremont County,,ID,1421,14144,15565
16045,Gem County,,ID,1323,15513,16836
16047,Gooding County,,ID,1376,14479,15855
16049,Idaho County,,ID,1157,15251,16408
16051,Jefferson County,,ID,2069,21506,23575
16053,Jerome County,,ID,2164,19853,22017
16055,Kootenai County,,ID,8062,116007,124069
16057,Latah County,,ID,4160,33019,37179
16059,Lemhi County,,ID,688,7844,8532
16061,Lewis County,,ID,485,4182,4667
16063,Lincoln County,,ID,518,5015,5533
16065,Madison County,,ID,2156,18755,20911
16067,Minidoka County,,ID,1848,16747,18595
16069,Nez Perce County,,ID,3519,39374,42893
16071,Oneida County,,ID,288,4345,4633
16073,Owyhee County,,ID,1201,9896,11097
16075,Payette County,,ID,1922,20770,22692
16077,Power County,,ID,626,7278,7904
16079,Shoshone County,,ID,1248,13552,14800
16081,Teton County,,ID,602,6507,7109
16083,Twin Falls County,,ID,5725,68373,74098
16085,Valley County,,ID,968,8754,9722
16087,Washington County,,ID,914,9820,10734
17001,Adams County,,IL,3346,81326,84672
17003,Alexander County,,IL,723,9145,9868
17005,Bond County,,IL,1233,18834,20067
17007,Boone County,,IL,3861,51713,55574
17009,Brown County,,IL,360,5989,6349
17011,Bureau County,,IL,2624,43164,45788
17013,Calhoun County,,IL,291,6023,6314
17015,Carroll County,,IL,1236,20703,21939
17017,Cass County,,IL,1201,16741,17942
17019,Champaign County,,IL,14709,183204,197913
17021,Christian County,,IL,2408,45671,48079
17023,Clark County,,IL,1031,20163,21194
17025,Clay County,,IL,1043,16835,17878
17027,Clinton County,,IL,2021,43823,45844
17029,Coles County,,IL,3737,53666,57403
17031,Cook County,,IL,268617,5917492,6186109
17033,Crawford County,,IL,1114,23742,24856
17035,Cumberland County,,IL,855,13616,14471
17037,DeKalb County,,IL,8732,98314,107046
17039,De Witt County,,IL,1402,20425,21827
17041,Douglas County,,IL,1551,26261,27812
17043,DuPage County,,IL,96797,1218325,1315122
17045,Edgar County,,IL,1160,22733,23893
17047,Edwards County,,IL,538,8643,9181
17049,Effingham County,,IL,2303,43339,45642
17051,Fayette County,,IL,1337,23794,25131
17053,Ford County,,IL,1224,18019,19243
17055,Franklin County,,IL,2296,45071,47367
17057,Fulton County,,IL,2313,45039,47352
17059,Gallatin County,,IL,473,7151,7624
17061,Greene County,,IL,964,17379,18343
17063,Grundy County,,IL,3467,51014,54481
17065,Hamilton County,,IL,474,8470,8944
17067,Hancock County,,IL,1434,25383,26817
17069,Hardin County,,IL,281,4732,5013
17071,Henderson County,,IL,599,10027,10626
17073,Henry County,,IL,4187,67455,71642
17075,Iroquois County,,IL,2346,40155,42501
17077,Jackson County,,IL,6112,53058,59170
17079,Jasper County,,IL,632,12589,13221
17081,Jefferson County,,IL,2297,42386,44683
17083,Jersey County,,IL,1622,27773,29395
17085,Jo Daviess County,,IL,1473,27883,29356
17087,Johnson County,,IL,914,12591,13505
17089,Kane County,,IL,30798,389802,420600
17091,Kankakee County,,IL,6224,120070,126294
17093,Kendall County,,IL,5244,63803,69047
17095,Knox County,,IL,3464,63727,67191
17097,Lake County,,IL,49940,736771,786711
17099,LaSalle County,,IL,6345,131198,137543
17101,Lawrence County,,IL,980,17056,18036
17103,Lee County,,IL,2691,43066,45757
17105,Livingston County,,IL,2443,43136,45579
17107,Logan County,,IL,1970,33741,35711
17109,McDonough County,,IL,2405,32043,34448
17111,McHenry County,,IL,18621,287711,306332
17113,McLean County,,IL,10998,166169,177167
17115,Macon County,,IL,6870,134255,141125
17117,Macoupin County,,IL,3084,55502,58586
17119,Madison County,,IL,14278,307740,322018
17121,Marion County,,IL,2429,48164,50593
17123,Marshall County,,IL,1319,18848,20167
17125,Mason County,,IL,1530,22099,23629
17127,Massac County,,IL,986,17261,18247
17129,Menard County,,IL,1127,15341,16468
17131,Mercer County,,IL,1273,21812,23085
17133,Monroe County,,IL,1659,35830,37489
17135,Montgomery County,,IL,1684,34912,36596
17137,Morgan County,,IL,2471,40842,43313
17139,Moultrie County,,IL,1026,15282,16308
17141,Ogle County,,IL,3844,62124,65968
17143,Peoria County,,IL,13517,210587,224104
17145,Perry County,,IL,1359,23574,24933
17147,Piatt County,,IL,1335,18601,19936
17149,Pike County,,IL,952,18787,19739
17151,Pope County,,IL,334,4058,4392
17153,Pulaski County,,IL,610,7481,8091
17155,Putnam County,,IL,470,6177,6647
17157,Randolph County,,IL,1812,35632,37444
17159,Richland County,,IL,1173,19631,20804
17161,Rock Island County,,IL,9700,172956,182656
17163,St. Clair County,,IL,18224,292351,310575
17165,Saline County,,IL,1445,27151,28596
17167,Sangamon County,,IL,10753,230183,240936
17169,Schuyler County,,IL,497,7984,8481
17171,Scott County,,IL,334,5757,6091
17173,Shelby County,,IL,1404,22909,24313
17175,Stark County,,IL,544,7927,8471
17177,Stephenson County,,IL,3207,61832,65039
17179,Tazewell County,,IL,9440,158681,168121
17181,Union County,,IL,1004,19701,20705
17183,Vermilion County,,IL,4216,93680,97896
17185,Wabash County,,IL,800,14600,15400
17187,Warren County,,IL,1290,17305,18595
17189,Washington County,,IL,1016,18288,19304
17191,Wayne County,,IL,847,18847,19694
17193,White County,,IL,822,17740,18562
17195,Whiteside County,,IL,3544,72855,76399
17197,Will County,,IL,26592,485523,512115
17199,Williamson County,,IL,3907,66410,70317
17201,Winnebago County,,IL,15009,327633,342642
17203,Woodford County,,IL,2381,36137,38518
18001,Adams County,,IN,1836,41357,43193
18003,Allen County,,IN,19487,400861,420348
18005,Bartholomew County,,IN,5951,94321,100272
18007,Benton County,,IN,1028,12329,13357
18009,Blackford County,,IN,1284,20024,21308
18011,Boone County,,IN,4445,61183,65628
18013,Brown County,,IN,2105,23732,25837
18015,Carroll County,,IN,2225,31640,33865
18017,Cass County,,IN,2777,47503,50280
18019,Clark County,,IN,8559,113962,122521
18021,Clay County,,IN,2250,35637,37887
18023,Clinton County,,IN,2481,38951,41432
18025,Crawford County,,IN,872,12399,13271
18027,Daviess County,,IN,1560,34444,36004
18029,Dearborn County,,IN,3893,61336,65229
18031,Decatur County,,IN,2147,34072,36219
18033,DeKalb County,,IN,3289,49320,52609
18035,Delaware County,,IN,7354,124815,132169
18037,Dubois County,,IN,2373,54065,56438
18039,Elkhart County,,IN,11999,218408,230407
18041,Fayette County,,IN,1786,29711,31497
18043,Floyd County,,IN,6652,81118,87770
18045,Fountain County,,IN,1658,23182,24840
18047,Franklin County,,IN,2550,38028,40578
18049,Fulton County,,IN,1741,25957,27698
18051,Gibson County,,IN,2039,39693,41732
18053,Grant County,,IN,4299,82102,86401
18055,Greene County,,IN,2262,35601,37863
18057,Hamilton County,,IN,17677,217968,235645
18059,Hancock County,,IN,5242,74523,79765
18061,Harrison County,,IN,2642,42056,44698
18063,Hendricks County,,IN,9812,134441,144253
18065,Henry County,,IN,3062,60710,63772
18067,Howard County,,IN,5666,106458,112124
18069,Huntington County,,IN,2656,48971,51627
18071,Jackson County,,IN,2708,44618,47326
18073,Jasper County,,IN,2615,39096,41711
18075,Jay County,,IN,1416,24814,26230
18077,Jefferson County,,IN,2092,37903,39995
18079,Jennings County,,IN,2012,30941,32953
18081,Johnson County,,IN,11509,135346,146855
18083,Knox County,,IN,2257,41748,44005
18085,Kosciusko County,,IN,5243,90332,95575
18087,LaGrange County,,IN,2414,41837,44251
18089,Lake County,,IN,26446,557344,583790
18091,LaPorte County,,IN,5968,127905,133873
18093,Lawrence County,,IN,2611,54007,56618
18095,Madison County,,IN,7907,153506,161413
18097,Marion County,,IN,66377,947771,1014148
18099,Marshall County,,IN,3396,54233,57629
18101,Martin County,,IN,730,12048,12778
18103,Miami County,,IN,2937,39968,42905
18105,Monroe County,,IN,11744,108157,119901
18107,Montgomery County,,IN,2345,40941,43286
18109,Morgan County,,IN,4770,65753,70523
18111,Newton County,,IN,1257,13387,14644
18113,Noble County,,IN,3400,53713,57113
18115,Ohio County,,IN,640,6630,7270
18117,Orange County,,IN,1216,20541,21757
18119,Owen County,,IN,1582,19092,20674
18121,Parke County,,IN,1189,16627,17816
18123,Perry County,,IN,1171,21155,22326
18125,Pike County,,IN,780,13493,14273
18127,Porter County,,IN,10393,160188,170581
18129,Posey County,,IN,2249,35736,37985
18131,Pulaski County,,IN,1149,16204,17353
18133,Putnam County,,IN,2411,34802,37213
18135,Randolph County,,IN,2088,31517,33605
18137,Ripley County,,IN,1413,18127,19540
18139,Rush County,,IN,1363,18983,20346
18141,St. Joseph County,,IN,16481,296169,312650
18143,Scott County,,IN,1570,25885,27455
18145,Shelby County,,IN,3140,45765,48905
18147,Spencer County,,IN,1878,23948,25826
18149,Starke County,,IN,4255,25389,29644
18151,Steuben County,,IN,2708,37790,40498
18153,Sullivan County,,IN,1343,22842,24185
18155,Switzerland County,,IN,612,7601,8213
18157,Tippecanoe County,,IN,13616,139846,153462
18159,Tipton County,,IN,1224,17754,18978
18161,Union County,,IN,320,4749,5069
18163,Vanderburgh County,,IN,11350,189891,201241
18165,Vermillion County,,IN,1437,19389,20826
18167,Vigo County,,IN,7235,109743,116978
18169,Wabash County,,IN,2203,39290,41493
18171,Warren County,,IN,551,8988,9539
18173,Warrick County,,IN,4851,59293,64144
18175,Washington County,,IN,1603,30612,32215
18177,Wayne County,,IN,4007,80175,84182
18179,Wells County,,IN,1730,29745,31475
18181,White County,,IN,1935,25686,27621
18183,Whitley County,,IN,2193,37935,40128
19001,Adair County,,IA,729,10975,11704
19003,Adams County,,IA,378,5550,5928
19005,Allamakee County,,IA,1222,17042,18264
19007,Appanoose County,,IA,915,14649,15564
19009,Audubon County,,IA,523,8865,9388
19011,Benton County,,IA,2027,33371,35398
19013,Black Hawk County,,IA,8268,137799,146067
19015,Boone County,,IA,2281,37137,39418
19017,Bremer County,,IA,1512,25742,27254
19019,Buchanan County,,IA,1653,26035,27688
19021,Buena Vista County,,IA,2053,22502,24555
19023,Butler County,,IA,1065,18649,19714
19025,Calhoun County,,IA,927,13691,14618
19027,Carroll County,,IA,1367,26986,28353
19029,Cass County,,IA,953,16211,17164
19031,Cedar County,,IA,1685,25098,26783
19033,Cerro Gordo County,,IA,3216,55997,59213
19035,Cherokee County,,IA,952,17018,17970
19037,Chickasaw County,,IA,742,15977,16719
19039,Clarke County,,IA,865,10481,11346
19041,Clay County,,IA,1521,21079,22600
19043,Clayton County,,IA,1168,23158,24326
19045,Clinton County,,IA,2994,59721,62715
19047,Crawford County,,IA,1087,18870,19957
19049,Dallas County,,IA,4208,48116,52324
19051,Davis County,,IA,526,10403,10929
19053,Decatur County,,IA,721,8193,8914
19055,Delaware County,,IA,1200,21308,22508
19057,Des Moines County,,IA,2746,49857,52603
19059,Dickinson County,,IA,1301,20193,21494
19061,Dubuque County,,IA,5018,108130,113148
19063,Emmet County,,IA,673,12571,13244
19065,Fayette County,,IA,1481,23952,25433
19067,Floyd County,,IA,1124,18577,19701
19069,Franklin County,,IA,858,14636,15494
19071,Fremont County,,IA,793,10470,11263
19073,Greene County,,IA,800,11785,12585
19075,Grundy County,,IA,900,15111,16011
19077,Guthrie County,,IA,861,12057,12918
19079,Hamilton County,,IA,1322,18735,20057
19081,Hancock County,,IA,900,14086,14986
19083,Hardin County,,IA,1305,19234,20539
19085,Harrison County,,IA,1198,18314,19512
19087,Henry County,,IA,1461,23364,24825
19089,Howard County,,IA,701,13295,13996
19091,Humboldt County,,IA,721,13003,13724
19093,Ida County,,IA,539,9160,9699
19095,Iowa County,,IA,1020,19627,20647
19097,Jackson County,,IA,1188,22823,24011
19099,Jasper County,,IA,2418,44061,46479
19101,Jefferson County,,IA,1162,17836,18998
19103,Johnson County,,IA,11958,111706,123664
19105,Jones County,,IA,1285,21995,23280
19107,Keokuk County,,IA,763,12981,13744
19109,Kossuth County,,IA,1181,21326,22507
19111,Lee County,,IA,2374,42564,44938
19113,Linn County,,IA,12444,223487,235931
19115,Louisa County,,IA,1012,16766,17778
19117,Lucas County,,IA,663,10130,10793
19119,Lyon County,,IA,771,15044,15815
19121,Madison County,,IA,1224,16734,17958
19123,Mahaska County,,IA,1977,27322,29299
19125,Marion County,,IA,2086,35827,37913
19127,Marshall County,,IA,2697,47226,49923
19129,Mills County,,IA,1287,16256,17543
19131,Mitchell County,,IA,582,12491,13073
19133,Monona County,,IA,755,11544,12299
19135,Monroe County,,IA,573,9133,9706
19137,Montgomery County,,IA,956,13723,14679
19139,Muscatine County,,IA,2658,45705,48363
19141,O'Brien County,,IA,1061,17737,18798
19143,Osceola County,,IA,379,7118,7497
19145,Page County,,IA,1177,16755,17932
19147,Palo Alto County,,IA,708,11246,11954
19149,Plymouth County,,IA,1514,28661,30175
19151,Pocahontas County,,IA,566,10073,10639
19153,Polk County,,IA,24682,435640,460322
19155,Pottawattamie County,,IA,6391,99263,105654
19157,Poweshiek County,,IA,1388,20605,21993
19159,Ringgold County,,IA,312,5591,5903
19161,Sac County,,IA,789,12940,13729
19163,Scott County,,IA,12035,181888,193923
19165,Shelby County,,IA,839,15566,16405
19167,Sioux County,,IA,1736,36834,38570
19169,Story County,,IA,8273,71990,80263
19171,Tama County,,IA,1177,18558,19735
19173,Taylor County,,IA,638,7859,8497
19175,Union County,,IA,1005,13091,14096
19177,Van Buren County,,IA,482,8650,9132
19179,Wapello County,,IA,2453,37574,40027
19181,Warren County,,IA,3018,41852,44870
19183,Washington County,,IA,1364,23375,24739
19185,Wayne County,,IA,452,7096,7548
19187,Webster County,,IA,2525,43623,46148
19189,Winnebago County,,IA,978,13818,14796
19191,Winneshiek County,,IA,1033,21583,22616
19193,Woodbury County,,IA,7954,118209,126163
19195,Worth County,,IA,576,8956,9532
19197,Wright County,,IA,1057,15874,16931
20001,Allen County,,KS,1124,15772,16896
20003,Anderson County,,KS,647,9997,10644
20005,Atchison County,,KS,1084,19226,20310
20007,Barber County,,KS,427,6142,6569
20009,Barton County,,KS,2090,31233,33323
20011,Bourbon County,,KS,1129,17533,18662
20013,Brown County,,KS,804,12875,13679
20015,Butler County,,KS,5103,66011,71114
20017,Chase County,,KS,268,3357,3625
20019,Chautauqua County,,KS,480,5367,5847
20021,Cherokee County,,KS,1747,25401,27148
20023,Cheyenne County,,KS,218,3738,3956
20025,Clark County,,KS,205,2663,2868
20027,Clay County,,KS,779,11455,12234
20029,Cloud County,,KS,862,11452,12314
20031,Coffey County,,KS,816,10989,11805
20033,Comanche County,,KS,116,2136,2252
20035,Cowley County,,KS,2672,38717,41389
20037,Crawford County,,KS,2725,36029,38754
20039,Decatur County,,KS,279,4076,4355
20041,Dickinson County,,KS,1878,22520,24398
20043,Doniphan County,,KS,611,8709,9320
20045,Douglas County,,KS,10232,95209,105441
20047,Edwards County,,KS,322,3845,4167
20049,Elk County,,KS,273,2883,3156
20051,Ellis County,,KS,2528,29777,32305
20053,Ellsworth County,,KS,480,7397,7877
20055,Finney County,,KS,4545,42955,47500
20057,Ford County,,KS,3262,33098,36360
20059,Franklin County,,KS,2017,27306,29323
20061,Geary County,,KS,11340,35081,46421
20063,Gove County,,KS,275,4095,4370
20065,Graham County,,KS,239,3702,3941
20067,Grant County,,KS,899,8877,9776
20069,Gray County,,KS,618,7192,7810
20071,Greeley County,,KS,151,1753,1904
20073,Greenwood County,,KS,615,8241,8856
20075,Hamilton County,,KS,265,2862,3127
20077,Harper County,,KS,506,7063,7569
20079,Harvey County,,KS,2844,39264,42108
20081,Haskell County,,KS,466,4284,4750
20083,Hodgeman County,,KS,150,2388,2538
20085,Jackson County,,KS,1068,15989,17057
20087,Jefferson County,,KS,1529,20185,21714
20089,Jewell County,,KS,312,4598,4910
20091,Johnson County,,KS,39869,532369,572238
20093,Kearny County,,KS,365,4704,5069
20095,Kingman County,,KS,732,10790,11522
20097,Kiowa County,,KS,367,3657,4024
20099,Labette County,,KS,1587,25059,26646
20101,Lane County,,KS,185,2646,2831
20103,Leavenworth County,,KS,9598,70526,80124
20105,Lincoln County,,KS,288,4523,4811
20107,Linn County,,KS,813,9544,10357
20109,Logan County,,KS,362,3578,3940
20111,Lyon County,,KS,3213,37800,41013
20113,McPherson County,,KS,2096,33773,35869
20115,Marion County,,KS,812,14231,15043
20117,Marshall County,,KS,662,13425,14087
20119,Meade County,,KS,433,5147,5580
20121,Miami County,,KS,2124,27109,29233
20123,Mitchell County,,KS,482,8165,8647
20125,Montgomery County,,KS,2888,38234,41122
20127,Morris County,,KS,470,7462,7932
20129,Morton County,,KS,470,4024,4494
20131,Nemaha County,,KS,722,11829,12551
20133,Neosho County,,KS,1187,17550,18737
20135,Ness County,,KS,290,4193,4483
20137,Norton County,,KS,441,6069,6510
20139,Osage County,,KS,1654,19570,21224
20141,Osborne County,,KS,340,5059,5399
20143,Ottawa County,,KS,764,9380,10144
20145,Pawnee County,,KS,593,7366,7959
20147,Phillips County,,KS,496,7378,7874
20149,Pottawatomie County,,KS,2369,25124,27493
20151,Pratt County,,KS,834,10743,11577
20153,Rawlins County,,KS,184,3451,3635
20155,Reno County,,KS,3960,71304,75264
20157,Republic County,,KS,414,6624,7038
20159,Rice County,,KS,843,10800,11643
20161,Riley County,,KS,7921,41122,49043
20163,Rooks County,,KS,426,6413,6839
20165,Rush County,,KS,279,4230,4509
20167,Russell County,,KS,652,7564,8216
20169,Saline County,,KS,4058,58544,62602
20171,Scott County,,KS,475,5754,6229
20173,Sedgwick County,,KS,27272,507309,534581
20175,Seward County,,KS,2841,21822,24663
20177,Shawnee County,,KS,10234,189854,200088
20179,Sheridan County,,KS,209,3341,3550
20181,Sherman County,,KS,732,6863,7595
20183,Smith County,,KS,303,4794,5097
20185,Stafford County,,KS,339,5148,5487
20187,Stanton County,,KS,205,2620,2825
20189,Stevens County,,KS,610,5777,6387
20191,Sumner County,,KS,1999,25585,27584
20193,Thomas County,,KS,732,8624,9356
20195,Trego County,,KS,280,3494,3774
20197,Wabaunsee County,,KS,586,6925,7511
20199,Wallace County,,KS,154,2050,2204
20201,Washington County,,KS,454,7055,7509
20203,Wichita County,,KS,246,2832,3078
20205,Wilson County,,KS,783,10219,11002
20207,Woodson County,,KS,248,3625,3873
20209,Wyandotte County,,KS,12911,153409,166320
21001,Adair County,,KY,878,17442,18320
21003,Allen County,,KY,1647,25080,26727
21005,Anderson County,,KY,1642,28634,30276
21007,Ballard County,,KY,632,9762,10394
21009,Barren County,,KY,2158,44362,46520
21011,Bath County,,KY,766,13051,13817
21013,Bell County,,KY,1630,25878,27508
21015,Boone County,,KY,10629,107990,118619
21017,Bourbon County,,KY,1748,23129,24877
21019,Boyd County,,KY,3366,55268,58634
21021,Boyle County,,KY,2477,29809,32286
21023,Bracken County,,KY,656,10396,11052
21025,Breathitt County,,KY,737,15797,16534
21027,Breckinridge County,,KY,1381,24272,25653
21029,Bullitt County,,KY,5506,76627,82133
21031,Butler County,,KY,766,13934,14700
21033,Caldwell County,,KY,860,14647,15507
21035,Calloway County,,KY,2265,33455,35720
21037,Campbell County,,KY,7040,97741,104781
21039,Carlisle County,,KY,435,6612,7047
21041,Carroll County,,KY,979,11893,12872
21043,Carter County,,KY,1229,29334,30563
21045,Casey County,,KY,824,17968,18792
21047,Christian County,,KY,18176,77681,95857
21049,Clark County,,KY,2708,38227,40935
21051,Clay County,,KY,670,18315,18985
21053,Clinton County,,KY,425,10417,10842
21055,Crittenden County,,KY,621,9352,9973
21057,Cumberland County,,KY,308,7255,7563
21059,Daviess County,,KY,4771,106487,111258
21061,Edmonson County,,KY,758,13583,14341
21063,Elliott County,,KY,304,5527,5831
21065,Estill County,,KY,920,18799,19719
21067,Fayette County,,KY,23061,269880,292941
21069,Fleming County,,KY,720,15412,16132
21071,Floyd County,,KY,1922,39586,41508
21073,Franklin County,,KY,3453,52524,55977
21075,Fulton County,,KY,689,7925,8614
21077,Gallatin County,,KY,660,5476,6136
21079,Garrard County,,KY,1566,19477,21043
21081,Grant County,,KY,2019,23239,25258
21083,Graves County,,KY,2188,40359,42547
21085,Grayson County,,KY,1189,22001,23190
21087,Green County,,KY,692,13823,14515
21089,Greenup County,,KY,2309,37643,39952
21091,Hancock County,,KY,677,9047,9724
21093,Hardin County,,KY,12983,105098,118081
21095,Harlan County,,KY,1401,27349,28750
21097,Harrison County,,KY,1265,19192,20457
21099,Hart County,,KY,1090,16010,17100
21101,Henderson County,,KY,2533,51704,54237
21103,Henry County,,KY,1396,16268,17664
21105,Hickman County,,KY,352,4526,4878
21107,Hopkins County,,KY,2744,50324,53068
21109,Jackson County,,KY,424,12895,13319
21111,Jefferson County,,KY,38176,797439,835615
21113,Jessamine County,,KY,4126,40117,44243
21115,Johnson County,,KY,1119,20732,21851
21117,Kenton County,,KY,15093,165750,180843
21119,Knott County,,KY,835,15086,15921
21121,Knox County,,KY,2046,31929,33975
21123,Larue County,,KY,984,13197,14181
21125,Laurel County,,KY,2738,54312,57050
21127,Lawrence County,,KY,767,13844,14611
21129,Lee County,,KY,294,6010,6304
21131,Leslie County,,KY,544,11304,11848
21133,Letcher County,,KY,1037,23701,24738
21135,Lewis County,,KY,699,13581,14280
21137,Lincoln County,,KY,1449,22999,24448
21139,Livingston County,,KY,723,9800,10523
21141,Logan County,,KY,1622,29294,30916
21143,Lyon County,,KY,669,7379,8048
21145,McCracken County,,KY,5081,70999,76080
21147,McCreary County,,KY,696,14734,15430
21149,McLean County,,KY,721,10659,11380
21151,Madison County,,KY,5388,63887,69275
21153,Magoffin County,,KY,531,10514,11045
21155,Marion County,,KY,829,19604,20433
21157,Marshall County,,KY,1970,31690,33660
21159,Martin County,,KY,570,10290,10860
21161,Mason County,,KY,1281,17625,18906
21163,Meade County,,KY,2045,25363,27408
21165,Menifee County,,KY,441,6012,6453
21167,Mercer County,,KY,1393,22514,23907
21169,Metcalfe County,,KY,464,8391,8855
21171,Monroe County,,KY,433,10176,10609
21173,Montgomery County,,KY,1516,22302,23818
21175,Morgan County,,KY,576,12185,12761
21177,Muhlenberg County,,KY,1295,34708,36003
21179,Nelson County,,KY,2212,45770,47982
21181,Nicholas County,,KY,332,5278,5610
21183,Ohio County,,KY,1189,24386,25575
21185,Oldham County,,KY,4014,47425,51439
21187,Owen County,,KY,700,9746,10446
21189,Owsley County,,KY,198,3495,3693
21191,Pendleton County,,KY,1050,15395,16445
21193,Perry County,,KY,1265,26306,27571
21195,Pike County,,KY,2873,59928,62801
21197,Powell County,,KY,880,12746,13626
21199,Pulaski County,,KY,2682,56935,59617
21201,Robertson County,,KY,157,1942,2099
21203,Rockcastle County,,KY,753,14833,15586
21205,Rowan County,,KY,1533,17246,18779
21207,Russell County,,KY,740,15517,16257
21209,Scott County,,KY,2557,32496,35053
21211,Shelby County,,KY,2747,35380,38127
21213,Simpson County,,KY,1322,18282,19604
21215,Spencer County,,KY,904,11420,12324
21217,Taylor County,,KY,1337,21692,23029
21219,Todd County,,KY,839,10805,11644
21221,Trigg County,,KY,935,13537,14472
21223,Trimble County,,KY,558,8821,9379
21225,Union County,,KY,977,16078,17055
21227,Warren County,,KY,6901,89096,95997
21229,Washington County,,KY,581,10903,11484
21231,Wayne County,,KY,764,18748,19512
21233,Webster County,,KY,1155,15414,16569
21235,Whitley County,,KY,2013,28964,30977
21237,Wolfe County,,KY,417,3644,4061
21239,Woodford County,,KY,2103,24257,26360
22001,Acadia Parish,,LA,3304,66297,69601
22003,Allen Parish,,LA,1546,23106,24652
22005,Ascension Parish,,LA,5083,87704,92787
22007,Assumption Parish,,LA,1763,30563,32326
22009,Avoyelles Parish,,LA,1792,42445,44237
22011,Beauregard Parish,,LA,2595,31083,33678
22013,Bienville Parish,,LA,1246,17036,18282
22015,Bossier Parish,,LA,12316,106741,119057
22017,Caddo Parish,,LA,16954,262439,279393
22019,Calcasieu Parish,,LA,10108,204378,214486
22021,Caldwell Parish,,LA,809,10894,11703
22023,Cameron Parish,,LA,599,8773,9372
22025,Catahoula Parish,,LA,675,10990,11665
22027,Claiborne Parish,,LA,828,15763,16591
22029,Concordia Parish,,LA,1286,20557,21843
22031,De Soto Parish,,LA,1851,27837,29688
22033,East Baton Rouge Parish,,LA,28184,421141,449325
22035,East Carroll Parish,,LA,647,8336,8983
22037,East Feliciana Parish,,LA,1376,20057,21433
22039,Evangeline Parish,,LA,1657,32163,33820
22041,Franklin Parish,,LA,1267,22082,23349
22043,Grant Parish,,LA,1756,21138,22894
22045,Iberia Parish,,LA,4146,82387,86533
22047,Iberville Parish,,LA,1964,34917,36881
22049,Jackson Parish,,LA,1772,24109,25881
22051,Jefferson Parish,,LA,34997,491734,526731
22053,Jefferson Davis Parish,,LA,1933,31451,33384
22055,Lafayette Parish,,LA,14683,205908,220591
22057,Lafourche Parish,,LA,5211,106140,111351
22059,La Salle Parish,,LA,782,14030,14812
22061,Lincoln Parish,,LA,3033,30460,33493
22063,Livingston Parish,,LA,6193,101816,108009
22065,Madison Parish,,LA,905,13173,14078
22067,Morehouse Parish,,LA,1794,33146,34940
22069,Natchitoches Parish,,LA,2840,37300,40140
22071,Orleans Parish,,LA,33687,456913,490600
22073,Ouachita Parish,,LA,9763,154203,163966
22075,Plaquemines Parish,,LA,2421,28438,30859
22077,Pointe Coupee Parish,,LA,1411,23544,24955
22079,Rapides Parish,,LA,7584,135835,143419
22081,Red River Parish,,LA,516,9078,9594
22083,Richland Parish,,LA,1327,20241,21568
22085,Sabine Parish,,LA,1285,23166,24451
22087,St. Bernard Parish,,LA,3563,73693,77256
22089,St. Charles Parish,,LA,4227,58751,62978
22091,St. Helena Parish,,LA,1102,14655,15757
22093,St. James Parish,,LA,1090,26326,27416
22095,St. John the Baptist Parish,,LA,2754,42820,45574
22097,St. Landry Parish,,LA,3989,81884,85873
22099,St. Martin Parish,,LA,2696,51211,53907
22101,St. Mary Parish,,LA,3534,57230,60764
22103,St. Tammany Parish,,LA,13598,206935,220533
22105,Tangipahoa Parish,,LA,5482,91778,97260
22107,Tensas Parish,,LA,492,6128,6620
22109,Terrebonne Parish,,LA,5548,104846,110394
22111,Union Parish,,LA,1376,21924,23300
22113,Vermilion Parish,,LA,2618,57858,60476
22115,Vernon Parish,,LA,10987,49409,60396
22117,Washington Parish,,LA,2052,41961,44013
22119,Webster Parish,,LA,2558,41711,44269
22121,West Baton Rouge Parish,,LA,1940,23885,25825
22123,West Carroll Parish,,LA,946,12739,13685
22125,West Feliciana Parish,,LA,850,10347,11197
22127,Winn Parish,,LA,949,13670,14619
23001,Androscoggin County,,ME,6153,114216,120369
23003,Aroostook County,,ME,3544,81275,84819
23005,Cumberland County,,ME,20335,306994,327329
23007,Franklin County,,ME,2006,31365,33371
23009,Hancock County,,ME,3338,57383,60721
23011,Kennebec County,,ME,6655,139201,145856
23013,Knox County,,ME,2357,44822,47179
23015,Lincoln County,,ME,2258,39413,41671
23017,Oxford County,,ME,3167,59918,63085
23019,Penobscot County,,ME,8024,159940,167964
23021,Piscataquis County,,ME,1205,18734,19939
23023,Sagadahoc County,,ME,3908,39436,43344
23025,Somerset County,,ME,2902,48780,51682
23027,Waldo County,,ME,2379,40122,42501
23029,Washington County,,ME,2048,37102,39150
23031,York County,,ME,11671,216005,227676
24001,Allegany County,,MD,3267,77734,81001
24003,Anne Arundel County,,MD,44475,576119,620594
24005,Baltimore County,,MD,61497,895913,957410
24009,Calvert County,,MD,4972,87698,92670
24011,Caroline County,,MD,2256,34719,36975
24013,Carroll County,,MD,10417,198730,209147
24015,Cecil County,,MD,5617,98523,104140
24017,Charles County,,MD,10206,147140,157346
24019,Dorchester County,,MD,1609,33803,35412
24021,Frederick County,,MD,14091,230716,244807
24023,Garrett County,,MD,1348,32960,34308
24025,Harford County,,MD,15928,260614,276542
24027,Howard County,,MD,26660,272370,299030
24029,Kent County,,MD,1375,25515,26890
24031,Montgomery County,,MD,74381,1009625,1084006
24033,Prince George's County,,MD,69700,881887,951587
24035,Queen Anne's County,,MD,3055,42120,45175
24037,St. Mary's County,,MD,7833,96710,104543
24039,Somerset County,,MD,1388,21339,22727
24041,Talbot County,,MD,2521,39004,41525
24043,Washington County,,MD,7149,148870,156019
24045,Wicomico County,,MD,5778,91224,97002
24047,Worcester County,,MD,3929,56300,60229
24510,Baltimore city,,MD,48638,592755,641393
25001,Barnstable County,,MA,12680,261146,273826
25003,Berkshire County,,MA,6096,153312,159408
25005,Bristol County,,MA,23755,606477,630232
25007,Dukes County,,MA,1030,17327,18357
25009,Essex County,,MA,39664,822351,862015
25011,Franklin County,,MA,4810,80145,84955
25013,Hampden County,,MA,18242,506865,525107
25015,Hampshire County,,MA,11673,155594,167267
25017,Middlesex County,,MA,115120,1664689,1779809
25019,Nantucket County,,MA,973,10242,11215
25021,Norfolk County,,MA,55817,734326,790143
25023,Plymouth County,,MA,26482,550062,576544
25025,Suffolk County,,MA,74700,669698,744398
25027,Worcester County,,MA,34845,864490,899335
26001,Alcona County,,MI,1124,15381,16505
26003,Alger County,,MI,678,10731,11409
26005,Allegan County,,MI,8649,139372,148021
26007,Alpena County,,MI,1753,39265,41018
26009,Antrim County,,MI,2482,34182,36664
26011,Arenac County,,MI,1367,22527,23894
26013,Baraga County,,MI,505,9793,10298
26015,Barry County,,MI,4469,74005,78474
26017,Bay County,,MI,6303,137546,143849
26019,Benzie County,,MI,1485,21979,23464
26021,Berrien County,,MI,10269,187179,197448
26023,Branch County,,MI,3627,54215,57842
26025,Calhoun County,,MI,8552,152523,161075
26027,Cass County,,MI,3911,59479,63390
26029,Charlevoix County,,MI,1801,26107,27908
26031,Cheboygan County,,MI,1927,35679,37606
26033,Chippewa County,,MI,2370,38104,40474
26035,Clare County,,MI,2835,40148,42983
26037,Clinton County,,MI,7005,101680,108685
26039,Crawford County,,MI,1342,18283,19625
26041,Delta County,,MI,1959,45665,47624
26043,Dickinson County,,MI,1686,32415,34101
26045,Eaton County,,MI,10865,124432,135297
26047,Emmet County,,MI,2104,32622,34726
26049,Genesee County,,MI,21973,524108,546081
26051,Gladwin County,,MI,1643,25260,26903
26053,Gogebic County,,MI,1014,17357,18371
26055,Grand Traverse County,,MI,6434,98634,105068
26057,Gratiot County,,MI,3533,56641,60174
26059,Hillsdale County,,MI,3098,54312,57410
26061,Houghton County,,MI,2255,34546,36801
26063,Huron County,,MI,2035,47226,49261
26065,Ingham County,,MI,24769,269147,293916
26067,Ionia County,,MI,3908,64651,68559
26069,Iosco County,,MI,2115,29735,31850
26071,Iron County,,MI,729,13972,14701
26073,Isabella County,,MI,5000,58718,63718
26075,Jackson County,,MI,7838,180076,187914
26077,Kalamazoo County,,MI,17284,262371,279655
26079,Kalkaska County,,MI,1152,12971,14123
26081,Kent County,,MI,34161,668133,702294
26083,Keweenaw County,,MI,196,2080,2276
26085,Lake County,,MI,1188,13368,14556
26087,Lapeer County,,MI,6712,109280,115992
26089,Leelanau County,,MI,1270,18222,19492
26091,Lenawee County,,MI,5610,109513,115123
26093,Livingston County,,MI,11989,195752,207741
26095,Luce County,,MI,402,6637,7039
26097,Mackinac County,,MI,1229,14261,15490
26099,Macomb County,,MI,43397,967008,1010405
26101,Manistee County,,MI,1708,28120,29828
26103,Marquette County,,MI,3644,69425,73069
26105,Mason County,,MI,1811,32283,34094
26107,Mecosta County,,MI,3925,45506,49431
26109,Menominee County,,MI,1438,28247,29685
26111,Midland County,,MI,5439,89531,94970
26113,Missaukee County,,MI,1230,16546,17776
26115,Monroe County,,MI,9332,182432,191764
26117,Montcalm County,,MI,4115,49536,53651
26119,Montmorency County,,MI,712,10822,11534
26121,Muskegon County,,MI,7682,195691,203373
26123,Newaygo County,,MI,3139,52291,55430
26125,Oakland County,,MI,90825,1400940,1491765
26127,Oceana County,,MI,1599,22540,24139
26129,Ogemaw County,,MI,1436,21201,22637
26131,Ontonagon County,,MI,503,8536,9039
26133,Osceola County,,MI,1710,20367,22077
26135,Oscoda County,,MI,441,7020,7461
26137,Otsego County,,MI,1733,24943,26676
26139,Ottawa County,,MI,15423,270120,285543
26141,Presque Isle County,,MI,801,14145,14946
26143,Roscommon County,,MI,1704,23614,25318
26145,Saginaw County,,MI,10809,240999,251808
26147,St. Clair County,,MI,8975,195741,204716
26149,St. Joseph County,,MI,4085,68550,72635
26151,Sanilac County,,MI,3009,51883,54892
26153,Schoolcraft County,,MI,484,9413,9897
26155,Shiawassee County,,MI,4188,71468,75656
26157,Tuscola County,,MI,3392,59714,63106
26159,Van Buren County,,MI,5106,68023,73129
26161,Washtenaw County,,MI,30013,309842,339855
26163,Wayne County,,MI,96050,2109563,2205613
26165,Wexford County,,MI,2518,32614,35132
27001,Aitkin County,,MN,1152,16838,17990
27003,Anoka County,,MN,25975,367546,393521
27005,Becker County,,MN,2056,38338,40394
27007,Beltrami County,,MN,2647,43783,46430
27009,Benton County,,MN,5078,51608,56686
27011,Big Stone County,,MN,366,7200,7566
27013,Blue Earth County,,MN,5380,60374,65754
27015,Brown County,,MN,1778,33739,35517
27017,Carlton County,,MN,1976,38230,40206
27019,Carver County,,MN,6956,89909,96865
27021,Cass County,,MN,2937,38042,40979
27023,Chippewa County,,MN,1080,18165,19245
27025,Chisago County,,MN,3614,58413,62027
27027,Clay County,,MN,3906,53337,57243
27029,Clearwater County,,MN,530,8326,8856
27031,Cook County,,MN,450,5868,6318
27033,Cottonwood County,,MN,856,15324,16180
27035,Crow Wing County,,MN,3651,56325,59976
27037,Dakota County,,MN,35734,444118,479852
27039,Dodge County,,MN,1523,25859,27382
27041,Douglas County,,MN,2184,39820,42004
27043,Faribault County,,MN,1133,20372,21505
27045,Fillmore County,,MN,1334,26142,27476
27047,Freeborn County,,MN,1805,37959,39764
27049,Goodhue County,,MN,2700,51610,54310
27051,Grant County,,MN,489,7868,8357
27053,Hennepin County,,MN,95327,1265345,1360672
27055,Houston County,,MN,1256,24298,25554
27057,Hubbard County,,MN,1228,15967,17195
27059,Isanti County,,MN,2750,38288,41038
27061,Itasca County,,MN,2404,49563,51967
27063,Jackson County,,MN,706,12472,13178
27065,Kanabec County,,MN,1204,16928,18132
27067,Kandiyohi County,,MN,3046,51625,54671
27069,Kittson County,,MN,328,6185,6513
27071,Koochiching County,,MN,907,16713,17620
27073,Lac qui Parle County,,MN,449,9215,9664
27075,Lake County,,MN,749,13959,14708
27077,Lake of the Woods County,,MN,328,4645,4973
27079,Le Sueur County,,MN,2210,34496,36706
27081,Lincoln County,,MN,402,7015,7417
27083,Lyon County,,MN,2158,30392,32550
27085,McLeod County,,MN,2804,44230,47034
27087,Mahnomen County,,MN,330,5245,5575
27089,Marshall County,,MN,719,12896,13615
27091,Martin County,,MN,1441,26817,28258
27093,Meeker County,,MN,1651,27067,28718
27095,Mille Lacs County,,MN,1567,23740,25307
27097,Morrison County,,MN,1825,36115,37940
27099,Mower County,,MN,2676,45756,48432
27101,Murray County,,MN,629,11764,12393
27103,Nicollet County,,MN,2957,29529,32486
27105,Nobles County,,MN,1607,23934,25541
27107,Norman County,,MN,532,9210,9742
27109,Olmsted County,,MN,9756,149602,159358
27111,Otter Tail County,,MN,3376,63747,67123
27113,Pennington County,,MN,1147,15213,16360
27115,Pine County,,MN,1770,25939,27709
27117,Pipestone County,,MN,684,10507,11191
27119,Polk County,,MN,2264,33620,35884
27121,Pope County,,MN,730,12729,13459
27123,Ramsey County,,MN,51493,555320,606813
27125,Red Lake County,,MN,280,4583,4863
27127,Redwood County,,MN,1153,20923,22076
27129,Renville County,,MN,1262,20025,21287
27131,Rice County,,MN,3470,58655,62125
27133,Rock County,,MN,694,12054,12748
27135,Roseau County,,MN,985,20086,21071
27137,St. Louis County,,MN,9969,218820,228789
27139,Scott County,,MN,7024,101478,108502
27141,Sherburne County,,MN,5629,67581,73210
27143,Sibley County,,MN,1021,15293,16314
27145,Stearns County,,MN,10025,137316,147341
27147,Steele County,,MN,2412,39451,41863
27149,Stevens County,,MN,706,10353,11059
27151,Swift County,,MN,984,11763,12747
27153,Todd County,,MN,1684,26542,28226
27155,Traverse County,,MN,353,4497,4850
27157,Wabasha County,,MN,1426,25510,26936
27159,Wadena County,,MN,892,12155,13047
27161,Waseca County,,MN,1552,22090,23642
27163,Washington County,,MN,17854,222946,240800
27165,Watonwan County,,MN,918,13479,14397
27167,Wilkin County,,MN,679,8678,9357
27169,Winona County,,MN,3359,51924,55283
27171,Wright County,,MN,6429,100440,106869
27173,Yellow Medicine County,,MN,680,10936,11616
28001,Adams County,,MS,2097,35733,37830
28003,Alcorn County,,MS,2133,37734,39867
28005,Amite County,,MS,1229,16377,17606
28007,Attala County,,MS,1232,21731,22963
28009,Benton County,,MS,840,8299,9139
28011,Bolivar County,,MS,2655,40265,42920
28013,Calhoun County,,MS,1001,18759,19760
28015,Carroll County,,MS,1130,13691,14821
28017,Chickasaw County,,MS,1293,23289,24582
28019,Choctaw County,,MS,608,7488,8096
28021,Claiborne County,,MS,615,11025,11640
28023,Clarke County,,MS,1782,28216,29998
28025,Clay County,,MS,1282,23726,25008
28027,Coahoma County,,MS,2122,33278,35400
28029,Copiah County,,MS,1872,33212,35084
28031,Covington County,,MS,1301,19690,20991
28033,DeSoto County,,MS,9760,130220,139980
28035,Forrest County,,MS,8397,90096,98493
28037,Franklin County,,MS,488,7429,7917
28039,George County,,MS,1312,23368,24680
28041,Greene County,,MS,624,8997,9621
28043,Grenada County,,MS,1715,25387,27102
28045,Hancock County,,MS,3571,45021,48592
28047,Harrison County,,MS,20639,191304,211943
28049,Hinds County,,MS,17422,261753,279175
28051,Holmes County,,MS,1345,19107,20452
28053,Humphreys County,,MS,880,12771,13651
28055,Issaquena County,,MS,152,1626,1778
28057,Itawamba County,,MS,1754,26601,28355
28059,Jackson County,,MS,10488,134698,145186
28061,Jasper County,,MS,992,17795,18787
28063,Jefferson County,,MS,432,7329,7761
28065,Jefferson Davis County,,MS,920,14874,15794
28067,Jones County,,MS,3516,61886,65402
28069,Kemper County,,MS,781,12368,13149
28071,Lafayette County,,MS,3444,33025,36469
28073,Lamar County,,MS,2259,27435,29694
28075,Lauderdale County,,MS,5513,76512,82025
28077,Lawrence County,,MS,957,16921,17878
28079,Leake County,,MS,1309,21930,23239
28081,Lee County,,MS,5591,89856,95447
28083,Leflore County,,MS,2495,34802,37297
28085,Lincoln County,,MS,1890,32836,34726
28087,Lowndes County,,MS,5431,61720,67151
28089,Madison County,,MS,7782,78084,85866
28091,Marion County,,MS,1525,30447,31972
28093,Marshall County,,MS,1999,27061,29060
28095,Monroe County,,MS,2626,45551,48177
28097,Montgomery County,,MS,775,12517,13292
28099,Neshoba County,,MS,1693,27763,29456
28101,Newton County,,MS,1350,25224,26574
28103,Noxubee County,,MS,613,13353,13966
28105,Oktibbeha County,,MS,3822,34381,38203
28107,Panola County,,MS,2219,38942,41161
28109,Pearl River County,,MS,2674,47865,50539
28111,Perry County,,MS,804,12798,13602
28113,Pike County,,MS,2460,36213,38673
28115,Pontotoc County,,MS,1662,22884,24546
28117,Prentiss County,,MS,1220,20816,22036
28119,Quitman County,,MS,682,9528,10210
28121,Rankin County,,MS,10059,124568,134627
28123,Scott County,,MS,1699,26257,27956
28125,Sharkey County,,MS,552,6376,6928
28127,Simpson County,,MS,1683,20847,22530
28129,Smith County,,MS,1024,16294,17318
28131,Stone County,,MS,706,8236,8942
28133,Sunflower County,,MS,2035,30331,32366
28135,Tallahatchie County,,MS,1095,16498,17593
28137,Tate County,,MS,2172,25920,28092
28139,Tippah County,,MS,1225,22436,23661
28141,Tishomingo County,,MS,1118,18919,20037
28143,Tunica County,,MS,807,9919,10726
28145,Union County,,MS,1672,25671,27343
28147,Walthall County,,MS,691,10419,11110
28149,Warren County,,MS,3677,57055,60732
28151,Washington County,,MS,4266,66714,70980
28153,Wayne County,,MS,857,19315,20172
28155,Webster County,,MS,821,13061,13882
28157,Wilkinson County,,MS,425,8447,8872
28159,Winston County,,MS,974,20229,21203
28161,Yalobusha County,,MS,950,14226,15176
28163,Yazoo County,,MS,1664,27084,28748
29001,Adair County,,MO,1979,22672,24651
29003,Andrew County,,MO,1811,21210,23021
29005,Atchison County,,MO,488,6909,7397
29007,Audrain County,,MO,1918,29704,31622
29009,Barry County,,MO,2935,38314,41249
29011,Barton County,,MO,1055,16143,17198
29013,Bates County,,MO,1371,19347,20718
29015,Benton County,,MO,1465,17705,19170
29017,Bollinger County,,MO,711,12762,13473
29019,Boone County,,MO,11708,137117,148825
29021,Buchanan County,,MO,6142,92011,98153
29023,Butler County,,MO,2987,43278,46265
29025,Caldwell County,,MO,862,10882,11744
29027,Callaway County,,MO,3155,42760,45915
29029,Camden County,,MO,3840,38535,42375
29031,Cape Girardeau County,,MO,5020,74372,79392
29033,Carroll County,,MO,591,11655,12246
29035,Carter County,,MO,574,6106,6680
29037,Cass County,,MO,7261,95606,102867
29039,Cedar County,,MO,1035,13808,14843
29041,Chariton County,,MO,561,9962,10523
29043,Christian County,,MO,6653,67867,74520
29045,Clark County,,MO,448,8694,9142
29047,Clay County,,MO,18623,223505,242128
29049,Clinton County,,MO,1899,20031,21930
29051,Cole County,,MO,5661,80484,86145
29053,Cooper County,,MO,1275,17339,18614
29055,Crawford County,,MO,1847,26038,27885
29057,Dade County,,MO,741,8860,9601
29059,Dallas County,,MO,1366,16449,17815
29061,Daviess County,,MO,822,9803,10625
29063,DeKalb County,,MO,659,7776,8435
29065,Dent County,,MO,963,14200,15163
29067,Douglas County,,MO,990,14237,15227
29069,Dunklin County,,MO,2227,33000,35227
29071,Franklin County,,MO,5708,112768,118476
29073,Gasconade County,,MO,1130,17384,18514
29075,Gentry County,,MO,538,8221,8759
29077,Greene County,,MO,20058,256961,277019
29079,Grundy County,,MO,788,11042,11830
29081,Harrison County,,MO,642,9142,9784
29083,Henry County,,MO,1667,24839,26506
29085,Hickory County,,MO,674,8575,9249
29087,Holt County,,MO,473,6480,6953
29089,Howard County,,MO,819,10997,11816
29091,Howell County,,MO,2946,42681,45627
29093,Iron County,,MO,850,11134,11984
29095,Jackson County,,MO,45460,719792,765252
29097,Jasper County,,MO,8162,113272,121434
29099,Jefferson County,,MO,13279,236782,250061
29101,Johnson County,,MO,5950,48598,54548
29103,Knox County,,MO,349,5139,5488
29105,Laclede County,,MO,2361,35660,38021
29107,Lafayette County,,MO,2473,34490,36963
29109,Lawrence County,,MO,2794,34289,37083
29111,Lewis County,,MO,743,10696,11439
29113,Lincoln County,,MO,2654,46150,48804
29115,Linn County,,MO,927,16272,17199
29117,Livingston County,,MO,1064,15305,16369
29119,McDonald County,,MO,2036,20517,22553
29121,Macon County,,MO,1193,17945,19138
29123,Madison County,,MO,852,12755,13607
29125,Maries County,,MO,712,8301,9013
29127,Marion County,,MO,2206,32511,34717
29129,Mercer County,,MO,284,3924,4208
29131,Miller County,,MO,1605,23791,25396
29133,Mississippi County,,MO,940,14021,14961
29135,Moniteau County,,MO,978,15227,16205
29137,Monroe County,,MO,777,11069,11846
29139,Montgomery County,,MO,970,13747,14717
29141,Morgan County,,MO,1571,19179,20750
29143,New Madrid County,,MO,1480,20078,21558
29145,Newton County,,MO,3895,49568,53463
29147,Nodaway County,,MO,1462,20240,21702
29149,Oregon County,,MO,719,9297,10016
29151,Osage County,,MO,758,14508,15266
29153,Ozark County,,MO,746,8930,9676
29155,Pemiscot County,,MO,1475,20253,21728
29157,Perry County,,MO,1114,20233,21347
29159,Pettis County,,MO,3049,44111,47160
29161,Phelps County,,MO,3549,41084,44633
29163,Pike County,,MO,1199,18120,19319
29165,Platte County,,MO,10655,81306,91961
29167,Polk County,,MO,2076,24005,26081
29169,Pulaski County,,MO,7642,37008,44650
29171,Putnam County,,MO,333,5747,6080
29173,Ralls County,,MO,669,10023,10692
29175,Randolph County,,MO,1545,22304,23849
29177,Ray County,,MO,1631,21304,22935
29179,Reynolds County,,MO,581,5957,6538
29181,Ripley County,,MO,933,13018,13951
29183,St. Charles County,,MO,20111,346073,366184
29185,St. Clair County,,MO,818,9086,9904
29186,Ste. Genevieve County,,MO,1362,21884,23246
29187,St. Francois County,,MO,3557,56964,60521
29189,St. Louis County,,MO,78504,1214994,1293498
29195,Saline County,,MO,1789,24034,25823
29197,Schuyler County,,MO,252,4464,4716
29199,Scotland County,,MO,268,5039,5307
29201,Scott County,,MO,2973,44728,47701
29203,Shannon County,,MO,499,7896,8395
29205,Shelby County,,MO,439,7666,8105
29207,Stoddard County,,MO,1939,31807,33746
29209,Stone County,,MO,3019,27199,30218
29211,Sullivan County,,MO,676,6597,7273
29213,Taney County,,MO,4403,39420,43823
29215,Texas County,,MO,1565,19513,21078
29217,Vernon County,,MO,1425,20141,21566
29219,Warren County,,MO,1977,25774,27751
29221,Washington County,,MO,1283,20690,21973
29223,Wayne County,,MO,827,11130,11957
29225,Webster County,,MO,2157,28560,30717
29227,Worth County,,MO,143,2315,2458
29229,Wright County,,MO,1559,18151,19710
29510,St. Louis city,,MO,37163,325573,362736
30001,Beaverhead County,,MT,905,8950,9855
30003,Big Horn County,,MT,742,12467,13209
30005,Blaine County,,MT,548,6978,7526
30007,Broadwater County,,MT,361,4459,4820
30009,Carbon County,,MT,886,10230,11116
30011,Carter County,,MT,85,1275,1360
30013,Cascade County,,MT,7859,89551,97410
30015,Chouteau County,,MT,461,5355,5816
30017,Custer County,,MT,1091,12743,13834
30019,Daniels County,,MT,133,2580,2713
30021,Dawson County,,MT,736,10332,11068
30023,Deer Lodge County,,MT,756,9906,10662
30025,Fallon County,,MT,242,3382,3624
30027,Fergus County,,MT,936,13250,14186
30029,Flathead County,,MT,5514,85169,90683
30031,Gallatin County,,MT,6920,70582,77502
30033,Garfield County,,MT,116,1373,1489
30035,Glacier County,,MT,1050,13850,14900
30037,Golden Valley County,,MT,133,1067,1200
30039,Granite County,,MT,378,2919,3297
30041,Hill County,,MT,1468,18491,19959
30043,Jefferson County,,MT,1049,11337,12386
30045,Judith Basin County,,MT,204,2480,2684
30047,Lake County,,MT,1891,24911,26802
30049,Lewis and Clark County,,MT,4381,63312,67693
30051,Liberty County,,MT,188,2352,2540
30053,Lincoln County,,MT,1494,18675,20169
30055,McCone County,,MT,177,1783,1960
30057,Madison County,,MT,571,6730,7301
30059,Meagher County,,MT,193,2271,2464
30061,Mineral County,,MT,554,4304,4858
30063,Missoula County,,MT,9147,98280,107427
30065,Musselshell County,,MT,450,4538,4988
30067,Park County,,MT,1732,16031,17763
30069,Petroleum County,,MT,0,0,0
30071,Phillips County,,MT,387,4991,5378
30073,Pondera County,,MT,504,7741,8245
30075,Powder River County,,MT,143,1652,1795
30077,Powell County,,MT,607,6278,6885
30079,Prairie County,,MT,83,1416,1499
30081,Ravalli County,,MT,2758,35521,38279
30083,Richland County,,MT,756,11681,12437
30085,Roosevelt County,,MT,760,11965,12725
30087,Rosebud County,,MT,963,10872,11835
30089,Sanders County,,MT,808,10025,10833
30091,Sheridan County,,MT,310,4834,5144
30093,Silver Bow County,,MT,2921,36730,39651
30095,Stillwater County,,MT,975,9230,10205
30097,Sweet Grass County,,MT,391,3730,4121
30099,Teton County,,MT,524,7572,8096
30101,Toole County,,MT,403,5589,5992
30103,Treasure County,,MT,0,0,0
30105,Valley County,,MT,619,8834,9453
30107,Wheatland County,,MT,253,2313,2566
30109,Wibaux County,,MT,99,1180,1279
30111,Yellowstone County,,MT,9333,146060,155393
31001,Adams County,,NE,2250,34335,36585
31003,Antelope County,,NE,579,8854,9433
31005,Arthur County,,NE,0,0,0
31007,Banner County,,NE,100,1009,1109
31009,Blaine County,,NE,0,0,0
31011,Boone County,,NE,436,7649,8085
31013,Box Butte County,,NE,1144,15033,16177
31015,Boyd County,,NE,145,2829,2974
31017,Brown County,,NE,260,4102,4362
31019,Buffalo County,,NE,3666,46692,50358
31021,Burt County,,NE,718,9515,10233
31023,Butler County,,NE,744,12344,13088
31025,Cass County,,NE,2526,29178,31704
31027,Cedar County,,NE,761,13219,13980
31029,Chase County,,NE,349,5031,5380
31031,Cherry County,,NE,537,7119,7656
31033,Cheyenne County,,NE,797,11654,12451
31035,Clay County,,NE,720,8698,9418
31037,Colfax County,,NE,1134,14797,15931
31039,Cuming County,,NE,888,13136,14024
31041,Custer County,,NE,916,14186,15102
31043,Dakota County,,NE,2668,23672,26340
31045,Dawes County,,NE,897,9002,9899
31047,Dawson County,,NE,2322,28597,30919
31049,Deuel County,,NE,233,2379,2612
31051,Dixon County,,NE,575,7137,7712
31053,Dodge County,,NE,2871,42032,44903
31055,Douglas County,,NE,35199,552973,588172
31057,Dundy County,,NE,213,2496,2709
31059,Fillmore County,,NE,509,8794,9303
31061,Franklin County,,NE,262,4353,4615
31063,Frontier County,,NE,353,3608,3961
31065,Furnas County,,NE,527,6043,6570
31067,Gage County,,NE,1453,26877,28330
31069,Garden County,,NE,221,2390,2611
31071,Garfield County,,NE,112,2548,2660
31073,Gosper County,,NE,271,2426,2697
31075,Grant County,,NE,142,1218,1360
31077,Greeley County,,NE,213,3655,3868
31079,Hall County,,NE,4723,61445,66168
31081,Hamilton County,,NE,852,11574,12426
31083,Harlan County,,NE,313,4109,4422
31085,Hayes County,,NE,69,1289,1358
31087,Hitchcock County,,NE,249,3513,3762
31089,Holt County,,NE,773,13122,13895
31091,Hooker County,,NE,122,1076,1198
31093,Howard County,,NE,586,7338,7924
31095,Jefferson County,,NE,548,9801,10349
31097,Johnson County,,NE,408,5331,5739
31099,Kearney County,,NE,498,7180,7678
31101,Keith County,,NE,896,9754,10650
31103,Keya Paha County,,NE,125,1176,1301
31105,Kimball County,,NE,354,4451,4805
31107,Knox County,,NE,574,9567,10141
31109,Lancaster County,,NE,16849,284304,301153
31111,Lincoln County,,NE,2577,40615,43192
31113,Logan County,,NE,99,915,1014
31115,Loup County,,NE,38,814,852
31117,McPherson County,,NE,0,0,0
31119,Madison County,,NE,3189,44368,47557
31121,Merrick County,,NE,781,8517,9298
31123,Morrill County,,NE,491,5695,6186
31125,Nance County,,NE,353,4715,5068
31127,Nemaha County,,NE,712,9168,9880
31129,Nuckolls County,,NE,348,6003,6351
31131,Otoe County,,NE,1153,17624,18777
31133,Pawnee County,,NE,236,3233,3469
31135,Perkins County,,NE,306,3461,3767
31137,Phelps County,,NE,789,11550,12339
31139,Pierce County,,NE,532,8439,8971
31141,Platte County,,NE,2455,37592,40047
31143,Polk County,,NE,459,6301,6760
31145,Red Willow County,,NE,954,12841,13795
31147,Richardson County,,NE,623,10397,11020
31149,Rock County,,NE,119,1777,1896
31151,Saline County,,NE,1239,14328,15567
31153,Sarpy County,,NE,15775,121641,137416
31155,Saunders County,,NE,1335,20093,21428
31157,Scotts Bluff County,,NE,2934,40411,43345
31159,Seward County,,NE,1438,18382,19820
31161,Sheridan County,,NE,644,6775,7419
31163,Sherman County,,NE,261,4148,4409
31165,Sioux County,,NE,70,987,1057
31167,Stanton County,,NE,331,3658,3989
31169,Thayer County,,NE,510,7018,7528
31171,Thomas County,,NE,110,982,1092
31173,Thurston County,,NE,526,7307,7833
31175,Valley County,,NE,267,4735,5002
31177,Washington County,,NE,1525,20892,22417
31179,Wayne County,,NE,794,8189,8983
31181,Webster County,,NE,352,4541,4893
31183,Wheeler County,,NE,71,852,923
31185,York County,,NE,1222,16293,17515
32001,Churchill County,,NV,3130,24723,27853
32003,Clark County,,NV,78702,1469592,1548294
32005,Douglas County,,NV,5139,46630,51769
32007,Elko County,,NV,5229,49143,54372
32009,Esmeralda County,,NV,99,882,981
32011,Eureka County,,NV,170,1685,1855
32013,Humboldt County,,NV,2419,18700,21119
32015,Lander County,,NV,855,6403,7258
32017,Lincoln County,,NV,362,3818,4180
32019,Lyon County,,NV,4163,37757,41920
32021,Mineral County,,NV,573,5227,5800
32023,Nye County,,NV,3714,32213,35927
32027,Pershing County,,NV,553,4555,5108
32029,Storey County,,NV,924,9282,10206
32031,Washoe County,,NV,23588,371347,394935
32033,White Pine County,,NV,1002,8921,9923
32510,Carson City,,NV,6046,54995,61041
33001,Belknap County,,NH,4783,70347,75130
33003,Carroll County,,NH,3609,49984,53593
33005,Cheshire County,,NH,4957,83554,88511
33007,Coos County,,NH,2244,39494,41738
33009,Grafton County,,NH,7668,90302,97970
33011,Hillsborough County,,NH,28411,454029,482440
33013,Merrimack County,,NH,10469,151425,161894
33015,Rockingham County,,NH,24186,338348,362534
33017,Strafford County,,NH,9111,124865,133976
33019,Sullivan County,,NH,2838,46664,49502
34001,Atlantic County,,NJ,13122,309070,322192
34003,Bergen County,,NJ,57993,1026605,1084598
34005,Burlington County,,NJ,30327,507522,537849
34007,Camden County,,NJ,32017,576843,608860
34009,Cape May County,,NJ,6792,114560,121352
34011,Cumberland County,,NJ,6333,157604,163937
34013,Essex County,,NJ,51697,813859,865556
34015,Gloucester County,,NJ,15033,294111,309144
34017,Hudson County,,NJ,54237,627026,681263
34019,Hunterdon County,,NJ,10059,146930,156989
34021,Mercer County,,NJ,24095,394814,418909
34023,Middlesex County,,NJ,61620,869513,931133
34025,Monmouth County,,NJ,36901,701377,738278
34027,Morris County,,NJ,38664,563586,602250
34029,Ocean County,,NJ,23717,587602,611319
34031,Passaic County,,NJ,32002,550275,582277
34033,Salem County,,NJ,3771,75726,79497
34035,Somerset County,,NJ,27444,331124,358568
34037,Sussex County,,NJ,9889,171878,181767
34039,Union County,,NJ,39709,588778,628487
34041,Warren County,,NJ,7246,114312,121558
35001,Bernalillo County,,NM,41589,535247,576836
35003,Catron County,,NM,374,2830,3204
35005,Chaves County,,NM,4644,57033,61677
35006,Cibola County,,NM,2040,21868,23908
35007,Colfax County,,NM,1193,14869,16062
35009,Curry County,,NM,5998,44119,50117
35011,De Baca County,,NM,226,2211,2437
35013,Dona Ana County,,NM,13802,166867,180669
35015,Eddy County,,NM,3692,49209,52901
35017,Grant County,,NM,2498,31231,33729
35019,Guadalupe County,,NM,401,4243,4644
35021,Harding County,,NM,37,711,748
35023,Hidalgo County,,NM,676,5239,5915
35025,Lea County,,NM,4108,56372,60480
35027,Lincoln County,,NM,1905,16328,18233
35028,Los Alamos County,,NM,2027,17828,19855
35029,Luna County,,NM,2253,24567,26820
35031,McKinley County,,NM,9640,85092,94732
35033,Mora County,,NM,319,4518,4837
35035,Otero County,,NM,7261,52375,59636
35037,Quay County,,NM,933,9418,10351
35039,Rio Arriba County,,NM,2748,39894,42642
35041,Roosevelt County,,NM,1773,16330,18103
35043,Sandoval County,,NM,9558,85900,95458
35045,San Juan County,,NM,11953,123041,134994
35047,San Miguel County,,NM,1864,24728,26592
35049,Santa Fe County,,NM,9667,110869,120536
35051,Sierra County,,NM,1050,10328,11378
35053,Socorro County,,NM,1465,14681,16146
35055,Taos County,,NM,1993,28033,30026
35057,Torrance County,,NM,1476,12008,13484
35059,Union County,,NM,460,4341,4801
35061,Valencia County,,NM,5298,61678,66976
36001,Albany County,,NY,22413,332910,355323
36003,Allegany County,,NY,3186,54802,57988
36005,Bronx County,,NY,77009,1177089,1254098
36007,Broome County,,NY,10276,230761,241037
36009,Cattaraugus County,,NY,5129,90446,95575
36011,Cayuga County,,NY,4599,91417,96016
36013,Chautauqua County,,NY,5920,149659,155579
36015,Chemung County,,NY,5208,103595,108803
36017,Chenango County,,NY,2926,54505,57431
36019,Clinton County,,NY,3208,89160,92368
36021,Columbia County,,NY,3689,71626,75315
36023,Cortland County,,NY,3159,51504,54663
36025,Delaware County,,NY,3242,49956,53198
36027,Dutchess County,,NY,15407,308638,324045
36029,Erie County,,NY,33383,1067893,1101276
36031,Essex County,,NY,2383,38625,41008
36033,Franklin County,,NY,2205,50038,52243
36035,Fulton County,,NY,2680,59461,62141
36037,Genesee County,,NY,3813,76386,80199
36039,Greene County,,NY,2740,49196,51936
36041,Hamilton County,,NY,422,5665,6087
36043,Herkimer County,,NY,3456,71433,74889
36045,Jefferson County,,NY,15717,118634,134351
36047,Kings County,,NY,138895,2252292,2391187
36049,Lewis County,,NY,1470,28533,30003
36051,Livingston County,,NY,4249,72930,77179
36053,Madison County,,NY,4803,78375,83178
36055,Monroe County,,NY,34482,861591,896073
36057,Montgomery County,,NY,3408,62797,66205
36059,Nassau County,,NY,76536,1595419,1671955
36061,New York County,,NY,147364,1470774,1618138
36063,Niagara County,,NY,10350,255860,266210
36065,Oneida County,,NY,10270,256167,266437
36067,Onondaga County,,NY,23585,516613,540198
36069,Ontario County,,NY,6929,119807,126736
36071,Orange County,,NY,21163,387608,408771
36073,Orleans County,,NY,2555,46912,49467
36075,Oswego County,,NY,6839,134877,141716
36077,Otsego County,,NY,3741,63234,66975
36079,Putnam County,,NY,7825,109688,117513
36081,Queens County,,NY,145355,2207110,2352465
36083,Rensselaer County,,NY,10853,172884,183737
36085,Richmond County,,NY,21869,476684,498553
36087,Rockland County,,NY,16947,329743,346690
36089,St. Lawrence County,,NY,5283,113111,118394
36091,Saratoga County,,NY,16303,237001,253304
36093,Schenectady County,,NY,9982,158472,168454
36095,Schoharie County,,NY,1699,29778,31477
36097,Schuyler County,,NY,1394,21478,22872
36099,Seneca County,,NY,2461,36527,38988
36101,Steuben County,,NY,5662,109757,115419
36103,Suffolk County,,NY,59919,1695927,1755846
36105,Sullivan County,,NY,4551,74590,79141
36107,Tioga County,,NY,3929,59005,62934
36109,Tompkins County,,NY,8373,84456,92829
36111,Ulster County,,NY,8904,179280,188184
36113,Warren County,,NY,4806,72956,77762
36115,Washington County,,NY,3560,61390,64950
36117,Wayne County,,NY,5701,109480,115181
36119,Westchester County,,NY,54895,1016842,1071737
36121,Wyoming County,,NY,2577,42598,45175
36123,Yates County,,NY,1399,23488,24887
37001,Alamance County,,NC,7861,162500,170361
37003,Alexander County,,NC,2476,39258,41734
37005,Alleghany County,,NC,620,11750,12370
37007,Anson County,,NC,1338,27762,29100
37009,Ashe County,,NC,989,26200,27189
37011,Avery County,,NC,1318,18143,19461
37013,Beaufort County,,NC,2922,54570,57492
37015,Bertie County,,NC,1202,23072,24274
37017,Bladen County,,NC,2873,44562,47435
37019,Brunswick County,,NC,4936,74882,79818
37021,Buncombe County,,NC,14723,235468,250191
37023,Burke County,,NC,5805,104944,110749
37025,Cabarrus County,,NC,13315,180736,194051
37027,Caldwell County,,NC,4553,92288,96841
37029,Camden County,,NC,799,9610,10409
37031,Carteret County,,NC,4588,65322,69910
37033,Caswell County,,NC,2111,30818,32929
37035,Catawba County,,NC,11624,187051,198675
37037,Chatham County,,NC,6543,82201,88744
37039,Cherokee County,,NC,1367,24369,25736
37041,Chowan County,,NC,922,15627,16549
37043,Clay County,,NC,570,8517,9087
37045,Cleveland County,,NC,6493,122532,129025
37047,Columbus County,,NC,2399,53466,55865
37049,Craven County,,NC,12326,100866,113192
37051,Cumberland County,,NC,50387,313029,363416
37053,Currituck County,,NC,1508,18124,19632
37055,Dare County,,NC,2527,32729,35256
37057,Davidson County,,NC,11597,203550,215147
37059,Davie County,,NC,2284,38739,41023
37061,Duplin County,,NC,3189,52171,55360
37063,Durham County,,NC,22702,235407,258109
37065,Edgecombe County,,NC,5278,66492,71770
37067,Forsyth County,,NC,21292,324453,345745
37069,Franklin County,,NC,4329,60273,64602
37071,Gaston County,,NC,13363,222282,235645
37073,Gates County,,NC,600,10367,10967
37075,Graham County,,NC,399,8235,8634
37077,Granville County,,NC,3417,50404,53821
37079,Greene County,,NC,1885,24257,26142
37081,Guilford County,,NC,32172,455145,487317
37083,Halifax County,,NC,3350,61195,64545
37085,Harnett County,,NC,9426,106911,116337
37087,Haywood County,,NC,2814,59090,61904
37089,Henderson County,,NC,5494,88851,94345
37091,Hertford County,,NC,1915,22857,24772
37093,Hoke County,,NC,4846,36067,40913
37095,Hyde County,,NC,361,5104,5465
37097,Iredell County,,NC,8417,141124,149541
37099,Jackson County,,NC,2409,28808,31217
37101,Johnston County,,NC,8832,135255,144087
37103,Jones County,,NC,852,12037,12889
37105,Lee County,,NC,3798,47862,51660
37107,Lenoir County,,NC,3946,64142,68088
37109,Lincoln County,,NC,2861,36386,39247
37111,McDowell County,,NC,2085,40494,42579
37113,Macon County,,NC,1795,31568,33363
37115,Madison County,,NC,1316,19695,21011
37117,Martin County,,NC,1559,26408,27967
37119,Mecklenburg County,,NC,60315,741449,801764
37121,Mitchell County,,NC,759,16688,17447
37123,Montgomery County,,NC,1774,30203,31977
37125,Moore County,,NC,4662,79253,83915
37127,Nash County,,NC,8226,99599,107825
37129,New Hanover County,,NC,14081,164083,178164
37131,Northampton County,,NC,1451,22423,23874
37133,Onslow County,,NC,33380,145960,179340
37135,Orange County,,NC,11714,79946,91660
37137,Pamlico County,,NC,874,12999,13873
37139,Pasquotank County,,NC,2932,33309,36241
37141,Pender County,,NC,3028,37094,40122
37143,Perquimans County,,NC,810,11706,12516
37145,Person County,,NC,2020,37165,39185
37147,Pitt County,,NC,9827,124969,134796
37149,Polk County,,NC,1525,22964,24489
37151,Randolph County,,NC,7796,127469,135265
37153,Richmond County,,NC,2543,50215,52758
37155,Robeson County,,NC,5168,116899,122067
37157,Rockingham County,,NC,4469,91855,96324
37159,Rowan County,,NC,7070,122136,129206
37161,Rutherford County,,NC,2854,59924,62778
37163,Sampson County,,NC,2676,50479,53155
37165,Scotland County,,NC,2440,39190,41630
37167,Stanly County,,NC,3071,61191,64262
37169,Stokes County,,NC,4352,59818,64170
37171,Surry County,,NC,4341,64668,69009
37173,Swain County,,NC,1039,17088,18127
37175,Transylvania County,,NC,1928,31848,33776
37177,Tyrrell County,,NC,306,4060,4366
37179,Union County,,NC,7883,129474,137357
37181,Vance County,,NC,2446,45110,47556
37183,Wake County,,NC,51070,651354,702424
37185,Warren County,,NC,991,14084,15075
37187,Washington County,,NC,809,14451,15260
37189,Watauga County,,NC,3349,34534,37883
37191,Wayne County,,NC,9359,107368,116727
37193,Wilkes County,,NC,2973,73302,76275
37195,Wilson County,,NC,4432,71461,75893
37197,Yadkin County,,NC,2285,39055,41340
37199,Yancey County,,NC,917,18799,19716
38001,Adams County,,ND,190,2862,3052
38003,Barnes County,,ND,856,13406,14262
38005,Benson County,,ND,515,7822,8337
38007,Billings County,,ND,0,0,0
38009,Bottineau County,,ND,521,8396,8917
38011,Bowman County,,ND,288,4034,4322
38013,Burke County,,ND,169,3066,3235
38015,Burleigh County,,ND,5455,81641,87096
38017,Cass County,,ND,11003,141060,152063
38019,Cavalier County,,ND,383,6168,6551
38021,Dickey County,,ND,511,6536,7047
38023,Divide County,,ND,157,2705,2862
38025,Dunn County,,ND,237,3896,4133
38027,Eddy County,,ND,227,2978,3205
38029,Emmons County,,ND,250,4872,5122
38031,Foster County,,ND,308,4366,4674
38033,Golden Valley County,,ND,164,2174,2338
38035,Grand Forks County,,ND,7917,69529,77446
38037,Grant County,,ND,185,3386,3571
38039,Griggs County,,ND,207,3308,3515
38041,Hettinger County,,ND,178,3368,3546
38043,Kidder County,,ND,206,3199,3405
38045,LaMoure County,,ND,287,5608,5895
38047,Logan County,,ND,142,2718,2860
38049,McHenry County,,ND,520,6908,7428
38051,McIntosh County,,ND,180,4039,4219
38053,McKenzie County,,ND,359,5295,5654
38055,McLean County,,ND,761,11287,12048
38057,Mercer County,,ND,634,10692,11326
38059,Morton County,,ND,2433,29466,31899
38061,Mountrail County,,ND,474,7991,8465
38063,Nelson County,,ND,282,4302,4584
38065,Oliver County,,ND,193,2770,2963
38067,Pembina County,,ND,670,10686,11356
38069,Pierce County,,ND,343,5488,5831
38071,Ramsey County,,ND,1061,13772,14833
38073,Ransom County,,ND,424,6579,7003
38075,Renville County,,ND,228,3201,3429
38077,Richland County,,ND,1671,20157,21828
38079,Rolette County,,ND,685,14465,15150
38081,Sargent County,,ND,302,5441,5743
38083,Sheridan County,,ND,170,2049,2219
38085,Sioux County,,ND,311,3425,3736
38087,Slope County,,ND,0,0,0
38089,Stark County,,ND,1731,26462,28193
38091,Steele County,,ND,197,3092,3289
38093,Stutsman County,,ND,1568,24804,26372
38095,Towner County,,ND,238,3477,3715
38097,Traill County,,ND,601,9260,9861
38099,Walsh County,,ND,945,14752,15697
38101,Ward County,,ND,7358,66586,73944
38103,Wells County,,ND,416,6079,6495
38105,Williams County,,ND,1336,23164,24500
39001,Adams County,,OH,1950,36674,38624
39003,Allen County,,OH,6248,132937,139185
39005,Ashland County,,OH,3569,66010,69579
39007,Ashtabula County,,OH,5587,123924,129511
39009,Athens County,,OH,4603,58451,63054
39011,Auglaize County,,OH,3117,58284,61401
39013,Belmont County,,OH,3545,84508,88053
39015,Brown County,,OH,3531,47709,51240
39017,Butler County,,OH,26421,390541,416962
39019,Carroll County,,OH,2402,39149,41551
39021,Champaign County,,OH,3785,56702,60487
39023,Clark County,,OH,8541,164319,172860
39025,Clermont County,,OH,18455,253740,272195
39027,Clinton County,,OH,3858,55817,59675
39029,Columbiana County,,OH,5876,130954,136830
39031,Coshocton County,,OH,2375,50568,52943
39033,Crawford County,,OH,3623,66892,70515
39035,Cuyahoga County,,OH,66580,1587201,1653781
39037,Darke County,,OH,3212,68029,71241
39039,Defiance County,,OH,3042,52389,55431
39041,Delaware County,,OH,17012,190427,207439
39043,Erie County,,OH,5446,100812,106258
39045,Fairfield County,,OH,11999,168914,180913
39047,Fayette County,,OH,2293,33607,35900
39049,Franklin County,,OH,79889,1175184,1255073
39051,Fulton County,,OH,3095,53880,56975
39053,Gallia County,,OH,1949,36061,38010
39055,Geauga County,,OH,6425,111378,117803
39057,Greene County,,OH,16230,167427,183657
39059,Guernsey County,,OH,2372,49771,52143
39061,Hamilton County,,OH,53442,939428,992870
39063,Hancock County,,OH,4957,88235,93192
39065,Hardin County,,OH,2422,35827,38249
39067,Harrison County,,OH,1219,18695,19914
39069,Henry County,,OH,2053,36294,38347
39071,Highland County,,OH,2903,41266,44169
39073,Hocking County,,OH,2113,31457,33570
39075,Holmes County,,OH,1624,41102,42726
39077,Huron County,,OH,4796,79896,84692
39079,Jackson County,,OH,2050,37251,39301
39081,Jefferson County,,OH,3497,78765,82262
39083,Knox County,,OH,3503,65689,69192
39085,Lake County,,OH,13057,281785,294842
39087,Lawrence County,,OH,3443,66363,69806
39089,Licking County,,OH,9260,165345,174605
39091,Logan County,,OH,3261,51669,54930
39093,Lorain County,,OH,15127,338885,354012
39095,Lucas County,,OH,24856,521088,545944
39097,Madison County,,OH,3427,40691,44118
39099,Mahoning County,,OH,12765,293695,306460
39101,Marion County,,OH,3820,77083,80903
39103,Medina County,,OH,11043,188061,199104
39105,Meigs County,,OH,1098,22046,23144
39107,Mercer County,,OH,2377,50558,52935
39109,Miami County,,OH,7077,120258,127335
39111,Monroe County,,OH,845,16968,17813
39113,Montgomery County,,OH,38032,647761,685793
39115,Morgan County,,OH,1078,20327,21405
39117,Morrow County,,OH,2230,28732,30962
39119,Muskingum County,,OH,4286,95728,100014
39121,Noble County,,OH,585,10186,10771
39123,Ottawa County,,OH,2833,50553,53386
39125,Paulding County,,OH,1279,23295,24574
39127,Perry County,,OH,1825,29483,31308
39129,Pickaway County,,OH,4065,51584,55649
39131,Pike County,,OH,2550,38673,41223
39133,Portage County,,OH,11883,168585,180468
39135,Preble County,,OH,2780,48562,51342
39137,Putnam County,,OH,1696,44770,46466
39139,Richland County,,OH,6889,135779,142668
39141,Ross County,,OH,3660,72055,75715
39143,Sandusky County,,OH,3661,71648,75309
39145,Scioto County,,OH,3545,68998,72543
39147,Seneca County,,OH,3360,67851,71211
39149,Shelby County,,OH,2887,56899,59786
39151,Stark County,,OH,17878,456249,474127
39153,Summit County,,OH,31071,630961,662032
39155,Trumbull County,,OH,10709,264347,275056
39157,Tuscarawas County,,OH,4557,107147,111704
39159,Union County,,OH,2731,38041,40772
39161,Van Wert County,,OH,1593,35510,37103
39163,Vinton County,,OH,741,10693,11434
39165,Warren County,,OH,13760,169385,183145
39167,Washington County,,OH,3707,67638,71345
39169,Wayne County,,OH,6787,133962,140749
39171,Williams County,,OH,2367,47256,49623
39173,Wood County,,OH,10509,130464,140973
39175,Wyandot County,,OH,1453,24483,25936
40001,Adair County,,OK,1580,22116,23696
40003,Alfalfa County,,OK,471,5558,6029
40005,Atoka County,,OK,851,12169,13020
40007,Beaver County,,OK,606,5467,6073
40009,Beckham County,,OK,1481,18771,20252
40011,Blaine County,,OK,1025,11898,12923
40013,Bryan County,,OK,2734,32262,34996
40015,Caddo County,,OK,2559,31567,34126
40017,Canadian County,,OK,8053,93706,101759
40019,Carter County,,OK,3196,46386,49582
40021,Cherokee County,,OK,3142,36729,39871
40023,Choctaw County,,OK,1084,13743,14827
40025,Cimarron County,,OK,301,3477,3778
40027,Cleveland County,,OK,21546,213051,234597
40029,Coal County,,OK,390,5017,5407
40031,Comanche County,,OK,16262,108020,124282
40033,Cotton County,,OK,594,6262,6856
40035,Craig County,,OK,1358,16455,17813
40037,Creek County,,OK,6593,73651,80244
40039,Custer County,,OK,2629,25035,27664
40041,Delaware County,,OK,2598,31877,34475
40043,Dewey County,,OK,428,5402,5830
40045,Ellis County,,OK,357,4088,4445
40047,Garfield County,,OK,5353,62545,67898
40049,Garvin County,,OK,2493,30327,32820
40051,Grady County,,OK,4045,46970,51015
40053,Grant County,,OK,476,5317,5793
40055,Greer County,,OK,521,5134,5655
40057,Harmon County,,OK,322,3034,3356
40059,Harper County,,OK,425,4502,4927
40061,Haskell County,,OK,771,11678,12449
40063,Hughes County,,OK,1153,12037,13190
40065,Jackson County,,OK,3950,28755,32705
40067,Jefferson County,,OK,626,6326,6952
40069,Johnston County,,OK,951,9655,10606
40071,Kay County,,OK,3691,52228,55919
40073,Kingfisher County,,OK,1037,15523,16560
40075,Kiowa County,,OK,813,10068,10881
40077,Latimer County,,OK,1052,11563,12615
40079,Le Flore County,,OK,3169,44350,47519
40081,Lincoln County,,OK,3495,38687,42182
40083,Logan County,,OK,4099,42825,46924
40085,Love County,,OK,660,8567,9227
40087,McClain County,,OK,2544,22485,25029
40089,McCurtain County,,OK,2027,32333,34360
40091,McIntosh County,,OK,1419,18221,19640
40093,Major County,,OK,551,8296,8847
40095,Marshall County,,OK,1006,12067,13073
40097,Mayes County,,OK,2857,40124,42981
40099,Murray County,,OK,912,10863,11775
40101,Muskogee County,,OK,4406,69501,73907
40103,Noble County,,OK,966,11849,12815
40105,Nowata County,,OK,806,10800,11606
40107,Okfuskee County,,OK,772,10943,11715
40109,Oklahoma County,,OK,51556,657170,708726
40111,Okmulgee County,,OK,2818,34971,37789
40113,Osage County,,OK,5251,51261,56512
40115,Ottawa County,,OK,2364,31956,34320
40117,Pawnee County,,OK,1595,16554,18149
40119,Payne County,,OK,6831,57675,64506
40121,Pittsburg County,,OK,2815,41735,44550
40123,Pontotoc County,,OK,2869,33097,35966
40125,Pottawatomie County,,OK,4898,61343,66241
40127,Pushmataha County,,OK,689,9912,10601
40129,Roger Mills County,,OK,303,3515,3818
40131,Rogers County,,OK,6566,86422,92988
40133,Seminole County,,OK,2009,22957,24966
40135,Sequoyah County,,OK,2607,37794,40401
40137,Stephens County,,OK,2983,43823,46806
40139,Texas County,,OK,2508,19092,21600
40141,Tillman County,,OK,629,8394,9023
40143,Tulsa County,,OK,44718,568794,613512
40145,Wagoner County,,OK,5681,55217,60898
40147,Washington County,,OK,4040,52058,56098
40149,Washita County,,OK,1026,10949,11975
40151,Woods County,,OK,804,8611,9415
40153,Woodward County,,OK,1496,19534,21030
41001,Baker County,,OR,1450,16476,17926
41003,Benton County,,OR,8591,83692,92283
41005,Clackamas County,,OR,35159,393074,428233
41007,Clatsop County,,OR,3104,34114,37218
41009,Columbia County,,OR,3318,48012,51330
41011,Coos County,,OR,4166,60211,64377
41013,Crook County,,OR,1439,19247,20686
41015,Curry County,,OR,1911,21749,23660
41017,Deschutes County,,OR,9605,125368,134973
41019,Douglas County,,OR,6400,105545,111945
41021,Gilliam County,,OR,175,2095,2270
41023,Grant County,,OR,870,7959,8829
41025,Harney County,,OR,779,7770,8549
41027,Hood River County,,OR,1846,22544,24390
41029,Jackson County,,OR,11019,190660,201679
41031,Jefferson County,,OR,1249,17209,18458
41033,Josephine County,,OR,4702,75167,79869
41035,Klamath County,,OR,4743,64155,68898
41037,Lake County,,OR,652,7378,8030
41039,Lane County,,OR,21136,331304,352440
41041,Lincoln County,,OR,4290,43196,47486
41043,Linn County,,OR,7534,105790,113324
41045,Malheur County,,OR,2569,28024,30593
41047,Marion County,,OR,20487,287328,307815
41049,Morrow County,,OR,1139,10458,11597
41051,Multnomah County,,OR,60218,685353,745571
41053,Polk County,,OR,6616,63741,70357
41055,Sherman County,,OR,197,1774,1971
41057,Tillamook County,,OR,1778,25059,26837
41059,Umatilla County,,OR,5674,71810,77484
41061,Union County,,OR,2286,26022,28308
41063,Wallowa County,,OR,646,7703,8349
41065,Wasco County,,OR,2109,24489,26598
41067,Washington County,,OR,42412,452197,494609
41069,Wheeler County,,OR,160,1388,1548
41071,Yamhill County,,OR,6382,81436,87818
42001,Adams County,,PA,6104,128787,134891
42003,Allegheny County,,PA,56444,1506305,1562749
42005,Armstrong County,,PA,3836,93563,97399
42007,Beaver County,,PA,8242,212458,220700
42009,Bedford County,,PA,2243,62996,65239
42011,Berks County,,PA,16158,463614,479772
42013,Blair County,,PA,4934,150422,155356
42015,Bradford County,,PA,3206,73559,76765
42017,Bucks County,,PA,39702,776787,816489
42019,Butler County,,PA,9415,211695,221110
42021,Cambria County,,PA,6217,176212,182429
42023,Cameron County,,PA,290,7137,7427
42025,Carbon County,,PA,3303,72932,76235
42027,Centre County,,PA,9423,129866,139289
42029,Chester County,,PA,30641,528084,558725
42031,Clarion County,,PA,2092,45470,47562
42033,Clearfield County,,PA,3905,92163,96068
42035,Clinton County,,PA,1957,40856,42813
42037,Columbia County,,PA,3390,77286,80676
42039,Crawford County,,PA,4443,105043,109486
42041,Cumberland County,,PA,16050,263564,279614
42043,Dauphin County,,PA,17649,320499,338148
42045,Delaware County,,PA,33113,635530,668643
42047,Elk County,,PA,1297,44196,45493
42049,Erie County,,PA,10849,322461,333310
42051,Fayette County,,PA,5867,171865,177732
42053,Forest County,,PA,373,5701,6074
42055,Franklin County,,PA,6097,159522,165619
42057,Fulton County,,PA,716,17354,18070
42059,Greene County,,PA,1930,42247,44177
42061,Huntingdon County,,PA,1973,48600,50573
42063,Indiana County,,PA,4505,97776,102281
42065,Jefferson County,,PA,2398,53797,56195
42067,Juniata County,,PA,1133,28338,29471
42069,Lackawanna County,,PA,8047,243912,251959
42071,Lancaster County,,PA,18891,579777,598668
42073,Lawrence County,,PA,3841,109402,113243
42075,Lebanon County,,PA,5731,144470,150201
42077,Lehigh County,,PA,19655,370412,390067
42079,Luzerne County,,PA,11153,361291,372444
42081,Lycoming County,,PA,5668,138897,144565
42083,McKean County,,PA,2105,51051,53156
42085,Mercer County,,PA,5332,134993,140325
42087,Mifflin County,,PA,1713,54514,56227
42089,Monroe County,,PA,9335,151656,160991
42091,Montgomery County,,PA,51646,855921,907567
42093,Montour County,,PA,1222,17683,18905
42095,Northampton County,,PA,15714,312487,328201
42097,Northumberland County,,PA,4459,105183,109642
42099,Perry County,,PA,2639,54344,56983
42101,Philadelphia County,,PA,78943,1458202,1537145
42103,Pike County,,PA,3454,50273,53727
42105,Potter County,,PA,1367,20324,21691
42107,Schuylkill County,,PA,5362,170484,175846
42109,Snyder County,,PA,1966,40183,42149
42111,Somerset County,,PA,2990,88748,91738
42113,Sullivan County,,PA,434,6314,6748
42115,Susquehanna County,,PA,2375,51056,53431
42117,Tioga County,,PA,2078,47215,49293
42119,Union County,,PA,2535,41462,43997
42121,Venango County,,PA,2773,64609,67382
42123,Warren County,,PA,2063,50340,52403
42125,Washington County,,PA,9136,229064,238200
42127,Wayne County,,PA,2865,51361,54226
42129,Westmoreland County,,PA,15272,419409,434681
42131,Wyoming County,,PA,1889,30138,32027
42133,York County,,PA,17078,455507,472585
44001,Bristol County,,RI,3177,55894,59071
44003,Kent County,,RI,11305,196630,207935
44005,Newport County,,RI,9694,93553,103247
44007,Providence County,,RI,28366,649194,677560
44009,Washington County,,RI,8181,138688,146869
45001,Abbeville County,,SC,1644,28818,30462
45003,Aiken County,,SC,8667,168428,177095
45005,Allendale County,,SC,664,11023,11687
45007,Anderson County,,SC,9940,202445,212385
45009,Bamberg County,,SC,1056,16589,17645
45011,Barnwell County,,SC,1221,22810,24031
45013,Beaufort County,,SC,13876,130922,144798
45015,Berkeley County,,SC,19920,153831,173751
45017,Calhoun County,,SC,957,15860,16817
45019,Charleston County,,SC,29828,319237,349065
45021,Cherokee County,,SC,2751,61101,63852
45023,Chester County,,SC,2184,40702,42886
45025,Chesterfield County,,SC,2458,48063,50521
45027,Clarendon County,,SC,2136,35918,38054
45029,Colleton County,,SC,2140,40921,43061
45031,Darlington County,,SC,4043,78365,82408
45033,Dillon County,,SC,1501,35072,36573
45035,Dorchester County,,SC,9376,89069,98445
45037,Edgefield County,,SC,1333,17730,19063
45039,Fairfield County,,SC,1516,26555,28071
45041,Florence County,,SC,8033,133780,141813
45043,Georgetown County,,SC,4076,66126,70202
45045,Greenville County,,SC,27401,422914,450315
45047,Greenwood County,,SC,3830,72930,76760
45049,Hampton County,,SC,1100,22124,23224
45051,Horry County,,SC,14958,208142,223100
45053,Jasper County,,SC,762,9130,9892
45055,Kershaw County,,SC,3511,63395,66906
45057,Lancaster County,,SC,3258,65768,69026
45059,Laurens County,,SC,3872,72021,75893
45061,Lee County,,SC,1673,23933,25606
45063,Lexington County,,SC,18465,261742,280207
45065,McCormick County,,SC,614,9776,10390
45067,Marion County,,SC,2135,37761,39896
45069,Marlboro County,,SC,1588,32486,34074
45071,Newberry County,,SC,1823,39616,41439
45073,Oconee County,,SC,3569,75570,79139
45075,Orangeburg County,,SC,5093,94538,99631
45077,Pickens County,,SC,7905,104124,112029
45079,Richland County,,SC,29621,311524,341145
45081,Saluda County,,SC,819,15373,16192
45083,Spartanburg County,,SC,11958,270663,282621
45085,Sumter County,,SC,9448,108102,117550
45087,Union County,,SC,1427,34042,35469
45089,Williamsburg County,,SC,2010,38229,40239
45091,York County,,SC,10422,186652,197074
46003,Aurora County,,SD,281,4002,4283
46005,Beadle County,,SD,1222,19918,21140
46007,Bennett County,,SD,246,3160,3406
46009,Bon Homme County,,SD,489,7476,7965
46011,Brookings County,,SD,2594,28253,30847
46013,Brown County,,SD,2622,41597,44219
46015,Brule County,,SD,532,5885,6417
46017,Buffalo County,,SD,162,1890,2052
46019,Butte County,,SD,1017,10242,11259
46021,Campbell County,,SD,130,2534,2664
46023,Charles Mix County,,SD,601,10173,10774
46025,Clark County,,SD,216,4680,4896
46027,Clay County,,SD,1814,12041,13855
46029,Codington County,,SD,2244,30828,33072
46031,Corson County,,SD,327,3950,4277
46033,Custer County,,SD,801,7376,8177
46035,Davison County,,SD,1742,20736,22478
46037,Day County,,SD,498,7179,7677
46039,Deuel County,,SD,368,5910,6278
46041,Dewey County,,SD,438,6517,6955
46043,Douglas County,,SD,199,4169,4368
46045,Edmunds County,,SD,255,4828,5083
46047,Fall River County,,SD,780,7472,8252
46049,Faulk County,,SD,178,2745,2923
46051,Grant County,,SD,614,9890,10504
46053,Gregory County,,SD,331,5822,6153
46055,Haakon County,,SD,206,2874,3080
46057,Hamlin County,,SD,482,6103,6585
46059,Hand County,,SD,219,4609,4828
46061,Hanson County,,SD,234,4205,4439
46063,Harding County,,SD,135,1678,1813
46065,Hughes County,,SD,1704,19381,21085
46067,Hutchinson County,,SD,536,9097,9633
46069,Hyde County,,SD,139,1899,2038
46071,Jackson County,,SD,286,2788,3074
46073,Jerauld County,,SD,150,2555,2705
46075,Jones County,,SD,127,1402,1529
46077,Kingsbury County,,SD,443,6180,6623
46079,Lake County,,SD,864,12437,13301
46081,Lawrence County,,SD,2600,23194,25794
46083,Lincoln County,,SD,2655,31022,33677
46085,Lyman County,,SD,302,4449,4751
46087,McCook County,,SD,452,6535,6987
46089,McPherson County,,SD,158,2953,3111
46091,Marshall County,,SD,346,5711,6057
46093,Meade County,,SD,4569,29701,34270
46095,Mellette County,,SD,181,2118,2299
46097,Miner County,,SD,202,2652,2854
46099,Minnehaha County,,SD,13236,177295,190531
46101,Moody County,,SD,456,7536,7992
46103,Pennington County,,SD,8254,97257,105511
46105,Perkins County,,SD,273,4133,4406
46107,Potter County,,SD,274,3185,3459
46109,Roberts County,,SD,628,10237,10865
46111,Sanborn County,,SD,259,2919,3178
46113,Shannon County,,SD,583,10537,11120
46115,Spink County,,SD,607,7722,8329
46117,Stanley County,,SD,389,3349,3738
46119,Sully County,,SD,124,1690,1814
46121,Todd County,,SD,514,7408,7922
46123,Tripp County,,SD,448,7068,7516
46125,Turner County,,SD,763,9504,10267
46127,Union County,,SD,1635,14003,15638
46129,Walworth County,,SD,609,6625,7234
46135,Yankton County,,SD,1844,24014,25858
46137,Ziebach County,,SD,98,1182,1280
47001,Anderson County,,TN,5848,87648,93496
47003,Bedford County,,TN,2409,42908,45317
47005,Benton County,,TN,1061,18187,19248
47007,Bledsoe County,,TN,680,10424,11104
47009,Blount County,,TN,6589,123962,130551
47011,Bradley County,,TN,6126,96107,102233
47013,Campbell County,,TN,1938,38739,40677
47015,Cannon County,,TN,1237,16932,18169
47017,Carroll County,,TN,2842,41282,44124
47019,Carter County,,TN,3545,58955,62500
47021,Cheatham County,,TN,3578,45037,48615
47023,Chester County,,TN,1371,18084,19455
47025,Claiborne County,,TN,1614,32418,34032
47027,Clay County,,TN,495,8699,9194
47029,Cocke County,,TN,1779,37543,39322
47031,Coffee County,,TN,3622,53596,57218
47033,Crockett County,,TN,1327,18027,19354
47035,Cumberland County,,TN,2676,56101,58777
47037,Davidson County,,TN,56162,620190,676352
47039,Decatur County,,TN,723,12807,13530
47041,DeKalb County,,TN,1195,21361,22556
47043,Dickson County,,TN,3288,47198,50486
47045,Dyer County,,TN,2597,41754,44351
47047,Fayette County,,TN,3724,48631,52355
47049,Fentress County,,TN,784,17816,18600
47051,Franklin County,,TN,2330,41314,43644
47053,Gibson County,,TN,3161,56909,60070
47055,Giles County,,TN,2012,36482,38494
47057,Grainger County,,TN,1341,20596,21937
47059,Greene County,,TN,3024,73267,76291
47061,Grundy County,,TN,731,15097,15828
47063,Hamblen County,,TN,4272,64959,69231
47065,Hamilton County,,TN,20141,354949,375090
47067,Hancock County,,TN,243,5774,6017
47069,Hardeman County,,TN,1580,27106,28686
47071,Hardin County,,TN,1447,28180,29627
47073,Hawkins County,,TN,3345,56386,59731
47075,Haywood County,,TN,1224,22672,23896
47077,Henderson County,,TN,1710,26323,28033
47079,Henry County,,TN,2029,33666,35695
47081,Hickman County,,TN,1559,21196,22755
47083,Houston County,,TN,629,9068,9697
47085,Humphreys County,,TN,1063,19060,20123
47087,Jackson County,,TN,962,14839,15801
47089,Jefferson County,,TN,4988,52039,57027
47091,Johnson County,,TN,746,15836,16582
47093,Knox County,,TN,26286,407101,433387
47095,Lake County,,TN,444,6152,6596
47097,Lauderdale County,,TN,1555,26197,27752
47099,Lawrence County,,TN,2037,43774,45811
47101,Lewis County,,TN,727,11120,11847
47103,Lincoln County,,TN,1560,33672,35232
47105,Loudon County,,TN,3133,45133,48266
47107,McMinn County,,TN,2825,54698,57523
47109,McNairy County,,TN,1658,25142,26800
47111,Macon County,,TN,1103,22274,23377
47113,Madison County,,TN,6594,90691,97285
47115,Marion County,,TN,1619,29588,31207
47117,Marshall County,,TN,1891,31342,33233
47119,Maury County,,TN,5205,81440,86645
47121,Meigs County,,TN,787,9274,10061
47123,Monroe County,,TN,2237,40284,42521
47125,Montgomery County,,TN,19937,136590,156527
47127,Moore County,,TN,367,5337,5704
47129,Morgan County,,TN,1395,25033,26428
47131,Obion County,,TN,2285,35708,37993
47133,Overton County,,TN,1289,23898,25187
47135,Perry County,,TN,562,7814,8376
47137,Pickett County,,TN,192,4326,4518
47139,Polk County,,TN,1318,17515,18833
47141,Putnam County,,TN,4557,59767,64324
47143,Rhea County,,TN,1917,30732,32649
47145,Roane County,,TN,2799,45828,48627
47147,Robertson County,,TN,4903,69008,73911
47149,Rutherford County,,TN,15100,198756,213856
47151,Scott County,,TN,692,20491,21183
47153,Sequatchie County,,TN,642,10358,11000
47155,Sevier County,,TN,5578,67566,73144
47157,Shelby County,,TN,54605,1017737,1072342
47159,Smith County,,TN,1376,18647,20023
47161,Stewart County,,TN,970,12312,13282
47163,Sullivan County,,TN,10184,173497,183681
47165,Sumner County,,TN,10059,133153,143212
47167,Tipton County,,TN,3601,50345,53946
47169,Trousdale County,,TN,513,7013,7526
47171,Unicoi County,,TN,1166,19235,20401
47173,Union County,,TN,1147,17916,19063
47175,Van Buren County,,TN,319,5001,5320
47177,Warren County,,TN,1874,38544,40418
47179,Washington County,,TN,8244,109029,117273
47181,Wayne County,,TN,657,14813,15470
47183,Weakley County,,TN,2343,33173,35516
47185,White County,,TN,983,20068,21051
47187,Williamson County,,TN,12103,131237,143340
47189,Wilson County,,TN,7765,100470,108235
48001,Anderson County,,TX,3388,43175,46563
48003,Andrews County,,TX,1198,14091,15289
48005,Angelina County,,TX,5588,84032,89620
48007,Aransas County,,TX,2417,20667,23084
48009,Archer County,,TX,1268,10763,12031
48011,Armstrong County,,TX,257,2131,2388
48013,Atascosa County,,TX,3536,44341,47877
48015,Austin County,,TX,1947,27375,29322
48017,Bailey County,,TX,647,7301,7948
48019,Bandera County,,TX,1654,17826,19480
48021,Bastrop County,,TX,5014,59691,64705
48023,Baylor County,,TX,397,3845,4242
48025,Bee County,,TX,2148,24502,26650
48027,Bell County,,TX,47629,253254,300883
48029,Bexar County,,TX,88149,1533665,1621814
48031,Blanco County,,TX,1249,11686,12935
48033,Borden County,,TX,104,693,797
48035,Bosque County,,TX,1623,17539,19162
48037,Bowie County,,TX,6830,92127,98957
48039,Brazoria County,,TX,18093,255589,273682
48041,Brazos County,,TX,15523,121854,137377
48043,Brewster County,,TX,1135,8367,9502
48045,Briscoe County,,TX,198,1853,2051
48047,Brooks County,,TX,622,7675,8297
48049,Brown County,,TX,2699,36351,39050
48051,Burleson County,,TX,1327,18158,19485
48053,Burnet County,,TX,3322,35533,38855
48055,Caldwell County,,TX,3288,33168,36456
48057,Calhoun County,,TX,1808,22074,23882
48059,Callahan County,,TX,1342,13104,14446
48061,Cameron County,,TX,17621,338019,355640
48063,Camp County,,TX,1477,15064,16541
48065,Carson County,,TX,822,7414,8236
48067,Cass County,,TX,2566,35558,38124
48069,Castro County,,TX,881,8249,9130
48071,Chambers County,,TX,4539,47757,52296
48073,Cherokee County,,TX,3128,46928,50056
48075,Childress County,,TX,537,6281,6818
48077,Clay County,,TX,1299,11100,12399
48079,Cochran County,,TX,349,3789,4138
48081,Coke County,,TX,372,3687,4059
48083,Coleman County,,TX,795,9202,9997
48085,Collin County,,TX,56576,540955,597531
48087,Collingsworth County,,TX,319,3225,3544
48089,Colorado County,,TX,1527,21096,22623
48091,Comal County,,TX,7367,86331,93698
48093,Comanche County,,TX,1271,14993,16264
48095,Concho County,,TX,332,2743,3075
48097,Cooke County,,TX,2970,39338,42308
48099,Coryell County,,TX,14944,54993,69937
48101,Cottle County,,TX,213,1904,2117
48103,Crane County,,TX,386,4390,4776
48105,Crockett County,,TX,414,3951,4365
48107,Crosby County,,TX,855,7916,8771
48109,Culberson County,,TX,367,3015,3382
48111,Dallam County,,TX,876,7778,8654
48113,Dallas County,,TX,182501,2271027,2453528
48115,Dawson County,,TX,1204,13820,15024
48117,Deaf Smith County,,TX,1760,19780,21540
48119,Delta County,,TX,475,5009,5484
48121,Denton County,,TX,48615,428331,476946
48123,DeWitt County,,TX,1241,21040,22281
48125,Dickens County,,TX,213,2124,2337
48127,Dimmit County,,TX,880,9921,10801
48129,Donley County,,TX,328,3400,3728
48131,Duval County,,TX,943,15209,16152
48133,Eastland County,,TX,1612,17368,18980
48135,Ector County,,TX,8772,130827,139599
48137,Edwards County,,TX,315,4156,4471
48139,Ellis County,,TX,9777,120766,130543
48141,El Paso County,,TX,44570,771586,816156
48143,Erath County,,TX,3308,30578,33886
48145,Falls County,,TX,1421,15872,17293
48147,Fannin County,,TX,2355,28246,30601
48149,Fayette County,,TX,1363,24229,25592
48151,Fisher County,,TX,414,4160,4574
48153,Floyd County,,TX,784,8150,8934
48155,Foard County,,TX,127,1642,1769
48157,Fort Bend County,,TX,32902,394242,427144
48159,Franklin County,,TX,1044,11604,12648
48161,Freestone County,,TX,1387,17522,18909
48163,Frio County,,TX,1016,14305,15321
48165,Gaines County,,TX,1281,14805,16086
48167,Galveston County,,TX,21288,272742,294030
48169,Garza County,,TX,290,3696,3986
48171,Gillespie County,,TX,1496,23283,24779
48173,Glasscock County,,TX,282,2497,2779
48175,Goliad County,,TX,831,9602,10433
48177,Gonzales County,,TX,1217,19145,20362
48179,Gray County,,TX,1862,22586,24448
48181,Grayson County,,TX,7529,113470,120999
48183,Gregg County,,TX,10635,134546,145181
48185,Grimes County,,TX,1810,21068,22878
48187,Guadalupe County,,TX,7671,89255,96926
48189,Hale County,,TX,3694,37554,41248
48191,Hall County,,TX,302,3507,3809
48193,Hamilton County,,TX,689,6658,7347
48195,Hansford County,,TX,549,5913,6462
48197,Hardeman County,,TX,455,4701,5156
48199,Hardin County,,TX,4101,52085,56186
48201,Harris County,,TX,195417,3532942,3728359
48203,Harrison County,,TX,4414,55979,60393
48205,Hartley County,,TX,318,3002,3320
48207,Haskell County,,TX,508,6204,6712
48209,Hays County,,TX,10493,88634,99127
48211,Hemphill County,,TX,424,3465,3889
48213,Henderson County,,TX,6300,74238,80538
48215,Hidalgo County,,TX,26609,567169,593778
48217,Hill County,,TX,2934,32008,34942
48219,Hockley County,,TX,2096,23504,25600
48221,Hood County,,TX,3699,42221,45920
48223,Hopkins County,,TX,2516,32718,35234
48225,Houston County,,TX,1496,20596,22092
48227,Howard County,,TX,2410,30362,32772
48229,Hudspeth County,,TX,395,3490,3885
48231,Hunt County,,TX,7830,78799,86629
48233,Hutchinson County,,TX,2402,25901,28303
48235,Irion County,,TX,225,1786,2011
48237,Jack County,,TX,706,7314,8020
48239,Jackson County,,TX,1133,15339,16472
48241,Jasper County,,TX,2759,37660,40419
48243,Jeff Davis County,,TX,288,2018,2306
48245,Jefferson County,,TX,16349,257450,273799
48247,Jim Hogg County,,TX,412,5323,5735
48249,Jim Wells County,,TX,2629,38443,41072
48251,Johnson County,,TX,11099,137634,148733
48253,Jones County,,TX,1690,15846,17536
48255,Karnes County,,TX,861,13296,14157
48257,Kaufman County,,TX,5996,74510,80506
48259,Kendall County,,TX,2081,24381,26462
48261,Kenedy County,,TX,0,0,0
48263,Kent County,,TX,84,1032,1116
48265,Kerr County,,TX,3317,44866,48183
48267,Kimble County,,TX,334,4402,4736
48269,King County,,TX,0,0,0
48271,Kinney County,,TX,252,3179,3431
48273,Kleberg County,,TX,3618,29288,32906
48275,Knox County,,TX,468,4085,4553
48277,Lamar County,,TX,3317,51252,54569
48279,Lamb County,,TX,1282,14614,15896
48281,Lampasas County,,TX,1645,15209,16854
48283,La Salle County,,TX,372,5616,5988
48285,Lavaca County,,TX,1294,19944,21238
48287,Lee County,,TX,1029,15823,16852
48289,Leon County,,TX,1426,15335,16761
48291,Liberty County,,TX,5388,62431,67819
48293,Limestone County,,TX,1633,20823,22456
48295,Lipscomb County,,TX,362,3008,3370
48297,Live Oak County,,TX,958,10592,11550
48299,Llano County,,TX,1310,13554,14864
48301,Loving County,,TX,0,0,0
48303,Lubbock County,,TX,18463,238308,256771
48305,Lynn County,,TX,642,6658,7300
48307,McCulloch County,,TX,740,8503,9243
48309,McLennan County,,TX,13730,213611,227341
48311,McMullen County,,TX,61,809,870
48313,Madison County,,TX,1062,10453,11515
48315,Marion County,,TX,672,7179,7851
48317,Martin County,,TX,463,4437,4900
48319,Mason County,,TX,230,3707,3937
48321,Matagorda County,,TX,3312,44610,47922
48323,Maverick County,,TX,3646,54826,58472
48325,Medina County,,TX,3085,36995,40080
48327,Menard County,,TX,193,2301,2494
48329,Midland County,,TX,9695,122220,131915
48331,Milam County,,TX,1612,24196,25808
48333,Mills County,,TX,360,4703,5063
48335,Mitchell County,,TX,681,6987,7668
48337,Montague County,,TX,1449,18486,19935
48339,Montgomery County,,TX,23959,291448,315407
48341,Moore County,,TX,1977,21602,23579
48343,Morris County,,TX,1124,14983,16107
48345,Motley County,,TX,189,1229,1418
48347,Nacogdoches County,,TX,4879,53452,58331
48349,Navarro County,,TX,3205,43333,46538
48351,Newton County,,TX,905,9630,10535
48353,Nolan County,,TX,1647,16450,18097
48355,Nueces County,,TX,25907,332744,358651
48357,Ochiltree County,,TX,739,9487,10226
48359,Oldham County,,TX,309,2161,2470
48361,Orange County,,TX,6045,93770,99815
48363,Palo Pinto County,,TX,2222,26562,28784
48365,Panola County,,TX,1688,23866,25554
48367,Parker County,,TX,8709,98717,107426
48369,Parmer County,,TX,1295,10307,11602
48371,Pecos County,,TX,1505,14142,15647
48373,Polk County,,TX,5051,52340,57391
48375,Potter County,,TX,13662,120810,134472
48377,Presidio County,,TX,1095,9881,10976
48379,Rains County,,TX,884,8938,9822
48381,Randall County,,TX,11251,94988,106239
48383,Reagan County,,TX,337,3713,4050
48385,Real County,,TX,313,3082,3395
48387,Red River County,,TX,1026,14017,15043
48389,Reeves County,,TX,1272,12993,14265
48391,Refugio County,,TX,674,8653,9327
48393,Roberts County,,TX,87,856,943
48395,Robertson County,,TX,1459,16679,18138
48397,Rockwall County,,TX,4300,39036,43336
48399,Runnels County,,TX,1194,12677,13871
48401,Rusk County,,TX,3369,42859,46228
48403,Sabine County,,TX,841,10156,10997
48405,San Augustine County,,TX,729,8313,9042
48407,San Jacinto County,,TX,1798,18552,20350
48409,San Patricio County,,TX,8129,64773,72902
48411,San Saba County,,TX,473,5565,6038
48413,Schleicher County,,TX,260,3114,3374
48415,Scurry County,,TX,1560,15450,17010
48417,Shackelford County,,TX,302,3621,3923
48419,Shelby County,,TX,1375,23990,25365
48421,Sherman County,,TX,285,2478,2763
48423,Smith County,,TX,12792,185226,198018
48425,Somervell County,,TX,692,6899,7591
48427,Starr County,,TX,3428,55188,58616
48429,Stephens County,,TX,956,9761,10717
48431,Sterling County,,TX,160,1265,1425
48433,Stonewall County,,TX,230,1702,1932
48435,Sutton County,,TX,410,4559,4969
48437,Swisher County,,TX,798,8059,8857
48439,Tarrant County,,TX,111315,1532516,1643831
48441,Taylor County,,TX,14343,129095,143438
48443,Terrell County,,TX,119,963,1082
48445,Terry County,,TX,1206,12183,13389
48447,Throckmorton County,,TX,230,1999,2229
48449,Titus County,,TX,2116,24550,26666
48451,Tom Green County,,TX,11471,107595,119066
48453,Travis County,,TX,83842,819040,902882
48455,Trinity County,,TX,1209,12575,13784
48457,Tyler County,,TX,1557,17652,19209
48459,Upshur County,,TX,2933,31701,34634
48461,Upton County,,TX,485,3590,4075
48463,Uvalde County,,TX,2038,27751,29789
48465,Val Verde County,,TX,4916,45611,50527
48467,Van Zandt County,,TX,3268,42489,45757
48469,Victoria County,,TX,5880,89247,95127
48471,Walker County,,TX,4687,42801,47488
48473,Waller County,,TX,2274,23198,25472
48475,Ward County,,TX,1196,11158,12354
48477,Washington County,,TX,2070,31167,33237
48479,Webb County,,TX,8042,215733,223775
48481,Wharton County,,TX,2727,45620,48347
48483,Wheeler County,,TX,504,5417,5921
48485,Wichita County,,TX,15484,126160,141644
48487,Wilbarger County,,TX,1176,14491,15667
48489,Willacy County,,TX,1545,19401,20946
48491,Williamson County,,TX,26130,232201,258331
48493,Wilson County,,TX,2541,31395,33936
48495,Winkler County,,TX,721,7328,8049
48497,Wise County,,TX,4042,47122,51164
48499,Wood County,,TX,2241,26657,28898
48501,Yoakum County,,TX,769,8028,8797
48503,Young County,,TX,1430,17226,18656
48505,Zapata County,,TX,567,11110,11677
48507,Zavala County,,TX,873,11107,11980
49001,Beaver County,,UT,548,6439,6987
49003,Box Elder County,,UT,3228,49516,52744
49005,Cache County,,UT,9552,92963,102515
49007,Carbon County,,UT,2050,21799,23849
49009,Daggett County,,UT,119,855,974
49011,Davis County,,UT,24372,272835,297207
49013,Duchesne County,,UT,1193,16016,17209
49015,Emery County,,UT,899,11923,12822
49017,Garfield County,,UT,514,4906,5420
49019,Grand County,,UT,779,8405,9184
49021,Iron County,,UT,3559,31978,35537
49023,Juab County,,UT,687,8672,9359
49025,Kane County,,UT,618,6061,6679
49027,Millard County,,UT,929,13074,14003
49029,Morgan County,,UT,646,8286,8932
49031,Piute County,,UT,166,1362,1528
49033,Rich County,,UT,182,1938,2120
49035,Salt Lake County,,UT,60637,977236,1037873
49037,San Juan County,,UT,1695,9022,10717
49039,Sanpete County,,UT,1645,21311,22956
49041,Sevier County,,UT,1395,19766,21161
49043,Summit County,,UT,3433,30527,33960
49045,Tooele County,,UT,4114,45748,49862
49047,Uintah County,,UT,1626,24870,26496
49049,Utah County,,UT,28854,368963,397817
49051,Wasatch County,,UT,1265,15488,16753
49053,Washington County,,UT,7298,86466,93764
49055,Wayne County,,UT,304,2518,2822
49057,Weber County,,UT,16108,213344,229452
50001,Addison County,,VT,2393,40544,42937
50003,Bennington County,,VT,2439,42417,44856
50005,Caledonia County,,VT,2029,33189,35218
50007,Chittenden County,,VT,11991,178346,190337
50009,Essex County,,VT,557,7287,7844
50011,Franklin County,,VT,2263,45769,48032
50013,Grand Isle County,,VT,656,7876,8532
50015,Lamoille County,,VT,1745,25746,27491
50017,Orange County,,VT,2250,33581,35831
50019,Orleans County,,VT,1384,29978,31362
50021,Rutland County,,VT,3514,73227,76741
50023,Washington County,,VT,3920,64463,68383
50025,Windham County,,VT,3490,50208,53698
50027,Windsor County,,VT,4825,67008,71833
51001,Accomack County,,VA,1997,38278,40275
51003,Albemarle County,,VA,10982,105967,116949
51005,Alleghany County,,VA,744,16151,16895
51007,Amelia County,,VA,964,14802,15766
51009,Amherst County,,VA,2027,33473,35500
51011,Appomattox County,,VA,823,16547,17370
51013,Arlington County,,VA,38848,203087,241935
51015,Augusta County,,VA,4400,94394,98794
51017,Bath County,,VA,354,6052,6406
51019,Bedford County,,VA,6161,84217,90378
51021,Bland County,,VA,380,7220,7600
51023,Botetourt County,,VA,3203,43519,46722
51025,Brunswick County,,VA,1248,18397,19645
51027,Buchanan County,,VA,1264,24701,25965
51029,Buckingham County,,VA,669,14162,14831
51031,Campbell County,,VA,5652,67343,72995
51033,Caroline County,,VA,1963,27269,29232
51035,Carroll County,,VA,1554,36421,37975
51036,Charles City County,,VA,730,9509,10239
51037,Charlotte County,,VA,801,14378,15179
51041,Chesterfield County,,VA,23258,320204,343462
51043,Clarke County,,VA,1220,13567,14787
51045,Craig County,,VA,309,5574,5883
51047,Culpeper County,,VA,2719,38362,41081
51049,Cumberland County,,VA,816,10040,10856
51051,Dickenson County,,VA,617,15013,15630
51053,Dinwiddie County,,VA,2053,25713,27766
51057,Essex County,,VA,676,11561,12237
51059,Fairfax County,,VA,115839,1119172,1235011
51061,Fauquier County,,VA,5106,62563,67669
51063,Floyd County,,VA,865,17055,17920
51065,Fluvanna County,,VA,1578,19461,21039
51067,Franklin County,,VA,2993,56339,59332
51069,Frederick County,,VA,5406,80056,85462
51071,Giles County,,VA,849,19175,20024
51073,Gloucester County,,VA,2625,40265,42890
51075,Goochland County,,VA,2091,25421,27512
51077,Grayson County,,VA,1068,20049,21117
51079,Greene County,,VA,1154,14272,15426
51081,Greensville County,,VA,819,13247,14066
51083,Halifax County,,VA,1748,41180,42928
51085,Hanover County,,VA,6413,99839,106252
51087,Henrico County,,VA,29298,315615,344913
51089,Henry County,,VA,3365,70400,73765
51091,Highland County,,VA,109,2755,2864
51093,Isle of Wight County,,VA,2393,34722,37115
51095,James City County,,VA,5327,63616,68943
51097,King and Queen County,,VA,491,6708,7199
51099,King George County,,VA,2406,18913,21319
51101,King William County,,VA,1016,15775,16791
51103,Lancaster County,,VA,711,14046,14757
51105,Lee County,,VA,980,22271,23251
51107,Loudoun County,,VA,17265,197497,214762
51109,Louisa County,,VA,1680,26191,27871
51111,Lunenburg County,,VA,701,11991,12692
51113,Madison County,,VA,894,13276,14170
51115,Mathews County,,VA,571,9672,10243
51117,Mecklenburg County,,VA,1904,33132,35036
51119,Middlesex County,,VA,658,10252,10910
51121,Montgomery County,,VA,7815,69492,77307
51125,Nelson County,,VA,1031,15699,16730
51127,New Kent County,,VA,1094,15456,16550
51131,Northampton County,,VA,736,13802,14538
51133,Northumberland County,,VA,758,12386,13144
51135,Nottoway County,,VA,1000,15341,16341
51137,Orange County,,VA,2359,30426,32785
51139,Page County,,VA,1144,28441,29585
51141,Patrick County,,VA,853,17575,18428
51143,Pittsylvania County,,VA,4161,88778,92939
51145,Powhatan County,,VA,1402,21890,23292
51147,Prince Edward County,,VA,1218,13918,15136
51149,Prince George County,,VA,5255,32826,38081
51153,Prince William County,,VA,38640,327159,365799
51155,Pulaski County,,VA,2227,38842,41069
51157,Rappahannock County,,VA,597,7843,8440
51159,Richmond County,,VA,523,8566,9089
51161,Roanoke County,,VA,10700,121151,131851
51163,Rockbridge County,,VA,1542,27766,29308
51165,Rockingham County,,VA,5018,90740,95758
51167,Russell County,,VA,1547,30615,32162
51169,Scott County,,VA,1119,22988,24107
51171,Shenandoah County,,VA,2206,40175,42381
51173,Smyth County,,VA,1613,39104,40717
51175,Southampton County,,VA,1160,19201,20361
51177,Spotsylvania County,,VA,8416,105027,113443
51179,Stafford County,,VA,11641,102423,114064
51181,Surry County,,VA,515,7031,7546
51183,Sussex County,,VA,807,10308,11115
51185,Tazewell County,,VA,2444,39997,42441
51187,Warren County,,VA,2512,36317,38829
51191,Washington County,,VA,3488,59862,63350
51193,Westmoreland County,,VA,1196,17605,18801
51195,Wise County,,VA,1918,39454,41372
51197,Wythe County,,VA,1397,28392,29789
51199,York County,,VA,8958,57710,66668
51510,Alexandria city,,VA,30284,128577,158861
51515,Bedford city,,VA,334,3685,4019
51520,Bristol city,,VA,1495,12303,13798
51530,Buena Vista city,,VA,422,4958,5380
51540,Charlottesville city,,VA,5109,23296,28405
51550,Chesapeake city,,VA,23765,216068,239833
51570,Colonial Heights city,,VA,1658,15493,17151
51580,Covington city,,VA,360,6282,6642
51590,Danville city,,VA,2625,32124,34749
51595,Emporia city,,VA,337,3904,4241
51600,Fairfax city,,VA,3118,17061,20179
51610,Falls Church city,,VA,1851,9344,11195
51620,Franklin city,,VA,706,7708,8414
51630,Fredericksburg city,,VA,3359,13160,16519
51640,Galax city,,VA,204,2032,2236
51650,Hampton city,,VA,20124,142178,162302
51660,Harrisonburg city,,VA,3206,14819,18025
51670,Hopewell city,,VA,2706,22568,25274
51678,Lexington city,,VA,288,2515,2803
51680,Lynchburg city,,VA,5467,47424,52891
51683,Manassas city,,VA,3804,23066,26870
51685,Manassas Park city,,VA,1302,7043,8345
51690,Martinsville city,,VA,1041,12173,13214
51700,Newport News city,,VA,26356,183304,209660
51710,Norfolk city,,VA,34576,211514,246090
51720,Norton city,,VA,361,3974,4335
51730,Petersburg city,,VA,3623,33528,37151
51735,Poquoson city,,VA,1295,13648,14943
51740,Portsmouth city,,VA,12129,99849,111978
51750,Radford city,,VA,1622,9552,11174
51760,Richmond city,,VA,21990,160155,182145
51770,Roanoke city,,VA,9027,77338,86365
51775,Salem city,,VA,2166,17711,19877
51790,Staunton city,,VA,1509,15093,16602
51800,Suffolk city,,VA,5597,70237,75834
51810,Virginia Beach city,,VA,55008,461345,516353
51820,Waynesboro city,,VA,1671,16743,18414
51830,Williamsburg city,,VA,928,4235,5163
51840,Winchester city,,VA,2584,16557,19141
53001,Adams County,,WA,1701,18608,20309
53003,Asotin County,,WA,2279,21834,24113
53005,Benton County,,WA,11118,158171,169289
53007,Chelan County,,WA,6399,71190,77589
53009,Clallam County,,WA,4265,70393,74658
53011,Clark County,,WA,22514,383894,406408
53013,Columbia County,,WA,494,5472,5966
53015,Cowlitz County,,WA,5700,99982,105682
53017,Douglas County,,WA,3671,33682,37353
53019,Ferry County,,WA,815,7262,8077
53021,Franklin County,,WA,4797,47295,52092
53023,Garfield County,,WA,109,1261,1370
53025,Grant County,,WA,5098,72307,77405
53027,Grays Harbor County,,WA,4432,68753,73185
53029,Island County,,WA,9480,70289,79769
53031,Jefferson County,,WA,2087,28517,30604
53033,King County,,WA,136297,1976063,2112360
53035,Kitsap County,,WA,23693,255398,279091
53037,Kittitas County,,WA,3238,30701,33939
53039,Klickitat County,,WA,1686,20206,21892
53041,Lewis County,,WA,4848,72496,77344
53043,Lincoln County,,WA,790,10385,11175
53045,Mason County,,WA,4357,52968,57325
53047,Okanogan County,,WA,3003,39733,42736
53049,Pacific County,,WA,1654,20135,21789
53051,Pend Oreille County,,WA,1512,15560,17072
53053,Pierce County,,WA,58718,756458,815176
53055,San Juan County,,WA,1076,15147,16223
53057,Skagit County,,WA,8127,119876,128003
53059,Skamania County,,WA,784,8611,9395
53061,Snohomish County,,WA,51302,680451,731753
53063,Spokane County,,WA,25878,456809,482687
53065,Stevens County,,WA,2770,36813,39583
53067,Thurston County,,WA,18105,229684,247789
53069,Wahkiakum County,,WA,351,3743,4094
53071,Walla Walla County,,WA,4127,51828,55955
53073,Whatcom County,,WA,11187,171265,182452
53075,Whitman County,,WA,4639,31830,36469
53077,Yakima County,,WA,11957,233955,245912
54001,Barbour County,,WV,806,15540,16346
54003,Berkeley County,,WV,4608,87561,92169
54005,Boone County,,WV,1553,28870,30423
54007,Braxton County,,WV,617,14312,14929
54009,Brooke County,,WV,1743,34448,36191
54011,Cabell County,,WV,6933,105937,112870
54013,Calhoun County,,WV,507,7094,7601
54015,Clay County,,WV,514,9367,9881
54017,Doddridge County,,WV,595,8966,9561
54019,Fayette County,,WV,2904,48244,51148
54021,Gilmer County,,WV,407,6109,6516
54023,Grant County,,WV,613,13549,14162
54025,Greenbrier County,,WV,1600,35315,36915
54027,Hampshire County,,WV,1111,22554,23665
54029,Hancock County,,WV,1766,35356,37122
54031,Hardy County,,WV,648,14067,14715
54033,Harrison County,,WV,4358,77126,81484
54035,Jackson County,,WV,1465,31427,32892
54037,Jefferson County,,WV,3252,48132,51384
54039,Kanawha County,,WV,11424,233777,245201
54041,Lewis County,,WV,912,17021,17933
54043,Lincoln County,,WV,1089,19983,21072
54045,Logan County,,WV,1892,32953,34845
54047,McDowell County,,WV,1208,19626,20834
54049,Marion County,,WV,2838,62760,65598
54051,Marshall County,,WV,1638,37630,39268
54053,Mason County,,WV,1157,28025,29182
54055,Mercer County,,WV,3483,63438,66921
54057,Mineral County,,WV,1554,29976,31530
54059,Mingo County,,WV,1571,25437,27008
54061,Monongalia County,,WV,5666,73045,78711
54063,Monroe County,,WV,627,12883,13510
54065,Morgan County,,WV,885,16460,17345
54067,Nicholas County,,WV,1409,27277,28686
54069,Ohio County,,WV,3052,53298,56350
54071,Pendleton County,,WV,658,9163,9821
54073,Pleasants County,,WV,424,8410,8834
54075,Pocahontas County,,WV,536,9489,10025
54077,Preston County,,WV,1280,31967,33247
54079,Putnam County,,WV,4177,49048,53225
54081,Raleigh County,,WV,4223,77506,81729
54083,Randolph County,,WV,1346,30387,31733
54085,Ritchie County,,WV,582,12597,13179
54087,Roane County,,WV,842,14780,15622
54089,Summers County,,WV,694,10404,11098
54091,Taylor County,,WV,674,14172,14846
54093,Tucker County,,WV,436,8184,8620
54095,Tyler County,,WV,537,10769,11306
54097,Upshur County,,WV,1059,21900,22959
54099,Wayne County,,WV,2193,37027,39220
54101,Webster County,,WV,389,8588,8977
54103,Wetzel County,,WV,1047,19165,20212
54105,Wirt County,,WV,531,7486,8017
54107,Wood County,,WV,4710,97873,102583
54109,Wyoming County,,WV,1143,22975,24118
55001,Adams County,,WI,2014,24388,26402
55003,Ashland County,,WI,1304,20798,22102
55005,Barron County,,WI,2970,57359,60329
55007,Bayfield County,,WI,1034,15246,16280
55009,Brown County,,WI,13236,283455,296691
55011,Buffalo County,,WI,1132,19849,20981
55013,Burnett County,,WI,1162,20697,21859
55015,Calumet County,,WI,4578,60062,64640
55017,Chippewa County,,WI,3688,69633,73321
55019,Clark County,,WI,2298,41015,43313
55021,Columbia County,,WI,4297,65042,69339
55023,Crawford County,,WI,1585,21154,22739
55025,Dane County,,WI,29489,501257,530746
55027,Dodge County,,WI,6367,104456,110823
55029,Door County,,WI,1598,35941,37539
55031,Douglas County,,WI,2487,49387,51874
55033,Dunn County,,WI,3287,42678,45965
55035,Eau Claire County,,WI,7368,98637,106005
55037,Florence County,,WI,376,5840,6216
55039,Fond du Lac County,,WI,5847,118193,124040
55041,Forest County,,WI,597,10297,10894
55043,Grant County,,WI,3408,59503,62911
55045,Green County,,WI,2304,43402,45706
55047,Green Lake County,,WI,1489,23930,25419
55049,Iowa County,,WI,1605,26667,28272
55051,Iron County,,WI,444,7407,7851
55053,Jackson County,,WI,1198,21829,23027
55055,Jefferson County,,WI,6728,93897,100625
55057,Juneau County,,WI,1952,29735,31687
55059,Kenosha County,,WI,10483,178084,188567
55061,Kewaunee County,,WI,1035,22285,23320
55063,La Crosse County,,WI,6935,120741,127676
55065,Lafayette County,,WI,1030,18584,19614
55067,Langlade County,,WI,1172,24291,25463
55069,Lincoln County,,WI,1829,38068,39897
55071,Manitowoc County,,WI,3764,100861,104625
55073,Marathon County,,WI,7157,155151,162308
55075,Marinette County,,WI,2987,51514,54501
55077,Marquette County,,WI,1247,15784,17031
55078,Menominee County,,WI,292,5363,5655
55079,Milwaukee County,,WI,52888,1053503,1106391
55081,Monroe County,,WI,2929,47307,50236
55083,Oconto County,,WI,2324,40755,43079
55085,Oneida County,,WI,2689,44677,47366
55087,Outagamie County,,WI,12537,197173,209710
55089,Ozaukee County,,WI,6790,104489,111279
55091,Pepin County,,WI,438,6981,7419
55093,Pierce County,,WI,2886,43548,46434
55095,Polk County,,WI,2375,46228,48603
55097,Portage County,,WI,4734,77453,82187
55099,Price County,,WI,1143,18452,19595
55101,Racine County,,WI,11717,224257,235974
55103,Richland County,,WI,1314,21289,22603
55105,Rock County,,WI,8474,175681,184155
55107,Rusk County,,WI,1003,17077,18080
55109,St. Croix County,,WI,4570,73968,78538
55111,Sauk County,,WI,4130,66128,70258
55113,Sawyer County,,WI,1050,18937,19987
55115,Shawano County,,WI,2380,43460,45840
55117,Sheboygan County,,WI,5642,139029,144671
55119,Taylor County,,WI,1161,21715,22876
55121,Trempealeau County,,WI,1855,30768,32623
55123,Vernon County,,WI,1546,28401,29947
55125,Vilas County,,WI,1397,23115,24512
55127,Walworth County,,WI,6970,101883,108853
55129,Washburn County,,WI,1075,15751,16826
55131,Washington County,,WI,8504,146692,155196
55133,Waukesha County,,WI,27863,441854,469717
55135,Waupaca County,,WI,3213,57984,61197
55137,Waushara County,,WI,1620,24046,25666
55139,Winnebago County,,WI,11417,178361,189778
55141,Wood County,,WI,4653,90627,95280
56001,Albany County,,WY,4278,29503,33781
56003,Big Horn County,,WY,948,11521,12469
56005,Campbell County,,WY,3251,39806,43057
56007,Carbon County,,WY,1808,16521,18329
56009,Converse County,,WY,1591,14046,15637
56011,Crook County,,WY,599,5760,6359
56013,Fremont County,,WY,2859,39672,42531
56015,Goshen County,,WY,1098,13322,14420
56017,Hot Springs County,,WY,548,5115,5663
56019,Johnson County,,WY,667,7568,8235
56021,Laramie County,,WY,8619,93138,101757
56023,Lincoln County,,WY,1428,16739,18167
56025,Natrona County,,WY,5255,74321,79576
56027,Niobrara County,,WY,230,2706,2936
56029,Park County,,WY,2635,29507,32142
56031,Platte County,,WY,771,9683,10454
56033,Sheridan County,,WY,2324,29711,32035
56035,Sublette County,,WY,610,6733,7343
56037,Sweetwater County,,WY,3884,44878,48762
56039,Teton County,,WY,2784,19328,22112
56041,Uinta County,,WY,2093,22222,24315
56043,Washakie County,,WY,917,9745,10662
56045,Weston County,,WY,637,7219,7856
12086,Dade County,,FL,111283,2321618,2432901
2230,Skagway Hoonah Ango,,AK,482,3585,4067
51560,Clifton Forge,,VA,384,4487,4871
2275,Wrangell Petersburg,,AK,678,7135,7813
2198,Prince Of Wales Oute,,AK,726,5143,5869
