Id,Label,timeset,state,totalmig,totalnonmig,population,indegree,outdegree,Degree,weighted indegree,weighted outdegree,Weighted Degree,Eccentricity,closnesscentrality,harmonicclosnesscentrality,betweenesscentrality,Authority,Hub,modularity_class,pageranks,componentnumber,strongcompnum,clustering,eigencentrality
1001,Autauga County,,AL,5200,52125,57325,15,14,29,3109,2673,5782,6,0.328432,0.346493,534.727265,0.003769,0.003919,12,0.000273,0,31,0.549708,0.029055
1003,Baldwin County,,AL,9047,158925,167972,42,29,71,6785,4229,11014,6,0.351361,0.375413,5337.545364,0.014677,0.012544,12,0.000671,0,31,0.437925,0.109528
1005,Barbour County,,AL,1839,27674,29513,9,11,20,664,996,1660,7,0.294493,0.309433,6132.588457,0.000645,0.001022,12,0.000269,0,31,0.472727,0.005147
1007,Bibb County,,AL,1272,21234,22506,4,4,8,935,833,1768,7,0.287439,0.300101,0.91533,0.000543,0.000602,12,0.000118,0,31,0.916667,0.004772
1009,Blount County,,AL,3038,55609,58647,7,8,15,3002,2089,5091,7,0.287269,0.300359,5.736361,0.000508,0.000582,12,0.000187,0,31,0.678571,0.004906
1011,Bullock County,,AL,626,10168,10794,3,3,6,242,325,567,7,0.275705,0.287248,0,0.000245,0.000231,12,0.000109,0,31,1,0.002
1013,Butler County,,AL,1079,22527,23606,5,3,8,335,390,725,7,0.275679,0.287191,2.933333,0.000247,0.000223,12,0.000158,0,31,0.5,0.002208
1015,Calhoun County,,AL,6592,130857,137449,21,22,43,3569,3580,7149,6,0.314456,0.332685,11204.151268,0.003965,0.003928,12,0.00043,0,31,0.413043,0.030341
1017,Chambers County,,AL,2358,43090,45448,6,7,13,1151,1427,2578,7,0.276072,0.288511,116.246212,0.00038,0.000318,12,0.000159,0,31,0.553571,0.003276
1019,Cherokee County,,AL,1346,24546,25892,6,5,11,887,757,1644,7,0.240616,0.249429,45.594007,0.000089,0.000077,12,0.000196,0,31,0.366667,0.00129
1021,Chilton County,,AL,1848,40380,42228,7,8,15,1374,1063,2437,7,0.290313,0.304233,11.418629,0.000761,0.00087,12,0.000175,0,31,0.767857,0.006637
1023,Choctaw County,,AL,716,16324,17040,3,2,5,163,122,285,7,0.265472,0.275787,10.238191,0.00027,0.000089,12,0.000113,0,31,0.5,0.002104
1025,Clarke County,,AL,1361,30333,31694,5,8,13,497,702,1199,7,0.289272,0.303016,75.974103,0.000348,0.001022,12,0.000163,0,31,0.428571,0.002961
1027,Clay County,,AL,865,16543,17408,5,4,9,427,426,853,7,0.239426,0.247477,5.973232,0.000052,0.000045,12,0.00015,0,31,0.5,0.000874
1029,Cleburne County,,AL,828,14656,15484,4,5,9,591,498,1089,7,0.240179,0.248964,9.551378,0.000078,0.000083,12,0.000132,0,31,0.6,0.001056
1031,Coffee County,,AL,5085,45077,50162,17,15,32,2481,2446,4927,6,0.324832,0.342855,2335.737002,0.004687,0.004024,12,0.000292,0,31,0.460784,0.033457
1033,Colbert County,,AL,3243,59163,62406,5,7,12,1745,1933,3678,7,0.288869,0.302242,1676.118536,0.000307,0.000707,12,0.000142,0,31,0.571429,0.00278
1035,Conecuh County,,AL,852,14522,15374,4,5,9,277,412,689,7,0.275836,0.287765,22.798826,0.000465,0.00024,102,0.000117,0,31,0.5,0.004065
1037,Coosa County,,AL,973,12996,13969,4,3,7,658,631,1289,8,0.226151,0.233458,0.366667,0.0004,0.00002,12,0.000122,0,31,0.833333,0.003369
1039,Covington County,,AL,1879,37826,39705,8,12,20,780,904,1684,7,0.294822,0.309789,369.929992,0.000822,0.001259,12,0.000203,0,31,0.39011,0.007553
1041,Crenshaw County,,AL,984,15507,16491,5,5,10,596,567,1163,7,0.276019,0.287994,8.738732,0.000282,0.000273,12,0.000164,0,31,0.6,0.0025
1043,Cullman County,,AL,3698,83236,86934,12,11,23,2286,2049,4335,7,0.289013,0.303016,53.563129,0.000807,0.000938,12,0.000284,0,31,0.50641,0.007696
1045,Dale County,,AL,7656,47833,55489,22,25,47,3443,4127,7570,6,0.333295,0.354046,6683.827248,0.005454,0.006651,12,0.000372,0,31,0.470085,0.040081
1047,Dallas County,,AL,2466,48579,51045,8,11,19,788,1234,2022,7,0.290982,0.305668,3364.546197,0.001337,0.001196,12,0.000235,0,31,0.467949,0.009549
1049,DeKalb County,,AL,3470,71776,75246,10,11,21,2191,2196,4387,7,0.289907,0.304377,965.894015,0.000913,0.000966,12,0.000267,0,31,0.439394,0.007969
1051,Elmore County,,AL,5502,72950,78452,12,13,25,4565,3307,7872,7,0.291245,0.306316,1229.967051,0.001112,0.00146,12,0.000277,0,31,0.485714,0.009397
1053,Escambia County,,AL,2133,37779,39912,6,9,15,891,1206,2097,6,0.295964,0.31122,72.220237,0.000922,0.001724,102,0.000162,0,31,0.625,0.008472
1055,Etowah County,,AL,5060,105187,110247,13,13,26,3106,3164,6270,7,0.28982,0.304566,605.641276,0.000889,0.001159,12,0.000312,0,31,0.521978,0.008299
1057,Fayette County,,AL,1141,21419,22560,5,5,10,583,606,1189,7,0.28761,0.300474,188.309689,0.000447,0.000447,12,0.000149,0,31,0.8,0.003756
1059,Franklin County,,AL,1728,31973,33701,7,8,15,750,1062,1812,7,0.238953,0.247995,148.175446,0.000033,0.000039,12,0.000227,0,31,0.321429,0.000822
1061,Geneva County,,AL,1737,25656,27393,5,5,10,999,996,1995,7,0.253691,0.263677,8.496121,0.000155,0.00013,12,0.000139,0,31,0.6,0.001481
1063,Greene County,,AL,510,9836,10346,2,2,4,168,238,406,7,0.259541,0.269251,0,0.000072,0.000056,12,0.000094,0,31,1,0.000655
1065,Hale County,,AL,1008,18288,19296,3,3,6,579,548,1127,7,0.259587,0.269481,139.202382,0.000072,0.000057,12,0.000149,0,31,0.5,0.000755
1067,Henry County,,AL,1215,18124,19339,3,3,6,726,762,1488,7,0.25358,0.263161,0,0.000117,0.000084,12,0.0001,0,31,1,0.00095
1069,Houston County,,AL,6050,97239,103289,24,26,50,4064,3559,7623,6,0.319859,0.340312,12902.320986,0.004097,0.006526,12,0.00049,0,31,0.384946,0.031794
1071,Jackson County,,AL,2673,57632,60305,8,7,15,1407,1398,2805,7,0.28175,0.294597,127.530437,0.000888,0.000537,12,0.000217,0,31,0.555556,0.007606
1073,Jefferson County,,AL,36298,723075,759373,123,112,235,24210,28396,52606,6,0.402383,0.438522,114955.619852,0.047288,0.044841,12,0.001872,0,31,0.305114,0.33999
1075,Lamar County,,AL,951,16764,17715,6,7,13,448,577,1025,7,0.288324,0.301765,156.207112,0.00011,0.000469,12,0.000182,0,31,0.5,0.001221
1077,Lauderdale County,,AL,4481,93759,98240,9,13,22,2192,2426,4618,6,0.311488,0.328294,6357.430644,0.000679,0.002075,12,0.000235,0,31,0.397436,0.006014
1079,Lawrence County,,AL,1988,37572,39560,5,7,12,1091,1479,2570,7,0.279769,0.291865,146.325514,0.000046,0.000332,12,0.000152,0,31,0.690476,0.000832
1081,Lee County,,AL,9282,108459,117741,27,28,55,5971,5319,11290,6,0.320849,0.341678,3080.385222,0.005132,0.006552,12,0.000498,0,31,0.398925,0.039528
1083,Limestone County,,AL,4102,73378,77480,9,7,16,2943,2503,5446,7,0.288611,0.301869,308.136283,0.00071,0.000721,12,0.000207,0,31,0.527778,0.006193
1085,Lowndes County,,AL,955,13706,14661,2,3,5,464,671,1135,7,0.275679,0.287191,0.833333,0.000232,0.000232,12,0.00011,0,31,0.666667,0.001815
1087,Macon County,,AL,1394,21031,22425,3,3,6,566,746,1312,7,0.27581,0.287478,0,0.000296,0.000271,12,0.000098,0,31,1,0.002322
1089,Madison County,,AL,16344,324751,341095,82,70,152,11079,9891,20970,6,0.387303,0.41871,36794.892097,0.034488,0.032757,12,0.001187,0,31,0.392356,0.247853
1091,Marengo County,,AL,1352,23597,24949,8,8,16,475,615,1090,7,0.290982,0.305169,809.693968,0.000679,0.000951,12,0.000243,0,31,0.388889,0.005535
1093,Marion County,,AL,1381,25717,27098,6,7,13,664,676,1340,7,0.287838,0.301105,261.590839,0.00008,0.000454,12,0.000184,0,31,0.547619,0.001122
1095,Marshall County,,AL,5153,83829,88982,10,11,21,3290,3384,6674,7,0.288725,0.302615,33.398162,0.000788,0.000927,12,0.000242,0,31,0.613636,0.006982
1097,Mobile County,,AL,16927,422815,439742,58,66,124,7861,10014,17875,6,0.379956,0.410755,31022.063107,0.02554,0.028224,12,0.000875,0,31,0.419104,0.184588
1099,Monroe County,,AL,1138,25603,26741,6,5,11,407,405,812,7,0.281696,0.294399,27.522031,0.000591,0.000562,12,0.000148,0,31,0.6,0.004705
1101,Montgomery County,,AL,17867,236593,254460,74,72,146,9724,11979,21703,6,0.380403,0.412414,63086.970039,0.026533,0.02786,12,0.001218,0,31,0.337756,0.194242
1103,Morgan County,,AL,6555,124545,131100,17,15,32,4112,3715,7827,7,0.305942,0.322191,4299.819207,0.003141,0.002044,12,0.000341,0,31,0.373684,0.023636
1105,Perry County,,AL,548,10115,10663,3,2,5,175,132,307,8,0.225466,0.23219,4.438034,0.000074,0.000012,12,0.000128,0,31,0.5,0.000785
1107,Pickens County,,AL,1171,22071,23242,3,4,7,376,639,1015,7,0.288095,0.301019,0,0.000102,0.000464,12,0.000104,0,31,0.833333,0.000884
1109,Pike County,,AL,2060,26587,28647,9,8,17,906,901,1807,7,0.291128,0.305077,128.288772,0.000767,0.000737,12,0.000222,0,31,0.541667,0.006315
1111,Randolph County,,AL,1319,22539,23858,6,7,13,473,677,1150,7,0.243563,0.253515,37.662834,0.000104,0.000151,12,0.000179,0,31,0.428571,0.001443
1113,Russell County,,AL,5179,49705,54884,6,7,13,3164,3637,6801,6,0.309298,0.325671,150.278355,0.00058,0.00191,12,0.000154,0,31,0.607143,0.004668
1115,St. Clair County,,AL,4353,64592,68945,7,7,14,3986,2906,6892,7,0.287525,0.300675,3.958952,0.000593,0.000716,12,0.000175,0,31,0.767857,0.005448
1117,Shelby County,,AL,12936,161125,174061,47,37,84,13382,8892,22274,6,0.357108,0.382713,10602.445216,0.018717,0.012364,12,0.000763,0,31,0.437029,0.138406
1119,Sumter County,,AL,767,13982,14749,2,3,5,141,214,355,7,0.265545,0.276074,1.91411,0.000434,0.000095,12,0.000082,0,31,0.75,0.003394
1121,Talladega County,,AL,4315,78762,83077,10,12,22,2264,2640,4904,7,0.29104,0.305857,1843.910686,0.000646,0.001266,12,0.00026,0,31,0.570513,0.006108
1123,Tallapoosa County,,AL,2299,40449,42748,8,9,17,1051,1245,2296,7,0.29011,0.30409,1378.778503,0.00068,0.000828,12,0.000217,0,31,0.513889,0.005711
1125,Tuscaloosa County,,AL,9062,168865,177927,36,37,73,5083,5039,10122,6,0.350344,0.375677,29592.137316,0.006113,0.007753,12,0.000764,0,31,0.221256,0.046419
1127,Walker County,,AL,3210,68189,71399,8,8,16,1648,1884,3532,7,0.287639,0.300904,150.688754,0.00056,0.000614,12,0.000212,0,31,0.571429,0.005288
1129,Washington County,,AL,928,18374,19302,3,3,6,451,491,942,7,0.275496,0.286663,72.809662,0.000242,0.000216,12,0.000101,0,31,0.25,0.00181
1131,Wilcox County,,AL,670,13044,13714,4,4,8,240,259,499,7,0.275836,0.28765,12.830326,0.000256,0.000239,12,0.000126,0,31,0.416667,0.002142
1133,Winston County,,AL,1365,24866,26231,5,6,11,709,761,1470,7,0.287439,0.30033,1085.085091,0.000387,0.000429,12,0.000156,0,31,0.533333,0.003415
2013,Aleutians East Borough,,AK,283,1604,1887,1,1,2,41,58,99,6,0.279338,0.292028,0,0.001118,0.000388,178,0.00006,0,31,1,0.007739
2016,Aleutians West Census Area,,AK,666,4110,4776,3,1,4,183,103,286,6,0.279311,0.291971,0,0.002,0.000388,178,0.000083,0,31,1,0.014109
2020,Anchorage Municipality,,AK,26080,286290,312370,124,121,245,16267,16648,32915,5,0.38751,0.425488,80878.87151,0.046967,0.043843,178,0.001887,0,31,0.285414,0.332634
2050,Bethel Census Area,,AK,930,15913,16843,2,5,7,245,535,780,6,0.282931,0.296292,6.889502,0.000365,0.000622,178,0.000098,0,31,0.7,0.002946
2060,Bristol Bay Borough,,AK,174,1275,1449,0,0,0,0,0,0,0,0,0,0,0,0,0,0.000051,1,32,0,0
2068,Denali Borough,,AK,359,2140,2499,1,2,3,48,104,152,6,0.282848,0.295776,0,0.000165,0.000563,178,0.000064,0,31,1,0.001351
2070,Dillingham Census Area,,AK,447,4486,4933,1,2,3,92,209,301,6,0.282848,0.295776,0,0.000362,0.000563,178,0.000064,0,31,1,0.002832
2090,Fairbanks North Star Borough,,AK,12016,92403,104419,61,61,122,5585,6174,11759,6,0.364641,0.394003,20713.189989,0.021184,0.020015,178,0.000939,0,31,0.335498,0.150462
2100,Haines Borough,,AK,238,2598,2836,1,1,2,44,48,92,7,0.24927,0.256771,0,0.000022,0.000012,178,0.00009,0,31,0,0.000195
2105,Hoonah-Angoon Census Area,,AK,0,0,0,0,0,0,0,0,0,0,0,0,0,0,0,1,0.000051,2,33,0,0
2110,Juneau City and Borough,,AK,2752,34217,36969,11,9,20,973,760,1733,6,0.332,0.350522,16881.096775,0.001488,0.002638,178,0.000412,0,31,0.287879,0.011292
2122,Kenai Peninsula Borough,,AK,4208,53375,57583,9,8,17,1499,1511,3010,6,0.33654,0.355579,402.604724,0.002615,0.004234,178,0.000215,0,31,0.554545,0.019841
2130,Ketchikan Gateway Borough,,AK,1523,14129,15652,3,5,8,160,379,539,6,0.315036,0.330877,824.717554,0.000384,0.001431,178,0.00014,0,31,0.7,0.003141
2150,Kodiak Island Borough,,AK,2046,15003,17049,3,6,9,196,658,854,6,0.33518,0.353289,3.501731,0.002037,0.003398,178,0.000086,0,31,0.732143,0.015084
2164,Lake and Peninsula Borough,,AK,199,1339,1538,1,1,2,64,64,128,6,0.279311,0.291971,0,0.000362,0.000388,178,0.000064,0,31,0,0.002832
2170,Matanuska-Susitna Borough,,AK,4723,64712,69435,14,10,24,4155,2117,6272,6,0.333716,0.352537,762.672249,0.004197,0.004172,178,0.000285,0,31,0.485714,0.031616
2180,Nome Census Area,,AK,630,8563,9193,1,2,3,110,254,364,6,0.282848,0.295776,0,0.000362,0.000563,178,0.000064,0,31,1,0.002832
2185,North Slope Borough,,AK,546,7019,7565,1,2,3,80,203,283,6,0.282848,0.295776,0,0.000362,0.000563,178,0.000064,0,31,1,0.002832
2188,Northwest Arctic Borough,,AK,505,6337,6842,1,2,3,103,248,351,6,0.282848,0.295776,0,0.000362,0.000563,178,0.000064,0,31,1,0.002832
2195,Petersburg Census Area,,AK,0,0,0,0,0,0,0,0,0,0,0,0,0,0,0,2,0.000051,3,34,0,0
2220,Sitka City and Borough,,AK,932,9787,10719,0,2,2,0,152,152,6,0.279434,0.292329,0,0,0.0004,178,0.000051,0,35,1,0
2240,Southeast Fairbanks Census Area,,AK,588,6031,6619,3,3,6,198,255,453,6,0.282876,0.295948,0,0.000562,0.000597,178,0.000101,0,31,1,0.004541
2261,Valdez-Cordova Census Area,,AK,1306,10777,12083,3,4,7,350,572,922,6,0.282903,0.29612,0,0.000562,0.000619,178,0.000101,0,31,1,0.004541
2270,Wade Hampton Census Area,,AK,357,6587,6944,2,2,4,151,222,373,6,0.279338,0.292143,0,0.000367,0.000391,178,0.000081,0,31,1,0.002946
2282,Yakutat City and Borough,,AK,89,546,635,0,0,0,0,0,0,0,0,0,0,0,0,3,0.000051,4,36,0,0
2290,Yukon-Koyukuk Census Area,,AK,598,6014,6612,1,2,3,230,325,555,6,0.282848,0.295776,0,0.000165,0.000563,178,0.000064,0,31,1,0.001351
4001,Apache County,,AZ,7189,56522,63711,15,11,26,5927,6087,12014,6,0.329177,0.347366,139.217504,0.004378,0.003001,100,0.000272,0,31,0.579167,0.033466
4003,Cochise County,,AZ,12793,114558,127351,47,35,82,6673,6211,12884,6,0.35645,0.382008,671.83536,0.021864,0.018947,178,0.000595,0,31,0.581633,0.156713
4005,Coconino County,,AZ,12861,119626,132487,30,31,61,8130,8483,16613,6,0.349585,0.373175,724.832135,0.01397,0.014136,178,0.000452,0,31,0.580159,0.100028
4007,Gila County,,AZ,4168,51639,55807,12,8,20,2582,2597,5179,6,0.32873,0.346333,9.443956,0.005987,0.002471,178,0.00022,0,31,0.818182,0.0458
4009,Graham County,,AZ,2103,25702,27805,8,9,17,1061,1344,2405,6,0.32914,0.34682,1084.298901,0.002167,0.002478,178,0.000182,0,31,0.633333,0.017573
4011,Greenlee County,,AZ,853,7977,8830,2,3,5,137,451,588,6,0.32847,0.345357,0,0.000045,0.00191,178,0.00008,0,31,0.916667,0.000545
4012,La Paz County,,AZ,1509,13952,15461,6,6,12,680,675,1355,6,0.32914,0.34662,0,0.003589,0.003074,178,0.000129,0,31,1,0.027847
4013,Maricopa County,,AZ,153048,3334471,3487519,606,503,1109,172494,130898,303392,5,0.488724,0.552037,813753.679194,0.140838,0.135333,178,0.008332,0,31,0.083698,1
4015,Mohave County,,AZ,11406,156492,167898,55,28,83,11703,6235,17938,6,0.345509,0.367826,236.01007,0.022684,0.013217,178,0.000678,0,31,0.583485,0.160827
4017,Navajo County,,AZ,7335,90033,97368,20,15,35,6646,5383,12029,6,0.335917,0.355682,117.634096,0.008176,0.005667,178,0.000323,0,31,0.652632,0.059962
4019,Pima County,,AZ,45304,895019,940323,209,191,400,36462,32015,68477,5,0.430158,0.471889,36887.128435,0.088406,0.083909,178,0.00241,0,31,0.297075,0.600975
4021,Pinal County,,AZ,12924,148392,161316,29,22,51,15675,8960,24635,6,0.343181,0.364078,191.584122,0.016495,0.0112,178,0.000393,0,31,0.712702,0.115521
4023,Santa Cruz County,,AZ,2652,45720,48372,5,5,10,1453,1866,3319,6,0.337989,0.356089,0,0.003551,0.004246,178,0.000109,0,31,1,0.025878
4025,Yavapai County,,AZ,12511,174879,187390,51,28,79,11618,6973,18591,6,0.346788,0.369548,250.607576,0.024941,0.014715,178,0.000609,0,31,0.644444,0.172313
4027,Yuma County,,AZ,10865,171376,182241,39,34,73,7092,5965,13057,6,0.350767,0.375344,257.902842,0.019559,0.01712,178,0.000486,0,31,0.64852,0.139936
5001,Arkansas County,,AR,1249,22117,23366,5,6,11,402,557,959,7,0.284038,0.296276,6.62619,0.000348,0.000399,54,0.000173,0,31,0.6,0.003227
5003,Ashley County,,AR,1315,25107,26422,6,7,13,417,520,937,6,0.31432,0.331216,164.335958,0.000406,0.001288,54,0.000182,0,31,0.404762,0.00358
5005,Baxter County,,AR,2584,41157,43741,10,10,20,974,782,1756,7,0.288869,0.303206,13571.328869,0.001953,0.000901,123,0.00033,0,31,0.339744,0.014943
5007,Benton County,,AR,12510,182626,195136,65,38,103,11037,7180,18217,6,0.360253,0.386587,22518.258772,0.025646,0.01205,123,0.001125,0,31,0.348892,0.18138
5009,Boone County,,AR,2624,37162,39786,10,12,22,1085,1322,2407,7,0.289272,0.303682,10861.84863,0.000369,0.001006,123,0.000388,0,31,0.252747,0.005695
5011,Bradley County,,AR,720,11950,12670,2,3,5,173,254,427,7,0.283954,0.29576,124.755577,0.000003,0.000327,54,0.00011,0,31,0.333333,0.000222
5013,Calhoun County,,AR,390,5652,6042,2,1,3,120,80,200,8,0.22151,0.227255,0,0.000031,0.000003,54,0.000087,0,31,1,0.000292
5015,Carroll County,,AR,1905,25101,27006,9,6,15,751,774,1525,7,0.269063,0.28015,385.365142,0.002677,0.000382,123,0.00027,0,31,0.486111,0.019991
5017,Chicot County,,AR,1104,12942,14046,6,6,12,344,481,825,7,0.284929,0.297481,153.240111,0.000357,0.000385,54,0.000183,0,31,0.380952,0.003187
5019,Clark County,,AR,1733,22901,24634,8,8,16,629,803,1432,7,0.284511,0.297338,1743.277906,0.000363,0.000562,54,0.00027,0,31,0.355556,0.003909
5021,Clay County,,AR,1133,17069,18202,5,5,10,542,579,1121,7,0.257424,0.267464,58.203381,0.000041,0.000033,54,0.000189,0,31,0.65,0.000802
5023,Cleburne County,,AR,1950,29418,31368,9,7,16,1214,982,2196,6,0.307823,0.322348,2261.575813,0.001019,0.001003,54,0.000271,0,31,0.513889,0.008218
5025,Cleveland County,,AR,602,9699,10301,3,3,6,370,293,663,7,0.253713,0.26264,367.432525,0.000038,0.000029,54,0.000126,0,31,0,0.0005
5027,Columbia County,,AR,1609,25803,27412,5,9,14,438,649,1087,6,0.317585,0.33455,1564.20387,0.00006,0.001306,54,0.000214,0,31,0.416667,0.000763
5029,Conway County,,AR,1331,22652,23983,4,5,9,718,777,1495,7,0.284065,0.296161,2.302114,0.000336,0.000378,54,0.000166,0,31,0.7,0.003194
5031,Craighead County,,AR,5875,84672,90547,24,26,50,3686,3404,7090,6,0.342857,0.365427,25242.234167,0.002078,0.003646,54,0.000631,0,31,0.229885,0.0173
5033,Crawford County,,AR,4331,57980,62311,10,11,21,3163,2956,6119,6,0.30031,0.31475,396.253431,0.001042,0.001154,123,0.000267,0,31,0.554545,0.009236
5035,Crittenden County,,AR,3754,54334,58088,9,8,17,1843,1914,3757,6,0.308084,0.322865,57.152882,0.00106,0.001045,54,0.000234,0,31,0.569444,0.008381
5037,Cross County,,AR,1472,20209,21681,6,7,13,628,739,1367,6,0.307921,0.322492,522.627565,0.000711,0.000975,54,0.000183,0,31,0.642857,0.005204
5039,Dallas County,,AR,606,8138,8744,2,4,6,117,210,327,7,0.284065,0.296104,133.437391,0.000004,0.00033,54,0.00011,0,31,0.416667,0.000217
5041,Desha County,,AR,1179,16083,17262,5,6,11,415,548,963,7,0.284093,0.296362,174.259424,0.000341,0.000387,54,0.000172,0,31,0.6,0.003115
5043,Drew County,,AR,1264,18150,19414,6,7,13,593,556,1149,7,0.284343,0.296793,2957.997934,0.000352,0.000363,54,0.000192,0,31,0.5,0.003235
5045,Faulkner County,,AR,6846,96735,103581,22,18,40,5204,3882,9086,6,0.32516,0.345259,4789.371844,0.003279,0.00323,54,0.000588,0,31,0.346014,0.026853
5047,Franklin County,,AR,1201,17174,18375,5,6,11,685,685,1370,7,0.266838,0.277737,18.811911,0.000162,0.000227,123,0.000169,0,31,0.866667,0.002055
5049,Fulton County,,AR,967,12187,13154,5,5,10,416,481,897,8,0.224472,0.231919,219.370268,0.00001,0.000021,54,0.000247,0,31,0.35,0.000671
5051,Garland County,,AR,5457,99309,104766,30,17,47,3359,2138,5497,6,0.345632,0.368136,16076.068215,0.008919,0.005362,54,0.000645,0,31,0.330645,0.066786
5053,Grant County,,AR,1466,20941,22407,4,5,9,981,818,1799,7,0.284038,0.296133,1.059524,0.000341,0.000442,54,0.00014,0,31,0.9,0.003106
5055,Greene County,,AR,2135,39275,41410,8,7,15,1170,999,2169,7,0.256923,0.267091,2710.445913,0.00101,0.000048,54,0.000249,0,31,0.444444,0.007668
5057,Hempstead County,,AR,1686,24802,26488,8,8,16,683,807,1490,7,0.284399,0.297194,5064.684102,0.000378,0.000402,152,0.00029,0,31,0.319444,0.003752
5059,Hot Spring County,,AR,1952,28135,30087,5,5,10,1112,1089,2201,7,0.28401,0.296075,1.483333,0.000357,0.000416,54,0.000174,0,31,0.85,0.003585
5061,Howard County,,AR,889,14131,15020,3,5,8,343,355,698,7,0.241256,0.249211,22.25193,0.000004,0.000023,152,0.000156,0,31,0.4,0.000338
5063,Independence County,,AR,2225,37666,39891,9,10,19,1098,1072,2170,7,0.28479,0.298113,3198.273735,0.000355,0.000548,54,0.000311,0,31,0.390909,0.003701
5065,Izard County,,AR,774,11440,12214,5,4,9,345,319,664,8,0.224368,0.231518,37.639831,0.000012,0.000019,54,0.000207,0,31,0.35,0.000656
5067,Jackson County,,AR,1182,17496,18678,5,6,11,408,634,1042,7,0.284343,0.296793,434.679741,0.00035,0.000368,54,0.000164,0,31,0.633333,0.003236
5069,Jefferson County,,AR,5200,83101,88301,16,16,32,2022,2836,4858,6,0.33957,0.361031,11329.636233,0.003533,0.00396,54,0.000391,0,31,0.333333,0.025243
5071,Johnson County,,AR,1414,22872,24286,6,6,12,599,588,1187,7,0.269138,0.280264,26.791878,0.000161,0.00043,123,0.000205,0,31,0.690476,0.002276
5073,Lafayette County,,AR,491,7492,7983,5,2,7,228,167,395,7,0.241156,0.248523,10.243604,0.000094,0.000019,54,0.000175,0,31,0.55,0.001117
5075,Lawrence County,,AR,1264,17592,18856,6,5,11,603,643,1246,7,0.255521,0.264915,10.394048,0.000038,0.000029,54,0.000226,0,31,0.533333,0.000894
5077,Lee County,,AR,977,10108,11085,3,7,10,213,583,796,6,0.307888,0.322435,40.405455,0.000019,0.000979,54,0.000122,0,31,0.714286,0.000433
5079,Lincoln County,,AR,637,9017,9654,3,3,6,244,323,567,7,0.283899,0.295645,0,0.000039,0.000356,54,0.000119,0,31,1,0.000559
5081,Little River County,,AR,860,13913,14773,4,3,7,368,386,754,7,0.249506,0.25835,96.807363,0.000062,0.000073,152,0.000169,0,31,0.416667,0.000957
5083,Logan County,,AR,1404,22653,24057,7,8,15,843,811,1654,7,0.284539,0.297395,141.498493,0.000081,0.000555,123,0.000222,0,31,0.597222,0.001388
5085,Lonoke County,,AR,5362,61484,66846,13,12,25,4410,3194,7604,6,0.308575,0.324156,349.897367,0.001573,0.001309,54,0.000348,0,31,0.483516,0.013311
5087,Madison County,,AR,1090,14629,15719,3,3,6,684,693,1377,7,0.268864,0.279346,0,0.000191,0.000379,123,0.000141,0,31,1,0.003023
5089,Marion County,,AR,1263,15090,16353,3,2,5,370,485,855,8,0.224698,0.231472,4.749883,0.000016,0.000019,123,0.000128,0,31,0.5,0.000461
5091,Miller County,,AR,3686,39848,43534,12,9,21,2842,2362,5204,6,0.317412,0.334263,10019.848302,0.002262,0.001353,152,0.00039,0,31,0.352564,0.017387
5093,Mississippi County,,AR,3541,50818,54359,7,13,20,800,1670,2470,6,0.325196,0.344559,4948.452075,0.000701,0.002905,54,0.000216,0,31,0.346154,0.005326
5095,Monroe County,,AR,704,9748,10452,6,4,10,338,268,606,7,0.283926,0.295817,409.478609,0.00033,0.000336,54,0.000168,0,31,0.5,0.003104
5097,Montgomery County,,AR,570,8689,9259,1,3,4,115,234,349,7,0.257173,0.266488,257.941483,0.000044,0.000074,54,0.000083,0,31,0.5,0.000664
5099,Nevada County,,AR,723,9639,10362,2,2,4,270,272,542,7,0.241056,0.248408,0.6875,0.000008,0.000022,152,0.00011,0,31,0.666667,0.000266
5101,Newton County,,AR,591,7799,8390,1,1,2,255,290,545,8,0.224386,0.23072,0,0.000008,0.000003,123,0.000078,0,31,0,0.000151
5103,Ouachita County,,AR,1651,28656,30307,5,7,12,502,709,1211,7,0.284511,0.297137,6399.5499,0.000341,0.000412,54,0.000199,0,31,0.380952,0.002919
5105,Perry County,,AR,818,10004,10822,4,3,7,466,453,919,7,0.283871,0.295587,0.333333,0.000335,0.000354,54,0.000145,0,31,0.833333,0.003127
5107,Phillips County,,AR,1666,24568,26234,4,8,12,352,760,1112,6,0.308019,0.322779,1319.001859,0.000978,0.001057,54,0.00011,0,31,0.416667,0.007066
5109,Pike County,,AR,756,9341,10097,5,4,9,294,338,632,7,0.25715,0.266631,491.574089,0.000053,0.00008,54,0.000192,0,31,0.4,0.001121
5111,Poinsett County,,AR,1594,24257,25851,5,5,10,874,968,1842,6,0.305652,0.319456,1.243167,0.000726,0.000647,54,0.000145,0,31,0.9,0.005092
5113,Polk County,,AR,1316,19838,21154,3,6,9,173,344,517,7,0.284734,0.29751,812.374265,0.00001,0.000594,123,0.000126,0,31,0.321429,0.000354
5115,Pope County,,AR,4018,53871,57889,14,11,25,1825,1954,3779,7,0.285265,0.298979,1497.553452,0.002579,0.000843,123,0.000371,0,31,0.429167,0.021173
5117,Prairie County,,AR,612,9312,9924,4,5,9,260,378,638,7,0.283954,0.295989,2.32619,0.000327,0.000366,54,0.000141,0,31,0.7,0.003073
5119,Pulaski County,,AR,27566,396655,424221,113,99,212,17900,19127,37027,6,0.39618,0.430228,170389.813441,0.039266,0.036245,54,0.00206,0,31,0.256468,0.283688
5121,Randolph County,,AR,1035,17827,18862,4,4,8,382,405,787,7,0.255544,0.264743,1.421644,0.000031,0.000026,54,0.000172,0,31,0.833333,0.000643
5123,St. Francis County,,AR,1917,25208,27125,7,7,14,790,982,1772,6,0.307921,0.322492,1366.477546,0.001013,0.000969,54,0.000199,0,31,0.642857,0.007625
5125,Saline County,,AR,5372,76120,81492,11,13,24,4253,3508,7761,7,0.284957,0.298801,257.128247,0.001505,0.000672,54,0.000319,0,31,0.47619,0.013284
5127,Scott County,,AR,884,11539,12423,2,4,6,272,370,642,7,0.258225,0.267957,5.190346,0.000061,0.000062,123,0.000086,0,31,0.45,0.000576
5129,Searcy County,,AR,439,6484,6923,0,2,2,0,90,90,8,0.224446,0.230985,0,0,0.000003,123,0.000051,0,37,1,0
5131,Sebastian County,,AR,9446,119515,128961,22,23,45,5199,6145,11344,6,0.347701,0.371356,14793.857062,0.00611,0.006784,123,0.000484,0,31,0.357143,0.045237
5133,Sevier County,,AR,1004,14866,15870,4,4,8,296,353,649,7,0.242809,0.251082,100.97042,0.000017,0.000012,152,0.00016,0,31,0.083333,0.000467
5135,Sharp County,,AR,1211,12469,13680,5,5,10,577,539,1116,7,0.255724,0.265231,197.872727,0.000035,0.000021,54,0.000222,0,31,0.5,0.000717
5137,Stone County,,AR,697,11600,12297,1,3,4,40,144,184,7,0.235982,0.243046,19.935194,0.000027,0.000011,54,0.000078,0,31,0.583333,0.000339
5139,Union County,,AR,2690,48632,51322,7,13,20,750,970,1720,6,0.328358,0.348634,5040.784512,0.001219,0.003377,54,0.000192,0,31,0.346154,0.009189
5141,Van Buren County,,AR,953,13497,14450,4,3,7,348,303,651,7,0.283871,0.295587,0.333333,0.000337,0.00036,54,0.000157,0,31,0.833333,0.003084
5143,Washington County,,AR,13493,154388,167881,55,34,89,9336,8156,17492,6,0.363227,0.389819,26534.661356,0.017555,0.01075,123,0.001086,0,31,0.299812,0.126846
5145,White County,,AR,4324,64687,69011,14,13,27,2211,2183,4394,6,0.318351,0.3361,3423.106187,0.002787,0.001647,54,0.000361,0,31,0.422794,0.021138
5147,Woodruff County,,AR,564,7656,8220,3,4,7,197,295,492,7,0.283982,0.295932,1.708333,0.000025,0.000356,54,0.00012,0,31,0.583333,0.000541
5149,Yell County,,AR,1674,20108,21782,5,4,9,723,875,1598,7,0.284038,0.295989,158.951991,0.000367,0.000347,123,0.000157,0,31,0.666667,0.003423
6001,Alameda County,,CA,134407,1560311,1694718,164,208,372,88610,123767,212377,5,0.427499,0.471459,19119.888631,0.081254,0.089143,178,0.001659,0,31,0.343643,0.542704
6003,Alpine County,,CA,164,1070,1234,0,1,1,0,42,42,7,0.253314,0.260988,0,0,0.000107,178,0.000051,0,38,0,0
6005,Amador County,,CA,2281,36019,38300,13,7,20,2158,1117,3275,6,0.303797,0.319037,0.18254,0.005697,0.002586,178,0.00016,0,31,0.961538,0.037026
6007,Butte County,,CA,11458,197578,209036,51,50,101,10529,8428,18957,6,0.342412,0.367068,1024.421174,0.018181,0.017493,178,0.000596,0,31,0.670814,0.129292
6009,Calaveras County,,CA,2821,44141,46962,15,9,24,3386,1638,5024,6,0.303956,0.319553,0.955089,0.006211,0.003173,178,0.000178,0,31,0.916667,0.040139
6011,Colusa County,,CA,1246,21072,22318,6,5,11,629,568,1197,6,0.291537,0.305102,1.15,0.001244,0.000978,178,0.000121,0,31,0.766667,0.00923
6013,Contra Costa County,,CA,73991,1072062,1146053,127,161,288,65158,65635,130793,5,0.407179,0.448404,9551.156056,0.062856,0.073367,178,0.001319,0,31,0.397011,0.422046
6015,Del Norte County,,CA,1616,21557,23173,7,5,12,559,469,1028,6,0.291683,0.305389,16.85921,0.002245,0.001055,178,0.000145,0,31,0.722222,0.016523
6017,El Dorado County,,CA,13016,177612,190628,40,43,83,13018,9988,23006,6,0.342049,0.365748,163.872612,0.016625,0.016678,178,0.000443,0,31,0.732367,0.11519
6019,Fresno County,,CA,29554,834382,863936,80,70,150,28325,23098,51423,6,0.369889,0.401119,2423.213042,0.035608,0.030845,178,0.000849,0,31,0.561345,0.244812
6021,Glenn County,,CA,1664,28154,29818,6,5,11,936,909,1845,6,0.291596,0.305217,22.636056,0.001991,0.000943,178,0.000138,0,31,0.766667,0.014732
6023,Humboldt County,,CA,7666,125150,132816,45,47,92,5189,5023,10212,6,0.342332,0.366638,2106.804455,0.017414,0.017774,178,0.000537,0,31,0.676848,0.122175
6025,Imperial County,,CA,8364,174349,182713,23,20,43,6337,6242,12579,6,0.33953,0.359665,4.945753,0.013055,0.010552,178,0.000279,0,31,0.915,0.092028
6027,Inyo County,,CA,1538,20444,21982,7,7,14,804,561,1365,6,0.333947,0.351854,0.703331,0.004781,0.004202,178,0.000119,0,31,0.910714,0.033279
6029,Kern County,,CA,27672,676878,704550,95,91,186,29529,19040,48569,6,0.380055,0.413826,3072.361462,0.040254,0.037372,178,0.001043,0,31,0.426612,0.282018
6031,Kings County,,CA,9655,117107,126762,34,31,65,6656,5656,12312,6,0.344443,0.366374,178.968041,0.016095,0.01572,178,0.000389,0,31,0.662162,0.113153
6033,Lake County,,CA,3779,54472,58251,19,17,36,3547,2110,5657,6,0.335412,0.354769,0.344644,0.009018,0.008129,178,0.000201,0,31,0.970356,0.05916
6035,Lassen County,,CA,2057,25929,27986,13,9,22,1003,836,1839,6,0.292418,0.306881,2.183051,0.005454,0.001717,178,0.000183,0,31,0.8125,0.03868
6037,Los Angeles County,,CA,363389,9964082,10327471,437,492,929,251419,341656,593075,5,0.487821,0.550218,469185.445269,0.131886,0.136256,178,0.005372,0,31,0.112342,0.915905
6039,Madera County,,CA,7074,116001,123075,27,24,51,7948,5239,13187,6,0.339808,0.360526,229.544861,0.013125,0.011966,178,0.000288,0,31,0.878079,0.090037
6041,Marin County,,CA,20281,250538,270819,41,60,101,13160,16324,29484,6,0.36662,0.396442,275.998737,0.02397,0.029683,178,0.00041,0,31,0.675347,0.162122
6043,Mariposa County,,CA,1299,17111,18410,11,6,17,1149,501,1650,7,0.272012,0.28458,0.257485,0.005589,0.00106,178,0.000145,0,31,0.962121,0.0373
6045,Mendocino County,,CA,4461,90205,94666,23,26,49,3050,2585,5635,6,0.339371,0.360382,4.511417,0.011556,0.010438,178,0.00024,0,31,0.886021,0.077214
6047,Merced County,,CA,12470,222257,234727,35,36,71,11342,9689,21031,6,0.340685,0.363194,295.390033,0.015998,0.015126,178,0.000372,0,31,0.813765,0.110431
6049,Modoc County,,CA,610,8697,9307,0,3,3,0,160,160,7,0.269406,0.281794,0,0,0.000563,178,0.000051,0,39,0.833333,0
6051,Mono County,,CA,1617,11457,13074,6,7,13,615,695,1310,6,0.334062,0.351969,0.538515,0.004324,0.00418,178,0.000108,0,31,0.902778,0.029311
6053,Monterey County,,CA,32538,420775,453313,81,106,187,16525,24753,41278,5,0.375194,0.410537,2519.534399,0.040393,0.045369,178,0.000846,0,31,0.437188,0.278389
6055,Napa County,,CA,9694,145585,155279,33,35,68,8530,7376,15906,6,0.341125,0.363711,26.180874,0.016711,0.015827,178,0.000339,0,31,0.89946,0.114667
6057,Nevada County,,CA,7550,104657,112207,35,34,69,6704,5378,12082,6,0.341527,0.363969,5878.757608,0.015362,0.013907,178,0.000402,0,31,0.805121,0.105588
6059,Orange County,,CA,173812,3142505,3316317,246,283,529,135011,159714,294725,5,0.442818,0.493113,51544.097039,0.104115,0.108098,178,0.002719,0,31,0.238605,0.704519
6061,Placer County,,CA,22676,302275,324951,66,60,126,32312,18616,50928,6,0.351446,0.379373,995.078239,0.026221,0.022913,178,0.000724,0,31,0.555856,0.184258
6063,Plumas County,,CA,1706,21618,23324,12,7,19,964,700,1664,6,0.294643,0.30959,1.053393,0.004916,0.001956,178,0.000167,0,31,0.924242,0.033506
6065,Riverside County,,CA,92523,1692766,1785289,192,170,362,153552,80009,233561,5,0.415748,0.456548,21737.467105,0.084402,0.071763,178,0.002136,0,31,0.321514,0.568911
6067,Sacramento County,,CA,73285,1367978,1441263,157,161,318,79238,63820,143058,5,0.411215,0.452152,28591.915439,0.068598,0.066339,178,0.001832,0,31,0.355071,0.47361
6069,San Benito County,,CA,5131,60532,65663,13,19,32,3631,3658,7289,6,0.339213,0.359263,0.038462,0.006872,0.009939,178,0.000153,0,31,0.983333,0.045634
6071,San Bernardino County,,CA,113819,1794718,1908537,186,221,407,129009,97642,226651,5,0.434796,0.479184,32544.099387,0.079951,0.086064,178,0.002086,0,31,0.280499,0.545706
6073,San Diego County,,CA,192104,3149849,3341953,431,475,906,143001,163894,306895,5,0.485862,0.546775,380906.217227,0.131308,0.135463,178,0.005353,0,31,0.120509,0.913094
6075,San Francisco County,,CA,89410,817933,907343,134,147,281,58138,81827,139965,5,0.411681,0.450459,5728.425135,0.072101,0.072855,178,0.001299,0,31,0.465455,0.473179
6077,San Joaquin County,,CA,32782,614315,647097,66,77,143,39803,26970,66773,6,0.362819,0.394238,1876.862011,0.02877,0.030869,178,0.0007,0,31,0.532989,0.199553
6079,San Luis Obispo County,,CA,15659,251451,267110,46,55,101,12687,11787,24474,6,0.346044,0.371884,99.001518,0.020789,0.021583,178,0.000464,0,31,0.685564,0.143131
6081,San Mateo County,,CA,72529,781240,853769,90,122,212,48318,66179,114497,5,0.39403,0.431405,2843.869717,0.048985,0.059225,178,0.000875,0,31,0.500308,0.326388
6083,Santa Barbara County,,CA,28621,412185,440806,67,81,148,16506,21769,38275,6,0.370078,0.402646,1931.911575,0.032727,0.035909,178,0.000731,0,31,0.552793,0.228277
6085,Santa Clara County,,CA,138619,1905506,2044125,180,231,411,77362,125972,203334,5,0.429078,0.475534,22028.524961,0.08564,0.095254,178,0.001844,0,31,0.309453,0.571877
6087,Santa Cruz County,,CA,20246,270478,290724,44,62,106,10863,16068,26931,6,0.358121,0.387316,226.168894,0.019741,0.025629,178,0.000439,0,31,0.648599,0.136439
6089,Shasta County,,CA,8525,176395,184920,53,48,101,9351,5660,15011,6,0.342898,0.367614,3003.226687,0.018643,0.016796,178,0.000643,0,31,0.573349,0.132214
6091,Sierra County,,CA,247,3407,3654,1,1,2,52,43,95,7,0.254603,0.263104,0,0.000115,0.000127,178,0.000061,0,31,0,0.000951
6093,Siskiyou County,,CA,2656,43546,46202,21,10,31,1732,1169,2901,6,0.33387,0.352141,77.615426,0.009482,0.003556,178,0.000259,0,31,0.762846,0.065942
6095,Solano County,,CA,35702,428689,464391,72,96,168,26361,28476,54837,6,0.375145,0.410118,3378.384041,0.03474,0.038363,178,0.000778,0,31,0.457772,0.243451
6097,Sonoma County,,CA,27298,509886,537184,56,82,138,18377,21560,39937,6,0.368014,0.400637,792.0085,0.027508,0.031077,178,0.000566,0,31,0.521429,0.189486
6099,Stanislaus County,,CA,24826,495929,520755,57,69,126,25996,19821,45817,6,0.361239,0.391736,1486.5613,0.024898,0.027452,178,0.000615,0,31,0.550526,0.174906
6101,Sutter County,,CA,6065,84642,90707,26,21,47,5831,4219,10050,6,0.3358,0.355745,234.670127,0.011216,0.00888,178,0.000295,0,31,0.868817,0.077234
6103,Tehama County,,CA,3068,50058,53126,18,8,26,2525,1471,3996,6,0.328136,0.345386,79.616622,0.007574,0.003293,178,0.000243,0,31,0.80719,0.05082
6105,Trinity County,,CA,770,11275,12045,4,2,6,369,322,691,7,0.255769,0.265394,0,0.001627,0.000298,178,0.000085,0,31,1,0.010218
6107,Tulare County,,CA,14514,371982,386496,41,39,80,13148,10276,23424,6,0.347452,0.371597,60.183611,0.019111,0.018033,178,0.000424,0,31,0.807611,0.131486
6109,Tuolumne County,,CA,3207,55531,58738,20,18,38,2869,1893,4762,6,0.338777,0.358701,222.599455,0.010054,0.00848,178,0.000235,0,31,0.885281,0.067597
6111,Ventura County,,CA,45663,848517,894180,106,126,232,36084,36606,72690,5,0.388703,0.426779,3507.211894,0.054875,0.053674,178,0.001097,0,31,0.423772,0.375524
6113,Yolo County,,CA,16696,172676,189372,42,44,86,12377,13195,25572,6,0.342574,0.366523,480.546297,0.018545,0.018617,178,0.00044,0,31,0.806738,0.128327
6115,Yuba County,,CA,7271,56704,63975,21,15,36,4774,4074,8848,6,0.341085,0.361082,25.485599,0.00814,0.007535,178,0.000236,0,31,0.833333,0.054929
8001,Adams County,,CO,47673,397660,445333,72,87,159,41909,38870,80779,6,0.385606,0.418446,14768.671197,0.03299,0.036469,100,0.000972,0,31,0.410372,0.228817
8003,Alamosa County,,CO,1582,14855,16437,7,8,15,669,727,1396,6,0.33257,0.350385,8771.399845,0.001868,0.003542,100,0.000232,0,31,0.5,0.013003
8005,Arapahoe County,,CO,72002,553889,625891,140,157,297,59780,60937,120717,5,0.423385,0.461226,45935.082601,0.068144,0.072775,100,0.001734,0,31,0.382149,0.465342
8007,Archuleta County,,CO,1088,10535,11623,5,1,6,286,110,396,7,0.253824,0.261887,0,0.0033,0.000075,100,0.000111,0,31,0.95,0.023706
8009,Baca County,,CO,392,4546,4938,0,1,1,0,42,42,7,0.236217,0.242047,0,0,0.000001,100,0.000051,0,40,0,0
8011,Bent County,,CO,496,5436,5932,2,3,5,132,187,319,7,0.258847,0.268016,0.666667,0.000014,0.000104,100,0.00013,0,31,0.833333,0.000276
8013,Boulder County,,CO,33140,298214,331354,100,109,209,19186,24627,43813,5,0.396342,0.43199,11288.107559,0.054367,0.053974,100,0.001139,0,31,0.465534,0.362652
8014,Broomfield County,,CO,6928,43140,50068,14,11,25,6219,5085,11304,6,0.333908,0.352181,0,0.008879,0.005985,100,0.000192,0,31,0.995238,0.06053
8015,Chaffee County,,CO,1579,17121,18700,7,7,14,508,474,982,6,0.332532,0.350212,3018.566306,0.002125,0.002586,100,0.000135,0,31,0.590909,0.014638
8017,Cheyenne County,,CO,256,2234,2490,0,0,0,0,0,0,0,0,0,0,0,0,4,0.000051,5,41,0,0
8019,Clear Creek County,,CO,1391,11294,12685,4,3,7,631,531,1162,6,0.30291,0.315576,0,0.001944,0.001535,100,0.000088,0,31,1,0.012459
8021,Conejos County,,CO,469,8126,8595,1,1,2,106,155,261,7,0.249592,0.256805,0,0.000029,0.000015,100,0.000075,0,31,0,0.000198
8023,Costilla County,,CO,298,3389,3687,0,1,1,0,68,68,7,0.249635,0.256889,0,0,0.000015,100,0.000051,0,42,0,0
8025,Crowley County,,CO,331,3422,3753,2,2,4,135,114,249,7,0.258824,0.267844,0,0.000099,0.000103,100,0.000099,0,31,1,0.00093
8027,Custer County,,CO,353,3695,4048,2,3,5,129,166,295,6,0.309133,0.322354,0,0.000131,0.000859,100,0.000086,0,31,1,0.001025
8029,Delta County,,CO,2125,28816,30941,9,3,12,1005,763,1768,7,0.256017,0.264779,2.435848,0.002579,0.00021,100,0.000176,0,31,0.888889,0.017955
8031,Denver County,,CO,86120,531097,617217,143,148,291,62157,76246,138403,5,0.424004,0.461031,52443.732351,0.068648,0.068564,100,0.001784,0,31,0.375044,0.460432
8033,Dolores County,,CO,226,1906,2132,0,0,0,0,0,0,0,0,0,0,0,0,5,0.000051,6,43,0,0
8035,Douglas County,,CO,24556,234815,259371,85,75,160,29221,17651,46872,5,0.392751,0.424042,5200.588367,0.047092,0.041655,100,0.001001,0,31,0.571639,0.326099
8037,Eagle County,,CO,6283,45243,51526,21,25,46,2515,2944,5459,6,0.353672,0.376848,2686.005014,0.011041,0.012371,100,0.00029,0,31,0.733618,0.07647
8039,Elbert County,,CO,2117,18847,20964,6,9,15,1521,1174,2695,6,0.314218,0.328633,2945,0.003009,0.003356,100,0.000111,0,31,0.791667,0.020406
8041,El Paso County,,CO,55206,597405,652611,246,241,487,36747,37130,73877,5,0.446976,0.490932,164891.004545,0.089746,0.087318,100,0.003285,0,31,0.215643,0.624631
8043,Fremont County,,CO,3274,40437,43711,11,10,21,1493,1311,2804,6,0.337439,0.356152,472.925983,0.00313,0.004635,100,0.000193,0,31,0.653846,0.021296
8045,Garfield County,,CO,4363,43871,48234,17,18,35,2159,2201,4360,6,0.342251,0.362316,1218.324662,0.007095,0.008431,100,0.000297,0,31,0.760234,0.049928
8047,Gilpin County,,CO,800,4923,5723,5,3,8,468,370,838,6,0.301026,0.313837,0,0.00239,0.001421,100,0.000097,0,31,1,0.015454
8049,Grand County,,CO,1658,12981,14639,7,6,13,615,420,1035,6,0.303829,0.317298,0,0.002759,0.002548,100,0.000118,0,31,1,0.018043
8051,Gunnison County,,CO,1798,13133,14931,6,8,14,308,409,717,6,0.314388,0.328908,3.310848,0.002187,0.002627,100,0.000138,0,31,0.803571,0.015284
8053,Hinsdale County,,CO,119,749,868,0,0,0,0,0,0,0,0,0,0,0,0,6,0.000051,7,44,0,0
8055,Huerfano County,,CO,560,6484,7044,1,2,3,57,192,249,7,0.258824,0.267844,0,0.000092,0.00011,100,0.00007,0,31,1,0.000757
8057,Jackson County,,CO,206,1672,1878,0,0,0,0,0,0,0,0,0,0,0,0,7,0.000051,8,45,0,0
8059,Jefferson County,,CO,60972,569126,630098,103,131,234,44136,50694,94830,5,0.414739,0.450935,30235.569045,0.049122,0.057731,100,0.001332,0,31,0.379905,0.339142
8061,Kiowa County,,CO,166,1962,2128,0,0,0,0,0,0,0,0,0,0,0,0,8,0.000051,9,46,0,0
8063,Kit Carson County,,CO,644,8610,9254,0,1,1,0,41,41,6,0.308977,0.321842,0,0,0.000741,100,0.000051,0,47,0,0
8065,Lake County,,CO,909,6836,7745,2,4,6,105,254,359,6,0.293363,0.305469,0.733333,0.000178,0.000571,100,0.000069,0,31,0.583333,0.001187
8067,La Plata County,,CO,4228,45756,49984,18,19,37,1698,1799,3497,6,0.340126,0.360801,3041.849395,0.009041,0.008007,100,0.000365,0,31,0.658009,0.064515
8069,Larimer County,,CO,24533,285077,309610,84,85,169,15912,15836,31748,5,0.379509,0.41293,18488.854297,0.035376,0.035541,100,0.001181,0,31,0.409914,0.246551
8071,Las Animas County,,CO,1122,15229,16351,7,4,11,403,320,723,6,0.310588,0.324128,253.035189,0.002206,0.001109,100,0.000155,0,31,0.571429,0.014863
8073,Lincoln County,,CO,428,4842,5270,1,1,2,56,51,107,6,0.308969,0.321838,0,0.000028,0.000741,100,0.000061,0,31,1,0.00025
8075,Logan County,,CO,1667,22377,24044,12,10,22,767,691,1458,6,0.314354,0.328977,7010.77653,0.003566,0.002812,100,0.000265,0,31,0.570513,0.024317
8077,Mesa County,,CO,7676,133442,141118,38,29,67,5604,3783,9387,6,0.343872,0.365846,13269.102601,0.013879,0.011651,100,0.000647,0,31,0.45,0.09931
8079,Mineral County,,CO,70,809,879,0,0,0,0,0,0,0,0,0,0,0,0,9,0.000051,10,48,0,0
8081,Moffat County,,CO,1291,14350,15641,2,3,5,230,311,541,7,0.255972,0.264665,0.93456,0.000122,0.000139,100,0.000082,0,31,0.5,0.00116
8083,Montezuma County,,CO,1827,24002,25829,8,6,14,656,568,1224,6,0.329326,0.34682,30.743344,0.002283,0.001759,100,0.000164,0,31,0.625,0.017257
8085,Montrose County,,CO,2567,37258,39825,14,12,26,1309,1147,2456,6,0.334062,0.352525,12216.502555,0.004503,0.004063,100,0.000367,0,31,0.591667,0.031809
8087,Morgan County,,CO,2152,29232,31384,9,7,16,904,869,1773,6,0.302532,0.315645,2119.97922,0.002849,0.00185,100,0.000186,0,31,0.777778,0.018933
8089,Otero County,,CO,1424,20004,21428,5,5,10,400,567,967,6,0.309232,0.322756,3618.142953,0.001381,0.000834,100,0.000171,0,31,0.466667,0.010005
8091,Ouray County,,CO,485,3303,3788,1,1,2,53,140,193,7,0.250431,0.257815,0,0.000034,0.000037,100,0.000077,0,31,0,0.000356
8093,Park County,,CO,2110,16134,18244,8,10,18,1442,1103,2545,6,0.314218,0.328748,7.352184,0.00311,0.003046,100,0.00013,0,31,0.711111,0.021035
8095,Phillips County,,CO,412,4474,4886,0,1,1,0,70,70,7,0.239232,0.24542,0,0,0.000029,100,0.000051,0,49,0,0
8097,Pitkin County,,CO,1821,12529,14350,4,5,9,483,708,1191,6,0.329513,0.34674,0,0.001183,0.002254,100,0.000094,0,31,1,0.00802
8099,Prowers County,,CO,1049,13860,14909,4,3,7,184,234,418,6,0.309166,0.322412,3159.542599,0.0001,0.000833,100,0.000179,0,31,0.45,0.001111
8101,Pueblo County,,CO,7457,154293,161750,30,27,57,4916,4106,9022,6,0.34908,0.372331,21182.426731,0.011125,0.011205,100,0.000609,0,31,0.418004,0.08007
8103,Rio Blanco County,,CO,694,6182,6876,2,1,3,141,104,245,7,0.255904,0.264263,0,0.000097,0.000115,100,0.000093,0,31,1,0.001016
8105,Rio Grande County,,CO,1286,16311,17597,4,4,8,352,363,715,6,0.312057,0.325758,0,0.001409,0.001415,100,0.000116,0,31,1,0.010012
8107,Routt County,,CO,2129,20788,22917,9,10,19,688,718,1406,6,0.304116,0.318274,632.50981,0.002862,0.003143,100,0.000151,0,31,0.809091,0.018855
8109,Saguache County,,CO,254,2287,2541,1,0,1,46,0,46,0,0,0,0,0.000021,0,100,0.000067,0,22,0,0.000211
8111,San Juan County,,CO,85,627,712,0,0,0,0,0,0,0,0,0,0,0,0,10,0.000051,11,50,0,0
8113,San Miguel County,,CO,978,6452,7430,1,1,2,43,68,111,7,0.250431,0.257815,0,0.000034,0.000037,100,0.000077,0,31,0,0.000356
8115,Sedgwick County,,CO,248,2818,3066,0,0,0,0,0,0,0,0,0,0,0,0,11,0.000051,12,51,0,0
8117,Summit County,,CO,4365,25537,29902,13,19,32,1419,1841,3260,6,0.343181,0.363636,1447.934522,0.006847,0.009163,100,0.000188,0,31,0.728947,0.047405
8119,Teller County,,CO,2866,21071,23937,3,7,10,1264,1409,2673,6,0.332341,0.349925,7.383512,0.00109,0.003022,100,0.000085,0,31,0.857143,0.008206
8121,Washington County,,CO,342,4028,4370,2,2,4,118,116,234,7,0.239229,0.245562,0,0.000038,0.000053,100,0.000096,0,31,1,0.000537
8123,Weld County,,CO,16342,203943,220285,34,33,67,15545,10483,26028,6,0.357327,0.38253,4901.652081,0.015372,0.017227,100,0.00052,0,31,0.590385,0.108323
8125,Yuma County,,CO,717,10365,11082,2,3,5,109,161,270,6,0.275417,0.287368,0,0.000165,0.000448,100,0.000087,0,31,1,0.00127
9001,Fairfield County,,CT,51189,989490,1040679,130,181,311,35041,42979,78020,5,0.404964,0.449001,9554.585636,0.072372,0.085536,102,0.001231,0,31,0.399551,0.470487
9003,Hartford County,,CT,41356,1027899,1069255,130,147,277,32516,33582,66098,6,0.397699,0.438407,8321.479817,0.070218,0.07457,102,0.001267,0,31,0.452903,0.463659
9005,Litchfield County,,CT,10774,223698,234472,17,25,42,8625,6872,15497,6,0.344648,0.366604,64.310283,0.01073,0.014157,102,0.000167,0,31,0.773563,0.063754
9007,Middlesex County,,CT,11980,192687,204667,22,23,45,10094,8257,18351,6,0.339808,0.361433,84.943496,0.013287,0.0132,102,0.000208,0,31,0.793103,0.079495
9009,New Haven County,,CT,40276,948035,988311,121,148,269,33810,32691,66501,6,0.394619,0.435606,4664.126947,0.067766,0.075015,102,0.00114,0,31,0.475081,0.440545
9011,New London County,,CT,18506,305384,323890,74,72,146,12123,11716,23839,6,0.361104,0.391512,1459.177692,0.039218,0.036304,102,0.000681,0,31,0.511337,0.250108
9013,Tolland County,,CT,10312,154137,164449,16,15,31,8885,7154,16039,6,0.332722,0.352273,14.074058,0.007184,0.007546,102,0.000163,0,31,0.857895,0.042236
9015,Windham County,,CT,6618,128076,134694,10,15,25,4794,4324,9118,6,0.310621,0.32838,3.343176,0.003465,0.006287,102,0.00012,0,31,0.75,0.019804
10001,Kent County,,DE,8856,151911,160767,34,25,59,6480,2940,9420,6,0.345016,0.367459,945.925177,0.015845,0.011875,126,0.000393,0,31,0.565854,0.100459
10003,New Castle County,,DE,26154,586162,612316,95,101,196,17988,18225,36213,6,0.385248,0.42061,5350.979804,0.05512,0.055273,126,0.000909,0,31,0.594959,0.356586
10005,Sussex County,,DE,7854,183534,191388,44,24,68,7605,3926,11531,6,0.320636,0.341179,4029.486896,0.016596,0.010086,126,0.000551,0,31,0.52029,0.107364
11001,District of Columbia,,DC,64815,554232,619047,148,140,288,42509,55382,97891,6,0.407751,0.446447,9823.741515,0.080442,0.073726,47,0.001508,0,31,0.446781,0.526609
12001,Alachua County,,FL,20482,210387,230869,74,78,152,12844,14446,27290,6,0.38653,0.418802,12300.016589,0.036899,0.044561,102,0.001176,0,31,0.56367,0.281076
12003,Baker County,,FL,1699,23401,25100,5,5,10,1003,1004,2007,6,0.302752,0.316741,2.47549,0.00109,0.001249,102,0.000145,0,31,0.666667,0.009179
12005,Bay County,,FL,13093,166084,179177,71,66,137,7098,6481,13579,6,0.367223,0.398031,27109.10285,0.031423,0.030703,102,0.001123,0,31,0.402566,0.236639
12007,Bradford County,,FL,1557,21285,22842,5,5,10,1161,878,2039,6,0.302847,0.316913,0.35,0.001426,0.00151,102,0.000139,0,31,0.866667,0.011131
12009,Brevard County,,FL,28454,555380,583834,203,130,333,28231,17505,45736,6,0.400773,0.438963,18301.662058,0.093597,0.067276,102,0.002317,0,31,0.363225,0.638816
12011,Broward County,,FL,122185,1781062,1903247,271,298,569,115085,109044,224129,5,0.447596,0.49841,76802.988457,0.112397,0.114573,102,0.003067,0,31,0.230822,0.771199
12013,Calhoun County,,FL,692,10709,11401,3,3,6,327,344,671,7,0.268715,0.280028,14.233003,0.000265,0.000293,102,0.000131,0,31,0.333333,0.002425
12015,Charlotte County,,FL,11866,152976,164842,77,27,104,10271,6383,16654,6,0.337871,0.360273,365.816612,0.039613,0.016964,102,0.000806,0,31,0.581944,0.260011
12017,Citrus County,,FL,7754,126412,134166,49,21,70,6622,3605,10227,6,0.316754,0.335859,1042.77632,0.026598,0.012591,102,0.00069,0,31,0.714694,0.190388
12019,Clay County,,FL,17911,173998,191909,63,47,110,15595,12093,27688,6,0.360253,0.38758,2666.007083,0.031663,0.024946,102,0.000918,0,31,0.582748,0.239233
12021,Collier County,,FL,19702,285333,305035,132,72,204,19657,12215,31872,6,0.38433,0.415989,2992.653685,0.069294,0.041128,102,0.001362,0,31,0.474068,0.454395
12023,Columbia County,,FL,3976,55202,59178,22,19,41,3241,2225,5466,6,0.316719,0.335572,857.857438,0.008069,0.009248,102,0.000473,0,31,0.543333,0.065176
12027,DeSoto County,,FL,2089,26794,28883,8,8,16,1019,959,1978,6,0.306977,0.321832,3.299972,0.002759,0.003923,102,0.000196,0,31,0.902778,0.027029
12029,Dixie County,,FL,1055,12855,13910,4,5,9,333,464,797,7,0.280498,0.292651,71.724374,0.001709,0.000944,102,0.000126,0,31,0.809524,0.013716
12031,Duval County,,FL,62797,887186,949983,269,217,486,54733,48829,103562,5,0.433821,0.478243,148217.743088,0.104791,0.093736,102,0.003477,0,31,0.251054,0.727522
12033,Escambia County,,FL,32537,308914,341451,124,118,242,17460,21588,39048,5,0.392062,0.429104,20575.974216,0.06051,0.052819,102,0.001584,0,31,0.384632,0.439383
12035,Flagler County,,FL,4607,67555,72162,42,13,55,6537,2341,8878,6,0.31603,0.333792,15.627298,0.024609,0.008713,102,0.000448,0,31,0.737514,0.158546
12037,Franklin County,,FL,761,9465,10226,2,4,6,138,279,417,7,0.281395,0.293512,15.417533,0.000575,0.000548,102,0.000081,0,31,0.666667,0.004252
12039,Gadsden County,,FL,3136,47715,50851,7,6,13,1760,2024,3784,6,0.309298,0.32395,792.755743,0.002782,0.001293,102,0.000198,0,31,0.375,0.021868
12041,Gilchrist County,,FL,1092,12743,13835,4,4,8,593,573,1166,7,0.278963,0.290614,1.72488,0.000485,0.000444,102,0.00013,0,31,0.75,0.003664
12043,Glades County,,FL,1145,10418,11563,7,6,13,713,598,1311,6,0.311054,0.326773,1.681919,0.002858,0.002734,102,0.000143,0,31,0.880952,0.02266
12045,Gulf County,,FL,953,11967,12920,2,2,4,365,423,788,7,0.281341,0.293168,0,0.000258,0.000543,102,0.000082,0,31,1,0.002127
12047,Hamilton County,,FL,983,11569,12552,4,4,8,401,473,874,6,0.30348,0.317665,16.158323,0.000987,0.001094,102,0.000144,0,31,0.666667,0.008004
12049,Hardee County,,FL,1958,23366,25324,5,6,11,608,1041,1649,6,0.308969,0.323404,2.627896,0.001693,0.00256,102,0.000138,0,31,0.966667,0.015589
12051,Hendry County,,FL,2976,33531,36507,8,11,19,1371,1727,3098,6,0.320035,0.337242,14.52035,0.004524,0.006846,102,0.000157,0,31,0.836364,0.034056
12053,Hernando County,,FL,9062,143768,152830,52,25,77,10381,5137,15518,6,0.343669,0.365691,81.138775,0.029104,0.016194,102,0.000611,0,31,0.733403,0.197345
12055,Highlands County,,FL,5889,84722,90611,30,27,57,3599,2827,6426,6,0.319016,0.338499,201.590368,0.013123,0.014452,102,0.000508,0,31,0.69254,0.109209
12057,Hillsborough County,,FL,79672,1143094,1222766,310,258,568,76411,65702,142113,5,0.446014,0.492545,129362.51189,0.117551,0.105838,102,0.003702,0,31,0.217094,0.81015
12059,Holmes County,,FL,1409,19210,20619,7,6,13,923,828,1751,7,0.269438,0.281486,111.079765,0.000653,0.000348,102,0.000205,0,31,0.47619,0.005967
12061,Indian River County,,FL,7865,128806,136671,44,21,65,6317,3641,9958,6,0.338896,0.359286,33.040353,0.026003,0.014031,102,0.000527,0,31,0.775362,0.181178
12063,Jackson County,,FL,2902,43818,46720,11,8,19,1187,1266,2453,6,0.286786,0.301165,453.594577,0.003691,0.001109,102,0.000266,0,31,0.445455,0.026932
12065,Jefferson County,,FL,1040,14343,15383,2,2,4,585,584,1169,7,0.27747,0.288376,0,0.000325,0.000288,102,0.000107,0,31,1,0.002374
12067,Lafayette County,,FL,402,4539,4941,1,1,2,61,81,142,7,0.232823,0.239192,0,0.000015,0.000057,102,0.000094,0,31,0,0.000512
12069,Lake County,,FL,19503,255375,274878,108,36,144,23147,11963,35110,6,0.352813,0.377485,558.094691,0.05842,0.022103,102,0.001211,0,31,0.586881,0.393292
12071,Lee County,,FL,29165,504798,533963,231,125,356,37300,18455,55755,6,0.405984,0.443188,19883.471256,0.093703,0.063783,102,0.002504,0,31,0.289765,0.624681
12073,Leon County,,FL,21005,237853,258858,78,74,152,14066,14754,28820,6,0.383822,0.414876,53209.034835,0.034393,0.038922,102,0.001385,0,31,0.469663,0.268783
12075,Levy County,,FL,2947,34744,37691,14,10,24,2059,1607,3666,6,0.309958,0.325608,291.279717,0.007085,0.004059,102,0.000277,0,31,0.770833,0.056461
12077,Liberty County,,FL,429,5729,6158,3,3,6,224,248,472,7,0.27747,0.288519,19.256134,0.000334,0.000309,102,0.000132,0,31,0.333333,0.002624
12079,Madison County,,FL,871,17280,18151,5,4,9,286,290,576,7,0.279688,0.291681,48.674439,0.00047,0.000449,102,0.000189,0,31,0.3,0.003841
12081,Manatee County,,FL,21109,298221,319330,126,59,185,20221,12773,32994,6,0.382306,0.412856,3443.356374,0.06764,0.035263,102,0.001405,0,31,0.536227,0.456941
12083,Marion County,,FL,16312,280333,296645,120,52,172,18443,8750,27193,6,0.363545,0.391449,2565.78045,0.061778,0.028491,102,0.001425,0,31,0.529701,0.424479
12085,Martin County,,FL,12199,146040,158239,49,32,81,11179,7732,18911,6,0.345509,0.368274,233.24201,0.028616,0.019433,102,0.000525,0,31,0.688596,0.188799
12086,Miami-Dade County,,FL,117974,2423966,2541940,199,247,446,67099,105538,172637,5,0.44363,0.48886,58457.933153,0.096655,0.104646,102,0.002219,0,31,0.300505,0.660945
12087,Monroe County,,FL,10483,81712,92195,31,38,69,3953,5507,9460,6,0.352,0.376596,41.008024,0.020265,0.022764,102,0.000426,0,31,0.757005,0.152631
12089,Nassau County,,FL,5465,68917,74382,12,8,20,3363,3066,6429,6,0.311555,0.326814,92.544378,0.005291,0.003082,102,0.000245,0,31,0.608974,0.041824
12091,Okaloosa County,,FL,20799,196507,217306,100,80,180,12309,11626,23935,6,0.388859,0.42166,12974.314006,0.046051,0.038679,102,0.001312,0,31,0.430768,0.335992
12093,Okeechobee County,,FL,2429,30786,33215,7,10,17,1157,944,2101,6,0.31449,0.330733,4.938054,0.003099,0.004895,102,0.000149,0,31,0.866667,0.022843
12095,Orange County,,FL,96430,1017432,1113862,274,242,516,89606,83055,172661,5,0.440334,0.486111,52083.552371,0.112824,0.106108,102,0.003167,0,31,0.261994,0.774783
12097,Osceola County,,FL,22268,200139,222407,87,47,134,24486,15834,40320,6,0.35905,0.385744,315.26434,0.049163,0.030096,102,0.000897,0,31,0.627303,0.32332
12099,Palm Beach County,,FL,71554,1265467,1337021,243,235,478,81771,59274,141045,5,0.428951,0.476022,46271.64698,0.1043,0.100574,102,0.002708,0,31,0.283832,0.710991
12101,Pasco County,,FL,27671,368121,395792,141,66,207,37363,18638,56001,6,0.375145,0.406566,3027.745711,0.069467,0.037294,102,0.001515,0,31,0.457134,0.462279
12103,Pinellas County,,FL,63858,992263,1056121,285,222,507,53758,50270,104028,5,0.434991,0.47958,66242.106053,0.112471,0.096725,102,0.003271,0,31,0.243734,0.767793
12105,Polk County,,FL,29151,526314,555465,146,81,227,26747,17550,44297,6,0.385248,0.418371,7639.38905,0.069432,0.045561,102,0.001734,0,31,0.435717,0.473903
12107,Putnam County,,FL,4339,69185,73524,16,15,31,2632,2592,5224,6,0.315241,0.332857,22.703111,0.008241,0.007998,102,0.000315,0,31,0.882353,0.068801
12109,St. Johns County,,FL,12077,142949,155026,63,25,88,12528,7375,19903,6,0.346003,0.368406,337.070414,0.037055,0.015865,102,0.000846,0,31,0.695853,0.268131
12111,St. Lucie County,,FL,14499,217552,232051,83,34,117,17983,8576,26559,6,0.344361,0.367109,439.400951,0.045877,0.019049,102,0.000866,0,31,0.642717,0.302246
12113,Santa Rosa County,,FL,12222,129809,142031,64,31,95,10641,6871,17512,6,0.353586,0.377893,2326.649404,0.032354,0.017277,102,0.000876,0,31,0.578322,0.239705
12115,Sarasota County,,FL,25595,364208,389803,158,84,242,25153,17302,42455,5,0.393763,0.426504,4915.085191,0.077218,0.049808,102,0.001655,0,31,0.440483,0.510488
12117,Seminole County,,FL,46795,410106,456901,134,103,237,39628,38239,77867,5,0.398901,0.433557,4983.650515,0.073374,0.059882,102,0.001601,0,31,0.51043,0.503057
12119,Sumter County,,FL,3781,49056,52837,16,10,26,2635,2208,4843,6,0.312191,0.328082,0,0.008577,0.006035,102,0.000308,0,31,0.970588,0.072537
12121,Suwannee County,,FL,2665,34570,37235,14,7,21,1543,1217,2760,6,0.303448,0.318061,6107.892581,0.006962,0.001822,102,0.000353,0,31,0.633333,0.053577
12123,Taylor County,,FL,984,19582,20566,1,3,4,94,186,280,6,0.30402,0.317757,0,0.000321,0.001153,102,0.000067,0,31,0.666667,0.002248
12125,Union County,,FL,825,10264,11089,6,5,11,601,501,1102,6,0.302847,0.316913,0.888239,0.001447,0.001509,102,0.000163,0,31,0.833333,0.011281
12127,Volusia County,,FL,29777,477066,506843,161,97,258,28898,19101,47999,6,0.39591,0.430418,4622.334469,0.080163,0.055441,102,0.001755,0,31,0.452417,0.540529
12129,Wakulla County,,FL,1879,23392,25271,3,2,5,1375,969,2344,7,0.281341,0.293168,0.871993,0.000337,0.000543,102,0.000112,0,31,0.666667,0.002635
12131,Walton County,,FL,3571,37702,41273,9,7,16,2415,1769,4184,6,0.289329,0.303725,91.532284,0.002582,0.001702,102,0.000195,0,31,0.583333,0.02067
12133,Washington County,,FL,1480,18829,20309,3,3,6,883,793,1676,7,0.268715,0.280028,0,0.000265,0.000295,102,0.000122,0,31,1,0.002459
13001,Appling County,,GA,870,18193,19063,4,3,7,293,215,508,7,0.234401,0.241467,261.861072,0.000015,0.000012,12,0.000183,0,31,0,0.000475
13003,Atkinson County,,GA,419,7890,8309,1,1,2,174,151,325,7,0.233272,0.239801,0,0.000008,0.000001,102,0.00009,0,31,0,0.000119
13005,Bacon County,,GA,595,10824,11419,3,4,7,270,318,588,7,0.23361,0.240862,23.51852,0.000016,0.000016,102,0.000181,0,31,0.333333,0.000382
13007,Baker County,,GA,219,3949,4168,5,1,6,435,69,504,7,0.244712,0.25319,178.514224,0.000065,0.000076,12,0.000172,0,31,0.45,0.001037
13009,Baldwin County,,GA,2729,43618,46347,9,13,22,1060,1530,2590,6,0.312124,0.328323,8605.760138,0.001614,0.003865,12,0.000339,0,31,0.448718,0.012849
13011,Banks County,,GA,1715,17019,18734,8,7,15,1536,1218,2754,6,0.300403,0.314675,68.898295,0.000824,0.000904,12,0.000256,0,31,0.696429,0.00729
13013,Barrow County,,GA,4702,52334,57036,13,13,26,5142,2911,8053,6,0.311154,0.326974,341.321435,0.003555,0.003587,12,0.00029,0,31,0.638095,0.028365
13015,Bartow County,,GA,7410,98056,105466,21,16,37,6065,4283,10348,6,0.312661,0.329322,1026.845084,0.008016,0.004115,12,0.000414,0,31,0.547431,0.062684
13017,Ben Hill County,,GA,1221,18656,19877,3,4,7,408,444,852,7,0.233816,0.241253,137.793592,0.000008,0.000003,12,0.000192,0,31,0.416667,0.000312
13019,Berrien County,,GA,1311,16592,17903,4,7,11,620,760,1380,7,0.255207,0.26546,758.653619,0.000132,0.000111,12,0.000195,0,31,0.5,0.001202
13021,Bibb County,,GA,10960,171449,182409,30,27,57,5335,6773,12108,6,0.322237,0.343434,15062.063274,0.008114,0.007653,12,0.000723,0,31,0.348485,0.060857
13023,Bleckley County,,GA,795,13563,14358,6,5,11,433,460,893,7,0.267182,0.27802,711.882381,0.000222,0.000273,12,0.000262,0,31,0.566667,0.002616
13025,Brantley County,,GA,1255,17764,19019,7,5,12,832,731,1563,7,0.2569,0.266432,38.99499,0.00092,0.000136,102,0.000241,0,31,0.547619,0.007629
13027,Brooks County,,GA,2148,19488,21636,4,5,9,1052,1085,2137,6,0.303512,0.317837,170.292414,0.000142,0.000984,12,0.000136,0,31,0.533333,0.001273
13029,Bryan County,,GA,3268,27609,30877,5,5,10,2053,1557,3610,7,0.285377,0.297599,44.214113,0.001411,0.000548,12,0.000127,0,31,0.633333,0.009728
13031,Bulloch County,,GA,3326,45809,49135,16,17,33,1928,1613,3541,6,0.313539,0.330556,18595.574138,0.003091,0.004211,12,0.000441,0,31,0.334211,0.022507
13033,Burke County,,GA,1884,29801,31685,7,6,13,1239,1178,2417,7,0.272293,0.283738,557.550645,0.000421,0.000424,104,0.000244,0,31,0.309524,0.003684
13035,Butts County,,GA,1966,22855,24821,10,10,20,1831,1306,3137,6,0.306977,0.322021,428.309585,0.002649,0.002195,12,0.000243,0,31,0.672727,0.020935
13037,Calhoun County,,GA,696,6075,6771,3,3,6,196,411,607,7,0.244939,0.253908,43.593472,0.000064,0.000077,12,0.000112,0,31,0.5,0.000829
13039,Camden County,,GA,7911,45334,53245,17,22,39,3103,4031,7134,6,0.341687,0.362753,2536.081832,0.006879,0.009718,102,0.000309,0,31,0.597826,0.052909
13043,Candler County,,GA,631,9228,9859,3,3,6,322,256,578,7,0.239466,0.247121,1.43629,0.00004,0.000031,12,0.000124,0,31,0.833333,0.000527
13045,Carroll County,,GA,6766,99122,105888,23,19,42,7222,4307,11529,6,0.311822,0.328811,5609.450968,0.005084,0.004326,12,0.00046,0,31,0.467391,0.040344
13047,Catoosa County,,GA,4813,58266,63079,7,7,14,4498,3392,7890,6,0.3062,0.320357,307.548397,0.000953,0.001118,146,0.000214,0,31,0.625,0.007999
13049,Charlton County,,GA,675,9027,9702,3,5,8,320,357,677,6,0.302721,0.316684,0.734142,0.000879,0.000982,102,0.000102,0,31,0.65,0.006952
13051,Chatham County,,GA,19870,238429,258299,83,86,169,9841,11968,21809,6,0.395748,0.428662,45732.146586,0.039715,0.041774,12,0.001182,0,31,0.441809,0.283212
13053,Chattahoochee County,,GA,350,3114,3464,1,1,2,139,175,314,7,0.279258,0.290677,0,0.000282,0.000277,12,0.000063,0,31,0,0.002051
13055,Chattooga County,,GA,1087,26563,27650,5,3,8,777,511,1288,7,0.238482,0.245956,8.49911,0.000059,0.000032,12,0.000178,0,31,0.45,0.001021
13057,Cherokee County,,GA,16191,181670,197861,49,44,93,16736,11102,27838,6,0.359184,0.386214,13886.433851,0.023753,0.020241,12,0.000847,0,31,0.499153,0.180784
13059,Clarke County,,GA,12145,91289,103434,43,40,83,6081,7161,13242,6,0.352171,0.377152,25103.15314,0.013507,0.01256,12,0.000911,0,31,0.360408,0.103635
13061,Clay County,,GA,245,3238,3483,1,0,1,63,0,63,0,0,0,0,0.000001,0,12,0.000071,0,29,0,0.000094
13063,Clayton County,,GA,35675,248535,284210,92,69,161,30207,29419,59626,6,0.385811,0.416799,28083.926716,0.044638,0.028638,12,0.001227,0,31,0.396844,0.304168
13065,Clinch County,,GA,306,6749,7055,2,2,4,91,84,175,7,0.23329,0.23999,4.439286,0.00013,0.000009,12,0.000105,0,31,0.5,0.00103
13067,Cobb County,,GA,76016,668174,744190,234,218,452,60014,65497,125511,5,0.437679,0.480653,107743.343522,0.098337,0.092402,12,0.00297,0,31,0.271639,0.67515
13069,Coffee County,,GA,2068,36475,38543,9,9,18,721,732,1453,6,0.304211,0.31933,26892.338121,0.000139,0.000978,102,0.000414,0,31,0.188889,0.001734
13071,Colquitt County,,GA,2351,42095,44446,10,9,19,951,1078,2029,7,0.256356,0.267457,97.549608,0.000226,0.000201,12,0.000291,0,31,0.455556,0.002465
13073,Columbia County,,GA,10681,119122,129803,35,31,66,7881,6017,13898,6,0.342817,0.366374,14086.413031,0.014344,0.014071,104,0.000598,0,31,0.499325,0.105145
13075,Cook County,,GA,1221,16957,18178,4,4,8,598,637,1235,7,0.255095,0.264857,0.47619,0.000133,0.000109,12,0.000147,0,31,0.916667,0.001224
13077,Coweta County,,GA,8115,104802,112917,27,17,44,6969,4450,11419,6,0.318037,0.335445,2071.815056,0.010005,0.004638,12,0.000463,0,31,0.480296,0.073203
13079,Crawford County,,GA,1119,13734,14853,4,3,7,780,650,1430,7,0.266838,0.27721,1.42838,0.000216,0.000266,12,0.00015,0,31,0.666667,0.002336
13081,Crisp County,,GA,1516,22526,24042,6,8,14,410,638,1048,7,0.267502,0.279259,6809.061913,0.000083,0.000276,12,0.000238,0,31,0.303571,0.001148
13083,Dade County,,GA,1154,15616,16770,6,5,11,805,663,1468,7,0.274221,0.285584,11.585781,0.000237,0.000253,146,0.0002,0,31,0.533333,0.002482
13085,Dawson County,,GA,1804,18333,20137,8,6,14,1858,1132,2990,6,0.306847,0.321666,0.769996,0.003297,0.002051,12,0.000187,0,31,0.928571,0.025217
13087,Decatur County,,GA,1582,28036,29618,6,6,12,725,579,1304,7,0.278936,0.291056,8005.614794,0.000337,0.000345,12,0.000193,0,31,0.261905,0.002946
13089,DeKalb County,,GA,94087,666732,760819,198,204,402,68715,85108,153823,5,0.436298,0.478208,95492.001045,0.087149,0.087561,12,0.002477,0,31,0.297836,0.59605
13091,Dodge County,,GA,833,17657,18490,4,4,8,332,349,681,7,0.235008,0.242155,399.398114,0.000013,0.000011,12,0.000221,0,31,0.416667,0.000502
13093,Dooly County,,GA,891,12606,13497,3,4,7,356,434,790,7,0.266324,0.276923,179.890517,0.000151,0.000199,12,0.000129,0,31,0.666667,0.00174
13095,Dougherty County,,GA,8149,104305,112454,29,30,59,4073,4792,8865,6,0.323963,0.345552,64136.701757,0.009151,0.007554,12,0.000708,0,31,0.315126,0.065444
13097,Douglas County,,GA,11463,100589,112052,27,18,45,10289,8059,18348,6,0.319437,0.337735,607.762577,0.012593,0.006314,12,0.00042,0,31,0.57931,0.088904
13099,Early County,,GA,803,11955,12758,4,6,10,386,383,769,7,0.247296,0.25773,734.753291,0.000055,0.00011,12,0.000152,0,31,0.3,0.000665
13101,Echols County,,GA,192,2620,2812,1,1,2,87,66,153,7,0.254938,0.264111,0,0.000122,0.000104,12,0.000066,0,31,0,0.000867
13103,Effingham County,,GA,3094,42485,45579,7,7,14,2786,1652,4438,6,0.305363,0.320282,76.02117,0.000922,0.001815,12,0.000181,0,31,0.517857,0.007091
13105,Elbert County,,GA,1085,21353,22438,5,4,9,408,394,802,7,0.260682,0.270536,0,0.00079,0.000133,12,0.00017,0,31,0.9,0.006591
13107,Emanuel County,,GA,1245,22761,24006,7,8,15,423,516,939,7,0.239901,0.248677,236.431842,0.000045,0.00004,12,0.000265,0,31,0.233333,0.000924
13109,Evans County,,GA,700,10437,11137,4,2,6,345,243,588,7,0.239268,0.246605,0.65,0.000389,0.000031,12,0.000129,0,31,0.833333,0.002956
13111,Fannin County,,GA,1191,21253,22444,8,6,14,634,464,1098,7,0.264746,0.275762,8545.492089,0.002338,0.000307,12,0.000346,0,31,0.430556,0.018164
13113,Fayette County,,GA,9758,106515,116273,26,23,49,7001,5997,12998,6,0.346168,0.367763,802.864952,0.013175,0.00948,12,0.000407,0,31,0.556303,0.093754
13115,Floyd County,,GA,5356,95428,100784,14,14,28,2487,2533,5020,6,0.311354,0.327433,6015.326178,0.003513,0.003535,12,0.000334,0,31,0.52381,0.027204
13117,Forsyth County,,GA,10125,126413,136538,45,25,70,11629,5861,17490,6,0.342009,0.363602,1463.322762,0.022878,0.010717,12,0.000703,0,31,0.520408,0.167871
13119,Franklin County,,GA,1594,25166,26760,10,10,20,1194,983,2177,6,0.300559,0.315306,257.11163,0.0009,0.001008,12,0.000302,0,31,0.588889,0.008067
13121,Fulton County,,GA,108631,734645,843276,240,230,470,83664,98932,182596,5,0.438009,0.482685,115924.656908,0.099669,0.096126,12,0.003121,0,31,0.26847,0.688241
13123,Gilmer County,,GA,1576,24769,26345,10,6,16,1053,670,1723,6,0.305716,0.319289,419.256962,0.003271,0.001113,12,0.000268,0,31,0.622222,0.025449
13125,Glascock County,,GA,195,2654,2849,1,0,1,49,0,49,0,0,0,0,0.000002,0,104,0.000073,0,24,0,0.00009
13127,Glynn County,,GA,5012,71981,76993,17,15,32,2027,1958,3985,6,0.315789,0.333184,3923.251769,0.006425,0.004513,102,0.000399,0,31,0.430952,0.0455
13129,Gordon County,,GA,3287,50578,53865,12,11,23,2526,2002,4528,6,0.310091,0.325356,2117.549682,0.003074,0.002242,12,0.000291,0,31,0.516484,0.023924
13131,Grady County,,GA,2000,27374,29374,7,7,14,1134,1174,2308,7,0.280471,0.293288,234.555573,0.000529,0.000481,12,0.000197,0,31,0.619048,0.004278
13133,Greene County,,GA,1048,16448,17496,6,4,10,434,414,848,7,0.260659,0.270507,10.76264,0.002346,0.000153,12,0.000161,0,31,0.619048,0.017763
13135,Gwinnett County,,GA,62543,676147,738690,216,206,422,63580,52998,116578,5,0.428825,0.472716,120456.527947,0.090013,0.081728,12,0.002899,0,31,0.266751,0.623149
13137,Habersham County,,GA,2321,37186,39507,9,8,17,1592,1356,2948,6,0.300466,0.314905,202.733401,0.002295,0.000902,12,0.000273,0,31,0.588889,0.017324
13139,Hall County,,GA,10672,154276,164948,29,26,55,7379,6708,14087,6,0.332989,0.354964,4280.836966,0.00895,0.008775,12,0.000619,0,31,0.393277,0.067844
13141,Hancock County,,GA,533,9102,9635,2,1,3,183,165,348,7,0.237896,0.244659,0,0.000755,0.000013,12,0.000083,0,31,1,0.005114
13143,Haralson County,,GA,1905,26053,27958,6,6,12,1583,1295,2878,6,0.304786,0.318423,527.468314,0.000904,0.001011,12,0.000159,0,31,0.733333,0.007511
13145,Harris County,,GA,2567,32019,34586,8,7,15,2482,1515,3997,7,0.281532,0.294321,99.945504,0.001868,0.000452,12,0.000177,0,31,0.666667,0.014088
13147,Hart County,,GA,1215,23587,24802,7,6,13,795,697,1492,7,0.263425,0.274301,29.078498,0.000843,0.000187,12,0.000213,0,31,0.571429,0.007202
13149,Heard County,,GA,1054,10467,11521,4,3,7,562,575,1137,7,0.241899,0.249844,0.125,0.000343,0.000154,12,0.000126,0,31,0.916667,0.003985
13151,Henry County,,GA,12845,154091,166936,43,30,73,17544,8480,26024,6,0.323818,0.344898,3964.186117,0.015937,0.007143,12,0.000726,0,31,0.417206,0.113278
13153,Houston County,,GA,10715,131837,142552,61,46,107,7402,5444,12846,6,0.361779,0.388659,59375.490743,0.023838,0.017817,12,0.001104,0,31,0.358428,0.174525
13155,Irwin County,,GA,865,9701,10566,4,3,7,532,549,1081,7,0.23376,0.240994,16.729266,0.000018,0.000003,12,0.000185,0,31,0.5,0.000446
13157,Jackson County,,GA,3968,43689,47657,14,14,28,3955,2729,6684,6,0.310455,0.32597,597.162349,0.003288,0.002763,12,0.000347,0,31,0.5,0.025746
13159,Jasper County,,GA,1267,14187,15454,9,6,15,1191,728,1919,7,0.245084,0.254476,5.528495,0.001814,0.000293,12,0.000209,0,31,0.763889,0.015291
13161,Jeff Davis County,,GA,835,14315,15150,3,4,7,291,324,615,7,0.233722,0.241086,399.261999,0.000008,0.000001,12,0.000175,0,31,0.166667,0.000317
13163,Jefferson County,,GA,1010,20006,21016,6,6,12,423,497,920,7,0.272318,0.283641,706.378303,0.000355,0.000326,104,0.000211,0,31,0.366667,0.002894
13165,Jenkins County,,GA,387,8126,8513,3,2,5,170,125,295,7,0.238953,0.246272,1.519282,0.000039,0.000029,12,0.000135,0,31,0.5,0.000525
13167,Johnson County,,GA,470,8597,9067,3,3,6,195,264,459,7,0.235047,0.242173,12.823786,0.00001,0.000009,12,0.000166,0,31,0.5,0.000386
13169,Jones County,,GA,1588,21163,22751,6,3,9,1424,880,2304,7,0.266887,0.277325,36.941684,0.000249,0.000277,12,0.000199,0,31,0.6,0.002846
13171,Lamar County,,GA,1498,17593,19091,7,7,14,974,1020,1994,7,0.278802,0.290545,70.29753,0.000354,0.000569,12,0.000232,0,31,0.738095,0.004615
13173,Lanier County,,GA,720,6743,7463,4,2,6,447,329,776,7,0.254983,0.264341,204.959907,0.000131,0.000106,12,0.000158,0,31,0.5,0.001176
13175,Laurens County,,GA,2187,49276,51463,14,9,23,1030,679,1709,6,0.306426,0.321361,23009.199184,0.000941,0.001091,12,0.000484,0,31,0.171429,0.008148
13177,Lee County,,GA,2412,21690,24102,6,5,11,1893,1392,3285,7,0.24496,0.254281,82.867537,0.000204,0.000078,12,0.000187,0,31,0.333333,0.001922
13179,Liberty County,,GA,16915,56559,73474,49,65,114,5037,7974,13011,6,0.378027,0.408603,16444.458524,0.022254,0.030751,12,0.000675,0,31,0.502739,0.155519
13181,Lincoln County,,GA,459,8757,9216,3,2,5,219,165,384,7,0.255364,0.264521,31.552168,0.00035,0.000119,104,0.000133,0,31,0.333333,0.002539
13183,Long County,,GA,1582,7312,8894,2,3,5,685,704,1389,7,0.285349,0.297283,0,0.000266,0.000523,12,0.000086,0,31,1,0.001535
13185,Lowndes County,,GA,8390,84545,92935,35,42,77,3760,4249,8009,6,0.34213,0.366626,60402.060267,0.012649,0.014764,12,0.000756,0,31,0.33156,0.095444
13187,Lumpkin County,,GA,2049,20058,22107,8,6,14,1443,1116,2559,6,0.306847,0.321666,5.217692,0.003139,0.001882,12,0.000213,0,31,0.857143,0.023974
13189,McDuffie County,,GA,1271,22801,24072,4,4,8,736,670,1406,7,0.271936,0.282791,5892.952381,0.000353,0.000321,104,0.000131,0,31,0.583333,0.002651
13191,McIntosh County,,GA,839,10831,11670,2,2,4,292,370,662,7,0.274792,0.285842,0,0.000382,0.000237,102,0.000085,0,31,1,0.002827
13193,Macon County,,GA,810,11979,12789,4,4,8,304,389,693,7,0.266178,0.276636,83.975505,0.000169,0.0002,12,0.000153,0,31,0.5,0.001851
13195,Madison County,,GA,1983,26784,28767,10,9,19,1692,1357,3049,7,0.260823,0.271454,79.501441,0.000858,0.00021,12,0.00034,0,31,0.544444,0.007674
13197,Marion County,,GA,463,5838,6301,2,1,3,137,124,261,7,0.279258,0.290677,3.307079,0.0003,0.000277,12,0.000082,0,31,0,0.00216
13199,Meriwether County,,GA,1860,23473,25333,8,8,16,1126,1173,2299,6,0.307529,0.322538,54.247814,0.001496,0.001621,12,0.000187,0,31,0.611111,0.012607
13201,Miller County,,GA,487,5891,6378,3,4,7,164,312,476,8,0.218905,0.225312,4.91781,0.000004,0.000004,12,0.000126,0,31,0.416667,0.000319
13205,Mitchell County,,GA,1485,22718,24203,5,7,12,709,847,1556,7,0.245084,0.254768,27.969309,0.000086,0.000098,12,0.000173,0,31,0.428571,0.001183
13207,Monroe County,,GA,1354,20687,22041,8,7,15,1137,699,1836,7,0.268989,0.280711,94.117792,0.001354,0.000445,12,0.00021,0,31,0.638889,0.012035
13209,Montgomery County,,GA,653,9169,9822,3,1,4,363,214,577,8,0.221477,0.227198,24.279162,0.000003,0,12,0.000142,0,31,0,0.000286
13211,Morgan County,,GA,1132,17235,18367,9,7,16,860,638,1498,6,0.300497,0.314847,140.805508,0.001613,0.000964,12,0.000236,0,31,0.625,0.012858
13213,Murray County,,GA,3213,36978,40191,7,7,14,2644,2190,4834,7,0.250582,0.260453,36.700706,0.000864,0.000196,12,0.000221,0,31,0.571429,0.007149
13215,Muscogee County,,GA,22187,198969,221156,81,86,167,12097,13759,25856,6,0.387407,0.420776,47853.252481,0.033539,0.034116,12,0.001266,0,31,0.386312,0.239708
13217,Newton County,,GA,6181,75713,81894,16,14,30,8374,4206,12580,6,0.311221,0.327204,775.191857,0.004685,0.003866,12,0.000333,0,31,0.588235,0.036454
13219,Oconee County,,GA,2079,21724,23803,9,7,16,1537,1221,2758,6,0.300435,0.314733,305.033665,0.001634,0.000933,12,0.000248,0,31,0.577778,0.013172
13221,Oglethorpe County,,GA,922,13042,13964,4,2,6,649,440,1089,7,0.260519,0.269962,0,0.000136,0.000119,12,0.000153,0,31,1,0.00163
13223,Paulding County,,GA,8111,91041,99152,17,17,34,9850,5552,15402,6,0.313878,0.33121,138.250366,0.005415,0.005214,12,0.000328,0,31,0.613158,0.042471
13225,Peach County,,GA,2104,21658,23762,4,4,8,1316,1342,2658,7,0.266912,0.277469,5.035583,0.000214,0.000267,12,0.000169,0,31,0.666667,0.002345
13227,Pickens County,,GA,1674,26216,27890,11,7,18,2062,953,3015,6,0.308411,0.322676,531.554906,0.003317,0.002138,12,0.000284,0,31,0.709091,0.026148
13229,Pierce County,,GA,1188,16041,17229,5,3,8,779,521,1300,7,0.240318,0.247982,22.836201,0.000795,0.000068,102,0.000209,0,31,0.633333,0.006616
13231,Pike County,,GA,1427,17202,18629,8,5,13,1322,912,2234,7,0.278722,0.290143,91.727746,0.001243,0.000528,12,0.000225,0,31,0.75,0.01131
13233,Polk County,,GA,2178,37476,39654,7,9,16,1297,1468,2765,6,0.304978,0.319112,266.61732,0.000965,0.001131,12,0.000184,0,31,0.597222,0.008318
13235,Pulaski County,,GA,686,9610,10296,3,3,6,238,311,549,7,0.26591,0.276063,585.468671,0.000149,0.000199,12,0.000162,0,31,0.666667,0.001742
13237,Putnam County,,GA,1383,19399,20782,10,8,18,788,634,1422,7,0.267256,0.27876,162.332054,0.001811,0.000365,12,0.000258,0,31,0.492424,0.014973
13239,Quitman County,,GA,298,2371,2669,1,1,2,84,108,192,8,0.227515,0.234063,0,0.000008,0.000005,12,0.000071,0,31,0,0.000145
13241,Rabun County,,GA,914,15757,16671,4,3,7,270,196,466,7,0.250302,0.259437,22.620375,0.001409,0.000123,12,0.000158,0,31,0.55,0.010604
13243,Randolph County,,GA,569,7590,8159,1,3,4,52,191,243,7,0.244836,0.253707,2946,0.000062,0.000076,12,0.000071,0,31,0.333333,0.000633
13245,Richmond County,,GA,19076,184807,203883,56,57,113,10060,11850,21910,6,0.372881,0.401739,27381.073586,0.024225,0.028165,104,0.00081,0,31,0.497366,0.173681
13247,Rockdale County,,GA,9264,72578,81842,16,19,35,7400,6695,14095,6,0.312628,0.329563,774.282873,0.007613,0.004714,12,0.000285,0,31,0.55,0.054003
13249,Schley County,,GA,379,3842,4221,1,1,2,109,121,230,7,0.236232,0.242919,0,0.000018,0.000001,12,0.00007,0,31,0,0.000109
13251,Screven County,,GA,885,14948,15833,4,4,8,341,430,771,7,0.283843,0.295596,18.599338,0.000398,0.000364,12,0.000141,0,31,0.5,0.002938
13253,Seminole County,,GA,717,9599,10316,3,4,7,273,407,680,7,0.242891,0.251856,124.480605,0.000004,0.000037,12,0.000126,0,31,0.583333,0.000319
13255,Spalding County,,GA,4594,57759,62353,13,14,27,3565,3350,6915,6,0.311187,0.327146,1297.14167,0.002736,0.00385,12,0.000331,0,31,0.56044,0.022351
13257,Stephens County,,GA,1773,25750,27523,5,7,12,511,720,1231,6,0.300403,0.314675,72.878263,0.000764,0.000904,12,0.000168,0,31,0.690476,0.006358
13259,Stewart County,,GA,320,5262,5582,1,1,2,40,105,145,7,0.279258,0.290677,0,0.000282,0.000277,12,0.000063,0,31,0,0.002051
13261,Sumter County,,GA,1983,33196,35179,6,11,17,557,773,1330,6,0.309265,0.325057,7016.051482,0.000069,0.002177,12,0.000247,0,31,0.318182,0.001163
13263,Talbot County,,GA,560,7218,7778,1,1,2,223,235,458,7,0.279258,0.290677,0,0.000282,0.000277,12,0.000063,0,31,0,0.002051
13265,Taliaferro County,,GA,141,1741,1882,0,0,0,0,0,0,0,0,0,0,0,0,13,0.000051,13,52,0,0
13267,Tattnall County,,GA,1290,17747,19037,6,8,14,487,627,1114,7,0.285883,0.298804,6681.772624,0.000637,0.000553,12,0.000213,0,31,0.392857,0.004321
13269,Taylor County,,GA,538,9641,10179,1,3,4,54,169,223,7,0.28175,0.294057,0,0.000147,0.000475,12,0.000071,0,31,0.666667,0.001522
13271,Telfair County,,GA,779,11308,12087,4,5,9,228,350,578,7,0.237546,0.245702,3056.055879,0.000008,0.000009,12,0.000198,0,31,0.25,0.000405
13273,Terrell County,,GA,806,11433,12239,2,3,5,375,428,803,7,0.244774,0.253592,2946,0.000063,0.000077,12,0.000102,0,31,0.333333,0.000748
13275,Thomas County,,GA,2627,37855,40482,8,9,17,1400,1405,2805,6,0.310455,0.326653,1142.231417,0.001384,0.00216,12,0.000205,0,31,0.566667,0.009596
13277,Tift County,,GA,2581,38760,41341,10,10,20,1267,1178,2445,6,0.304434,0.319789,9287.292439,0.000191,0.001051,12,0.000358,0,31,0.310606,0.002347
13279,Toombs County,,GA,1586,23098,24684,4,7,11,489,663,1152,7,0.284455,0.29699,6377.748048,0.000005,0.000367,12,0.000249,0,31,0.232143,0.000428
13281,Towns County,,GA,679,9625,10304,2,2,4,198,233,431,9,0.173301,0.176723,15.623183,0,0.00004,12,0.00025,0,31,0,0.000473
13283,Treutlen County,,GA,357,6198,6555,1,3,4,63,192,255,7,0.235791,0.243142,56.998529,0.000009,0.000008,12,0.000096,0,31,0.666667,0.000177
13285,Troup County,,GA,3860,61595,65455,13,14,27,2376,2017,4393,6,0.313573,0.330119,2710.412308,0.003587,0.003944,12,0.00028,0,31,0.538462,0.027789
13287,Turner County,,GA,588,9912,10500,3,3,6,204,224,428,7,0.233967,0.24127,1.494444,0.000012,0.000003,12,0.000138,0,31,0.833333,0.000344
13289,Twiggs County,,GA,778,10590,11368,3,4,7,510,446,956,7,0.244013,0.253064,2.47619,0.000219,0.000079,12,0.00014,0,31,0.8,0.002299
13291,Union County,,GA,991,17712,18703,10,3,13,742,249,991,8,0.209584,0.215386,5899.517988,0.004809,0.000034,12,0.000364,0,31,0.466667,0.03648
13293,Upson County,,GA,1348,27945,29293,6,4,10,670,453,1123,7,0.243931,0.253041,6.600956,0.00035,0.000103,12,0.000193,0,31,0.666667,0.00436
13295,Walker County,,GA,4663,64407,69070,9,8,17,3664,3324,6988,7,0.274402,0.286192,347.256248,0.000333,0.000337,146,0.00029,0,31,0.5,0.003596
13297,Walton County,,GA,4037,53248,57285,12,12,24,4016,2577,6593,6,0.311154,0.32686,466.374565,0.002737,0.003513,12,0.00027,0,31,0.67619,0.021853
13299,Ware County,,GA,2161,32150,34311,8,7,15,982,1055,2037,6,0.303702,0.318211,8525.232637,0.000943,0.000935,102,0.000325,0,31,0.339286,0.00796
13301,Warren County,,GA,483,6613,7096,1,3,4,156,324,480,7,0.271757,0.282372,2946,0.000003,0.000203,104,0.000079,0,31,0.333333,0.000115
13303,Washington County,,GA,872,21702,22574,4,4,8,239,240,479,7,0.23917,0.246955,48.797185,0.000044,0.000024,12,0.000196,0,31,0.166667,0.000596
13305,Wayne County,,GA,1366,25860,27226,8,8,16,617,491,1108,6,0.305234,0.320127,6349.282974,0.00142,0.001446,12,0.000247,0,31,0.361111,0.010686
13307,Webster County,,GA,165,2456,2621,1,0,1,55,0,55,0,0,0,0,0.000001,0,12,0.00008,0,30,0,0.000097
13309,Wheeler County,,GA,305,4725,5030,1,3,4,84,127,211,7,0.235028,0.242069,2.266667,0,0.000008,12,0.000084,0,31,0.166667,0.000099
13311,White County,,GA,1698,22137,23835,11,5,16,1528,870,2398,6,0.30031,0.314273,11.481851,0.003175,0.000869,12,0.000272,0,31,0.663636,0.024518
13313,Whitfield County,,GA,7309,97862,105171,17,15,32,3713,4594,8307,6,0.329438,0.349306,2773.165246,0.006237,0.004825,12,0.00037,0,31,0.505848,0.045939
13315,Wilcox County,,GA,422,7115,7537,2,2,4,178,157,335,8,0.211246,0.217077,15.384076,0.000002,0.000001,12,0.000117,0,31,0,0.000205
13317,Wilkes County,,GA,569,11476,12045,2,2,4,107,131,238,7,0.260519,0.269962,18.861731,0.000105,0.000114,104,0.000126,0,31,0,0.001066
13319,Wilkinson County,,GA,582,10440,11022,2,3,5,228,266,494,7,0.243993,0.252892,1.485714,0.000095,0.000088,12,0.000096,0,31,0.666667,0.000801
13321,Worth County,,GA,1314,18469,19783,6,6,12,778,755,1533,7,0.245125,0.254688,679.869997,0.000076,0.000081,12,0.000225,0,31,0.5,0.001206
15001,Hawaii County,,HI,6293,157233,163526,29,18,47,5068,3560,8628,6,0.341647,0.362276,6.727113,0.016161,0.012686,178,0.000324,0,31,0.87957,0.111047
15003,Honolulu County,,HI,60861,999244,1060105,224,225,449,41444,44506,85950,5,0.431565,0.477514,42792.879631,0.09459,0.092237,178,0.002504,0,31,0.284422,0.65112
15005,Kalawao County,,HI,0,0,0,0,0,0,0,0,0,0,0,0,0,0,0,14,0.000051,14,53,0,0
15007,Kauai County,,HI,2802,66081,68883,9,7,16,714,1213,1927,6,0.340087,0.358947,0,0.007781,0.00612,178,0.000134,0,31,0.990909,0.053561
15009,Maui County,,HI,6613,148036,154649,33,19,52,4451,3656,8107,6,0.341727,0.36242,7.042153,0.018895,0.012371,178,0.000363,0,31,0.911765,0.130439
16001,Ada County,,ID,24331,356534,380865,110,89,199,19637,17862,37499,6,0.363727,0.396505,63017.518508,0.034262,0.028966,178,0.001741,0,31,0.317619,0.247906
16003,Adams County,,ID,340,3859,4199,2,1,3,90,58,148,7,0.26674,0.278125,0,0.000331,0.000283,178,0.000086,0,31,1,0.003278
16005,Bannock County,,ID,6720,80713,87433,25,27,52,3290,3788,7078,6,0.334639,0.356353,17146.157141,0.005512,0.005703,178,0.000526,0,31,0.365927,0.042084
16007,Bear Lake County,,ID,426,6877,7303,1,1,2,46,59,105,7,0.250756,0.259191,0,0.000047,0.000046,178,0.000067,0,31,0,0.000462
16009,Benewah County,,ID,673,10018,10691,2,2,4,184,223,407,7,0.270668,0.282625,0,0.000335,0.00038,178,0.000084,0,31,1,0.002958
16011,Bingham County,,ID,3401,48201,51602,11,13,24,1993,2301,4294,6,0.330676,0.349747,2035.153204,0.002603,0.002791,178,0.000229,0,31,0.692308,0.019066
16013,Blaine County,,ID,1777,21396,23173,7,5,12,555,491,1046,6,0.331242,0.34891,1772.41749,0.00239,0.002267,178,0.000188,0,31,0.660714,0.018592
16015,Boise County,,ID,702,6146,6848,2,2,4,449,406,855,7,0.266985,0.278562,0,0.000331,0.000423,178,0.000086,0,31,1,0.003278
16017,Bonner County,,ID,2654,38944,41598,13,6,19,1540,1059,2599,6,0.309991,0.326085,723.554235,0.006663,0.001532,178,0.00026,0,31,0.697802,0.047182
16019,Bonneville County,,ID,6684,92409,99093,21,18,39,4516,3942,8458,6,0.332608,0.352565,1302.819916,0.007502,0.004147,178,0.000345,0,31,0.571146,0.054929
16021,Boundary County,,ID,685,10242,10927,3,2,5,173,174,347,7,0.25505,0.263753,0,0.000348,0.000174,178,0.000121,0,31,1,0.003434
16023,Butte County,,ID,308,3011,3319,0,0,0,0,0,0,0,0,0,0,0,0,15,0.000051,15,54,0,0
16025,Camas County,,ID,96,989,1085,0,0,0,0,0,0,0,0,0,0,0,0,16,0.000051,16,55,0,0
16027,Canyon County,,ID,10558,147940,158498,52,36,88,11684,7106,18790,6,0.344198,0.367786,11685.595831,0.016937,0.011095,178,0.00079,0,31,0.409994,0.120388
16029,Caribou County,,ID,617,7984,8601,1,1,2,61,168,229,7,0.250756,0.259191,0,0.000047,0.000046,178,0.000067,0,31,0,0.000462
16031,Cassia County,,ID,2285,26820,29105,7,8,15,1012,1346,2358,6,0.285013,0.29957,60.402291,0.001041,0.000864,178,0.000154,0,31,0.736111,0.007436
16033,Clark County,,ID,183,904,1087,0,0,0,0,0,0,0,0,0,0,0,0,17,0.000051,17,56,0,0
16035,Clearwater County,,ID,786,8842,9628,2,3,5,154,341,495,7,0.249377,0.257779,0,0.000032,0.000048,178,0.000086,0,31,1,0.000428
16037,Custer County,,ID,395,4175,4570,0,0,0,0,0,0,0,0,0,0,0,0,18,0.000051,18,57,0,0
16039,Elmore County,,ID,5271,27072,32343,12,22,34,1097,2094,3191,6,0.344811,0.367723,2174.46739,0.004345,0.008374,178,0.000223,0,31,0.505,0.034566
16041,Franklin County,,ID,886,12987,13873,3,4,7,346,446,792,6,0.297968,0.312058,0,0.000733,0.000895,178,0.000088,0,31,1,0.00459
16043,Fremont County,,ID,1272,14456,15728,6,6,12,656,668,1324,6,0.284706,0.298864,3.534281,0.001111,0.000699,178,0.000136,0,31,0.904762,0.007035
16045,Gem County,,ID,1289,16258,17547,3,3,6,791,724,1515,7,0.26701,0.278734,0,0.000334,0.000426,178,0.000114,0,31,1,0.003404
16047,Gooding County,,ID,1372,14452,15824,4,4,8,531,854,1385,7,0.266838,0.278699,66.003112,0.000305,0.000328,178,0.000145,0,31,0.75,0.002834
16049,Idaho County,,ID,1036,14897,15933,3,5,8,217,429,646,7,0.266936,0.279044,474.12011,0.000256,0.000331,178,0.000123,0,31,0.65,0.002482
16051,Jefferson County,,ID,1864,22035,23899,7,6,13,1308,1172,2480,6,0.295964,0.310422,6.353848,0.001135,0.000656,178,0.000149,0,31,0.928571,0.00729
16053,Jerome County,,ID,2106,19648,21754,6,8,14,1122,1409,2531,7,0.267157,0.279652,54.379085,0.000448,0.000498,178,0.000164,0,31,0.597222,0.004434
16055,Kootenai County,,ID,7746,121369,129115,39,29,68,6291,4525,10816,6,0.342251,0.364543,7535.206262,0.014439,0.010752,178,0.00069,0,31,0.50443,0.104806
16057,Latah County,,ID,3884,33666,37550,13,16,29,1513,1924,3437,6,0.331886,0.351728,2160.488183,0.002186,0.004123,178,0.000261,0,31,0.51462,0.016622
16059,Lemhi County,,ID,563,7864,8427,0,0,0,0,0,0,0,0,0,0,0,0,19,0.000051,19,58,0,0
16061,Lewis County,,ID,400,4222,4622,2,2,4,122,154,276,7,0.237274,0.244571,0,0.00002,0.000016,178,0.00009,0,31,1,0.000323
16063,Lincoln County,,ID,519,5215,5734,5,3,8,309,211,520,7,0.255229,0.263856,1.166667,0.000091,0.000063,178,0.000162,0,31,0.6,0.001034
16065,Madison County,,ID,2199,20031,22230,8,10,18,1044,1395,2439,6,0.330526,0.349174,124.396356,0.001996,0.002443,178,0.000166,0,31,0.790909,0.013146
16067,Minidoka County,,ID,1530,16052,17582,4,6,10,707,907,1614,7,0.26728,0.279709,40.544406,0.000311,0.000519,178,0.000116,0,31,0.738095,0.002887
16069,Nez Perce County,,ID,2915,39314,42229,11,12,23,1899,1828,3727,6,0.311021,0.328042,7398.396456,0.001656,0.002074,178,0.000256,0,31,0.522727,0.013221
16071,Oneida County,,ID,286,4396,4682,1,1,2,51,40,91,7,0.240656,0.247515,0,0.000019,0.000011,178,0.000068,0,31,0,0.000165
16073,Owyhee County,,ID,1074,9977,11051,2,2,4,656,638,1294,7,0.266985,0.278562,0,0.000331,0.000423,178,0.000086,0,31,1,0.003278
16075,Payette County,,ID,1859,21205,23064,5,5,10,1102,1024,2126,7,0.267108,0.279164,1.924762,0.000351,0.000436,178,0.000168,0,31,0.75,0.003683
16077,Power County,,ID,657,7124,7781,2,2,4,254,290,544,7,0.250777,0.259363,0,0.00007,0.000067,178,0.000082,0,31,1,0.000721
16079,Shoshone County,,ID,1087,12636,13723,2,2,4,297,453,750,7,0.270668,0.282625,0,0.000335,0.00038,178,0.000084,0,31,1,0.002958
16081,Teton County,,ID,814,7004,7818,1,3,4,230,227,457,7,0.258133,0.268247,1.597869,0.000018,0.000125,178,0.000071,0,31,0,0.000284
16083,Twin Falls County,,ID,4941,70004,74945,20,23,43,3590,3012,6602,6,0.342574,0.364141,7035.139279,0.00497,0.007366,178,0.000399,0,31,0.468333,0.037404
16085,Valley County,,ID,814,8699,9513,2,2,4,351,269,620,7,0.266985,0.278562,0,0.000331,0.000423,178,0.000086,0,31,1,0.003278
16087,Washington County,,ID,754,9828,10582,3,4,7,261,415,676,7,0.267084,0.278992,0,0.000256,0.000434,178,0.00012,0,31,1,0.002475
17001,Adams County,,IL,3140,80795,83935,8,12,20,852,1075,1927,6,0.329775,0.34868,8415.178376,0.00012,0.002813,56,0.000303,0,31,0.307692,0.001445
17003,Alexander County,,IL,757,8812,9569,3,4,7,233,394,627,7,0.238267,0.245762,2963.290828,0.000019,0.000016,56,0.000116,0,31,0.416667,0.000392
17005,Bond County,,IL,1135,18899,20034,6,5,11,654,579,1233,7,0.276072,0.287495,177.63242,0.00101,0.000316,56,0.00017,0,31,0.6,0.007117
17007,Boone County,,IL,4142,55006,59148,8,9,17,4702,2785,7487,6,0.337282,0.356416,9.572424,0.0031,0.003244,179,0.000114,0,31,0.844444,0.017745
17009,Brown County,,IL,265,5958,6223,1,1,2,47,72,119,7,0.248057,0.255736,7.514449,0,0.000001,56,0.000086,0,31,0,0.000097
17011,Bureau County,,IL,2343,43358,45701,8,9,17,1272,1287,2559,6,0.326402,0.344146,1686.723763,0.001897,0.001813,179,0.000167,0,31,0.588889,0.012377
17013,Calhoun County,,IL,219,5898,6117,2,1,3,162,58,220,7,0.233422,0.239286,0,0.000116,0.000007,56,0.000107,0,31,1,0.001003
17015,Carroll County,,IL,1091,20715,21806,7,6,13,577,495,1072,7,0.272548,0.283558,6.024231,0.001901,0.000173,179,0.000141,0,31,0.678571,0.012181
17017,Cass County,,IL,972,16745,17717,4,4,8,445,423,868,7,0.26148,0.27167,222.270086,0.000105,0.000089,179,0.00015,0,31,0.45,0.00102
17019,Champaign County,,IL,13345,187662,201007,49,54,103,6976,7179,14155,6,0.379608,0.408982,27031.573454,0.017914,0.024792,179,0.000683,0,31,0.390625,0.118028
17021,Christian County,,IL,2156,43923,46079,5,5,10,1132,1108,2240,7,0.26302,0.27357,48.174334,0.000157,0.000121,179,0.000149,0,31,0.5,0.001372
17023,Clark County,,IL,1062,20172,21234,5,5,10,454,477,931,7,0.249313,0.258812,4533.221906,0.000045,0.000035,179,0.000197,0,31,0.3,0.000764
17025,Clay County,,IL,893,16633,17526,4,4,8,411,362,773,8,0.225099,0.232219,1349.930002,0.000006,0.000018,121,0.000183,0,31,0.25,0.000532
17027,Clinton County,,IL,1855,44510,46365,6,7,13,1169,1046,2215,6,0.306361,0.320191,133.782921,0.001008,0.000969,56,0.000167,0,31,0.714286,0.007165
17029,Coles County,,IL,3461,53349,56810,11,16,27,1579,1785,3364,6,0.328321,0.347354,12438.465096,0.001351,0.002085,179,0.000295,0,31,0.358333,0.009453
17031,Cook County,,IL,273310,5913065,6186375,386,476,862,147395,252817,400212,5,0.483034,0.545122,630096.623871,0.119887,0.129432,179,0.004873,0,31,0.117084,0.82362
17033,Crawford County,,IL,1010,23457,24467,3,3,6,234,235,469,8,0.199904,0.20533,31.820594,0,0,179,0.000176,0,31,0,0.0003
17035,Cumberland County,,IL,728,13170,13898,4,4,8,377,433,810,7,0.247613,0.255965,8.03927,0.000021,0.000022,179,0.000155,0,31,0.666667,0.000574
17037,DeKalb County,,IL,8391,100512,108903,15,20,35,6889,5654,12543,6,0.339371,0.360554,78.084506,0.003522,0.005142,179,0.000204,0,31,0.607143,0.020857
17039,De Witt County,,IL,1197,20254,21451,5,5,10,714,576,1290,7,0.278561,0.289977,7.549182,0.00033,0.00026,179,0.000133,0,31,0.7,0.002266
17041,Douglas County,,IL,1594,26344,27938,4,6,10,708,876,1584,7,0.277284,0.288709,119.528411,0.000224,0.000194,179,0.000128,0,31,0.566667,0.001474
17043,DuPage County,,IL,96944,1239989,1336933,165,228,393,73140,86080,159220,5,0.434405,0.479471,59389.780562,0.075116,0.09047,179,0.001835,0,31,0.276037,0.497627
17045,Edgar County,,IL,1161,22041,23202,6,5,11,537,484,1021,7,0.277179,0.289082,275.693478,0.000072,0.000205,179,0.000181,0,31,0.404762,0.001014
17047,Edwards County,,IL,463,8692,9155,2,3,5,165,191,356,8,0.202723,0.208331,3.193419,0.000001,0.000001,121,0.000116,0,31,0.5,0.000204
17049,Effingham County,,IL,2072,43370,45442,10,9,19,937,818,1755,7,0.28096,0.293598,13956.605997,0.001228,0.000344,179,0.000303,0,31,0.340909,0.008815
17051,Fayette County,,IL,1232,24074,25306,6,6,12,567,529,1096,7,0.267921,0.278396,84.936113,0.00012,0.000134,56,0.000203,0,31,0.366667,0.001574
17053,Ford County,,IL,1199,18341,19540,6,5,11,708,755,1463,7,0.278695,0.289983,1.498274,0.001415,0.000291,179,0.000123,0,31,0.866667,0.009421
17055,Franklin County,,IL,2010,45117,47127,7,6,13,1124,1003,2127,7,0.248822,0.257814,1476.763761,0.001121,0.000075,56,0.000234,0,31,0.428571,0.008063
17057,Fulton County,,IL,1824,44454,46278,5,6,11,1050,942,1992,7,0.269288,0.280755,5.022743,0.000189,0.000175,179,0.000126,0,31,0.7,0.001173
17059,Gallatin County,,IL,356,6881,7237,2,2,4,176,156,332,8,0.203077,0.208369,0,0.000001,0.000001,56,0.000133,0,31,1,0.000212
17061,Greene County,,IL,845,16944,17789,5,5,10,497,477,974,7,0.267576,0.27773,391.533111,0.000133,0.000132,56,0.000211,0,31,0.55,0.001438
17063,Grundy County,,IL,3430,53078,56508,8,9,17,3160,2182,5342,6,0.326329,0.344031,2.658778,0.002474,0.002131,179,0.000129,0,31,0.822222,0.014808
17065,Hamilton County,,IL,445,8210,8655,3,3,6,145,152,297,7,0.235676,0.24254,6.216229,0.00001,0.000021,56,0.000142,0,31,0.5,0.000459
17067,Hancock County,,IL,1332,24575,25907,4,4,8,444,529,973,7,0.25,0.258944,370.705333,0.00004,0.000014,179,0.000138,0,31,0.35,0.000479
17069,Hardin County,,IL,272,4695,4967,0,1,1,0,49,49,8,0.203019,0.20808,0,0,0,56,0.000051,0,59,0,0
17071,Henderson County,,IL,603,10052,10655,2,3,5,239,275,514,7,0.223798,0.230495,13.535084,0.000004,0.000004,179,0.000098,0,31,0.166667,0.000229
17073,Henry County,,IL,3621,66709,70330,10,12,22,2523,2151,4674,6,0.326843,0.345053,1262.687813,0.001484,0.001876,179,0.000202,0,31,0.50641,0.009791
17075,Iroquois County,,IL,2038,39537,41575,6,7,13,1248,1171,2419,6,0.326329,0.343802,83.947809,0.001604,0.001296,179,0.000124,0,31,0.589286,0.010088
17077,Jackson County,,IL,5466,53669,59135,19,16,35,2414,2661,5075,6,0.330225,0.349696,7012.443653,0.004247,0.003098,56,0.000366,0,31,0.422078,0.026282
17079,Jasper County,,IL,599,12755,13354,3,3,6,184,230,414,8,0.21985,0.22617,1586.056775,0.000003,0.00001,179,0.000175,0,31,0,0.000371
17081,Jefferson County,,IL,2120,43080,45200,11,10,21,992,850,1842,6,0.30675,0.321166,9876.261699,0.001433,0.001012,56,0.000308,0,31,0.439394,0.010711
17083,Jersey County,,IL,1644,28140,29784,5,5,10,1196,1108,2304,6,0.304466,0.317832,3151.965609,0.000812,0.000751,56,0.000234,0,31,0.55,0.00561
17085,Jo Daviess County,,IL,1470,27740,29210,7,5,12,820,752,1572,6,0.326329,0.343543,170.01333,0.002044,0.001066,179,0.000143,0,31,0.52381,0.012694
17087,Johnson County,,IL,850,13185,14035,6,3,9,452,377,829,7,0.252346,0.261156,2854.679893,0.001087,0.000031,56,0.000259,0,31,0.261905,0.007623
17089,Kane County,,IL,32747,423576,456323,44,72,116,33786,25809,59595,5,0.384738,0.415725,3946.514083,0.021744,0.03444,179,0.00051,0,31,0.474846,0.144192
17091,Kankakee County,,IL,5933,120814,126747,12,15,27,3865,3082,6947,6,0.343181,0.364256,579.0571,0.004429,0.005272,179,0.000185,0,31,0.633333,0.028263
17093,Kendall County,,IL,5250,73269,78519,9,8,17,8879,3712,12591,6,0.337126,0.356129,9.100324,0.00322,0.003218,179,0.000127,0,31,0.855556,0.018695
17095,Knox County,,IL,3194,61934,65128,11,11,22,1384,1420,2804,6,0.327543,0.345535,2051.178403,0.002289,0.001287,179,0.000206,0,31,0.551282,0.013998
17097,Lake County,,IL,48835,769850,818685,109,160,269,39440,38161,77601,5,0.415689,0.455188,12233.250202,0.060415,0.073395,179,0.001161,0,31,0.377057,0.406134
17099,LaSalle County,,IL,6013,131777,137790,19,17,36,4002,3432,7434,6,0.337714,0.358023,4318.012306,0.004616,0.003497,179,0.000282,0,31,0.48538,0.029518
17101,Lawrence County,,IL,793,16952,17745,4,4,8,423,395,818,7,0.229221,0.236495,1101.062671,0.000006,0.000006,121,0.000199,0,31,0,0.000441
17103,Lee County,,IL,2506,42918,45424,9,9,18,1608,1511,3119,6,0.326146,0.343744,2.409174,0.002389,0.001996,179,0.000141,0,31,0.847222,0.014342
17105,Livingston County,,IL,2328,43209,45537,8,11,19,1091,1231,2322,6,0.326476,0.34449,346.954946,0.002236,0.002141,179,0.000147,0,31,0.627273,0.014097
17107,Logan County,,IL,2007,33210,35217,7,7,14,914,996,1910,6,0.327101,0.344513,202.893179,0.000373,0.0012,179,0.00016,0,31,0.714286,0.002491
17109,McDonough County,,IL,2174,32115,34289,9,12,21,731,933,1664,6,0.32795,0.346224,11294.820985,0.001266,0.001882,179,0.000226,0,31,0.423077,0.008409
17111,McHenry County,,IL,19009,303835,322844,25,39,64,20299,13313,33612,6,0.363682,0.38948,621.686593,0.013669,0.020324,179,0.000304,0,31,0.576966,0.092525
17113,McLean County,,IL,9781,173790,183571,38,30,68,5840,5062,10902,6,0.348913,0.373387,7511.633507,0.00908,0.008514,179,0.000557,0,31,0.319767,0.060294
17115,Macon County,,IL,6647,131379,138026,18,24,42,2161,3277,5438,6,0.345098,0.36805,13308.461125,0.003865,0.005253,179,0.000347,0,31,0.364615,0.02599
17117,Macoupin County,,IL,2887,55576,58463,9,8,17,1959,1925,3884,6,0.307302,0.321361,486.537848,0.001113,0.001036,56,0.000264,0,31,0.458333,0.008018
17119,Madison County,,IL,14218,309591,323809,43,40,83,9891,8947,18838,6,0.36487,0.39068,32415.436499,0.012808,0.013245,56,0.000802,0,31,0.291241,0.089622
17121,Marion County,,IL,2296,46893,49189,8,9,17,817,982,1799,7,0.276914,0.289165,3158.318784,0.000911,0.000374,56,0.000246,0,31,0.409091,0.006717
17123,Marshall County,,IL,1109,18781,19890,7,7,14,739,709,1448,7,0.269138,0.280709,684.615259,0.001276,0.0002,179,0.000165,0,31,0.607143,0.008429
17125,Mason County,,IL,1420,21786,23206,6,7,13,833,879,1712,7,0.271783,0.283441,55.594379,0.000268,0.000152,179,0.000176,0,31,0.47619,0.001638
17127,Massac County,,IL,986,17317,18303,5,2,7,396,332,728,7,0.250604,0.258688,1054.681782,0.000037,0.000021,54,0.000232,0,31,0.2,0.000773
17129,Menard County,,IL,1147,15307,16454,3,2,5,729,659,1388,7,0.261245,0.270965,0.9,0.000096,0.000079,179,0.00012,0,31,0.833333,0.000853
17131,Mercer County,,IL,1334,21706,23040,6,5,11,798,751,1549,7,0.269238,0.279558,24.187455,0.000212,0.000133,179,0.000138,0,31,0.6,0.001508
17133,Monroe County,,IL,1749,38050,39799,6,7,13,1807,1105,2912,6,0.306039,0.319772,30.999808,0.001258,0.001382,56,0.000147,0,31,0.833333,0.008563
17135,Montgomery County,,IL,1781,34294,36075,6,6,12,739,992,1731,7,0.270064,0.281013,46.216524,0.000217,0.000203,56,0.000194,0,31,0.5,0.00204
17137,Morgan County,,IL,2281,40533,42814,8,8,16,1074,1127,2201,6,0.327285,0.344858,12648.921316,0.001283,0.001079,179,0.000253,0,31,0.291667,0.009062
17139,Moultrie County,,IL,952,15605,16557,4,4,8,587,530,1117,7,0.256855,0.266367,1.784957,0.000063,0.000045,179,0.000123,0,31,0.75,0.000727
17141,Ogle County,,IL,3688,63129,66817,12,11,23,2851,2148,4999,6,0.326255,0.344146,144.798986,0.002589,0.00204,179,0.000176,0,31,0.704545,0.015614
17143,Peoria County,,IL,12383,211021,223404,27,41,68,6500,7876,14376,6,0.366898,0.394645,17210.827232,0.005738,0.015444,179,0.000421,0,31,0.385024,0.037169
17145,Perry County,,IL,1256,23339,24595,6,5,11,647,635,1282,7,0.248609,0.257349,10.918739,0.000252,0.000069,56,0.000187,0,31,0.6,0.002471
17147,Piatt County,,IL,1170,18782,19952,4,4,8,794,664,1458,7,0.277126,0.288163,1.608009,0.000252,0.000184,179,0.000114,0,31,0.75,0.00163
17149,Pike County,,IL,823,18473,19296,2,5,7,117,335,452,7,0.262165,0.27283,18.480268,0.000032,0.000105,56,0.000099,0,31,0.4,0.000289
17151,Pope County,,IL,276,4006,4282,0,2,2,0,86,86,8,0.201568,0.206194,0,0,0.000009,54,0.000051,0,60,1,0
17153,Pulaski County,,IL,531,7428,7959,1,4,5,102,225,327,7,0.238248,0.245705,1,0,0.000011,56,0.000075,0,31,0.416667,0.000097
17155,Putnam County,,IL,490,7184,7674,3,3,6,322,306,628,7,0.25261,0.261024,0,0.000045,0.000064,179,0.000101,0,31,1,0.000719
17157,Randolph County,,IL,1720,35412,37132,7,8,15,930,973,1903,6,0.306297,0.320317,400.227626,0.000352,0.001011,56,0.000216,0,31,0.527778,0.003236
17159,Richland County,,IL,1086,19372,20458,4,4,8,257,309,566,8,0.203247,0.20917,61.765003,0.000001,0,121,0.000216,0,31,0.166667,0.000398
17161,Rock Island County,,IL,9484,170895,180379,22,26,48,4883,5742,10625,6,0.351574,0.374857,8178.240966,0.006063,0.00894,179,0.00033,0,31,0.424731,0.039047
17163,St. Clair County,,IL,17412,293303,310715,62,56,118,10365,10850,21215,6,0.3768,0.406129,25917.998037,0.024101,0.023915,56,0.000937,0,31,0.392961,0.170049
17165,Saline County,,IL,1370,26857,28227,5,7,12,385,578,963,7,0.254647,0.265044,5584.721474,0.000018,0.000078,56,0.000265,0,31,0.178571,0.00062
17167,Sangamon County,,IL,10627,232531,243158,39,38,77,6190,5797,11987,6,0.3535,0.379081,31944.45716,0.009345,0.011418,179,0.000699,0,31,0.31383,0.061543
17169,Schuyler County,,IL,420,7964,8384,3,3,6,201,162,363,7,0.247149,0.255019,2955.342346,0.000025,0.000011,179,0.000125,0,31,0.166667,0.000449
17171,Scott County,,IL,369,5577,5946,2,2,4,213,232,445,7,0.246834,0.254324,0,0.00001,0.000012,179,0.000113,0,31,1,0.000283
17173,Shelby County,,IL,1454,24469,25923,7,7,14,843,821,1664,7,0.257128,0.267303,81.552658,0.000066,0.000056,179,0.00022,0,31,0.428571,0.001109
17175,Stark County,,IL,480,7290,7770,2,2,4,155,248,403,7,0.268541,0.278958,0,0.000143,0.00006,179,0.000074,0,31,1,0.000612
17177,Stephenson County,,IL,2874,60456,63330,9,10,19,1552,1400,2952,6,0.326843,0.344921,263.318434,0.002346,0.002324,179,0.000162,0,31,0.6,0.01408
17179,Tazewell County,,IL,8740,159203,167943,16,18,34,5587,5554,11141,6,0.339411,0.360296,2543.861295,0.002583,0.004115,179,0.000282,0,31,0.407143,0.016119
17181,Union County,,IL,896,19831,20727,4,5,9,284,374,658,7,0.251298,0.260741,216.185888,0.000043,0.000073,56,0.000135,0,31,0.333333,0.000744
17183,Vermilion County,,IL,4161,91760,95921,10,12,22,1403,1732,3135,6,0.340286,0.360836,3846.407868,0.002728,0.003282,179,0.000222,0,31,0.39011,0.017552
17185,Wabash County,,IL,644,14562,15206,4,5,9,245,311,556,7,0.253492,0.263208,3654.371972,0.000048,0.000042,121,0.000182,0,31,0.25,0.00073
17187,Warren County,,IL,1225,16672,17897,5,5,10,480,572,1052,7,0.260612,0.270332,872.151656,0.000101,0.000081,179,0.000145,0,31,0.45,0.001028
17189,Washington County,,IL,910,18357,19267,6,7,13,570,543,1113,7,0.276335,0.288144,99.224347,0.000327,0.000337,56,0.000183,0,31,0.595238,0.002983
17191,Wayne County,,IL,985,18505,19490,5,6,11,383,477,860,7,0.254024,0.264355,5217.865439,0.000009,0.000053,121,0.000244,0,31,0.166667,0.000595
17193,White County,,IL,953,17159,18112,7,5,12,377,304,681,7,0.253647,0.263523,4566.685851,0.000049,0.000041,121,0.000294,0,31,0.285714,0.001018
17195,Whiteside County,,IL,3614,71615,75229,12,15,27,1594,2030,3624,6,0.32699,0.345627,181.509813,0.002555,0.00222,179,0.000182,0,31,0.538095,0.015225
17197,Will County,,IL,29242,536873,566115,43,60,103,45294,21848,67142,6,0.383164,0.412999,2952.162613,0.021593,0.031251,179,0.0005,0,31,0.544755,0.144189
17199,Williamson County,,IL,4072,67143,71215,13,13,26,2288,2005,4293,6,0.329813,0.348749,13896.100302,0.002261,0.002074,56,0.000375,0,31,0.361905,0.01542
17201,Winnebago County,,IL,14292,329632,343924,28,47,75,9634,8536,18170,6,0.372786,0.40023,4178.441869,0.009914,0.020326,179,0.000364,0,31,0.445578,0.066711
17203,Woodford County,,IL,2207,36108,38315,5,4,9,1613,1298,2911,7,0.268964,0.279963,0.89478,0.000251,0.000154,179,0.00012,0,31,0.7,0.001678
18001,Adams County,,IN,1665,41415,43080,4,4,8,760,776,1536,7,0.275104,0.286606,83.675841,0.000237,0.000178,121,0.00013,0,31,0.416667,0.001658
18003,Allen County,,IN,17753,404692,422445,63,69,132,10012,10679,20691,6,0.379013,0.410084,55784.680092,0.021011,0.026943,121,0.000886,0,31,0.332042,0.145501
18005,Bartholomew County,,IN,5223,93481,98704,13,14,27,2780,2854,5634,6,0.330789,0.351039,835.671728,0.002234,0.003156,121,0.000256,0,31,0.4125,0.015921
18007,Benton County,,IN,948,11989,12937,2,1,3,428,411,839,7,0.268764,0.279053,0,0.000126,0.0001,121,0.000088,0,31,1,0.000977
18009,Blackford County,,IN,1123,19594,20717,4,4,8,604,553,1157,7,0.251625,0.260861,5.113845,0.000047,0.000038,121,0.00013,0,31,0.416667,0.000678
18011,Boone County,,IN,4245,64625,68870,10,8,18,3418,2538,5956,6,0.295753,0.309803,102.612474,0.002341,0.001068,121,0.000202,0,31,0.654545,0.016546
18013,Brown County,,IN,1889,21860,23749,5,5,10,1176,1182,2358,6,0.295422,0.308884,0.2,0.00078,0.000699,121,0.00012,0,31,0.95,0.005353
18015,Carroll County,,IN,1930,30502,32432,6,6,12,1457,1163,2620,6,0.295663,0.309401,6.330126,0.000735,0.000714,121,0.00015,0,31,0.766667,0.005518
18017,Cass County,,IN,2557,48529,51086,8,7,15,1173,1245,2418,6,0.295753,0.309688,233.562919,0.000744,0.000712,121,0.000184,0,31,0.553571,0.00573
18019,Clark County,,IN,7582,115511,123093,13,13,26,6286,5171,11457,6,0.306426,0.323944,412.354351,0.001273,0.002152,121,0.000329,0,31,0.345833,0.009869
18021,Clay County,,IN,1893,32982,34875,8,8,16,1422,1196,2618,6,0.295603,0.309516,7.307826,0.00066,0.000673,121,0.000214,0,31,0.642857,0.005475
18023,Clinton County,,IN,2322,38328,40650,6,7,13,994,1393,2387,6,0.295753,0.309688,2.83442,0.000976,0.001012,121,0.000147,0,31,0.714286,0.007519
18025,Crawford County,,IN,842,12559,13401,6,6,12,566,469,1035,7,0.293393,0.306253,676.90128,0.00049,0.000521,121,0.000208,0,31,0.380952,0.004285
18027,Daviess County,,IN,1291,34267,35558,8,8,16,621,600,1221,7,0.271402,0.282745,546.245794,0.000185,0.00013,121,0.000289,0,31,0.482143,0.001794
18029,Dearborn County,,IN,3594,63008,66602,11,12,23,3166,2369,5535,6,0.301089,0.31677,2276.12786,0.001623,0.001384,121,0.000256,0,31,0.410256,0.011003
18031,Decatur County,,IN,1999,33971,35970,10,9,19,1171,1225,2396,6,0.295603,0.309688,50.816509,0.000668,0.000653,121,0.000229,0,31,0.472727,0.005409
18033,DeKalb County,,IN,2835,49645,52480,7,8,15,1900,1823,3723,6,0.296085,0.310463,82.163978,0.000256,0.000766,121,0.000175,0,31,0.5,0.002104
18035,Delaware County,,IN,7578,123668,131246,20,21,41,3612,4277,7889,6,0.335684,0.357352,8290.927679,0.003131,0.003647,121,0.000342,0,31,0.426407,0.021055
18037,Dubois County,,IN,2232,55778,58010,11,12,23,1121,1124,2245,6,0.296387,0.311169,4377.720102,0.000637,0.000701,121,0.00041,0,31,0.325758,0.005503
18039,Elkhart County,,IN,10272,218341,228613,23,27,50,6352,6038,12390,6,0.352256,0.375729,3133.19551,0.007704,0.008593,121,0.000322,0,31,0.482759,0.051214
18041,Fayette County,,IN,1596,29086,30682,7,7,14,829,963,1792,6,0.295573,0.309401,47.557772,0.000628,0.000621,121,0.000177,0,31,0.571429,0.004952
18043,Floyd County,,IN,6640,80934,87574,9,7,16,4246,4796,9042,6,0.300808,0.315754,113.592769,0.001133,0.001089,121,0.000241,0,31,0.511111,0.008799
18045,Fountain County,,IN,1544,22557,24101,7,7,14,886,1019,1905,6,0.295813,0.309716,662.477636,0.000741,0.000704,121,0.000212,0,31,0.452381,0.005543
18047,Franklin County,,IN,1937,34504,36441,9,9,18,1612,1236,2848,6,0.300839,0.315966,127.894891,0.000861,0.001275,121,0.000205,0,31,0.477778,0.00572
18049,Fulton County,,IN,1770,25981,27751,7,8,15,869,957,1826,6,0.295753,0.30986,58.945258,0.00007,0.0008,121,0.000165,0,31,0.444444,0.001239
18051,Gibson County,,IN,1937,40197,42134,8,8,16,1210,1131,2341,7,0.253492,0.263638,30.226344,0.000066,0.000062,121,0.000295,0,31,0.5,0.001314
18053,Grant County,,IN,3951,79856,83807,10,12,22,1459,1935,3394,6,0.296508,0.311668,1062.753095,0.001134,0.001221,121,0.0002,0,31,0.55303,0.008601
18055,Greene County,,IN,2100,37899,39999,10,9,19,1355,1334,2689,6,0.295813,0.310003,126.727555,0.000761,0.000692,121,0.000252,0,31,0.5,0.005865
18057,Hamilton County,,IN,17811,244523,262334,81,66,147,22351,12190,34541,6,0.383164,0.413814,22181.133742,0.035442,0.030051,121,0.001054,0,31,0.418303,0.245723
18059,Hancock County,,IN,5387,77222,82609,12,10,22,4990,3661,8651,6,0.295723,0.310032,16.030606,0.001122,0.00101,121,0.000233,0,31,0.598485,0.008898
18061,Harrison County,,IN,2374,42774,45148,6,6,12,1742,1578,3320,7,0.293156,0.305794,6.713997,0.000498,0.000527,121,0.000207,0,31,0.633333,0.004265
18063,Hendricks County,,IN,10546,136817,147363,23,18,41,11044,7386,18430,6,0.339888,0.361209,2431.896598,0.006541,0.003506,121,0.000385,0,31,0.440217,0.045277
18065,Henry County,,IN,3138,59823,62961,10,9,19,1781,1941,3722,6,0.295783,0.310032,209.159064,0.000928,0.000939,121,0.000216,0,31,0.577778,0.00755
18067,Howard County,,IN,5178,106122,111300,13,15,28,2615,2725,5340,6,0.29675,0.312471,1204.380148,0.002338,0.00144,121,0.000246,0,31,0.4875,0.016564
18069,Huntington County,,IN,2437,47599,50036,6,8,14,1191,1295,2486,6,0.295994,0.31029,68.490437,0.000268,0.000784,121,0.000161,0,31,0.553571,0.002084
18071,Jackson County,,IN,2548,43780,46328,9,9,18,1324,1447,2771,6,0.295813,0.31009,101.269258,0.001142,0.000654,121,0.000229,0,31,0.533333,0.008801
18073,Jasper County,,IN,2415,39696,42111,9,9,18,1901,1406,3307,6,0.32758,0.345925,504.240639,0.002172,0.001927,179,0.000179,0,31,0.597222,0.014133
18075,Jay County,,IN,1350,24842,26192,5,7,12,714,755,1469,6,0.295813,0.309831,267.427168,0.000051,0.000609,121,0.000155,0,31,0.261905,0.00078
18077,Jefferson County,,IN,2215,38922,41137,11,14,25,998,1214,2212,6,0.301214,0.317304,383.023914,0.000551,0.001153,121,0.000283,0,31,0.32967,0.005065
18079,Jennings County,,IN,2186,30998,33184,7,8,15,1271,1343,2614,6,0.295663,0.309688,44.245198,0.00068,0.000648,121,0.000174,0,31,0.607143,0.005189
18081,Johnson County,,IN,11817,140304,152121,23,22,45,9757,8504,18261,6,0.342736,0.365111,2307.004433,0.004028,0.005738,121,0.000412,0,31,0.369458,0.029222
18083,Knox County,,IN,2077,41221,43298,8,10,18,670,911,1581,6,0.296538,0.311082,7046.031578,0.000663,0.000717,121,0.000258,0,31,0.444444,0.005308
18085,Kosciusko County,,IN,5016,90476,95492,14,14,28,2614,2765,5379,6,0.328507,0.347934,2159.099866,0.002663,0.003077,121,0.000243,0,31,0.477941,0.01707
18087,LaGrange County,,IN,2505,42234,44739,6,7,13,1549,1676,3225,7,0.279985,0.292115,12.479611,0.000333,0.00044,121,0.000144,0,31,0.571429,0.002536
18089,Lake County,,IN,26576,558102,584678,42,75,117,19680,19399,39079,6,0.386839,0.418492,9671.428518,0.021636,0.037423,179,0.000524,0,31,0.494211,0.146379
18091,LaPorte County,,IN,6000,127409,133409,10,16,26,3099,3156,6255,6,0.340047,0.36114,264.581989,0.003204,0.004918,179,0.000153,0,31,0.6875,0.019368
18093,Lawrence County,,IN,2173,54232,56405,8,7,15,1214,1096,2310,6,0.295603,0.309458,2876.443015,0.000723,0.000665,121,0.000232,0,31,0.402778,0.005466
18095,Madison County,,IN,7434,150574,158008,10,16,26,3496,4166,7662,6,0.332341,0.35225,494.844449,0.001247,0.002535,121,0.000203,0,31,0.525,0.009387
18097,Marion County,,IN,66351,953937,1020288,190,176,366,47288,55853,103141,5,0.418806,0.459992,218930.450689,0.068744,0.069944,121,0.002628,0,31,0.247009,0.47031
18099,Marshall County,,IN,3033,55315,58348,11,10,21,2151,1866,4017,6,0.296357,0.311151,993.228569,0.00243,0.001132,121,0.000181,0,31,0.666667,0.015286
18101,Martin County,,IN,624,11793,12417,4,3,7,240,262,502,7,0.22886,0.2358,4.012627,0.000013,0.000013,121,0.000171,0,31,0.5,0.000556
18103,Miami County,,IN,2742,38778,41520,8,9,17,1280,1530,2810,6,0.296085,0.310549,216.275967,0.000646,0.001159,121,0.000172,0,31,0.509091,0.005073
18105,Monroe County,,IN,10296,109219,119515,34,37,71,5130,5715,10845,6,0.366112,0.392539,12369.046581,0.008613,0.014392,121,0.000552,0,31,0.352451,0.057791
18107,Montgomery County,,IN,2417,40292,42709,9,7,16,1025,1274,2299,6,0.295633,0.309458,9.458291,0.00079,0.000758,121,0.000226,0,31,0.597222,0.006385
18109,Morgan County,,IN,4912,69099,74011,9,14,23,3935,3534,7469,6,0.296085,0.311123,17.99924,0.001047,0.001196,121,0.000199,0,31,0.516484,0.00815
18111,Newton County,,IN,1001,13222,14223,5,4,9,664,580,1244,6,0.284204,0.295988,271.534534,0.001528,0.000298,179,0.000111,0,31,0.533333,0.009476
18113,Noble County,,IN,3645,53485,57130,7,7,14,2167,2347,4514,7,0.275208,0.287179,6.905934,0.000337,0.000274,121,0.000167,0,31,0.642857,0.002609
18115,Ohio County,,IN,596,5973,6569,3,2,5,352,344,696,7,0.23145,0.238328,0,0.000602,0.000018,121,0.000102,0,31,1,0.003566
18117,Orange County,,IN,1110,20737,21847,6,5,11,554,527,1081,7,0.231856,0.239634,959.418311,0.000721,0.00002,121,0.00019,0,31,0.404762,0.005156
18119,Owen County,,IN,1587,22416,24003,7,8,15,1461,1092,2553,6,0.295512,0.309401,3.849158,0.000753,0.000724,121,0.00017,0,31,0.696429,0.005685
18121,Parke County,,IN,1158,17200,18358,8,6,14,851,695,1546,6,0.295542,0.309171,478.962402,0.000656,0.000609,121,0.000221,0,31,0.625,0.005444
18123,Perry County,,IN,1075,21165,22240,6,5,11,492,548,1040,7,0.25438,0.264229,165.091468,0.00007,0.000058,121,0.000233,0,31,0.466667,0.001113
18125,Pike County,,IN,802,13009,13811,6,4,10,525,462,987,7,0.253293,0.26272,0.869127,0.000066,0.000048,121,0.000218,0,31,0.8,0.001115
18127,Porter County,,IN,10396,163017,173413,16,20,36,8496,6424,14920,6,0.34477,0.366988,200.838473,0.005784,0.008446,179,0.000223,0,31,0.666667,0.036949
18129,Posey County,,IN,2316,35755,38071,4,5,9,1241,1466,2707,7,0.254291,0.264,18.097788,0.000053,0.000053,121,0.000186,0,31,0.6,0.000809
18131,Pulaski County,,IN,984,15959,16943,7,7,14,616,551,1167,7,0.269063,0.28043,49.343884,0.000401,0.000172,121,0.000151,0,31,0.5,0.002456
18133,Putnam County,,IN,2705,38322,41027,8,10,18,1825,1763,3588,6,0.295663,0.30986,9.765354,0.000668,0.000781,121,0.0002,0,31,0.609091,0.0056
18135,Randolph County,,IN,2110,31018,33128,6,6,12,1149,1214,2363,6,0.295723,0.309573,31.22493,0.000099,0.000629,121,0.000146,0,31,0.547619,0.00116
18137,Ripley County,,IN,1454,22639,24093,6,7,13,921,956,1877,6,0.30059,0.315364,28.777114,0.000628,0.001078,121,0.000155,0,31,0.619048,0.004031
18139,Rush County,,IN,1126,19608,20734,6,7,13,712,726,1438,6,0.295512,0.309286,14.158062,0.000612,0.000608,121,0.000163,0,31,0.666667,0.00477
18141,St. Joseph County,,IN,15765,293844,309609,42,54,96,7762,9985,17747,6,0.385811,0.414859,6489.563314,0.019477,0.030102,121,0.000522,0,31,0.55156,0.130502
18143,Scott County,,IN,1540,26079,27619,8,7,15,1082,1005,2087,6,0.30087,0.315869,30.525,0.000535,0.0011,121,0.000218,0,31,0.652778,0.0047
18145,Shelby County,,IN,3126,45466,48592,8,10,18,1604,2144,3748,6,0.295753,0.31009,10.447754,0.000682,0.000998,121,0.000198,0,31,0.577778,0.00536
18147,Spencer County,,IN,1377,22139,23516,5,5,10,829,859,1688,7,0.254358,0.264172,6.825971,0.00007,0.000066,121,0.000199,0,31,0.75,0.001047
18149,Starke County,,IN,1657,25563,27220,9,8,17,1185,1090,2275,6,0.326109,0.343572,368.624167,0.00177,0.001445,121,0.000159,0,31,0.611111,0.010775
18151,Steuben County,,IN,2560,37412,39972,9,8,17,1491,1333,2824,6,0.296357,0.310807,213.199634,0.000917,0.000793,121,0.000187,0,31,0.472222,0.006784
18153,Sullivan County,,IN,1215,22337,23552,5,5,10,728,696,1424,6,0.295633,0.3092,1.75,0.00062,0.000608,121,0.000149,0,31,0.9,0.00471
18155,Switzerland County,,IN,810,7628,8438,4,5,9,385,467,852,6,0.294165,0.307099,807.355044,0.000607,0.000578,121,0.000138,0,31,0.55,0.003711
18157,Tippecanoe County,,IN,11921,143783,155704,44,46,90,6392,6349,12741,6,0.367502,0.395787,22682.60202,0.012139,0.01501,121,0.000747,0,31,0.293182,0.08216
18159,Tipton County,,IN,1189,17783,18972,3,4,7,669,771,1440,6,0.295482,0.308884,0,0.000281,0.00089,121,0.000089,0,31,1,0.002526
18161,Union County,,IN,452,5132,5584,3,4,7,223,286,509,7,0.273781,0.284987,0.949722,0.000248,0.000214,121,0.000095,0,31,0.833333,0.001763
18163,Vanderburgh County,,IN,10371,190920,201291,28,27,55,6108,6289,12397,6,0.338896,0.361771,64320.856882,0.00493,0.005734,121,0.000771,0,31,0.220143,0.035982
18165,Vermillion County,,IN,1178,19292,20470,4,4,8,640,613,1253,7,0.248184,0.257004,3.478604,0.000064,0.000035,121,0.000141,0,31,0.5,0.000808
18167,Vigo County,,IN,6517,109657,116174,19,21,40,2788,3402,6190,6,0.329551,0.350086,11748.486526,0.002828,0.003101,121,0.000424,0,31,0.330952,0.019554
18169,Wabash County,,IN,2066,38793,40859,5,8,13,793,1094,1887,6,0.296055,0.310405,52.797138,0.000274,0.000783,121,0.000124,0,31,0.607143,0.002002
18171,Warren County,,IN,585,9044,9629,3,3,6,368,350,718,7,0.269288,0.280149,0.792832,0.000157,0.000129,121,0.000106,0,31,0.666667,0.001192
18173,Warrick County,,IN,4290,62018,66308,9,8,17,3174,2607,5781,6,0.296236,0.310422,1319.727461,0.000898,0.00062,121,0.000283,0,31,0.411111,0.007334
18175,Washington County,,IN,1589,30809,32398,8,8,16,1004,993,1997,6,0.300839,0.315926,1094.949356,0.000504,0.001105,121,0.000256,0,31,0.527778,0.004591
18177,Wayne County,,IN,4007,79200,83207,14,15,29,1692,2075,3767,6,0.309826,0.327979,2806.667404,0.002702,0.002416,121,0.000276,0,31,0.371324,0.020585
18179,Wells County,,IN,1780,31679,33459,5,4,9,1041,993,2034,7,0.275026,0.286433,141.699613,0.000236,0.000178,121,0.000153,0,31,0.4,0.001753
18181,White County,,IN,2119,26159,28278,7,7,14,943,1205,2148,6,0.295813,0.309803,218.638499,0.00153,0.00088,121,0.000158,0,31,0.625,0.00971
18183,Whitley County,,IN,2041,38894,40935,6,5,11,1518,1255,2773,7,0.275052,0.286606,3.564286,0.000269,0.000203,121,0.000145,0,31,0.666667,0.00204
19001,Adair County,,IA,651,11125,11776,4,5,9,299,335,634,6,0.284929,0.296849,3.95,0.000312,0.000243,179,0.000193,0,31,0.7,0.002135
19003,Adams County,,IA,285,5552,5837,1,0,1,54,0,54,0,0,0,0,0.000002,0,179,0.000087,0,2,0,0.000111
19005,Allamakee County,,IA,733,16977,17710,2,3,5,187,212,399,7,0.224924,0.23153,13.667887,0.000001,0.000005,179,0.000121,0,31,0.333333,0.00022
19007,Appanoose County,,IA,651,14544,15195,5,4,9,278,199,477,6,0.284957,0.296792,1987.132729,0.000298,0.00022,179,0.000243,0,31,0.5,0.002097
19009,Audubon County,,IA,496,8577,9073,2,3,5,81,183,264,6,0.284901,0.296562,131.784688,0.000298,0.000216,179,0.000099,0,31,0.5,0.001736
19011,Benton County,,IA,2056,34196,36252,6,6,12,1572,1256,2828,6,0.276308,0.287494,61.996124,0.000594,0.000246,179,0.000172,0,31,0.619048,0.003917
19013,Black Hawk County,,IA,7898,137835,145733,27,32,59,3184,4385,7569,6,0.352513,0.376343,30370.027193,0.006608,0.007774,179,0.000596,0,31,0.279516,0.047633
19015,Boone County,,IA,2330,37037,39367,7,6,13,1413,1242,2655,6,0.285125,0.297308,146.67937,0.000384,0.000261,179,0.000211,0,31,0.642857,0.002629
19017,Bremer County,,IA,1377,25787,27164,5,4,9,830,607,1437,6,0.285209,0.297222,141.711435,0.000142,0.000269,179,0.000167,0,31,0.5,0.001605
19019,Buchanan County,,IA,1343,25432,26775,5,5,10,702,650,1352,6,0.285602,0.298043,53.891054,0.000145,0.000362,179,0.000165,0,31,0.6,0.001643
19021,Buena Vista County,,IA,1712,22649,24361,8,7,15,531,456,987,6,0.299135,0.313281,10580.898461,0.001695,0.000889,179,0.000321,0,31,0.255556,0.01251
19023,Butler County,,IA,862,18710,19572,4,4,8,461,443,904,7,0.260752,0.270166,6.764286,0.00007,0.000057,179,0.000147,0,31,0.3,0.000823
19025,Calhoun County,,IA,800,13522,14322,2,4,6,188,290,478,7,0.251059,0.259446,2364.226858,0.000015,0.000006,179,0.000098,0,31,0.166667,0.000218
19027,Carroll County,,IA,1300,26787,28087,6,5,11,402,395,797,6,0.294106,0.306979,998.679718,0.000304,0.000581,179,0.000188,0,31,0.25,0.002148
19029,Cass County,,IA,742,15955,16697,3,4,7,238,232,470,6,0.293987,0.306663,37.10364,0.00003,0.000601,91,0.000142,0,31,0.6,0.000496
19031,Cedar County,,IA,1529,23794,25323,5,5,10,977,849,1826,6,0.277258,0.288194,10.698055,0.000345,0.000242,179,0.000137,0,31,0.7,0.002212
19033,Cerro Gordo County,,IA,2860,55148,58008,12,13,25,1149,1267,2416,6,0.335141,0.35501,22157.670981,0.000651,0.002293,179,0.000396,0,31,0.291209,0.004636
19035,Cherokee County,,IA,855,16808,17663,4,3,7,261,231,492,7,0.258317,0.267478,134.915252,0.000052,0.000056,50,0.000163,0,31,0.25,0.000808
19037,Chickasaw County,,IA,783,15480,16263,3,4,7,152,264,416,7,0.260893,0.270453,337.431574,0.000066,0.000056,179,0.000119,0,31,0.3,0.000712
19039,Clarke County,,IA,901,10546,11447,3,3,6,346,307,653,6,0.284818,0.29639,1,0.000297,0.000219,179,0.000143,0,31,0.666667,0.00187
19041,Clay County,,IA,1170,20932,22102,5,4,9,415,305,720,7,0.231819,0.239223,4333.474726,0.000052,0.000017,50,0.000205,0,31,0.2,0.000919
19043,Clayton County,,IA,1048,23059,24107,7,6,13,560,504,1064,7,0.266398,0.277059,3544.45823,0.000178,0.000131,179,0.000222,0,31,0.357143,0.00207
19045,Clinton County,,IA,2849,59388,62237,8,11,19,1347,1492,2839,6,0.340087,0.359986,759.819885,0.001493,0.002747,179,0.000161,0,31,0.618182,0.009952
19047,Crawford County,,IA,1101,19024,20125,3,6,9,138,390,528,6,0.294136,0.30718,171.928902,0.000383,0.000605,179,0.000136,0,31,0.303571,0.002963
19049,Dallas County,,IA,4305,50206,54511,17,11,28,4603,2601,7204,6,0.333066,0.351607,4436.448209,0.002757,0.001869,179,0.000434,0,31,0.385621,0.019103
19051,Davis County,,IA,616,10032,10648,2,1,3,168,169,337,7,0.22299,0.228997,0,0.000003,0.000003,179,0.000109,0,31,1,0.00022
19053,Decatur County,,IA,651,8089,8740,2,2,4,154,183,337,6,0.28479,0.296218,0,0.000295,0.000215,179,0.00011,0,31,1,0.001747
19055,Delaware County,,IA,1020,21327,22347,5,5,10,460,534,994,7,0.266178,0.276542,7.157546,0.000111,0.000129,179,0.000177,0,31,0.55,0.001446
19057,Des Moines County,,IA,2499,48914,51413,8,8,16,838,963,1801,6,0.287184,0.30043,9517.17259,0.000335,0.000454,179,0.000214,0,31,0.361111,0.002497
19059,Dickinson County,,IA,1308,19907,21215,6,6,12,415,426,841,6,0.288353,0.301211,15125.437977,0.000336,0.000289,50,0.000311,0,31,0.190476,0.002439
19061,Dubuque County,,IA,4170,108666,112836,14,16,30,1921,2055,3976,6,0.344035,0.365553,5154.509196,0.004027,0.003795,179,0.000295,0,31,0.448529,0.027729
19063,Emmet County,,IA,672,12187,12859,2,1,3,124,102,226,7,0.223832,0.229642,22.857465,0.000002,0.000003,50,0.000122,0,31,0,0.000212
19065,Fayette County,,IA,1298,23497,24795,6,7,13,551,657,1208,6,0.285799,0.298646,1461.099175,0.000145,0.000364,179,0.000218,0,31,0.428571,0.001731
19067,Floyd County,,IA,920,18466,19386,5,6,11,447,400,847,6,0.285433,0.297882,676.098054,0.000084,0.000274,179,0.000204,0,31,0.4,0.00096
19069,Franklin County,,IA,764,14551,15315,2,5,7,183,355,538,6,0.285237,0.297452,12.204758,0.000022,0.00022,179,0.000095,0,31,0.25,0.00025
19071,Fremont County,,IA,729,10262,10991,5,3,8,352,212,564,6,0.288984,0.300585,3.233333,0.000409,0.000388,91,0.000196,0,31,0.55,0.003307
19073,Greene County,,IA,725,11726,12451,3,6,9,153,376,529,6,0.284985,0.297079,3.2,0.000022,0.000263,179,0.000146,0,31,0.633333,0.00051
19075,Grundy County,,IA,806,15226,16032,3,3,6,382,301,683,6,0.285153,0.297021,55.281846,0.000069,0.00029,179,0.000119,0,31,0.666667,0.000886
19077,Guthrie County,,IA,669,12069,12738,5,3,8,519,315,834,6,0.284846,0.296447,1.283333,0.000317,0.000238,179,0.000188,0,31,0.65,0.002236
19079,Hamilton County,,IA,1151,18667,19818,6,6,12,583,602,1185,6,0.285153,0.297366,1542.326088,0.000369,0.000239,179,0.000177,0,31,0.6,0.002341
19081,Hancock County,,IA,695,13840,14535,3,4,7,305,302,607,7,0.251385,0.260017,484.581388,0.000021,0.000006,179,0.000155,0,31,0.416667,0.00035
19083,Hardin County,,IA,1110,19002,20112,4,6,10,290,459,749,6,0.285293,0.297653,206.044255,0.000064,0.000312,179,0.000131,0,31,0.566667,0.00074
19085,Harrison County,,IA,1015,18228,19243,3,3,6,550,479,1029,6,0.288955,0.300528,3.84668,0.000553,0.000389,91,0.00012,0,31,0.583333,0.004106
19087,Henry County,,IA,1307,23067,24374,6,7,13,525,542,1067,6,0.28707,0.300115,1888.722152,0.000168,0.000405,179,0.000172,0,31,0.535714,0.001304
19089,Howard County,,IA,684,13043,13727,2,4,6,176,224,400,7,0.235485,0.242568,42.878748,0.000006,0.000008,179,0.000113,0,31,0.25,0.00025
19091,Humboldt County,,IA,611,12540,13151,3,3,6,195,194,389,6,0.285125,0.296935,247.102455,0.000016,0.000216,179,0.000125,0,31,0.5,0.000319
19093,Ida County,,IA,487,8811,9298,2,1,3,111,50,161,7,0.258202,0.26699,1.916667,0.000047,0.000041,50,0.000091,0,31,0,0.000526
19095,Iowa County,,IA,1103,19662,20765,6,5,11,703,626,1329,6,0.276177,0.287121,1122.458892,0.000238,0.000204,179,0.000194,0,31,0.466667,0.002068
19097,Jackson County,,IA,1228,22628,23856,4,5,9,595,690,1285,7,0.269113,0.27946,3.004576,0.000226,0.000189,179,0.000107,0,31,0.65,0.001743
19099,Jasper County,,IA,2300,44695,46995,8,8,16,1249,1240,2489,6,0.285433,0.297865,18.094164,0.000426,0.000297,179,0.000234,0,31,0.527778,0.003224
19101,Jefferson County,,IA,1071,17253,18324,4,7,11,316,442,758,6,0.286928,0.299885,1441.768566,0.000008,0.000406,179,0.000153,0,31,0.5,0.000448
19103,Johnson County,,IA,11547,117872,129419,39,45,84,6092,6594,12686,5,0.378717,0.406181,44769.573497,0.011522,0.019041,179,0.000726,0,31,0.349406,0.077504
19105,Jones County,,IA,1152,21648,22800,5,4,9,734,590,1324,6,0.275993,0.286662,16.327403,0.00011,0.000191,179,0.000156,0,31,0.6,0.001442
19107,Keokuk County,,IA,699,13339,14038,4,4,8,272,283,555,7,0.223522,0.2304,14.341382,0.000008,0.000009,179,0.000171,0,31,0.25,0.000482
19109,Kossuth County,,IA,938,20308,21246,4,5,9,218,269,487,6,0.285237,0.297394,3227.642443,0.000002,0.000214,179,0.000192,0,31,0.15,0.000389
19111,Lee County,,IA,2005,41442,43447,4,7,11,616,706,1322,6,0.277126,0.288705,5971.222479,0.000007,0.000193,179,0.000186,0,31,0.333333,0.000423
19113,Linn County,,IA,11824,225930,237754,40,38,78,6771,6744,13515,6,0.362321,0.388481,46606.685971,0.011147,0.009005,179,0.000793,0,31,0.256707,0.078616
19115,Louisa County,,IA,984,15469,16453,4,5,9,425,517,942,6,0.275052,0.28564,4.938034,0.000176,0.000104,179,0.000121,0,31,0.65,0.001114
19117,Lucas County,,IA,663,10101,10764,4,4,8,263,272,535,6,0.284846,0.296562,1448.194334,0.000297,0.000221,179,0.000185,0,31,0.55,0.001988
19119,Lyon County,,IA,678,15056,15734,3,3,6,261,311,572,7,0.265205,0.275007,0,0.000097,0.000078,50,0.000148,0,31,1,0.000947
19121,Madison County,,IA,1145,16938,18083,5,4,9,810,656,1466,6,0.284901,0.296677,3.95,0.000314,0.000241,179,0.000199,0,31,0.7,0.002258
19123,Mahaska County,,IA,1720,27533,29253,7,6,13,703,716,1419,6,0.285405,0.297578,2054.989591,0.000304,0.000234,179,0.000245,0,31,0.452381,0.002404
19125,Marion County,,IA,2141,35320,37461,5,8,13,760,1061,1821,6,0.288295,0.300557,983.806223,0.0003,0.00025,179,0.000192,0,31,0.392857,0.002127
19127,Marshall County,,IA,2540,47085,49625,11,11,22,899,1139,2038,6,0.287127,0.300803,4608.839875,0.002743,0.000494,179,0.000271,0,31,0.429487,0.020341
19129,Mills County,,IA,1225,17217,18442,4,5,9,818,682,1500,6,0.291947,0.304109,9.780968,0.000556,0.000543,91,0.000147,0,31,0.7,0.004226
19131,Mitchell County,,IA,517,12425,12942,3,2,5,141,115,256,7,0.251124,0.259283,54.751855,0.000021,0.000006,179,0.000129,0,31,0.333333,0.000348
19133,Monona County,,IA,667,11611,12278,4,1,5,346,194,540,7,0.258202,0.26699,8.210946,0.000423,0.000041,50,0.000142,0,31,0.5,0.003299
19135,Monroe County,,IA,455,8873,9328,4,4,8,202,228,430,7,0.225169,0.231823,9.190446,0.0003,0.00001,179,0.000171,0,31,0.7,0.001995
19137,Montgomery County,,IA,786,13393,14179,4,5,9,216,287,503,6,0.28907,0.300987,216.06886,0.000405,0.000393,91,0.000159,0,31,0.6,0.003165
19139,Muscatine County,,IA,2585,48077,50662,5,10,15,973,1322,2295,6,0.331696,0.350218,313.904118,0.000332,0.001672,179,0.000129,0,31,0.533333,0.001868
19141,O'Brien County,,IA,1013,17263,18276,3,6,9,221,397,618,7,0.224282,0.231381,3025.534167,0.000005,0.000005,50,0.000167,0,31,0.066667,0.000336
19143,Osceola County,,IA,352,6873,7225,1,0,1,59,0,59,0,0,0,0,0,0,50,0.000074,0,27,0,0.000096
19145,Page County,,IA,902,16073,16975,4,5,9,289,314,603,6,0.289128,0.301073,2995.631054,0.000378,0.000392,91,0.000179,0,31,0.5,0.002985
19147,Palo Alto County,,IA,674,10949,11623,2,4,6,101,238,339,7,0.22287,0.229183,682.454367,0.000002,0,50,0.000127,0,31,0,0.000204
19149,Plymouth County,,IA,1423,28445,29868,4,5,9,737,632,1369,6,0.286391,0.298548,91.642433,0.00005,0.000257,50,0.000169,0,31,0.433333,0.000747
19151,Pocahontas County,,IA,522,9728,10250,2,1,3,100,58,158,7,0.230312,0.236565,34.46021,0,0.000014,179,0.000098,0,31,0,0.000187
19153,Polk County,,IA,24280,446880,471160,100,97,197,16514,16846,33360,5,0.398081,0.431824,224747.210879,0.025808,0.035479,179,0.002111,0,31,0.211274,0.177463
19155,Pottawattamie County,,IA,6090,97028,103118,18,12,30,3898,3644,7542,6,0.334716,0.353553,4513.557425,0.00242,0.003082,91,0.000506,0,31,0.28655,0.018581
19157,Poweshiek County,,IA,1227,20768,21995,8,7,15,519,491,1010,6,0.286504,0.299139,630.719284,0.001449,0.00034,179,0.000232,0,31,0.472222,0.01016
19159,Ringgold County,,IA,242,5602,5844,2,0,2,86,0,86,0,0,0,0,0.000293,0,179,0.000098,0,15,0,0.001732
19161,Sac County,,IA,739,12336,13075,3,4,7,170,267,437,6,0.285097,0.297021,485.482623,0.000012,0.00023,179,0.000142,0,31,0.416667,0.000411
19163,Scott County,,IA,10573,181749,192322,22,30,52,4902,5652,10554,6,0.363318,0.387643,10830.998287,0.006149,0.011863,179,0.000371,0,31,0.4375,0.041857
19165,Shelby County,,IA,662,15419,16081,2,3,5,216,233,449,6,0.289042,0.300671,0.666667,0.000397,0.000389,91,0.000104,0,31,0.833333,0.002919
19167,Sioux County,,IA,1749,37049,38798,6,7,13,475,697,1172,6,0.28841,0.301469,3203.589978,0.00014,0.000332,50,0.000234,0,31,0.333333,0.001544
19169,Story County,,IA,7491,73755,81246,21,23,44,2921,3684,6605,6,0.353156,0.37655,7488.807259,0.002271,0.006819,179,0.000484,0,31,0.358466,0.016276
19171,Tama County,,IA,1042,18268,19310,5,6,11,479,521,1000,6,0.285602,0.298186,16.242989,0.000147,0.000399,179,0.000158,0,31,0.733333,0.001874
19173,Taylor County,,IA,536,7591,8127,2,3,5,116,179,295,7,0.227408,0.233737,25.820062,0.000012,0.000008,179,0.000101,0,31,0,0.000241
19175,Union County,,IA,954,12920,13874,4,4,8,235,323,558,6,0.284873,0.29662,4212.179886,0.000297,0.000218,179,0.000173,0,31,0.25,0.001961
19177,Van Buren County,,IA,471,9293,9764,2,3,5,165,195,360,7,0.223213,0.22972,1.674603,0.000007,0.000003,179,0.000099,0,31,0.666667,0.000226
19179,Wapello County,,IA,2280,37252,39532,9,11,20,762,859,1621,6,0.286957,0.300459,15026.820141,0.000304,0.000389,179,0.000388,0,31,0.257576,0.002642
19181,Warren County,,IA,3141,43602,46743,8,9,17,2329,2108,4437,6,0.285349,0.297808,27.513648,0.000375,0.000271,179,0.000288,0,31,0.430556,0.002746
19183,Washington County,,IA,1317,23539,24856,7,7,14,728,682,1410,6,0.276361,0.287666,2113.848137,0.000253,0.000192,179,0.000189,0,31,0.410714,0.002062
19185,Wayne County,,IA,385,7372,7757,3,2,5,150,109,259,7,0.221832,0.227533,0.5,0.000297,0.000005,179,0.00016,0,31,0.833333,0.001865
19187,Webster County,,IA,2227,42477,44704,7,11,18,673,958,1631,6,0.332799,0.351837,12195.89678,0.000357,0.001554,179,0.000222,0,31,0.336364,0.002426
19189,Winnebago County,,IA,794,13520,14314,5,4,9,290,305,595,7,0.25132,0.259874,2230.509803,0.000029,0.000006,179,0.000217,0,31,0.35,0.000606
19191,Winneshiek County,,IA,1093,21550,22643,5,4,9,315,319,634,7,0.237042,0.244502,165.827116,0.00001,0.000008,179,0.000184,0,31,0.15,0.000548
19193,Woodbury County,,IA,7241,116502,123743,20,28,48,2878,4141,7019,6,0.348035,0.371149,41638.818998,0.004999,0.005136,50,0.000687,0,31,0.245977,0.035949
19195,Worth County,,IA,532,8823,9355,3,2,5,266,232,498,7,0.251146,0.259271,4.754915,0.000027,0.000006,179,0.000138,0,31,0.5,0.000417
19197,Wright County,,IA,953,15486,16439,4,5,9,261,331,592,6,0.285293,0.297509,194.880544,0.000017,0.000225,179,0.000142,0,31,0.380952,0.00043
20001,Allen County,,KS,1068,15662,16730,2,3,5,145,315,460,7,0.233365,0.240391,7.601046,0.000009,0.000024,56,0.000093,0,31,0,0.000224
20003,Anderson County,,KS,654,10057,10711,4,5,9,333,317,650,6,0.296993,0.308913,3605.523809,0.000507,0.000563,56,0.000129,0,31,0.55,0.003752
20005,Atchison County,,KS,1122,19374,20496,7,7,14,459,432,891,6,0.299505,0.312282,6056.198518,0.000722,0.000678,56,0.000186,0,31,0.428571,0.005404
20007,Barber County,,KS,333,5966,6299,0,1,1,0,43,43,6,0.285756,0.29712,0,0,0.000259,56,0.000051,0,61,0,0
20009,Barton County,,KS,1871,31160,33031,8,11,19,503,718,1221,6,0.301182,0.314991,14478.233659,0.000368,0.000924,56,0.000362,0,31,0.325758,0.002752
20011,Bourbon County,,KS,1123,17541,18664,3,5,8,225,403,628,6,0.300746,0.313527,25.184399,0.000507,0.000747,56,0.000102,0,31,0.4,0.003621
20013,Brown County,,KS,873,12590,13463,2,7,9,112,446,558,6,0.297267,0.30963,1351.232353,0.000006,0.000647,56,0.000114,0,31,0.333333,0.000236
20015,Butler County,,KS,4778,67219,71997,8,11,19,3163,2787,5950,6,0.319753,0.336289,270.214058,0.000478,0.001846,56,0.000223,0,31,0.442308,0.003514
20017,Chase County,,KS,249,3277,3526,1,1,2,71,64,135,7,0.233028,0.239329,0,0.00001,0.00002,56,0.000082,0,31,0,0.000257
20019,Chautauqua County,,KS,356,5201,5557,1,1,2,71,89,160,7,0.233328,0.239708,0,0.000011,0.000007,56,0.000071,0,31,0,0.000149
20021,Cherokee County,,KS,1688,25382,27070,5,5,10,843,1012,1855,7,0.256855,0.266721,6.875153,0.000074,0.000077,56,0.00015,0,31,0.65,0.001101
20023,Cheyenne County,,KS,246,3538,3784,0,0,0,0,0,0,0,0,0,0,0,0,20,0.000051,20,62,0,0
20025,Clark County,,KS,242,2647,2889,1,1,2,68,58,126,7,0.231542,0.237343,0,0.000007,0.000021,56,0.000076,0,31,0,0.000235
20027,Clay County,,KS,769,11607,12376,3,3,6,215,239,454,7,0.270946,0.281075,0,0.000182,0.000125,56,0.000104,0,31,1,0.00117
20029,Cloud County,,KS,716,10618,11334,2,3,5,127,162,289,7,0.261716,0.270895,5848,0.000012,0.000044,56,0.000163,0,31,0.333333,0.000277
20031,Coffey County,,KS,675,11038,11713,2,2,4,185,160,345,7,0.267133,0.277311,0.80722,0.000019,0.000114,56,0.000103,0,31,0.666667,0.000424
20033,Comanche County,,KS,116,2130,2246,0,0,0,0,0,0,0,0,0,0,0,0,21,0.000051,21,63,0,0
20035,Cowley County,,KS,2881,38894,41775,5,7,12,839,1151,1990,6,0.297236,0.311025,40.348787,0.000378,0.000744,56,0.000159,0,31,0.547619,0.002788
20037,Crawford County,,KS,2584,36185,38769,9,14,23,1224,1303,2527,6,0.304371,0.319536,3235.675422,0.000888,0.001555,56,0.000232,0,31,0.362637,0.006517
20039,Decatur County,,KS,299,4082,4381,0,0,0,0,0,0,0,0,0,0,0,0,22,0.000051,22,64,0,0
20041,Dickinson County,,KS,1702,22396,24098,5,6,11,806,644,1450,6,0.302563,0.315616,113.137463,0.000517,0.000863,56,0.000154,0,31,0.733333,0.0033
20043,Doniphan County,,KS,619,8683,9302,2,3,5,293,307,600,7,0.237565,0.244749,2.386341,0.000022,0.000016,56,0.000098,0,31,0.666667,0.000328
20045,Douglas County,,KS,10502,98118,108620,36,25,61,5696,5784,11480,6,0.3579,0.382002,8454.634654,0.008759,0.010139,56,0.000715,0,31,0.312821,0.061391
20047,Edwards County,,KS,334,3703,4037,0,0,0,0,0,0,0,0,0,0,0,0,23,0.000051,23,65,0,0
20049,Elk County,,KS,271,2992,3263,1,0,1,41,0,41,0,0,0,0,0.000329,0,56,0.000063,0,8,0,0.001963
20051,Ellis County,,KS,2254,30090,32344,8,12,20,584,908,1492,6,0.304084,0.318819,23449.623645,0.000879,0.001339,56,0.000405,0,31,0.373626,0.006076
20053,Ellsworth County,,KS,483,7365,7848,2,2,4,121,123,244,7,0.234572,0.241455,3.25,0.00002,0.000013,56,0.000109,0,31,0.5,0.000312
20055,Finney County,,KS,3780,41864,45644,9,17,26,651,1247,1898,6,0.345221,0.366586,21880.007894,0.00147,0.00496,56,0.000373,0,31,0.28655,0.010609
20057,Ford County,,KS,2542,33022,35564,7,8,15,685,697,1382,6,0.301276,0.31456,11206.709397,0.002573,0.000846,56,0.000239,0,31,0.345455,0.017288
20059,Franklin County,,KS,1913,27921,29834,8,8,16,1186,1104,2290,6,0.301151,0.314377,812.286844,0.001196,0.001039,56,0.000198,0,31,0.527778,0.008345
20061,Geary County,,KS,10430,35602,46032,26,39,65,2872,4145,7017,6,0.364184,0.390433,10437.676941,0.010429,0.015114,56,0.000395,0,31,0.56446,0.072388
20063,Gove County,,KS,243,4045,4288,0,0,0,0,0,0,0,0,0,0,0,0,24,0.000051,24,66,0,0
20065,Graham County,,KS,229,3796,4025,0,0,0,0,0,0,0,0,0,0,0,0,25,0.000051,25,67,0,0
20067,Grant County,,KS,839,9173,10012,0,2,2,0,120,120,7,0.256759,0.265298,0,0,0.000012,56,0.000051,0,69,0.5,0
20069,Gray County,,KS,576,7299,7875,2,2,4,175,162,337,7,0.256764,0.265337,0,0.000048,0.000033,56,0.000095,0,31,1,0.000422
20071,Greeley County,,KS,112,1663,1775,0,0,0,0,0,0,0,0,0,0,0,0,26,0.000051,26,70,0,0
20073,Greenwood County,,KS,663,7995,8658,3,3,6,263,253,516,6,0.285883,0.297624,1.008151,0.000354,0.000283,56,0.000112,0,31,0.833333,0.002351
20075,Hamilton County,,KS,258,2777,3035,0,0,0,0,0,0,0,0,0,0,0,0,27,0.000051,27,71,0,0
20077,Harper County,,KS,418,7000,7418,1,2,3,95,139,234,6,0.285742,0.297222,0,0.000329,0.000261,56,0.000063,0,31,1,0.001963
20079,Harvey County,,KS,2552,40222,42774,5,7,12,1337,1325,2662,6,0.300683,0.313642,17.896595,0.000381,0.000821,56,0.000142,0,31,0.642857,0.0025
20081,Haskell County,,KS,399,4494,4893,1,1,2,55,58,113,7,0.256693,0.265045,0,0,0.000012,56,0.000072,0,68,0.5,0.000088
20083,Hodgeman County,,KS,148,2367,2515,1,0,1,45,0,45,0,0,0,0,0.000007,0,56,0.000076,0,9,0,0.000235
20085,Jackson County,,KS,1147,16156,17303,4,4,8,688,659,1347,7,0.269188,0.279598,2.783333,0.000119,0.00018,56,0.00013,0,31,0.5,0.001187
20087,Jefferson County,,KS,1473,20398,21871,7,7,14,1099,995,2094,6,0.299196,0.311765,128.726715,0.00086,0.000784,56,0.000182,0,31,0.690476,0.006167
20089,Jewell County,,KS,287,4349,4636,0,0,0,0,0,0,0,0,0,0,0,0,28,0.000051,28,72,0,0
20091,Johnson County,,KS,38286,560095,598381,151,135,286,35805,29087,64892,5,0.421909,0.457427,163380.685941,0.057214,0.059314,56,0.002282,0,31,0.291057,0.392533
20093,Kearny County,,KS,448,4668,5116,1,1,2,82,107,189,7,0.25665,0.264964,0,0.000041,0.000012,56,0.000069,0,31,0,0.000187
20095,Kingman County,,KS,632,10574,11206,2,2,4,262,291,553,6,0.285771,0.29728,0,0.000357,0.000267,56,0.000086,0,31,1,0.002138
20097,Kiowa County,,KS,230,3586,3816,0,0,0,0,0,0,0,0,0,0,0,0,29,0.000051,29,73,0,0
20099,Labette County,,KS,1375,24588,25963,6,7,13,516,613,1129,6,0.286447,0.299145,681.678648,0.000402,0.000331,56,0.000162,0,31,0.571429,0.002986
20101,Lane County,,KS,155,2443,2598,0,0,0,0,0,0,0,0,0,0,0,0,30,0.000051,30,74,0,0
20103,Leavenworth County,,KS,10038,72273,82311,32,35,67,5561,5357,10918,6,0.354449,0.378972,2651.982909,0.011351,0.01238,56,0.000468,0,31,0.486643,0.07803
20105,Lincoln County,,KS,258,4424,4682,1,1,2,67,65,132,7,0.234439,0.240996,0,0.000012,0.00001,56,0.000081,0,31,0,0.000187
20107,Linn County,,KS,694,9631,10325,4,4,8,386,317,703,6,0.296902,0.308626,2.433333,0.00058,0.000493,56,0.00011,0,31,0.5,0.004014
20109,Logan County,,KS,279,3726,4005,0,1,1,0,40,40,8,0.18918,0.192649,0,0,0,56,0.000051,0,76,0,0
20111,Lyon County,,KS,3061,38208,41269,15,12,27,1119,1264,2383,6,0.303797,0.318555,11557.833376,0.002442,0.001223,56,0.000444,0,31,0.258333,0.018017
20113,McPherson County,,KS,1931,33603,35534,6,9,15,718,847,1565,6,0.301057,0.314503,809.623878,0.000378,0.000884,56,0.000188,0,31,0.555556,0.002649
20115,Marion County,,KS,791,14058,14849,3,4,7,306,383,689,6,0.285827,0.297624,0.2,0.000343,0.000269,56,0.000098,0,31,0.833333,0.002201
20117,Marshall County,,KS,698,13132,13830,2,3,5,88,185,273,7,0.261622,0.270694,4624.909452,0.00001,0.000034,56,0.000108,0,31,0.1,0.000252
20119,Meade County,,KS,423,5309,5732,0,1,1,0,46,46,7,0.23471,0.241349,0,0,0.000012,56,0.000051,0,77,0,0
20121,Miami County,,KS,1890,27619,29509,6,8,14,1248,1153,2401,6,0.301026,0.314147,40.807861,0.001009,0.001022,56,0.000155,0,31,0.607143,0.006937
20123,Mitchell County,,KS,421,7874,8295,0,0,0,0,0,0,0,0,0,0,0,0,31,0.000051,31,78,0,0
20125,Montgomery County,,KS,2602,37473,40075,9,11,20,863,1171,2034,6,0.304307,0.319232,6063.83329,0.000835,0.001289,56,0.000262,0,31,0.356061,0.005682
20127,Morris County,,KS,473,7383,7856,2,2,4,93,102,195,7,0.261858,0.270878,1.273548,0.000135,0.000055,56,0.000091,0,31,0.5,0.000945
20129,Morton County,,KS,455,4007,4462,0,2,2,0,108,108,7,0.231198,0.23814,0,0,0.000001,56,0.000051,0,79,0,0
20131,Nemaha County,,KS,544,11847,12391,2,2,4,147,111,258,7,0.266912,0.27699,21.822605,0.000006,0.000094,56,0.000095,0,31,0.166667,0.000187
20133,Neosho County,,KS,1199,17490,18689,4,6,10,399,474,873,6,0.297267,0.309516,662.96455,0.000018,0.000493,56,0.000146,0,31,0.4,0.000485
20135,Ness County,,KS,300,3866,4166,0,0,0,0,0,0,0,0,0,0,0,0,32,0.000051,32,80,0,0
20137,Norton County,,KS,306,5903,6209,0,0,0,0,0,0,0,0,0,0,0,0,33,0.000051,33,81,0,0
20139,Osage County,,KS,1501,19410,20911,4,5,9,846,964,1810,6,0.297328,0.309418,1.549967,0.000204,0.000669,56,0.000148,0,31,0.9,0.001863
20141,Osborne County,,KS,326,4900,5226,0,0,0,0,0,0,0,0,0,0,0,0,34,0.000051,34,82,0,0
20143,Ottawa County,,KS,738,9581,10319,1,1,2,285,278,563,7,0.234439,0.240996,0,0.000012,0.00001,56,0.000081,0,31,0,0.000187
20145,Pawnee County,,KS,536,7061,7597,1,1,2,59,75,134,7,0.231487,0.237447,0,0.000008,0.000003,56,0.000079,0,31,0,0.000125
20147,Phillips County,,KS,448,7166,7614,0,0,0,0,0,0,0,0,0,0,0,0,35,0.000051,35,83,0,0
20149,Pottawatomie County,,KS,2275,25638,27913,6,7,13,1245,1141,2386,6,0.29969,0.312311,6450.029128,0.000769,0.000689,56,0.000185,0,31,0.380952,0.005394
20151,Pratt County,,KS,802,10784,11586,1,2,3,69,243,312,6,0.285771,0.29728,0,0.000329,0.000267,56,0.000063,0,31,1,0.001963
20153,Rawlins County,,KS,186,3215,3401,0,0,0,0,0,0,0,0,0,0,0,0,36,0.000051,36,84,0,0
20155,Reno County,,KS,4003,70560,74563,14,15,29,1762,1955,3717,6,0.33949,0.36021,7986.973655,0.001009,0.003389,56,0.000402,0,31,0.342105,0.007631
20157,Republic County,,KS,407,6141,6548,1,1,2,43,75,118,8,0.207443,0.211958,0,0,0,56,0.000097,0,31,0,0.000094
20159,Rice County,,KS,791,10632,11423,3,3,6,233,288,521,7,0.253691,0.262365,1.75,0.000043,0.000014,56,0.000119,0,31,0.666667,0.00042
20161,Riley County,,KS,6910,40955,47865,24,20,44,2988,3246,6234,6,0.353887,0.376458,14348.851447,0.004161,0.006082,56,0.000534,0,31,0.324138,0.029415
20163,Rooks County,,KS,417,6267,6684,1,1,2,47,83,130,7,0.233197,0.239484,0,0.000011,0.000007,56,0.000079,0,31,0,0.00015
20165,Rush County,,KS,283,4137,4420,1,1,2,58,63,121,7,0.231505,0.237504,0,0.000011,0.000003,56,0.000079,0,31,1,0.00015
20167,Russell County,,KS,500,7366,7866,1,1,2,120,118,238,7,0.233197,0.239484,0,0.000011,0.000007,56,0.000079,0,31,0,0.00015
20169,Saline County,,KS,4050,58974,63024,16,15,31,1642,2012,3654,6,0.3062,0.321803,22859.519304,0.001208,0.001494,56,0.000528,0,31,0.321637,0.008661
20171,Scott County,,KS,448,5781,6229,1,1,2,50,59,109,7,0.25665,0.264964,0,0.000041,0.000012,56,0.000069,0,31,0,0.000187
20173,Sedgwick County,,KS,26473,517674,544147,90,107,197,14248,16917,31165,5,0.399945,0.434275,122711.814421,0.031319,0.039813,56,0.001577,0,31,0.308246,0.223481
20175,Seward County,,KS,2454,23082,25536,7,8,15,564,742,1306,6,0.306588,0.321924,14996.504863,0.001503,0.001129,56,0.000322,0,31,0.255556,0.010303
20177,Shawnee County,,KS,10190,191038,201228,42,36,78,6062,5863,11925,6,0.363819,0.390393,30005.31165,0.011425,0.01233,56,0.000882,0,31,0.302449,0.081787
20179,Sheridan County,,KS,171,3246,3417,0,0,0,0,0,0,0,0,0,0,0,0,37,0.000051,37,85,0,0
20181,Sherman County,,KS,612,6615,7227,0,1,1,0,41,41,8,0.18918,0.192649,0,0,0,56,0.000051,0,86,0,0
20183,Smith County,,KS,226,4566,4792,0,0,0,0,0,0,0,0,0,0,0,0,38,0.000051,38,87,0,0
20185,Stafford County,,KS,423,4937,5360,1,2,3,65,111,176,7,0.253647,0.262135,0,0.000008,0.000011,56,0.000079,0,31,1,0.000125
20187,Stanton County,,KS,250,2522,2772,0,0,0,0,0,0,0,0,0,0,0,0,39,0.000051,39,88,0,0
20189,Stevens County,,KS,519,5730,6249,2,1,3,138,43,181,7,0.234667,0.24126,14.232864,0.000009,0.000012,56,0.000106,0,31,0,0.000269
20191,Sumner County,,KS,1803,25447,27250,4,4,8,916,1059,1975,6,0.285939,0.297854,3.183094,0.000352,0.000296,56,0.000127,0,31,0.6,0.002318
20193,Thomas County,,KS,759,8472,9231,2,1,3,81,66,147,7,0.23324,0.239574,5810,0,0.000007,56,0.000137,0,75,0,0.000175
20195,Trego County,,KS,192,3379,3571,0,0,0,0,0,0,0,0,0,0,0,0,40,0.000051,40,89,0,0
20197,Wabaunsee County,,KS,499,6961,7460,2,2,4,232,233,465,7,0.266887,0.276904,0,0.000107,0.000101,56,0.000094,0,31,1,0.000945
20199,Wallace County,,KS,151,2004,2155,0,0,0,0,0,0,0,0,0,0,0,0,41,0.000051,41,90,0,0
20201,Washington County,,KS,374,7352,7726,1,0,1,68,0,68,0,0,0,0,0,0,56,0.000081,0,16,0,0.000094
20203,Wichita County,,KS,231,2730,2961,0,0,0,0,0,0,0,0,0,0,0,0,42,0.000051,42,91,0,0
20205,Wilson County,,KS,684,10021,10705,4,3,7,332,278,610,6,0.285911,0.297653,458.29547,0.000346,0.000266,56,0.000124,0,31,0.75,0.002335
20207,Woodson County,,KS,193,3555,3748,0,0,0,0,0,0,0,0,0,0,0,0,43,0.000051,43,92,0,0
20209,Wyandotte County,,KS,13892,150710,164602,16,24,40,7873,10897,18770,6,0.357459,0.381325,1448.067255,0.005352,0.009126,56,0.000305,0,31,0.52,0.036721
21001,Adair County,,KY,880,17958,18838,3,5,8,214,350,564,8,0.229583,0.236701,4342.539285,0.00046,0.000014,121,0.00012,0,31,0.333333,0.003724
21003,Allen County,,KY,1694,25257,26951,7,6,13,1045,911,1956,7,0.268045,0.278754,177.213557,0.000685,0.000135,121,0.000205,0,31,0.232143,0.005399
21005,Anderson County,,KY,1647,28871,30518,6,6,12,1140,907,2047,7,0.294972,0.308107,49.371695,0.000722,0.000749,121,0.000212,0,31,0.733333,0.005902
21007,Ballard County,,KY,540,9651,10191,1,1,2,221,234,455,7,0.250453,0.258298,0,0.000019,0.000012,54,0.000096,0,31,0,0.000204
21009,Barren County,,KY,2130,45036,47166,8,8,16,1278,1138,2416,7,0.295302,0.308968,9088.256254,0.000495,0.000764,121,0.000357,0,31,0.263889,0.004488
21011,Bath County,,KY,812,13403,14215,4,5,9,425,421,846,8,0.228356,0.235459,1473.404545,0.000263,0.000009,121,0.0002,0,31,0.633333,0.002199
21013,Bell County,,KY,1477,25669,27146,3,6,9,528,775,1303,7,0.282628,0.29489,1845.552916,0.000007,0.000247,146,0.000127,0,31,0.366667,0.000339
21015,Boone County,,KY,10687,115521,126208,26,17,43,9871,7428,17299,6,0.334948,0.355682,10111.246124,0.009866,0.003827,121,0.000493,0,31,0.460114,0.070769
21017,Bourbon County,,KY,1773,23355,25128,8,7,15,1108,1109,2217,7,0.282024,0.294098,4828.582708,0.000267,0.000253,121,0.000381,0,31,0.428571,0.002707
21019,Boyd County,,KY,3150,55177,58327,8,9,17,1772,1722,3494,6,0.308477,0.325459,5139.53149,0.001053,0.001502,121,0.00028,0,31,0.430556,0.007752
21021,Boyle County,,KY,2201,29814,32015,9,8,17,1285,1282,2567,7,0.295242,0.308784,1970.810372,0.000729,0.000754,121,0.000303,0,31,0.488889,0.006263
21023,Bracken County,,KY,649,10676,11325,4,3,7,385,277,662,7,0.236752,0.24472,79.928349,0.000091,0.000016,121,0.00015,0,31,0.5,0.000782
21025,Breathitt County,,KY,755,15702,16457,2,2,4,86,136,222,8,0.220117,0.225871,6.375,0.000004,0.000002,121,0.000115,0,31,0.166667,0.000228
21027,Breckinridge County,,KY,1246,24571,25817,6,7,13,907,829,1736,7,0.295573,0.308956,1599.281036,0.0006,0.000619,121,0.000227,0,31,0.482143,0.004701
21029,Bullitt County,,KY,5538,79355,84893,7,11,18,5473,4245,9718,7,0.295302,0.308899,24.416531,0.000627,0.000635,121,0.000202,0,31,0.4,0.004963
21031,Butler County,,KY,712,13966,14678,2,2,4,279,277,556,7,0.25169,0.260456,9.264554,0.000041,0.000021,121,0.000091,0,31,0.333333,0.000392
21033,Caldwell County,,KY,774,15315,16089,4,4,8,352,298,650,7,0.279204,0.290183,5312.458824,0.000203,0.000135,54,0.000157,0,31,0.166667,0.001327
21035,Calloway County,,KY,2208,33758,35966,6,6,12,796,789,1585,7,0.303385,0.317967,2924.592732,0.000485,0.001096,54,0.00027,0,31,0.333333,0.0042
21037,Campbell County,,KY,7353,96730,104083,12,13,25,4848,5651,10499,6,0.309826,0.327629,3979.517913,0.001738,0.002504,121,0.000305,0,31,0.543956,0.012376
21039,Carlisle County,,KY,355,6298,6653,2,2,4,110,141,251,7,0.250626,0.258729,0,0.000019,0.000013,54,0.000151,0,31,1,0.000316
21041,Carroll County,,KY,966,12043,13009,6,7,13,423,529,952,7,0.293393,0.306397,101.629312,0.000117,0.000592,121,0.000192,0,31,0.464286,0.00156
21043,Carter County,,KY,1179,29782,30961,5,6,11,489,604,1093,7,0.282271,0.294442,1190.883848,0.000021,0.00026,121,0.000312,0,31,0.4,0.000687
21045,Casey County,,KY,817,18027,18844,4,4,8,381,344,725,7,0.232004,0.239203,45.600544,0.000019,0.000021,121,0.000186,0,31,0.5,0.000567
21047,Christian County,,KY,18110,78215,96325,37,57,94,6444,9309,15753,6,0.386068,0.415289,31671.99332,0.016063,0.023395,146,0.000561,0,31,0.44214,0.112876
21049,Clark County,,KY,2600,38853,41453,9,9,18,1545,1529,3074,7,0.282298,0.294872,490.349784,0.000277,0.000261,121,0.00035,0,31,0.455556,0.002912
21051,Clay County,,KY,843,17997,18840,2,3,5,200,420,620,8,0.229638,0.236523,0,0.000006,0.000016,121,0.000141,0,31,1,0.000271
21053,Clinton County,,KY,432,10376,10808,1,2,3,69,113,182,8,0.188266,0.192045,2946,0,0.000007,121,0.000114,0,31,0,0.000135
21055,Crittenden County,,KY,504,9231,9735,2,3,5,123,164,287,8,0.219717,0.225769,21.291074,0.000001,0.000002,54,0.000139,0,31,0,0.000203
21057,Cumberland County,,KY,315,7200,7515,1,0,1,41,0,41,0,0,0,0,0,0,121,0.000099,0,18,0,0.000091
21059,Daviess County,,KY,4130,106822,110952,14,14,28,1986,2080,4066,7,0.306103,0.322558,13117.833636,0.001402,0.001386,121,0.000415,0,31,0.285714,0.011187
21061,Edmonson County,,KY,715,13763,14478,3,3,6,345,367,712,7,0.251756,0.260743,1.142857,0.000495,0.00003,121,0.000125,0,31,0.75,0.003914
21063,Elliott County,,KY,258,5633,5891,3,2,5,159,86,245,8,0.228176,0.234529,6.685714,0.000008,0.000002,121,0.000247,0,31,0.666667,0.000323
21065,Estill County,,KY,1023,18757,19780,4,4,8,438,573,1011,7,0.281969,0.293638,3.033333,0.000265,0.000247,121,0.000163,0,31,0.833333,0.002259
21067,Fayette County,,KY,20928,272907,293835,95,86,181,13596,14170,27766,6,0.392273,0.424994,247776.198935,0.028384,0.030603,121,0.00212,0,31,0.210973,0.204558
21069,Fleming County,,KY,808,15750,16558,3,4,7,359,312,671,7,0.282106,0.293897,966.811763,0.000008,0.000237,121,0.000178,0,31,0.416667,0.00032
21071,Floyd County,,KY,1820,40049,41869,6,6,12,810,886,1696,7,0.282463,0.29462,7821.75357,0.000259,0.000245,121,0.000218,0,31,0.309524,0.002325
21073,Franklin County,,KY,3488,52534,56022,9,9,18,1632,1973,3605,7,0.295122,0.308738,89.898785,0.000742,0.000762,121,0.000296,0,31,0.466667,0.006377
21075,Fulton County,,KY,674,7914,8588,4,4,8,317,405,722,7,0.236598,0.243924,3738.491012,0.00002,0.000012,54,0.000194,0,31,0.5,0.000486
21077,Gallatin County,,KY,604,5786,6390,5,5,10,442,373,815,7,0.262663,0.271913,1.716606,0.000114,0.000129,121,0.000169,0,31,0.85,0.001446
21079,Garrard County,,KY,1632,20925,22557,6,7,13,1325,1114,2439,7,0.282051,0.294126,441.59835,0.000274,0.000259,121,0.000212,0,31,0.690476,0.002542
21081,Grant County,,KY,2147,23322,25469,10,9,19,1819,1586,3405,6,0.297176,0.311301,386.745477,0.000972,0.000847,121,0.000289,0,31,0.533333,0.006949
21083,Graves County,,KY,1867,41054,42921,8,6,14,1019,906,1925,7,0.252544,0.26165,2441.796114,0.000049,0.000023,54,0.000388,0,31,0.285714,0.001007
21085,Grayson County,,KY,1007,22475,23482,7,3,10,778,446,1224,7,0.295032,0.307464,213.355382,0.000636,0.000581,121,0.000211,0,31,0.47619,0.004968
21087,Green County,,KY,682,13938,14620,6,4,10,512,325,837,7,0.295032,0.307579,779.001882,0.000602,0.000586,121,0.000169,0,31,0.6,0.004705
21089,Greenup County,,KY,2196,37479,39675,7,6,13,1405,1313,2718,7,0.28238,0.2947,5114.554945,0.001046,0.000257,121,0.000238,0,31,0.404762,0.007579
21091,Hancock County,,KY,605,9094,9699,3,3,6,346,352,698,8,0.235199,0.242716,4.370528,0.000017,0.000017,121,0.000143,0,31,0.5,0.000446
21093,Hardin County,,KY,12415,107765,120180,34,44,78,5762,6491,12253,6,0.367781,0.394938,10878.055879,0.009971,0.016054,121,0.000625,0,31,0.429965,0.071424
21095,Harlan County,,KY,1197,27886,29083,2,6,8,116,478,594,7,0.282435,0.29466,754.239525,0.000002,0.000253,146,0.000102,0,31,0.333333,0.000195
21097,Harrison County,,KY,1175,19682,20857,5,6,11,599,689,1288,7,0.282051,0.294012,1540.445453,0.000269,0.000252,121,0.000207,0,31,0.433333,0.00238
21099,Hart County,,KY,967,16167,17134,4,5,9,510,593,1103,7,0.295362,0.308325,10.976297,0.000597,0.000606,121,0.000141,0,31,0.666667,0.004459
21101,Henderson County,,KY,2476,51485,53961,8,8,16,1261,1359,2620,7,0.296115,0.310093,6931.800844,0.000527,0.000791,121,0.000288,0,31,0.402778,0.004705
21103,Henry County,,KY,1242,16561,17803,6,5,11,980,803,1783,7,0.293096,0.305593,4.047222,0.000481,0.000516,121,0.000196,0,31,0.566667,0.004192
21105,Hickman County,,KY,292,4364,4656,1,2,3,40,94,134,8,0.201723,0.20647,0,0,0.000001,54,0.000092,0,31,1,0.0001
21107,Hopkins County,,KY,2177,50292,52469,9,11,20,1082,1044,2126,7,0.300186,0.315493,3760.16144,0.000301,0.001163,121,0.000276,0,31,0.371212,0.00247
21109,Jackson County,,KY,591,12853,13444,3,3,6,263,315,578,8,0.229638,0.236523,3.754978,0.000014,0.000016,121,0.000166,0,31,0.833333,0.00046
21111,Jefferson County,,KY,36052,797318,833370,154,135,289,24948,27314,52262,6,0.414147,0.451108,239824.605985,0.059857,0.054867,121,0.002607,0,31,0.274286,0.414006
21113,Jessamine County,,KY,4212,41956,46168,8,9,17,2804,2427,5231,7,0.282133,0.294528,91.245575,0.000728,0.000269,121,0.000296,0,31,0.511111,0.006188
21115,Johnson County,,KY,1137,21182,22319,5,6,11,505,493,998,7,0.282463,0.29462,3262.625067,0.000004,0.000245,121,0.000212,0,31,0.333333,0.000563
21117,Kenton County,,KY,14531,165891,180422,19,22,41,11087,11278,22365,6,0.355664,0.377961,11156.178878,0.00426,0.008179,121,0.000419,0,31,0.426154,0.031995
21119,Knott County,,KY,856,15804,16660,3,4,7,339,469,808,7,0.282106,0.293868,714.940934,0.000004,0.000239,121,0.000153,0,31,0.5,0.000331
21121,Knox County,,KY,1662,32325,33987,4,5,9,890,990,1880,7,0.282243,0.294172,1841.447265,0.000263,0.000252,121,0.000163,0,31,0.65,0.002208
21123,Larue County,,KY,1050,13268,14318,4,5,9,575,736,1311,7,0.295092,0.307809,1.569444,0.000597,0.000594,121,0.000139,0,31,0.75,0.004485
21125,Laurel County,,KY,2739,54843,57582,13,8,21,1873,1276,3149,7,0.295392,0.309014,9214.857207,0.000953,0.000754,121,0.000407,0,31,0.269231,0.007846
21127,Lawrence County,,KY,844,13961,14805,6,4,10,419,364,783,7,0.236328,0.244396,3209.027386,0.000778,0.000009,121,0.000219,0,31,0.266667,0.005661
21129,Lee County,,KY,334,6115,6449,0,0,0,0,0,0,0,0,0,0,0,0,44,0.000051,44,93,0,0
21131,Leslie County,,KY,530,11587,12117,1,2,3,85,210,295,8,0.228266,0.234701,2.666667,0.000002,0.00001,121,0.000089,0,31,0,0.000115
21133,Letcher County,,KY,820,24293,25113,4,4,8,260,259,519,8,0.220937,0.22757,1248.962931,0.000008,0.000004,121,0.000159,0,31,0.166667,0.00042
21135,Lewis County,,KY,572,13252,13824,3,3,6,193,194,387,8,0.220434,0.226675,80.705616,0.000006,0.000009,121,0.000155,0,31,0.333333,0.000355
21137,Lincoln County,,KY,1394,23643,25037,7,8,15,1074,974,2048,7,0.282216,0.294517,1042.439811,0.000276,0.000266,121,0.000273,0,31,0.553571,0.002622
21139,Livingston County,,KY,746,9838,10584,3,3,6,376,409,785,7,0.250626,0.258901,496.40457,0.000019,0.000013,54,0.000196,0,31,0.333333,0.0004
21141,Logan County,,KY,1385,29330,30715,6,7,13,707,728,1435,7,0.299752,0.313261,168.292368,0.000259,0.000622,121,0.000169,0,31,0.428571,0.001858
21143,Lyon County,,KY,659,7479,8138,2,3,5,139,272,411,7,0.250907,0.259268,27.937176,0.00002,0.000014,54,0.00013,0,31,0.333333,0.00031
21145,McCracken County,,KY,4565,70950,75515,14,13,27,2152,2100,4252,6,0.3341,0.353725,40862.296186,0.001509,0.002312,54,0.0007,0,31,0.171429,0.011663
21147,McCreary County,,KY,703,14577,15280,2,2,4,177,228,405,7,0.23286,0.239903,15.954266,0.000013,0.000015,146,0.000137,0,31,0,0.000317
21149,McLean County,,KY,667,10877,11544,2,4,6,293,435,728,8,0.236021,0.243786,0,0.000017,0.000016,121,0.000097,0,31,0.833333,0.000318
21151,Madison County,,KY,5193,66550,71743,19,16,35,3220,2768,5988,7,0.297785,0.312865,7446.495431,0.00097,0.000979,121,0.000599,0,31,0.201087,0.008668
21153,Magoffin County,,KY,419,10742,11161,2,3,5,135,184,319,8,0.220468,0.226617,7.027381,0.000004,0.000002,121,0.000111,0,31,0.333333,0.00022
21155,Marion County,,KY,882,19886,20768,4,6,10,380,504,884,7,0.295002,0.308164,20.014701,0.000473,0.000749,121,0.000133,0,31,0.6,0.003898
21157,Marshall County,,KY,1796,31926,33722,5,4,9,1122,935,2057,7,0.250756,0.259245,23.386457,0.000029,0.000017,54,0.000282,0,31,0.5,0.000639
21159,Martin County,,KY,469,10408,10877,2,3,5,95,169,264,8,0.220484,0.226657,7.963429,0.000002,0.000009,121,0.000103,0,31,0.333333,0.000242
21161,Mason County,,KY,1207,17263,18470,4,5,9,487,574,1061,7,0.282161,0.294126,1240.092655,0.000012,0.000244,121,0.000195,0,31,0.15,0.000452
21163,Meade County,,KY,2001,25064,27065,5,4,9,1379,1196,2575,7,0.295062,0.307636,5.564834,0.0006,0.000586,121,0.000152,0,31,0.65,0.004599
21165,Menifee County,,KY,494,6111,6605,2,1,3,143,105,248,8,0.2201,0.225699,0,0.000002,0.000002,121,0.00013,0,31,1,0.000234
21167,Mercer County,,KY,1400,22948,24348,9,6,15,983,799,1782,7,0.281997,0.293897,10.692857,0.000286,0.000261,121,0.000294,0,31,0.472222,0.002927
21169,Metcalfe County,,KY,471,8197,8668,3,2,5,230,208,438,8,0.228015,0.234208,1.277778,0.000006,0.000004,121,0.000189,0,31,0.5,0.000357
21171,Monroe County,,KY,445,10187,10632,3,2,5,175,145,320,8,0.228015,0.234208,36.192907,0.000042,0.000004,121,0.000189,0,31,0.666667,0.000512
21173,Montgomery County,,KY,1481,22797,24278,7,7,14,877,805,1682,7,0.282188,0.294413,4832.800763,0.000265,0.000245,121,0.000371,0,31,0.47619,0.002522
21175,Morgan County,,KY,561,12283,12844,3,2,5,142,112,254,8,0.228015,0.234196,2922.586525,0.000006,0.000002,121,0.000239,0,31,0.166667,0.000311
21177,Muhlenberg County,,KY,1227,34508,35735,7,8,15,582,562,1144,7,0.296781,0.310563,1052.457216,0.000259,0.000664,121,0.0002,0,31,0.464286,0.001927
21179,Nelson County,,KY,2104,47167,49271,9,8,17,1676,1228,2904,7,0.297115,0.310782,102.821041,0.000871,0.000831,121,0.000229,0,31,0.472222,0.006797
21181,Nicholas County,,KY,297,5298,5595,2,1,3,131,74,205,8,0.22,0.225538,0,0.000004,0.000002,121,0.000126,0,31,1,0.000241
21183,Ohio County,,KY,1230,24511,25741,4,4,8,681,592,1273,7,0.293244,0.305765,510.335183,0.000017,0.000513,121,0.000157,0,31,0.366667,0.000507
21185,Oldham County,,KY,3822,49630,53452,7,7,14,3233,2434,5667,7,0.295032,0.308337,67.677785,0.000743,0.000758,121,0.00021,0,31,0.547619,0.006062
21187,Owen County,,KY,878,10305,11183,8,8,16,643,608,1251,7,0.282216,0.294585,137.784119,0.000377,0.000373,121,0.000252,0,31,0.535714,0.003561
21189,Owsley County,,KY,164,3409,3573,0,0,0,0,0,0,0,0,0,0,0,0,45,0.000051,45,94,0,0
21191,Pendleton County,,KY,1085,15816,16901,6,6,12,895,805,1700,7,0.262734,0.272143,108.218319,0.000129,0.000142,121,0.00021,0,31,0.566667,0.001626
21193,Perry County,,KY,1297,26919,28216,5,5,10,626,525,1151,7,0.282079,0.293954,12230.688471,0.000255,0.000234,121,0.000224,0,31,0.15,0.002204
21195,Pike County,,KY,2476,59594,62070,5,7,12,790,994,1784,7,0.282876,0.295383,7063.880258,0.000257,0.000251,121,0.000188,0,31,0.190476,0.002283
21197,Powell County,,KY,817,12560,13377,4,6,10,341,472,813,7,0.282024,0.293983,4416.22619,0.000259,0.000241,121,0.000184,0,31,0.366667,0.002188
21199,Pulaski County,,KY,2475,57768,60243,13,9,22,1261,968,2229,6,0.301714,0.316626,17228.659908,0.001535,0.001228,121,0.000455,0,31,0.294872,0.011074
21201,Robertson County,,KY,155,2006,2161,0,0,0,0,0,0,0,0,0,0,0,0,46,0.000051,46,95,0,0
21203,Rockcastle County,,KY,803,14730,15533,3,6,9,330,504,834,7,0.282161,0.294172,2.519048,0.000012,0.000267,121,0.000137,0,31,0.766667,0.000435
21205,Rowan County,,KY,1532,17509,19041,8,8,16,565,694,1259,7,0.295302,0.308939,18538.455088,0.000261,0.000733,121,0.000472,0,31,0.25,0.00258
21207,Russell County,,KY,608,15654,16262,2,3,5,162,225,387,7,0.232023,0.239088,13.156972,0,0.000017,121,0.000111,0,31,0.333333,0.000222
21209,Scott County,,KY,2557,34415,36972,10,9,19,2011,1380,3391,7,0.295242,0.308968,231.887673,0.000734,0.00076,121,0.000342,0,31,0.436364,0.006468
21211,Shelby County,,KY,2717,36624,39341,8,9,17,2113,1740,3853,7,0.295062,0.308624,60.033727,0.000738,0.000767,121,0.000248,0,31,0.527778,0.006167
21213,Simpson County,,KY,1367,18572,19939,6,6,12,763,819,1582,7,0.299845,0.313203,138.09586,0.000673,0.000673,121,0.000171,0,31,0.7,0.005377
21215,Spencer County,,KY,1024,12869,13893,4,4,8,1312,686,1998,7,0.293008,0.305306,0.25,0.000471,0.000513,121,0.00013,0,31,0.916667,0.003946
21217,Taylor County,,KY,1088,22038,23126,5,6,11,466,495,961,7,0.297115,0.310552,1144.849082,0.000597,0.000823,121,0.000154,0,31,0.5,0.004574
21219,Todd County,,KY,774,10512,11286,3,3,6,375,399,774,7,0.280444,0.291687,12.536323,0.000406,0.000355,146,0.000092,0,31,0.5,0.002766
21221,Trigg County,,KY,844,13511,14355,2,2,4,345,246,591,7,0.280363,0.2914,0,0.000401,0.000353,146,0.000071,0,31,1,0.002652
21223,Trimble County,,KY,685,9168,9853,5,5,10,603,431,1034,7,0.293274,0.305938,70.179366,0.000478,0.00051,121,0.000166,0,31,0.6,0.004038
21225,Union County,,KY,920,16176,17096,3,3,6,346,405,751,7,0.254113,0.263397,518.122136,0.000007,0.000045,121,0.000163,0,31,0.333333,0.00033
21227,Warren County,,KY,6376,91779,98155,22,22,44,3224,3329,6553,6,0.336228,0.358138,13766.608958,0.002499,0.004337,121,0.00052,0,31,0.242165,0.019262
21229,Washington County,,KY,548,10814,11362,3,5,8,233,280,513,7,0.294942,0.307935,9.5307,0.000266,0.000742,121,0.000115,0,31,0.65,0.002107
21231,Wayne County,,KY,629,18948,19577,3,2,5,277,250,527,7,0.231875,0.238572,8798.928937,0.000874,0.000013,121,0.00015,0,31,0,0.005663
21233,Webster County,,KY,1075,15173,16248,3,3,6,535,617,1152,8,0.230971,0.237955,6.853132,0.000016,0.000007,121,0.000149,0,31,0.666667,0.000361
21235,Whitley County,,KY,1834,30428,32262,4,5,9,927,1022,1949,7,0.282161,0.294098,78.281416,0.000264,0.000255,121,0.000177,0,31,0.55,0.002234
21237,Wolfe County,,KY,324,3449,3773,2,1,3,105,48,153,9,0.185725,0.189141,6.052778,0.000002,0,121,0.000126,0,31,0.166667,0.000206
21239,Woodford County,,KY,1767,24408,26175,6,6,12,1010,1041,2051,7,0.281942,0.293811,16.247513,0.000722,0.000261,121,0.000216,0,31,0.690476,0.005903
22001,Acadia Parish,,LA,3273,67643,70916,9,9,18,2011,2141,4152,6,0.322023,0.339939,99.748213,0.001475,0.001404,54,0.000209,0,31,0.711111,0.01113
22003,Allen Parish,,LA,1423,23380,24803,8,6,14,942,796,1738,7,0.259309,0.269936,12.877326,0.000517,0.000206,152,0.00019,0,31,0.625,0.00427
22005,Ascension Parish,,LA,5353,92260,97613,17,15,32,5416,3290,8706,6,0.322488,0.341345,839.143125,0.00239,0.00231,54,0.00032,0,31,0.519608,0.017902
22007,Assumption Parish,,LA,1601,30452,32053,6,5,11,1012,1065,2077,7,0.274792,0.286904,1.78373,0.000334,0.000275,54,0.000139,0,31,0.7,0.002659
22009,Avoyelles Parish,,LA,1583,42650,44233,7,4,11,907,695,1602,7,0.274844,0.286904,73.570808,0.001396,0.000333,54,0.000172,0,31,0.571429,0.010433
22011,Beauregard Parish,,LA,2603,31771,34374,4,5,9,1487,1242,2729,6,0.32238,0.33991,184.485476,0.001197,0.001408,152,0.000113,0,31,0.8,0.009037
22013,Bienville Parish,,LA,1139,17055,18194,7,7,14,628,688,1316,7,0.266422,0.277661,18.49672,0.000258,0.000253,54,0.000183,0,31,0.619048,0.0026
22015,Bossier Parish,,LA,12341,109142,121483,40,27,67,8242,7301,15543,6,0.341286,0.364446,7121.891893,0.013365,0.008072,54,0.000622,0,31,0.413319,0.098825
22017,Caddo Parish,,LA,16409,261501,277910,44,48,92,10388,11524,21912,6,0.361014,0.388504,20006.688093,0.015057,0.016212,54,0.000697,0,31,0.38389,0.110744
22019,Calcasieu Parish,,LA,9270,205017,214287,33,37,70,5344,5771,11115,6,0.347036,0.371809,8725.455744,0.007074,0.009874,152,0.000571,0,31,0.366434,0.052982
22021,Caldwell Parish,,LA,670,10970,11640,3,2,5,331,325,656,7,0.252588,0.262258,0.95,0.000074,0.000059,54,0.000129,0,31,0.666667,0.000808
22023,Cameron Parish,,LA,605,9468,10073,1,2,3,210,336,546,7,0.257675,0.267136,0,0.000082,0.000068,152,0.000064,0,31,1,0.000558
22025,Catahoula Parish,,LA,585,10919,11504,3,4,7,224,275,499,7,0.252764,0.262861,17.197847,0.000068,0.000069,54,0.000114,0,31,0.416667,0.000764
22027,Claiborne Parish,,LA,881,15975,16856,6,6,12,459,441,900,7,0.266667,0.277879,12.347272,0.000275,0.00026,54,0.000149,0,31,0.666667,0.002553
22029,Concordia Parish,,LA,1212,19996,21208,3,5,8,340,513,853,7,0.275313,0.287966,3049.204543,0.000259,0.000266,54,0.000105,0,31,0.3,0.001835
22031,De Soto Parish,,LA,1803,28166,29969,6,5,11,1407,1152,2559,6,0.321523,0.338677,73.272309,0.001248,0.00126,54,0.00015,0,31,0.666667,0.009856
22033,East Baton Rouge Parish,,LA,25916,421663,447579,80,86,166,16917,19930,36847,6,0.378569,0.411823,81735.021359,0.024191,0.030903,54,0.001328,0,31,0.278673,0.176707
22035,East Carroll Parish,,LA,570,7728,8298,2,2,4,168,249,417,7,0.252566,0.262201,0,0.000066,0.000058,54,0.000104,0,31,1,0.000655
22037,East Feliciana Parish,,LA,1415,20235,21650,3,3,6,855,948,1803,7,0.274688,0.286445,1.205377,0.000272,0.000223,54,0.000136,0,31,0.666667,0.001962
22039,Evangeline Parish,,LA,1739,32798,34537,7,7,14,835,1127,1962,7,0.275052,0.287707,57.46689,0.001233,0.000408,54,0.000172,0,31,0.839286,0.009524
22041,Franklin Parish,,LA,1043,21611,22654,5,4,9,424,443,867,6,0.316237,0.331881,1481.868721,0.000959,0.00093,54,0.000153,0,31,0.3,0.006997
22043,Grant Parish,,LA,1540,21230,22770,4,5,9,1043,991,2034,7,0.247465,0.256844,5.83852,0.000058,0.000077,54,0.000135,0,31,0.5,0.000907
22045,Iberia Parish,,LA,3994,84060,88054,9,11,20,2249,2650,4899,6,0.322416,0.340771,8.528534,0.001527,0.001794,54,0.000186,0,31,0.704545,0.011464
22047,Iberville Parish,,LA,2105,34256,36361,4,6,10,975,1551,2526,7,0.274792,0.287019,1.47619,0.000278,0.000248,54,0.000131,0,31,0.733333,0.002069
22049,Jackson Parish,,LA,1890,24137,26027,6,8,14,1088,1029,2117,6,0.316823,0.333316,521.650014,0.00023,0.001104,54,0.000169,0,31,0.5,0.002095
22051,Jefferson Parish,,LA,32797,488210,521007,70,85,155,24054,26619,50673,6,0.386273,0.419571,19769.975257,0.033301,0.03668,54,0.000936,0,31,0.404324,0.237967
22053,Jefferson Davis Parish,,LA,1803,30779,32582,7,6,13,1090,1203,2293,6,0.321417,0.338648,456.971154,0.001194,0.001182,152,0.000185,0,31,0.619048,0.009207
22055,Lafayette Parish,,LA,14214,210311,224525,36,36,72,9780,10260,20040,6,0.344852,0.369588,3308.015527,0.009837,0.009833,54,0.000618,0,31,0.384828,0.072468
22057,Lafourche Parish,,LA,5234,108811,114045,13,16,29,3680,3701,7381,6,0.322488,0.34146,282.434097,0.002354,0.002248,54,0.000232,0,31,0.552288,0.017164
22059,La Salle Parish,,LA,807,14155,14962,5,6,11,322,424,746,7,0.253116,0.263704,60.767223,0.000104,0.000096,54,0.000189,0,31,0.4,0.001244
22061,Lincoln Parish,,LA,2834,30627,33461,10,12,22,1235,1460,2695,6,0.327322,0.347171,1842.852611,0.00134,0.003267,54,0.000232,0,31,0.564103,0.010787
22063,Livingston Parish,,LA,6475,107126,113601,20,12,32,7119,4243,11362,6,0.322416,0.340886,1149.883972,0.002517,0.001866,54,0.000408,0,31,0.430952,0.019235
22065,Madison Parish,,LA,786,12528,13314,4,4,8,248,324,572,7,0.253469,0.26371,23.931779,0.000083,0.000064,54,0.000139,0,31,0.4,0.000888
22067,Morehouse Parish,,LA,1653,33075,34728,6,5,11,840,888,1728,6,0.316374,0.332197,1274.749377,0.00097,0.000934,54,0.000191,0,31,0.4,0.007147
22069,Natchitoches Parish,,LA,2441,37918,40359,12,12,24,1086,1229,2315,6,0.326072,0.345558,6589.745618,0.003357,0.002428,54,0.00025,0,31,0.494505,0.025165
22071,Orleans Parish,,LA,32137,448035,480172,78,90,168,18299,25914,44213,6,0.39721,0.430917,20090.079957,0.040734,0.045958,54,0.000978,0,31,0.494747,0.282829
22073,Ouachita Parish,,LA,8528,157545,166073,35,34,69,5172,4944,10116,6,0.337792,0.362414,45947.649936,0.00699,0.007919,54,0.000758,0,31,0.250831,0.050937
22075,Plaquemines Parish,,LA,2436,29341,31777,7,6,13,1750,1326,3076,7,0.300995,0.316205,28.207514,0.002164,0.001487,54,0.000133,0,31,0.777778,0.016196
22077,Pointe Coupee Parish,,LA,1292,23132,24424,4,5,9,672,835,1507,7,0.27474,0.286789,1.671645,0.000275,0.000237,54,0.000137,0,31,0.65,0.002086
22079,Rapides Parish,,LA,6784,136030,142814,23,22,45,3674,3720,7394,6,0.328395,0.349839,7046.575229,0.004457,0.004434,54,0.000446,0,31,0.406667,0.033723
22081,Red River Parish,,LA,451,8928,9379,3,3,6,189,257,446,7,0.265375,0.275762,0.952381,0.000156,0.000154,54,0.000103,0,31,0.666667,0.001452
22083,Richland Parish,,LA,1338,19955,21293,4,5,9,622,816,1438,7,0.252676,0.262803,3.8125,0.000074,0.000075,54,0.000166,0,31,0.55,0.000909
22085,Sabine Parish,,LA,1266,22926,24192,5,7,12,496,637,1133,6,0.322237,0.33991,4.451124,0.000353,0.001476,54,0.00013,0,31,0.761905,0.003093
22087,St. Bernard Parish,,LA,3451,72405,75856,5,8,13,2038,2481,4519,6,0.322273,0.340197,18.279847,0.001115,0.002054,54,0.000116,0,31,0.75,0.007677
22089,St. Charles Parish,,LA,4026,56032,60058,10,11,21,2902,2719,5621,6,0.322309,0.340599,43.204261,0.001199,0.002131,54,0.000182,0,31,0.717949,0.008676
22091,St. Helena Parish,,LA,1048,14517,15565,3,3,6,638,690,1328,7,0.27474,0.286531,0,0.000289,0.000239,54,0.000111,0,31,1,0.0021
22093,St. James Parish,,LA,1093,26150,27243,3,6,9,343,809,1152,7,0.280282,0.293139,0.25,0.000339,0.000542,54,0.000094,0,31,0.933333,0.002506
22095,St. John the Baptist Parish,,LA,3110,47339,50449,10,10,20,2644,2063,4707,6,0.322273,0.340427,211.420373,0.002222,0.002087,54,0.000182,0,31,0.75641,0.015485
22097,St. Landry Parish,,LA,3770,82251,86021,12,12,24,2570,2581,5151,6,0.322416,0.340886,137.254748,0.001818,0.001799,54,0.000261,0,31,0.634615,0.013722
22099,St. Martin Parish,,LA,2700,52272,54972,7,7,14,2171,2011,4182,6,0.32188,0.33948,0.818097,0.001686,0.001347,54,0.000153,0,31,0.857143,0.012241
22101,St. Mary Parish,,LA,3088,56814,59902,9,11,20,1308,1829,3137,6,0.322309,0.340599,189.480724,0.002081,0.002163,54,0.000172,0,31,0.727273,0.014795
22103,St. Tammany Parish,,LA,12832,215631,228463,57,48,105,12730,7869,20599,6,0.364687,0.392815,7688.137181,0.023169,0.020038,54,0.000834,0,31,0.447917,0.170107
22105,Tangipahoa Parish,,LA,5458,95130,100588,14,14,28,3880,3342,7222,6,0.322667,0.341489,711.792354,0.002204,0.002251,54,0.000303,0,31,0.508333,0.01646
22107,Tensas Parish,,LA,469,5862,6331,1,3,4,40,157,197,7,0.252654,0.262488,1.342075,0.000002,0.000066,54,0.000069,0,31,0.416667,0.000108
22109,Terrebonne Parish,,LA,5398,105531,110929,12,14,26,3303,3633,6936,6,0.32418,0.343084,241.800816,0.002342,0.002536,54,0.000214,0,31,0.666667,0.01699
22111,Union Parish,,LA,1298,21687,22985,5,5,10,769,692,1461,7,0.25316,0.263641,14.419438,0.000137,0.000089,54,0.000149,0,31,0.45,0.001184
22113,Vermilion Parish,,LA,2716,58128,60844,11,9,20,1735,1897,3632,6,0.322023,0.339939,9.656545,0.001522,0.001416,54,0.000226,0,31,0.690909,0.011605
22115,Vernon Parish,,LA,11394,48537,59931,39,42,81,3806,4914,8720,6,0.355752,0.382576,4663.289064,0.015997,0.013013,152,0.000511,0,31,0.458039,0.113344
22117,Washington Parish,,LA,2114,42442,44556,7,8,15,1051,1185,2236,7,0.287639,0.301323,199.636704,0.001132,0.001053,54,0.000156,0,31,0.660714,0.007988
22119,Webster Parish,,LA,2536,41707,44243,6,9,15,1292,1505,2797,6,0.325269,0.343893,533.317216,0.000242,0.002135,54,0.000162,0,31,0.5,0.002485
22121,West Baton Rouge Parish,,LA,1987,24155,26142,5,5,10,1405,1541,2946,7,0.274766,0.286847,1.064502,0.000294,0.000245,54,0.000153,0,31,0.85,0.002341
22123,West Carroll Parish,,LA,781,12459,13240,5,5,10,383,442,825,7,0.252808,0.263062,18.126264,0.000075,0.00007,54,0.000204,0,31,0.366667,0.001006
22125,West Feliciana Parish,,LA,642,10446,11088,2,2,4,328,317,645,7,0.274662,0.286273,0,0.000257,0.000202,54,0.000102,0,31,1,0.001691
22127,Winn Parish,,LA,909,13642,14551,4,5,9,302,398,700,7,0.253138,0.263676,14.639172,0.000031,0.000125,54,0.000136,0,31,0.6,0.000633
23001,Androscoggin County,,ME,6078,116081,122159,19,14,33,4558,3890,8448,6,0.299876,0.316156,465.007767,0.003865,0.001583,103,0.000351,0,31,0.471053,0.025333
23003,Aroostook County,,ME,2784,81278,84062,14,9,23,1302,1298,2600,7,0.266202,0.278102,216.114772,0.0042,0.000591,103,0.000244,0,31,0.666667,0.027122
23005,Cumberland County,,ME,19010,314395,333405,83,71,154,14856,13660,28516,6,0.361284,0.391133,33749.945991,0.037965,0.033008,103,0.001045,0,31,0.44372,0.252483
23007,Franklin County,,ME,1801,31709,33510,7,8,15,888,1008,1896,7,0.266178,0.27793,0.663677,0.000481,0.000581,103,0.000179,0,31,0.875,0.004387
23009,Hancock County,,ME,2936,59303,62239,12,8,20,1691,1202,2893,7,0.266178,0.27793,23.490955,0.002716,0.000571,103,0.000237,0,31,0.689394,0.016719
23011,Kennebec County,,ME,6356,141564,147920,24,18,42,5006,3884,8890,6,0.331091,0.350924,2042.407299,0.004515,0.00318,103,0.000449,0,31,0.46,0.028193
23013,Knox County,,ME,2233,45419,47652,10,6,16,944,1035,1979,7,0.266105,0.277529,1.926292,0.00203,0.000459,103,0.000216,0,31,0.722222,0.013357
23015,Lincoln County,,ME,2219,40569,42788,10,6,16,1346,1123,2469,7,0.266105,0.277529,3.276861,0.001953,0.000475,103,0.000224,0,31,0.681818,0.012999
23017,Oxford County,,ME,3041,60814,63855,12,7,19,2319,1844,4163,7,0.266202,0.277844,20.136534,0.00258,0.000583,103,0.000195,0,31,0.69697,0.015948
23019,Penobscot County,,ME,8031,162673,170704,32,25,57,5324,4861,10185,6,0.332646,0.353696,3737.008188,0.007296,0.006488,103,0.000511,0,31,0.448413,0.044608
23021,Piscataquis County,,ME,1104,18563,19667,3,4,7,564,581,1145,7,0.266056,0.277184,0,0.000165,0.000423,103,0.000101,0,31,1,0.001366
23023,Sagadahoc County,,ME,3667,40885,44552,9,6,15,2546,2100,4646,6,0.327839,0.344909,325.741937,0.00187,0.001543,103,0.000213,0,31,0.611111,0.015346
23025,Somerset County,,ME,2692,48305,50997,12,9,21,1803,1760,3563,7,0.266202,0.278102,62.024335,0.00144,0.000588,103,0.00024,0,31,0.598485,0.009344
23027,Waldo County,,ME,2323,41840,44163,9,7,16,1624,1364,2988,7,0.266129,0.277701,7.82839,0.001186,0.000478,103,0.000228,0,31,0.711111,0.009021
23029,Washington County,,ME,1779,36551,38330,6,7,13,615,818,1433,7,0.266153,0.277758,0.291667,0.000455,0.000595,103,0.00016,0,31,0.952381,0.004187
23031,York County,,ME,11797,225451,237248,35,40,75,10575,8332,18907,6,0.339411,0.362885,6453.394378,0.01152,0.012854,103,0.000464,0,31,0.441258,0.07426
24001,Allegany County,,MD,2909,77355,80264,10,10,20,1233,1342,2575,6,0.302059,0.317786,6294.063164,0.002214,0.002293,47,0.000241,0,31,0.4,0.01567
24003,Anne Arundel County,,MD,46982,590177,637159,143,153,296,36551,37117,73668,6,0.39683,0.438281,25663.431008,0.071469,0.071208,47,0.001587,0,31,0.373264,0.484183
24005,Baltimore County,,MD,62312,911555,973867,149,138,287,59439,54428,113867,6,0.401715,0.440479,26167.144946,0.074533,0.070438,47,0.001637,0,31,0.436464,0.49524
24009,Calvert County,,MD,5613,93270,98883,17,11,28,6346,3166,9512,6,0.310887,0.327961,2.709299,0.009066,0.005406,47,0.000222,0,31,0.911765,0.065057
24011,Caroline County,,MD,2111,35103,37214,10,8,18,1902,1465,3367,7,0.290313,0.305163,146.932064,0.002088,0.001611,47,0.000216,0,31,0.733333,0.015489
24013,Carroll County,,MD,10996,206702,217698,17,20,37,11816,7539,19355,6,0.317412,0.336857,154.415924,0.007462,0.007505,47,0.00024,0,31,0.636667,0.052808
24015,Cecil County,,MD,5568,102475,108043,21,13,34,5755,3378,9133,7,0.296902,0.313932,30.88225,0.008114,0.004608,126,0.000251,0,31,0.771429,0.054234
24017,Charles County,,MD,11338,154193,165531,23,27,50,10709,7254,17963,6,0.339808,0.361553,140.212695,0.013121,0.013438,47,0.000299,0,31,0.682759,0.094554
24019,Dorchester County,,MD,1654,33569,35223,7,4,11,1011,869,1880,7,0.243522,0.252597,0.229314,0.001349,0.00024,47,0.000166,0,31,0.904762,0.010344
24021,Frederick County,,MD,17082,243623,260705,43,47,90,14654,11299,25953,6,0.360925,0.387718,3110.554944,0.021515,0.023394,47,0.000572,0,31,0.498023,0.15309
24023,Garrett County,,MD,1240,33300,34540,8,4,12,622,374,996,7,0.28724,0.300491,2222.962178,0.002179,0.000642,47,0.000205,0,31,0.428571,0.015072
24025,Harford County,,MD,15885,270616,286501,44,45,89,14096,10556,24652,6,0.353457,0.37935,912.303298,0.02515,0.02295,47,0.000494,0,31,0.601403,0.171724
24027,Howard County,,MD,27778,283338,311116,77,72,149,22501,21624,44125,6,0.379013,0.410285,2463.805201,0.047955,0.042084,47,0.000793,0,31,0.641158,0.319001
24029,Kent County,,MD,1364,25160,26524,6,7,13,648,652,1300,7,0.285686,0.300807,2.443057,0.001223,0.001334,47,0.000133,0,31,0.666667,0.008986
24031,Montgomery County,,MD,79940,1049002,1128942,202,211,413,58344,69279,127623,5,0.426557,0.470919,50375.911587,0.094265,0.095507,47,0.002201,0,31,0.321937,0.629611
24033,Prince George's County,,MD,75495,907893,983388,151,167,318,62408,65822,128230,5,0.409764,0.451986,23572.499199,0.075009,0.077718,47,0.001641,0,31,0.370337,0.504044
24035,Queen Anne's County,,MD,3085,44765,47850,13,10,23,3201,2014,5215,6,0.297511,0.312982,56.816765,0.004921,0.002475,47,0.000205,0,31,0.652381,0.034301
24037,St. Mary's County,,MD,7191,102658,109849,29,25,54,5475,3719,9194,6,0.337989,0.359734,109.066348,0.013466,0.013027,47,0.000365,0,31,0.60084,0.096966
24039,Somerset County,,MD,1440,21048,22488,3,3,6,680,867,1547,7,0.243461,0.25231,0,0.000651,0.000239,126,0.0001,0,31,1,0.004946
24041,Talbot County,,MD,2624,39527,42151,11,10,21,1653,1369,3022,6,0.301339,0.316758,376.480161,0.003997,0.002713,47,0.000217,0,31,0.681818,0.028048
24043,Washington County,,MD,7410,152774,160184,20,17,37,6526,4477,11003,6,0.310555,0.328799,5536.826443,0.005894,0.004826,47,0.00035,0,31,0.492857,0.043341
24045,Wicomico County,,MD,5658,92135,97793,21,17,38,4245,3251,7496,6,0.308706,0.325941,1478.282834,0.006384,0.004871,126,0.000367,0,31,0.554113,0.045471
24047,Worcester County,,MD,4336,58129,62465,17,11,28,3158,2647,5805,6,0.305395,0.321258,547.295746,0.005989,0.003607,126,0.000265,0,31,0.683007,0.04156
24510,Baltimore city,,MD,47957,571866,619823,97,84,181,33227,42082,75309,6,0.384178,0.417068,4588.298078,0.055853,0.046562,47,0.001012,0,31,0.602289,0.366985
25001,Barnstable County,,MA,12818,268006,280824,48,54,102,11024,8452,19476,6,0.348955,0.375034,2291.996062,0.025833,0.025308,103,0.000484,0,31,0.525362,0.16363
25003,Berkshire County,,MA,5523,153805,159328,26,24,50,2687,2492,5179,6,0.33953,0.360979,1116.580876,0.011733,0.010369,103,0.000242,0,31,0.686492,0.066343
25005,Bristol County,,MA,24731,618903,643634,36,70,106,21254,19813,41067,6,0.36391,0.394226,1401.800518,0.0211,0.033391,103,0.000356,0,31,0.527207,0.136378
25007,Dukes County,,MA,1088,18235,19323,2,3,5,170,252,422,6,0.299289,0.314004,0,0.00145,0.001563,103,0.000065,0,31,1,0.008737
25009,Essex County,,MA,44018,836346,880364,81,122,203,32593,37418,70011,6,0.385555,0.423479,5973.108554,0.04696,0.060907,103,0.00077,0,31,0.488497,0.304531
25011,Franklin County,,MA,4776,81298,86074,14,12,26,3193,2911,6104,6,0.30059,0.316747,3.411111,0.005611,0.004016,103,0.000158,0,31,0.842857,0.032189
25013,Hampden County,,MA,17171,514979,532150,50,60,110,11859,11816,23675,6,0.361914,0.390599,927.305743,0.027107,0.03271,103,0.000478,0,31,0.619876,0.17411
25015,Hampshire County,,MA,10754,160299,171053,29,24,53,7929,7235,15164,6,0.341727,0.363435,175.816312,0.017735,0.01194,103,0.000267,0,31,0.813492,0.107913
25017,Middlesex County,,MA,120840,1684945,1805785,198,233,431,85869,109634,195503,5,0.426056,0.473198,70433.831919,0.09223,0.097234,103,0.001999,0,31,0.304493,0.608276
25019,Nantucket County,,MA,955,11304,12259,2,2,4,107,161,268,6,0.290313,0.30384,0,0.000788,0.000802,103,0.000064,0,31,1,0.004542
25021,Norfolk County,,MA,57835,743619,801454,104,135,239,45398,52048,97446,5,0.400828,0.439222,8854.411437,0.059779,0.070194,103,0.000972,0,31,0.51486,0.384255
25023,Plymouth County,,MA,28975,563611,592586,42,70,112,24739,23873,48612,6,0.362185,0.391913,1394.636075,0.02552,0.034998,103,0.00043,0,31,0.558867,0.16945
25025,Suffolk County,,MA,84994,678019,763013,142,159,301,53998,78182,132180,5,0.408381,0.449461,17585.543198,0.071274,0.078463,103,0.001343,0,31,0.429373,0.455194
25027,Worcester County,,MA,36814,892485,929299,91,135,226,30504,29435,59939,6,0.393656,0.433081,7533.572728,0.050733,0.066258,103,0.000846,0,31,0.458007,0.326432
26001,Alcona County,,MI,749,12413,13162,6,2,8,498,220,718,7,0.233873,0.240821,0.616667,0.002,0.000033,48,0.000124,0,31,0.9,0.012212
26003,Alger County,,MI,556,10258,10814,1,2,3,90,179,269,7,0.248014,0.256098,0,0.000026,0.000018,179,0.00008,0,31,1,0.000222
26005,Allegan County,,MI,7888,124258,132146,14,16,30,6479,5595,12074,6,0.341005,0.362104,357.565685,0.003569,0.004602,48,0.000206,0,31,0.704167,0.022613
26007,Alpena County,,MI,1627,36483,38110,7,7,14,546,391,937,6,0.30501,0.320219,2654.436212,0.001975,0.001919,48,0.000218,0,31,0.535714,0.012336
26009,Antrim County,,MI,1745,26670,28415,11,5,16,1349,772,2121,7,0.283788,0.296256,96.234208,0.002486,0.000414,48,0.000217,0,31,0.736364,0.015851
26011,Arenac County,,MI,1147,19316,20463,7,5,12,688,526,1214,6,0.299104,0.313556,0.376623,0.001783,0.000814,48,0.000129,0,31,0.928571,0.01104
26013,Baraga County,,MI,437,8896,9333,1,2,3,98,186,284,7,0.248269,0.256494,0,0.000011,0.00003,179,0.000087,0,31,1,0.000169
26015,Barry County,,MI,3765,69417,73182,8,9,17,3096,2646,5742,7,0.287042,0.300348,1.686738,0.000976,0.000782,48,0.000132,0,31,0.847222,0.005911
26017,Bay County,,MI,5343,134517,139860,15,17,32,3059,3342,6401,6,0.332265,0.352307,220.77092,0.002772,0.003923,48,0.000235,0,31,0.639706,0.017409
26019,Benzie County,,MI,1205,19445,20650,7,4,11,948,624,1572,7,0.254179,0.263257,1,0.002074,0.000096,48,0.00017,0,31,0.767857,0.012918
26021,Berrien County,,MI,9284,180103,189387,21,28,49,4297,5013,9310,6,0.352641,0.376555,378.080414,0.006674,0.011136,121,0.000261,0,31,0.560345,0.042307
26023,Branch County,,MI,2886,48642,51528,9,8,17,1549,1538,3087,6,0.302879,0.318343,74.053836,0.002305,0.001026,48,0.000151,0,31,0.652778,0.014687
26025,Calhoun County,,MI,7839,155949,163788,20,25,45,4420,4613,9033,6,0.340925,0.363235,423.938416,0.004597,0.006687,48,0.000257,0,31,0.558405,0.029041
26027,Cass County,,MI,3587,57588,61175,7,7,14,2509,2393,4902,6,0.326146,0.343515,1.166054,0.001696,0.001442,121,0.000122,0,31,0.880952,0.010588
26029,Charlevoix County,,MI,1780,31135,32915,10,8,18,982,816,1798,6,0.305042,0.320391,32.593472,0.002422,0.001729,48,0.000212,0,31,0.788889,0.015314
26031,Cheboygan County,,MI,1903,31441,33344,10,10,20,1003,910,1913,6,0.312931,0.329706,1808.876309,0.002034,0.002533,48,0.000238,0,31,0.532051,0.013006
26033,Chippewa County,,MI,2049,38108,40157,7,6,13,511,359,870,6,0.303037,0.317441,1309.81313,0.001832,0.001128,48,0.000158,0,31,0.569444,0.01173
26035,Clare County,,MI,2300,32449,34749,11,11,22,1391,1228,2619,6,0.303766,0.319783,56.721937,0.00235,0.00175,48,0.000185,0,31,0.704545,0.014565
26037,Clinton County,,MI,5386,80508,85894,16,14,30,4837,3699,8536,6,0.305427,0.321683,53.353901,0.002917,0.002422,48,0.000217,0,31,0.69883,0.018235
26039,Crawford County,,MI,1002,14573,15575,4,3,7,448,302,750,6,0.301214,0.315312,0.527778,0.001447,0.000651,48,0.000113,0,31,0.833333,0.009259
26041,Delta County,,MI,1683,44911,46594,6,4,10,473,416,889,7,0.261433,0.271633,3148.289463,0.000098,0.000092,179,0.00024,0,31,0.433333,0.001276
26043,Dickinson County,,MI,1439,32459,33898,5,7,12,468,603,1071,7,0.261504,0.272149,8795.58792,0.000037,0.0001,179,0.000255,0,31,0.404762,0.00068
26045,Eaton County,,MI,10402,126372,136774,21,22,43,8093,7708,15801,6,0.340206,0.361903,655.111367,0.004612,0.005181,48,0.000271,0,31,0.630435,0.029351
26047,Emmet County,,MI,2353,37195,39548,9,9,18,1037,1129,2166,6,0.305074,0.320564,3.779776,0.00264,0.001856,48,0.000164,0,31,0.736364,0.015925
26049,Genesee County,,MI,20189,503757,523946,46,79,125,14098,14219,28317,6,0.379261,0.41145,10913.670387,0.016458,0.028547,48,0.000611,0,31,0.309395,0.117957
26051,Gladwin County,,MI,1602,28945,30547,11,8,19,1357,795,2152,6,0.299227,0.31413,1.862542,0.002181,0.000993,48,0.000172,0,31,0.836364,0.013777
26053,Gogebic County,,MI,963,17064,18027,4,3,7,247,220,467,7,0.248142,0.256499,8882.876123,0.001076,0.000018,179,0.000252,0,31,0.1,0.007406
26055,Grand Traverse County,,MI,5909,95888,101797,28,23,51,4223,3523,7746,6,0.340485,0.362362,6760.869588,0.004658,0.005167,48,0.000569,0,31,0.419951,0.030944
26057,Gratiot County,,MI,2420,44881,47301,12,11,23,1588,1450,3038,7,0.28707,0.300813,25.024723,0.002219,0.000685,48,0.00019,0,31,0.74359,0.0142
26059,Hillsdale County,,MI,2997,54201,57198,13,12,25,2151,1716,3867,6,0.307139,0.324518,229.068159,0.002487,0.001986,48,0.000197,0,31,0.471429,0.015563
26061,Houghton County,,MI,2002,35874,37876,6,6,12,455,405,860,6,0.304882,0.320833,12361.678213,0.001446,0.001385,179,0.00026,0,31,0.190476,0.009281
26063,Huron County,,MI,1763,43719,45482,8,8,16,980,946,1926,6,0.303607,0.319152,0.761544,0.002103,0.001713,48,0.000128,0,31,0.888889,0.012994
26065,Ingham County,,MI,24147,286995,311142,54,70,124,14827,17760,32587,6,0.377633,0.408982,11768.088954,0.016496,0.027892,48,0.000677,0,31,0.344839,0.111717
26067,Ionia County,,MI,3804,66077,69881,8,11,19,2923,2683,5606,7,0.287127,0.300749,3.741597,0.000749,0.000797,48,0.000148,0,31,0.709091,0.005091
26069,Iosco County,,MI,1927,30007,31934,8,9,17,990,815,1805,6,0.303639,0.319324,1414.216423,0.002082,0.001828,48,0.000173,0,31,0.763889,0.012983
26071,Iron County,,MI,610,13778,14388,1,1,2,77,46,123,7,0.248014,0.255983,0,0.000001,0.000018,179,0.000082,0,31,1,0.000103
26073,Isabella County,,MI,4692,58922,63614,21,19,40,2819,2687,5506,6,0.305588,0.322544,155.325218,0.002897,0.002869,48,0.000351,0,31,0.512681,0.018993
26075,Jackson County,,MI,7144,178591,185735,16,20,36,4786,4108,8894,6,0.340406,0.361961,177.785395,0.004465,0.005912,48,0.000204,0,31,0.694737,0.027817
26077,Kalamazoo County,,MI,15786,263771,279557,42,48,90,10018,10614,20632,6,0.370739,0.398933,4024.44354,0.013641,0.020581,48,0.000496,0,31,0.450505,0.089381
26079,Kalkaska County,,MI,1366,18742,20108,6,4,10,785,619,1404,7,0.254179,0.263257,1.2,0.002064,0.000096,48,0.000142,0,31,0.696429,0.012731
26081,Kent County,,MI,33400,676185,709585,99,109,208,22392,25998,48390,6,0.395802,0.43129,54372.805145,0.038293,0.044036,48,0.001345,0,31,0.323147,0.261925
26083,Keweenaw County,,MI,150,2182,2332,1,1,2,59,79,138,7,0.233666,0.240564,0,0.000011,0.000012,179,0.000087,0,31,0,0.000169
26085,Lake County,,MI,805,10344,11149,7,6,13,542,387,929,7,0.28376,0.296313,3.262302,0.001197,0.000409,48,0.000154,0,31,0.638889,0.007984
26087,Lapeer County,,MI,5823,106404,112227,9,10,19,4714,3994,8708,6,0.303766,0.319668,1.880654,0.002526,0.002036,48,0.000133,0,31,0.845455,0.015639
26089,Leelanau County,,MI,1547,24997,26544,6,4,10,897,820,1717,6,0.300621,0.314813,266.97868,0.002229,0.001058,48,0.000144,0,31,0.833333,0.014211
26091,Lenawee County,,MI,5290,115825,121115,12,14,26,3600,3056,6656,6,0.306232,0.322974,139.481009,0.003083,0.002905,48,0.000164,0,31,0.720833,0.01842
26093,Livingston County,,MI,11271,198451,209722,20,22,42,11123,7439,18562,6,0.347368,0.369565,391.047869,0.007703,0.008857,48,0.000242,0,31,0.66,0.050856
26095,Luce County,,MI,454,6533,6987,0,2,2,0,94,94,7,0.240122,0.247622,0,0,0.000028,48,0.000051,0,96,1,0
26097,Mackinac County,,MI,994,14004,14998,4,4,8,262,296,558,6,0.311254,0.326205,1636.320089,0.001566,0.001569,48,0.00011,0,31,0.466667,0.009811
26099,Macomb County,,MI,42128,989073,1031201,68,92,160,38525,33974,72499,6,0.384076,0.418239,14445.915515,0.032608,0.038018,48,0.00083,0,31,0.36596,0.229986
26101,Manistee County,,MI,1523,28431,29954,10,6,16,832,612,1444,7,0.283732,0.296256,89.930323,0.002117,0.000484,48,0.000243,0,31,0.627273,0.013609
26103,Marquette County,,MI,3240,70781,74021,14,14,28,1089,1006,2095,6,0.329738,0.349461,26651.843012,0.00214,0.003174,179,0.000489,0,31,0.271242,0.014046
26105,Mason County,,MI,1648,32566,34214,8,7,15,730,698,1428,7,0.286702,0.299607,20.227355,0.00191,0.000592,48,0.000177,0,31,0.666667,0.012489
26107,Mecosta County,,MI,3292,39672,42964,14,13,27,1897,1896,3793,6,0.305234,0.32131,117.054151,0.002741,0.002197,48,0.000237,0,31,0.602941,0.017376
26109,Menominee County,,MI,1387,28367,29754,5,5,10,710,767,1477,7,0.261457,0.271805,203.229814,0.000107,0.000099,179,0.0002,0,31,0.75,0.001249
26111,Midland County,,MI,5446,100710,106156,16,18,34,3160,2838,5998,6,0.340685,0.362047,442.330882,0.003577,0.005137,48,0.000245,0,31,0.594737,0.022234
26113,Missaukee County,,MI,963,16401,17364,7,3,10,613,438,1051,7,0.233986,0.24128,4.009524,0.001806,0.000059,48,0.000201,0,31,0.595238,0.011914
26115,Monroe County,,MI,8367,178097,186464,13,16,29,7156,5420,12576,6,0.340525,0.361674,287.664693,0.004938,0.005091,48,0.000163,0,31,0.712418,0.030447
26117,Montcalm County,,MI,4363,68514,72877,12,11,23,3399,2961,6360,6,0.303163,0.318245,43.091197,0.001521,0.001284,48,0.000204,0,31,0.704545,0.010088
26119,Montmorency County,,MI,749,10982,11731,5,3,8,384,189,573,6,0.301245,0.31537,0.63254,0.001762,0.000646,48,0.000126,0,31,0.85,0.011169
26121,Muskegon County,,MI,7235,191124,198359,15,19,34,4625,4457,9082,6,0.343994,0.36568,898.368909,0.003894,0.005259,48,0.000236,0,31,0.491342,0.024828
26123,Newaygo County,,MI,3232,53262,56494,10,7,17,2532,2118,4650,7,0.28376,0.296428,18.069629,0.001973,0.000493,48,0.000188,0,31,0.666667,0.013035
26125,Oakland County,,MI,85218,1413220,1498438,192,223,415,66233,74217,140450,5,0.426369,0.472216,106131.147183,0.083098,0.08796,48,0.002247,0,31,0.272778,0.558352
26127,Oceana County,,MI,1802,29788,31590,6,6,12,1117,1039,2156,7,0.28982,0.303464,33.050598,0.000718,0.000762,48,0.000146,0,31,0.733333,0.00588
26129,Ogemaw County,,MI,1350,23920,25270,10,9,19,907,603,1510,6,0.303639,0.319324,10.032383,0.002114,0.001582,48,0.00018,0,31,0.788889,0.013419
26131,Ontonagon County,,MI,449,8514,8963,1,2,3,46,100,146,7,0.233835,0.241029,4.407017,0,0.000021,179,0.000122,0,31,0,0.000153
26133,Osceola County,,MI,1786,26259,28045,8,8,16,918,943,1861,7,0.283843,0.296715,359.838791,0.001823,0.000445,48,0.000234,0,31,0.544444,0.012107
26135,Oscoda County,,MI,644,9414,10058,4,0,4,293,0,293,0,0,0,0,0.001969,0,48,0.000081,0,0,1,0.011818
26137,Otsego County,,MI,1864,28234,30098,12,9,21,985,644,1629,6,0.303639,0.319324,53.34537,0.002654,0.001551,48,0.000268,0,31,0.598485,0.016499
26139,Ottawa County,,MI,15812,288479,304291,32,31,63,12295,11167,23462,6,0.347909,0.371327,3603.92377,0.009044,0.008468,48,0.000457,0,31,0.426891,0.061164
26141,Presque Isle County,,MI,760,16277,17037,4,2,6,306,176,482,7,0.238463,0.245805,0.833333,0.001077,0.000033,48,0.000114,0,31,0.75,0.006978
26143,Roscommon County,,MI,1780,27693,29473,12,10,22,1381,665,2046,6,0.30367,0.319496,2187.717386,0.002684,0.001863,48,0.000242,0,31,0.615385,0.016645
26145,Saginaw County,,MI,9886,241923,251809,31,35,66,5624,6399,12023,6,0.352727,0.377347,2779.00622,0.00703,0.008194,48,0.000428,0,31,0.403983,0.047698
26147,St. Clair County,,MI,8119,196294,204413,11,16,27,7023,5201,12224,6,0.334601,0.354924,135.929372,0.004129,0.006501,48,0.000158,0,31,0.70915,0.026073
26149,St. Joseph County,,MI,3596,71647,75243,14,13,27,2034,2149,4183,6,0.328916,0.34814,342.076909,0.003572,0.002965,48,0.000203,0,31,0.626374,0.022503
26151,Sanilac County,,MI,2774,51711,54485,9,8,17,1941,1731,3672,6,0.303607,0.319152,0.922258,0.00214,0.001788,48,0.000135,0,31,0.902778,0.013269
26153,Schoolcraft County,,MI,442,9858,10300,0,1,1,0,49,49,8,0.207308,0.212305,0,0,0.000001,179,0.000051,0,97,0,0
26155,Shiawassee County,,MI,4453,86087,90540,11,12,23,3104,2751,5855,6,0.305363,0.321338,15.853492,0.002481,0.002501,48,0.000166,0,31,0.814103,0.015304
26157,Tuscola County,,MI,3502,69952,73454,9,12,21,2543,2276,4819,6,0.30517,0.32108,3.813274,0.002114,0.002305,48,0.000142,0,31,0.765152,0.013212
26159,Van Buren County,,MI,5491,85027,90518,14,12,26,4073,3724,7797,6,0.330038,0.348961,81.882745,0.003781,0.002675,48,0.000202,0,31,0.690476,0.02456
26161,Washtenaw County,,MI,29628,343538,373166,94,93,187,21300,21904,43204,6,0.39759,0.431261,9144.270945,0.047921,0.048766,48,0.000983,0,31,0.468666,0.309596
26163,Wayne County,,MI,92661,2109350,2202011,173,230,403,52586,81126,133712,5,0.430861,0.476894,119523.887739,0.073565,0.083957,48,0.002086,0,31,0.240291,0.499229
26165,Wexford County,,MI,2199,35168,37367,14,6,20,1607,928,2535,7,0.283788,0.29637,560.589088,0.002636,0.000426,48,0.000341,0,31,0.519048,0.016896
27001,Aitkin County,,MN,1130,16432,17562,8,8,16,761,590,1351,6,0.306394,0.320535,2.103092,0.001488,0.001122,50,0.00019,0,31,0.791667,0.010352
27003,Anoka County,,MN,27405,371861,399266,42,51,93,24177,22446,46623,6,0.36214,0.388883,7909.547165,0.009193,0.011796,50,0.000803,0,31,0.264098,0.067063
27005,Becker County,,MN,1930,40829,42759,9,8,17,1149,925,2074,6,0.307204,0.32174,5861.475443,0.00118,0.000761,50,0.000331,0,31,0.527778,0.00828
27007,Beltrami County,,MN,2454,44972,47426,15,12,27,1515,1044,2559,6,0.307562,0.322802,5566.791598,0.001609,0.001393,50,0.000408,0,31,0.414286,0.011692
27009,Benton County,,MN,5288,53797,59085,16,13,29,4575,3979,8554,6,0.332038,0.351171,238.083149,0.001605,0.002584,50,0.000355,0,31,0.588235,0.012067
27011,Big Stone County,,MN,320,7201,7521,0,0,0,0,0,0,0,0,0,0,0,0,49,0.000051,47,98,0,0
27013,Blue Earth County,,MN,5098,62502,67600,21,17,38,3172,3262,6434,6,0.332456,0.352146,6001.577913,0.001749,0.002635,50,0.000451,0,31,0.361472,0.013329
27015,Brown County,,MN,1669,34156,35825,5,4,9,436,445,881,6,0.306329,0.319932,279.495586,0.000739,0.000684,50,0.000143,0,31,0.6,0.005258
27017,Carlton County,,MN,1853,39124,40977,8,5,13,1552,979,2531,6,0.306394,0.320162,3.907937,0.00124,0.00102,50,0.000209,0,31,0.785714,0.008711
27019,Carver County,,MN,7108,95550,102658,19,16,35,7328,4681,12009,6,0.341005,0.361886,819.812863,0.005986,0.004476,50,0.000358,0,31,0.541126,0.041839
27021,Cass County,,MN,2833,39951,42784,13,12,25,2170,1723,3893,6,0.30675,0.321568,16.728729,0.001621,0.001402,50,0.0003,0,31,0.653846,0.012018
27023,Chippewa County,,MN,1035,17744,18779,5,6,11,356,467,823,6,0.306394,0.320305,10273.647437,0.000713,0.000669,50,0.000255,0,31,0.233333,0.005077
27025,Chisago County,,MN,4031,61861,65892,8,12,20,4404,2917,7321,6,0.332,0.350999,52.047351,0.001505,0.002634,50,0.000172,0,31,0.765152,0.010479
27027,Clay County,,MN,4015,54212,58227,9,8,17,2701,2313,5014,6,0.309925,0.325287,707.7722,0.000882,0.001541,50,0.000306,0,31,0.492424,0.006526
27029,Clearwater County,,MN,480,8236,8716,1,2,3,118,192,310,7,0.235523,0.24235,0,0.000011,0.000014,50,0.00008,0,31,1,0.000209
27031,Cook County,,MN,419,6056,6475,2,1,3,119,60,179,7,0.254558,0.263412,0,0.000748,0.00006,50,0.000084,0,31,1,0.005182
27033,Cottonwood County,,MN,741,14717,15458,3,1,4,175,70,245,8,0.191962,0.195806,34.246234,0,0,50,0.00014,0,31,0,0.000304
27035,Crow Wing County,,MN,3368,56133,59501,17,13,30,2750,1993,4743,6,0.306685,0.321597,15.314542,0.001708,0.001416,50,0.000359,0,31,0.633987,0.012984
27037,Dakota County,,MN,35332,452539,487871,92,94,186,29573,28367,57940,6,0.386633,0.420185,50627.751965,0.028585,0.030383,50,0.001557,0,31,0.241632,0.201976
27039,Dodge County,,MN,1660,26598,28258,7,7,14,1141,1050,2191,6,0.306523,0.320564,2.760256,0.001104,0.001014,50,0.00016,0,31,0.857143,0.007837
27041,Douglas County,,MN,2126,43940,46066,14,11,25,1382,1055,2437,6,0.307367,0.322343,2968.652725,0.001634,0.001292,50,0.000363,0,31,0.514286,0.011879
27043,Faribault County,,MN,1026,20460,21486,2,4,6,226,351,577,7,0.250539,0.259088,3,0.000032,0.000036,50,0.000103,0,31,0.583333,0.000372
27045,Fillmore County,,MN,1442,26600,28042,7,7,14,814,841,1655,6,0.306685,0.320879,10276.285255,0.000831,0.000766,50,0.000192,0,31,0.380952,0.005989
27047,Freeborn County,,MN,1741,38296,40037,8,10,18,644,797,1441,6,0.307009,0.321556,6328.182246,0.001102,0.001027,50,0.000185,0,31,0.492424,0.007933
27049,Goodhue County,,MN,3076,52526,55602,10,10,20,1764,1815,3579,6,0.331924,0.350654,118.493882,0.001544,0.002545,50,0.000211,0,31,0.645455,0.010893
27051,Grant County,,MN,443,8165,8608,2,2,4,168,172,340,7,0.235275,0.242034,0,0.000022,0.000026,50,0.000108,0,31,1,0.00042
27053,Hennepin County,,MN,97681,1261235,1358916,241,235,476,68449,86764,155213,5,0.441069,0.485503,398647.48751,0.079347,0.084786,50,0.003738,0,31,0.202045,0.539553
27055,Houston County,,MN,1147,24875,26022,3,5,8,485,613,1098,6,0.30675,0.320764,6.197294,0.00006,0.000793,179,0.00011,0,31,0.9,0.000748
27057,Hubbard County,,MN,1107,16026,17133,7,5,12,562,495,1057,6,0.306394,0.320162,880.795345,0.001083,0.000692,50,0.000201,0,31,0.595238,0.007796
27059,Isanti County,,MN,2836,41004,43840,11,11,22,3766,2037,5803,6,0.306491,0.321051,4.30202,0.001569,0.001174,50,0.000225,0,31,0.769231,0.011163
27061,Itasca County,,MN,2065,50361,52426,8,8,16,1135,874,2009,6,0.331924,0.350396,65.071196,0.001478,0.002497,50,0.000195,0,31,0.847222,0.010345
27063,Jackson County,,MN,673,13084,13757,3,4,7,191,215,406,7,0.237546,0.245024,2978.50543,0.000008,0.000009,50,0.000238,0,31,0,0.000316
27065,Kanabec County,,MN,1148,18487,19635,9,6,15,1234,642,1876,6,0.306297,0.320133,0.787302,0.001484,0.001051,50,0.000191,0,31,0.833333,0.010261
27067,Kandiyohi County,,MN,2556,51332,53888,11,11,22,1243,1316,2559,6,0.309265,0.324713,4096.841366,0.001363,0.001548,50,0.000308,0,31,0.397436,0.010284
27069,Kittson County,,MN,276,5786,6062,0,0,0,0,0,0,0,0,0,0,0,0,51,0.000051,48,99,0,0
27071,Koochiching County,,MN,766,16276,17042,1,3,4,74,217,291,6,0.306297,0.31976,0,0.000048,0.000729,50,0.00007,0,31,1,0.000572
27073,Lac qui Parle County,,MN,392,9090,9482,1,1,2,43,58,101,7,0.234553,0.240588,0,0.000006,0.000006,50,0.000087,0,31,0,0.000137
27075,Lake County,,MN,660,14167,14827,2,2,4,321,273,594,6,0.306168,0.319444,0,0.000748,0.000715,50,0.000084,0,31,1,0.005182
27077,Lake of the Woods County,,MN,276,4542,4818,1,1,2,46,56,102,7,0.234951,0.241041,0,0.000006,0.000006,50,0.000097,0,31,0,0.000133
27079,Le Sueur County,,MN,2183,35475,37658,11,9,20,2054,1370,3424,6,0.306555,0.320879,6.569037,0.001441,0.001022,50,0.000249,0,31,0.709091,0.010359
27081,Lincoln County,,MN,431,6894,7325,2,1,3,122,75,197,7,0.235657,0.242172,0,0.000012,0.000006,50,0.000102,0,31,0.5,0.00024
27083,Lyon County,,MN,2092,30232,32324,7,12,19,537,805,1342,6,0.30828,0.323697,13526.925387,0.000713,0.001318,50,0.000312,0,31,0.291209,0.005223
27085,McLeod County,,MN,2665,45249,47914,14,13,27,1624,1547,3171,6,0.306685,0.321597,139.566029,0.001783,0.001415,50,0.000297,0,31,0.442857,0.013086
27087,Mahnomen County,,MN,354,4659,5013,1,1,2,52,79,131,7,0.235028,0.241271,0,0.000006,0.00001,50,0.000086,0,31,0,0.000171
27089,Marshall County,,MN,616,12744,13360,3,3,6,329,245,574,7,0.255746,0.264958,8.165985,0.000057,0.000038,50,0.000132,0,31,0.666667,0.000572
27091,Martin County,,MN,1253,26413,27666,5,5,10,340,349,689,6,0.306458,0.320248,4703.362144,0.000722,0.001187,50,0.000175,0,31,0.380952,0.005145
27093,Meeker County,,MN,1626,27498,29124,8,6,14,1108,864,1972,6,0.306329,0.320191,3.388035,0.001077,0.000742,50,0.000195,0,31,0.694444,0.007998
27095,Mille Lacs County,,MN,1724,24763,26487,13,11,24,1814,1117,2931,6,0.306458,0.320994,5.656746,0.001546,0.001139,50,0.000283,0,31,0.74359,0.011172
27097,Morrison County,,MN,1992,38830,40822,10,10,20,1323,1246,2569,6,0.306458,0.320879,2.296693,0.001276,0.001114,50,0.000232,0,31,0.827273,0.009005
27099,Mower County,,MN,2368,44526,46894,7,10,17,881,1099,1980,6,0.306912,0.321511,18.915162,0.001084,0.001318,50,0.000166,0,31,0.733333,0.007756
27101,Murray County,,MN,561,11624,12185,2,2,4,112,132,244,7,0.23581,0.242619,3.5,0.000017,0.000007,50,0.000097,0,31,0.5,0.000243
27103,Nicollet County,,MN,3037,29296,32333,10,10,20,1948,1925,3873,6,0.30662,0.321109,504.330962,0.001048,0.001331,50,0.000249,0,31,0.530303,0.007948
27105,Nobles County,,MN,1459,24021,25480,3,6,9,220,422,642,6,0.307953,0.322435,4038.589984,0.000079,0.000738,50,0.000172,0,31,0.3,0.000906
27107,Norman County,,MN,558,8706,9264,2,3,5,146,236,382,7,0.260635,0.270258,1.366667,0.000068,0.000047,50,0.000121,0,31,0.833333,0.000624
27109,Olmsted County,,MN,9245,156314,165559,33,34,67,5042,5194,10236,5,0.365421,0.390553,8025.59233,0.00978,0.012006,50,0.000568,0,31,0.354928,0.068046
27111,Otter Tail County,,MN,3343,63555,66898,16,14,30,1964,1768,3732,6,0.307497,0.322917,5572.184953,0.001575,0.001354,50,0.000485,0,31,0.416667,0.011566
27113,Pennington County,,MN,1114,15056,16170,5,7,12,426,557,983,7,0.264024,0.274886,3785.870326,0.000063,0.000091,50,0.000275,0,31,0.404762,0.000793
27115,Pine County,,MN,1930,25977,27907,10,11,21,1472,1313,2785,6,0.30662,0.321252,7.177021,0.001568,0.00146,50,0.000228,0,31,0.681818,0.011203
27117,Pipestone County,,MN,682,10379,11061,2,4,6,112,256,368,7,0.265399,0.275552,369.255275,0.000079,0.000082,50,0.000137,0,31,0.416667,0.000817
27119,Polk County,,MN,2092,33996,36088,6,8,14,841,985,1826,6,0.307497,0.322113,3569.876242,0.000119,0.000747,50,0.000241,0,31,0.355556,0.001326
27121,Pope County,,MN,740,12393,13133,3,3,6,272,319,591,6,0.3062,0.319617,0,0.000744,0.000693,50,0.00011,0,31,1,0.005131
27123,Ramsey County,,MN,54997,548260,603257,102,107,209,35053,47521,82574,5,0.395748,0.430601,54103.148113,0.034078,0.042341,50,0.001663,0,31,0.296936,0.233745
27125,Red Lake County,,MN,238,4872,5110,2,1,3,151,72,223,8,0.208891,0.214029,0,0.000007,0.000001,50,0.00011,0,31,1,0.000215
27127,Redwood County,,MN,1139,20360,21499,4,6,10,279,462,741,6,0.306523,0.320506,50.669333,0.000725,0.000695,50,0.00014,0,31,0.5,0.00501
27129,Renville County,,MN,1237,19912,21149,5,6,11,400,488,888,6,0.308936,0.323594,59.934949,0.000268,0.001002,50,0.000168,0,31,0.52381,0.002968
27131,Rice County,,MN,3750,59603,63353,13,11,24,2690,2126,4816,6,0.306653,0.321281,10.810417,0.001621,0.00135,50,0.000262,0,31,0.631868,0.011457
27133,Rock County,,MN,644,12039,12683,3,2,5,236,189,425,7,0.265157,0.274806,1.5,0.000085,0.000076,50,0.000134,0,31,0.666667,0.000915
27135,Roseau County,,MN,872,20090,20962,4,4,8,188,189,377,6,0.307074,0.321051,6785.338637,0.000701,0.000694,50,0.000217,0,31,0.25,0.004902
27137,St. Louis County,,MN,10137,216696,226833,32,31,63,5005,6244,11249,6,0.341446,0.364624,8924.535711,0.007323,0.005861,50,0.000708,0,31,0.343697,0.0538
27139,Scott County,,MN,8832,114058,122890,18,20,38,10088,6123,16211,6,0.337478,0.358207,604.850818,0.003647,0.003855,50,0.000353,0,31,0.538961,0.026265
27141,Sherburne County,,MN,6347,76633,82980,14,15,29,7196,4758,11954,6,0.332227,0.351687,67.939384,0.001695,0.002686,50,0.000283,0,31,0.709559,0.012639
27143,Sibley County,,MN,976,15125,16101,7,6,13,497,465,962,6,0.306297,0.320133,1.122444,0.001051,0.00077,50,0.000176,0,31,0.880952,0.007774
27145,Stearns County,,MN,10233,142594,152827,26,29,55,7052,7547,14599,6,0.340166,0.36223,1707.036581,0.002965,0.004058,50,0.000594,0,31,0.383871,0.022081
27147,Steele County,,MN,2470,40334,42804,9,11,20,1195,1364,2559,6,0.306782,0.321453,7.814512,0.001449,0.001326,50,0.000194,0,31,0.727273,0.009999
27149,Stevens County,,MN,663,9778,10441,0,2,2,0,123,123,6,0.306208,0.319507,0,0,0.000669,50,0.000051,0,100,1,0
27151,Swift County,,MN,774,11672,12446,2,2,4,177,178,355,7,0.23629,0.243056,0,0.000018,0.000017,50,0.000111,0,31,1,0.000326
27153,Todd County,,MN,1514,23943,25457,10,8,18,827,844,1671,6,0.306458,0.32065,898.222954,0.001241,0.000744,50,0.000254,0,31,0.7,0.008805
27155,Traverse County,,MN,242,4262,4504,0,0,0,0,0,0,0,0,0,0,0,0,52,0.000051,49,101,0,0
27157,Wabasha County,,MN,1293,25800,27093,4,6,10,709,771,1480,6,0.306491,0.320449,45.133375,0.000386,0.001006,50,0.000114,0,31,0.666667,0.002922
27159,Wadena County,,MN,1000,12112,13112,3,5,8,295,407,702,6,0.307042,0.321109,9.210789,0.000023,0.000726,50,0.000141,0,31,0.6,0.00055
27161,Waseca County,,MN,1509,21869,23378,8,9,17,743,808,1551,6,0.309133,0.324254,516.798559,0.000772,0.001339,50,0.000204,0,31,0.563636,0.00585
27163,Washington County,,MN,19347,239154,258501,28,32,60,16542,14743,31285,6,0.351404,0.375517,2653.580478,0.010943,0.008947,50,0.000443,0,31,0.41394,0.074843
27165,Watonwan County,,MN,867,13145,14012,2,5,7,134,362,496,7,0.249849,0.258433,2922.093804,0.000254,0.000035,50,0.000091,0,31,0.266667,0.002525
27167,Wilkin County,,MN,508,8496,9004,3,3,6,284,237,521,7,0.260122,0.269678,0,0.000067,0.000052,50,0.000172,0,31,1,0.00078
27169,Winona County,,MN,2917,51218,54135,11,12,23,1251,1716,2967,6,0.308838,0.324472,3049.95797,0.002529,0.001803,50,0.000247,0,31,0.461538,0.017103
27171,Wright County,,MN,7184,110414,117598,16,21,37,9032,5160,14192,6,0.332494,0.352778,491.039771,0.00282,0.002807,50,0.000327,0,31,0.585714,0.021522
27173,Yellow Medicine County,,MN,673,10693,11366,2,2,4,155,222,377,7,0.235772,0.242602,6.333333,0.000016,0.000012,50,0.000109,0,31,0,0.000279
28001,Adams County,,MS,1928,34120,36048,5,8,13,478,672,1150,7,0.278534,0.292184,8072.613466,0.001,0.000384,54,0.000164,0,31,0.277778,0.007246
28003,Alcorn County,,MS,1768,38196,39964,8,7,15,941,899,1840,6,0.305684,0.319743,5138.702061,0.0007,0.00064,54,0.000287,0,31,0.375,0.00583
28005,Amite County,,MS,1043,16172,17215,4,5,9,446,526,972,7,0.275,0.287277,2925.83063,0.000261,0.000237,54,0.000186,0,31,0.3,0.002044
28007,Attala County,,MS,1186,21030,22216,4,6,10,284,487,771,7,0.269313,0.280942,333.308831,0.000115,0.000191,54,0.000139,0,31,0.566667,0.001178
28009,Benton County,,MS,745,9438,10183,4,6,10,394,480,874,6,0.305427,0.319198,252.759931,0.000684,0.0007,54,0.000151,0,31,0.566667,0.00526
28011,Bolivar County,,MS,2458,39406,41864,7,9,16,866,1234,2100,6,0.33094,0.349661,70.622325,0.000885,0.001843,54,0.000153,0,31,0.638889,0.006329
28013,Calhoun County,,MS,816,17090,17906,5,5,10,315,405,720,7,0.236578,0.244776,40.234733,0.000008,0.000021,54,0.000189,0,31,0.357143,0.000558
28015,Carroll County,,MS,1149,14585,15734,3,4,7,527,568,1095,6,0.305395,0.318939,1277.603531,0.000014,0.000623,54,0.000127,0,31,0.666667,0.000388
28017,Chickasaw County,,MS,1310,21712,23022,5,6,11,628,854,1482,7,0.236405,0.244517,17.233918,0.000012,0.000009,54,0.000202,0,31,0.6,0.000625
28019,Choctaw County,,MS,611,7870,8481,3,4,7,150,239,389,7,0.250691,0.259495,8.69407,0.00002,0.00001,54,0.000128,0,31,0.333333,0.000384
28021,Claiborne County,,MS,741,11119,11860,3,3,6,251,369,620,7,0.269038,0.280023,270.26619,0.000123,0.000094,54,0.000116,0,31,0.5,0.001035
28023,Clarke County,,MS,1702,25476,27178,5,5,10,821,885,1706,7,0.258432,0.268584,90.182668,0.000042,0.000069,54,0.000172,0,31,0.466667,0.000936
28025,Clay County,,MS,1484,22923,24407,5,6,11,554,742,1296,7,0.260589,0.270502,174.400227,0.000064,0.000039,54,0.000175,0,31,0.566667,0.000854
28027,Coahoma County,,MS,1946,31960,33906,6,10,16,511,1090,1601,6,0.330865,0.349661,2944.720825,0.000789,0.001789,54,0.000176,0,31,0.455556,0.005703
28029,Copiah County,,MS,1539,32465,34004,3,6,9,842,1003,1845,7,0.269989,0.281871,0.638889,0.000155,0.000198,54,0.000115,0,31,0.833333,0.001391
28031,Covington County,,MS,1075,20366,21441,7,7,14,857,671,1528,7,0.254313,0.26526,100.940982,0.000382,0.000083,54,0.000201,0,31,0.678571,0.003057
28033,DeSoto County,,MS,9825,141143,150968,35,18,53,11369,5374,16743,6,0.330563,0.351303,11580.033391,0.008187,0.002651,54,0.000702,0,31,0.212551,0.058769
28035,Forrest County,,MS,7472,81154,88626,31,29,60,4923,4371,9294,6,0.333985,0.35691,16617.634593,0.001847,0.004585,54,0.000716,0,31,0.238739,0.015711
28037,Franklin County,,MS,437,7481,7918,2,2,4,142,120,262,8,0.2181,0.224773,2.306746,0.000005,0.00001,54,0.000095,0,31,0,0.000275
28039,George County,,MS,1201,23645,24846,4,4,8,918,569,1487,7,0.285968,0.298896,23.610211,0.000672,0.000606,54,0.000109,0,31,0.666667,0.004718
28041,Greene County,,MS,552,8933,9485,3,4,7,187,261,448,7,0.276098,0.287811,104.071668,0.000276,0.000232,54,0.000106,0,31,0.5,0.001997
28043,Grenada County,,MS,1669,24576,26245,8,11,19,714,799,1513,6,0.306491,0.321522,10341.64164,0.00068,0.000834,54,0.00025,0,31,0.371212,0.00521
28045,Hancock County,,MS,3500,46177,49677,9,8,17,2282,1896,4178,7,0.292949,0.307034,136.653374,0.002684,0.001225,54,0.000165,0,31,0.777778,0.018662
28047,Harrison County,,MS,20518,191754,212272,77,97,174,10265,12490,22755,6,0.392326,0.427238,33335.655127,0.033359,0.039944,54,0.001117,0,31,0.372293,0.242026
28049,Hinds County,,MS,16658,258496,275154,50,55,105,10399,12389,22788,6,0.367828,0.39732,62773.944078,0.010744,0.012864,54,0.000984,0,31,0.221491,0.079731
28051,Holmes County,,MS,1230,19322,20552,6,7,13,461,693,1154,6,0.306297,0.320719,532.207006,0.001215,0.000808,54,0.000172,0,31,0.607143,0.008699
28053,Humphreys County,,MS,695,11446,12141,2,4,6,105,271,376,7,0.269088,0.280253,0.333333,0.000121,0.000129,54,0.000079,0,31,0.666667,0.00094
28055,Issaquena County,,MS,142,1191,1333,0,0,0,0,0,0,0,0,0,0,0,0,53,0.000051,50,102,0,0
28057,Itawamba County,,MS,1789,29785,31574,8,6,14,1311,1170,2481,7,0.236482,0.244747,106.912302,0.000012,0.000009,54,0.000315,0,31,0.428571,0.000991
28059,Jackson County,,MS,10654,135461,146115,38,34,72,5701,5859,11560,6,0.351829,0.377072,8396.638942,0.014183,0.013027,54,0.000601,0,31,0.411193,0.104323
28061,Jasper County,,MS,1180,18798,19978,4,5,9,569,620,1189,7,0.250604,0.26033,7.034755,0.000008,0.000033,54,0.00016,0,31,0.45,0.00056
28063,Jefferson County,,MS,488,6993,7481,2,3,5,126,184,310,7,0.245312,0.253648,3.646999,0.000004,0.000014,54,0.000101,0,31,0.333333,0.000255
28065,Jefferson Davis County,,MS,904,13479,14383,7,7,14,397,569,966,7,0.270039,0.282101,44.223669,0.000154,0.000158,54,0.000207,0,31,0.660714,0.001694
28067,Jones County,,MS,3325,64207,67532,15,13,28,1668,1845,3513,7,0.286786,0.301381,10318.906695,0.001878,0.000597,54,0.000363,0,31,0.3875,0.014364
28069,Kemper County,,MS,781,12166,12947,3,2,5,347,407,754,7,0.253691,0.261881,15.571541,0.000036,0.00004,54,0.000139,0,31,0.333333,0.000621
28071,Lafayette County,,MS,3195,33884,37079,14,13,27,1388,1464,2852,6,0.306977,0.322584,4428.756314,0.000898,0.000904,54,0.000432,0,31,0.371429,0.007976
28073,Lamar County,,MS,2984,35096,38080,11,12,23,1980,1771,3751,7,0.287184,0.302012,517.765049,0.00057,0.000767,54,0.000297,0,31,0.461538,0.004942
28075,Lauderdale County,,MS,5440,75941,81381,20,19,39,2267,2320,4587,6,0.339729,0.360067,17687.459081,0.004675,0.004243,54,0.000509,0,31,0.289855,0.036189
28077,Lawrence County,,MS,874,15691,16565,7,6,13,441,377,818,7,0.269914,0.281728,165.932159,0.000162,0.000108,54,0.000209,0,31,0.555556,0.001946
28079,Leake County,,MS,1217,22135,23352,6,7,13,657,713,1370,7,0.269363,0.2812,42.296042,0.000188,0.000192,54,0.000203,0,31,0.666667,0.002135
28081,Lee County,,MS,5226,87080,92306,19,17,36,3400,3262,6662,6,0.309035,0.325999,21028.976106,0.000929,0.001299,54,0.000594,0,31,0.289474,0.008641
28083,Leflore County,,MS,2099,32353,34452,8,10,18,788,1094,1882,6,0.306458,0.32135,1646.269331,0.000851,0.000804,54,0.000182,0,31,0.466667,0.00612
28085,Lincoln County,,MS,1880,32984,34864,8,8,16,990,953,1943,7,0.270114,0.282388,1223.093865,0.000199,0.000213,54,0.00025,0,31,0.402778,0.002171
28087,Lowndes County,,MS,5052,63689,68741,13,19,32,1598,1685,3283,6,0.344361,0.365743,16937.685097,0.002705,0.004177,54,0.000308,0,31,0.302632,0.019774
28089,Madison County,,MS,7721,80778,88499,33,18,51,6147,4954,11101,6,0.339173,0.360411,7664.776302,0.005718,0.003681,54,0.000656,0,31,0.27381,0.042234
28091,Marion County,,MS,1589,29732,31321,8,8,16,643,796,1439,7,0.254581,0.265822,502.989706,0.000173,0.000091,54,0.000249,0,31,0.366667,0.002034
28093,Marshall County,,MS,1776,26074,27850,8,6,14,1343,1218,2561,6,0.305523,0.319341,946.990499,0.000704,0.000702,54,0.000255,0,31,0.553571,0.00586
28095,Monroe County,,MS,1881,38547,40428,7,7,14,1010,1001,2011,7,0.260752,0.270961,332.277342,0.00005,0.00004,54,0.000249,0,31,0.482143,0.001002
28097,Montgomery County,,MS,653,11345,11998,2,2,4,192,191,383,7,0.234629,0.241209,0,0.000012,0.000006,54,0.000097,0,31,1,0.00024
28099,Neshoba County,,MS,1489,29724,31213,9,7,16,847,763,1610,7,0.260635,0.271305,500.904798,0.000224,0.000093,54,0.000317,0,31,0.486111,0.002727
28101,Newton County,,MS,1130,22885,24015,6,7,13,741,649,1390,7,0.27242,0.284252,159.007384,0.000086,0.000182,54,0.000212,0,31,0.517857,0.001375
28103,Noxubee County,,MS,653,12917,13570,1,2,3,111,271,382,7,0.256379,0.264952,9.724534,0.000034,0.000023,54,0.000064,0,31,0,0.000265
28105,Oktibbeha County,,MS,3750,34726,38476,14,15,29,1339,1392,2731,6,0.334023,0.354373,18021.506909,0.001048,0.002171,54,0.000389,0,31,0.300654,0.008448
28107,Panola County,,MS,1949,37146,39095,9,9,18,1293,1257,2550,6,0.305652,0.319944,2395.138448,0.000718,0.000708,54,0.000275,0,31,0.511111,0.005932
28109,Pearl River County,,MS,2701,48893,51594,9,11,20,1734,1452,3186,7,0.293126,0.307723,89.076436,0.001257,0.001266,54,0.000182,0,31,0.560606,0.008917
28111,Perry County,,MS,795,12204,12999,3,3,6,287,414,701,7,0.250496,0.259813,1.666667,0.000045,0.000035,54,0.000118,0,31,0.666667,0.000609
28113,Pike County,,MS,2347,36728,39075,9,9,18,1052,1184,2236,7,0.278695,0.292643,6222.140941,0.00188,0.000371,54,0.000252,0,31,0.397436,0.012869
28115,Pontotoc County,,MS,1484,23493,24977,7,7,14,1242,960,2202,7,0.236675,0.245206,597.480254,0.000041,0.000022,54,0.000285,0,31,0.482143,0.001452
28117,Prentiss County,,MS,1181,22539,23720,6,5,11,721,701,1422,7,0.236367,0.244317,14.197217,0.000017,0.000019,54,0.000253,0,31,0.566667,0.000842
28119,Quitman County,,MS,757,8682,9439,3,4,7,220,396,616,7,0.248843,0.257079,0.45,0.000026,0.000024,54,0.000115,0,31,0.75,0.000439
28121,Rankin County,,MS,9495,128479,137974,40,33,73,8680,6157,14837,6,0.337086,0.361616,23615.689483,0.005294,0.005719,54,0.00086,0,31,0.217854,0.039889
28123,Scott County,,MS,1450,26006,27456,7,7,14,830,831,1661,7,0.269363,0.2812,538.03572,0.001022,0.000184,54,0.000215,0,31,0.482143,0.007114
28125,Sharkey County,,MS,450,6386,6836,1,0,1,59,0,59,0,0,0,0,0.00004,0,54,0.00006,0,4,0,0.000252
28127,Simpson County,,MS,1619,23174,24793,6,8,14,849,1087,1936,7,0.270114,0.282388,66.830884,0.000194,0.00017,54,0.00018,0,31,0.583333,0.001884
28129,Smith County,,MS,882,14060,14942,7,6,13,533,555,1088,7,0.25239,0.262812,49.80437,0.000094,0.000072,54,0.000214,0,31,0.547619,0.001469
28131,Stone County,,MS,903,11005,11908,5,3,8,558,407,965,7,0.282435,0.294827,0,0.000492,0.000408,54,0.000135,0,31,0.85,0.003679
28133,Sunflower County,,MS,2012,28307,30319,6,9,15,680,1007,1687,6,0.330865,0.349547,445.594831,0.000825,0.0018,54,0.000135,0,31,0.569444,0.005818
28135,Tallahatchie County,,MS,882,14851,15733,8,7,15,460,442,902,6,0.305523,0.319513,2219.9261,0.000706,0.000696,54,0.000197,0,31,0.444444,0.005301
28137,Tate County,,MS,2004,27739,29743,6,6,12,1520,1305,2825,6,0.305459,0.319255,2.592783,0.000702,0.000703,54,0.000221,0,31,0.8,0.005603
28139,Tippah County,,MS,1075,22253,23328,4,7,11,451,604,1055,7,0.249914,0.259891,650.971876,0.000667,0.000098,54,0.000157,0,31,0.607143,0.004807
28141,Tishomingo County,,MS,1037,18622,19659,5,5,10,399,454,853,7,0.236501,0.244661,47.579938,0.000012,0.000014,54,0.000214,0,31,0.466667,0.000595
28143,Tunica County,,MS,1228,11311,12539,7,5,12,942,786,1728,6,0.305363,0.318997,387.000339,0.000713,0.000696,54,0.000205,0,31,0.571429,0.005664
28145,Union County,,MS,1500,25988,27488,9,7,16,1072,890,1962,7,0.236617,0.245091,2094.789291,0.000709,0.000027,54,0.000308,0,31,0.488889,0.00599
28147,Walthall County,,MS,706,11078,11784,3,2,5,306,220,526,8,0.218051,0.224687,1.071429,0.000005,0.000017,54,0.00013,0,31,0.666667,0.000442
28149,Warren County,,MS,3286,56139,59425,10,11,21,1008,1234,2242,6,0.323674,0.342154,3874.967019,0.000594,0.002014,54,0.000282,0,31,0.395604,0.004804
28151,Washington County,,MS,3908,62347,66255,9,16,25,850,1666,2516,6,0.346209,0.368153,4682.234683,0.002763,0.004848,54,0.000183,0,31,0.382353,0.018985
28153,Wayne County,,MS,832,19422,20254,2,4,6,203,342,545,7,0.250604,0.260186,6.884896,0.000005,0.000033,54,0.000104,0,31,0.416667,0.000335
28155,Webster County,,MS,796,12276,13072,3,3,6,260,266,526,7,0.250647,0.259294,19.881443,0.000018,0.000009,54,0.000125,0,31,0.333333,0.000384
28157,Wilkinson County,,MS,420,8612,9032,2,1,3,155,49,204,8,0.215702,0.22143,0,0.000257,0.000002,54,0.000095,0,31,1,0.001693
28159,Winston County,,MS,963,19591,20554,3,3,6,206,224,430,7,0.259494,0.268527,34.647181,0.000019,0.000049,54,0.000138,0,31,0.333333,0.000407
28161,Yalobusha County,,MS,923,14955,15878,4,6,10,448,563,1011,7,0.248993,0.258548,9.39858,0.000026,0.000092,54,0.000148,0,31,0.566667,0.000618
28163,Yazoo County,,MS,1237,26409,27646,7,5,12,584,557,1141,7,0.269213,0.280626,81.329444,0.001277,0.000195,54,0.000187,0,31,0.571429,0.009155
29001,Adair County,,MO,1916,22349,24265,5,7,12,443,575,1018,6,0.333295,0.351768,17726.809658,0.000092,0.002271,56,0.000291,0,31,0.25,0.001145
29003,Andrew County,,MO,1673,21488,23161,3,2,5,1207,1063,2270,7,0.263139,0.27249,50.91825,0.000025,0.000091,56,0.000123,0,31,0.583333,0.000402
29005,Atchison County,,MO,374,6823,7197,0,0,0,0,0,0,0,0,0,0,0,0,55,0.000051,51,103,0,0
29007,Audrain County,,MO,1780,28891,30671,7,9,16,764,964,1728,6,0.304562,0.318578,177.670384,0.000125,0.001011,56,0.000247,0,31,0.5,0.001657
29009,Barry County,,MO,2720,38597,41317,10,11,21,1584,1619,3203,6,0.294613,0.309045,179.207579,0.000755,0.001049,56,0.000332,0,31,0.560606,0.007738
29011,Barton County,,MO,1023,16411,17434,4,4,8,536,481,1017,7,0.256741,0.266434,13.421139,0.000065,0.000067,56,0.000155,0,31,0.333333,0.000901
29013,Bates County,,MO,1365,19740,21105,6,5,11,768,619,1387,6,0.30087,0.313516,46.886868,0.000956,0.000895,56,0.000168,0,31,0.452381,0.006806
29015,Benton County,,MO,1263,17559,18822,8,5,13,887,526,1413,7,0.292594,0.304973,9.870341,0.000785,0.000434,56,0.000207,0,31,0.714286,0.006359
29017,Bollinger County,,MO,737,13048,13785,4,3,7,400,340,740,7,0.238033,0.245194,1.410714,0.000035,0.000022,56,0.000173,0,31,0.666667,0.000624
29019,Boone County,,MO,11272,142694,153966,47,36,83,6203,5676,11879,6,0.363545,0.389664,53911.4015,0.010507,0.011083,56,0.00106,0,31,0.253628,0.075877
29021,Buchanan County,,MO,5498,91367,96865,14,15,29,2948,3157,6105,6,0.309892,0.325786,17334.035686,0.0012,0.001986,56,0.000443,0,31,0.297794,0.009104
29023,Butler County,,MO,2700,43292,45992,10,14,24,1255,1311,2566,6,0.306685,0.32228,14924.684683,0.000746,0.00116,56,0.000403,0,31,0.263736,0.005704
29025,Caldwell County,,MO,831,11046,11877,5,4,9,480,430,910,7,0.270064,0.280132,1843.400168,0.000561,0.000124,56,0.000164,0,31,0.533333,0.004089
29027,Callaway County,,MO,3074,43804,46878,8,8,16,2146,1782,3928,6,0.305266,0.319553,712.658042,0.001454,0.001189,56,0.00023,0,31,0.533333,0.010294
29029,Camden County,,MO,3395,40518,43913,13,15,28,1676,1654,3330,6,0.310821,0.326693,296.516315,0.002309,0.002299,56,0.000312,0,31,0.52381,0.017214
29031,Cape Girardeau County,,MO,4993,75838,80831,19,18,37,2724,2519,5243,6,0.31209,0.328438,23166.120061,0.001228,0.002262,56,0.000549,0,31,0.225296,0.009773
29033,Carroll County,,MO,717,11515,12232,5,4,9,288,224,512,7,0.292594,0.30483,1501.910167,0.000446,0.000396,56,0.000174,0,31,0.5,0.003283
29035,Carter County,,MO,457,6220,6677,1,1,2,116,104,220,7,0.234724,0.241306,0,0.00001,0.000006,56,0.000075,0,31,0,0.000151
29037,Cass County,,MO,7916,99902,107818,16,16,32,6712,5153,11865,6,0.334794,0.354517,739.585452,0.003487,0.003232,56,0.000335,0,31,0.414286,0.02384
29039,Cedar County,,MO,1027,14135,15162,5,5,10,417,453,870,6,0.294852,0.307163,9.762796,0.000591,0.000628,56,0.000174,0,31,0.633333,0.004733
29041,Chariton County,,MO,466,9845,10311,2,3,5,102,199,301,7,0.266863,0.276944,762.541707,0.000005,0.000091,56,0.000112,0,31,0.5,0.000229
29043,Christian County,,MO,7016,72673,79689,24,15,39,6347,4591,10938,6,0.30517,0.320856,2912.125241,0.004576,0.001683,56,0.000665,0,31,0.323333,0.033823
29045,Clark County,,MO,442,8686,9128,1,1,2,75,96,171,7,0.217008,0.222367,0,0.000002,0,179,0.000073,0,31,0,0.000099
29047,Clay County,,MO,18685,231158,249843,42,39,81,14976,13410,28386,6,0.369513,0.395581,23701.186609,0.013795,0.014411,56,0.000809,0,31,0.347968,0.096548
29049,Clinton County,,MO,1776,20933,22709,8,8,16,1511,1159,2670,6,0.301151,0.314348,1213.713314,0.000633,0.001072,56,0.000269,0,31,0.527778,0.005026
29051,Cole County,,MO,5393,81832,87225,23,19,42,3305,3257,6562,6,0.331848,0.35221,13005.957147,0.004676,0.003381,56,0.000539,0,31,0.360507,0.034556
29053,Cooper County,,MO,1308,17789,19097,6,5,11,680,646,1326,7,0.266961,0.27746,55.954554,0.000116,0.000098,56,0.000216,0,31,0.466667,0.001426
29055,Crawford County,,MO,1562,26327,27889,8,5,13,1066,778,1844,6,0.303893,0.317097,277.629761,0.001191,0.000681,56,0.000203,0,31,0.555556,0.008437
29057,Dade County,,MO,646,8882,9528,2,2,4,228,253,481,7,0.273369,0.283891,66.723355,0.000151,0.000195,56,0.000107,0,31,0,0.00165
29059,Dallas County,,MO,1335,17003,18338,7,5,12,827,759,1586,7,0.273343,0.284207,3.336111,0.000201,0.000245,56,0.000264,0,31,0.571429,0.002738
29061,Daviess County,,MO,724,9786,10510,4,5,9,244,313,557,7,0.27029,0.280665,1530.767553,0.000439,0.000138,56,0.000178,0,31,0.5,0.003162
29063,DeKalb County,,MO,638,7851,8489,3,2,5,320,247,567,7,0.236694,0.243564,0,0.000144,0.000015,56,0.000122,0,31,1,0.00124
29065,Dent County,,MO,878,13969,14847,3,2,5,277,250,527,7,0.273369,0.28392,3.69965,0.000722,0.000211,56,0.000121,0,31,0.833333,0.004771
29067,Douglas County,,MO,1084,14400,15484,7,6,13,480,543,1023,7,0.273524,0.284666,9.72822,0.000185,0.000243,56,0.000255,0,31,0.553571,0.00277
29069,Dunklin County,,MO,2019,32638,34657,9,9,18,1075,1042,2117,7,0.260448,0.271699,456.954345,0.000089,0.000054,56,0.00028,0,31,0.388889,0.001378
29071,Franklin County,,MO,5751,113531,119282,16,16,32,4337,3760,8097,6,0.307725,0.323433,230.049133,0.002207,0.001768,56,0.000404,0,31,0.488971,0.016569
29073,Gasconade County,,MO,1074,17940,19014,6,6,12,707,533,1240,6,0.303988,0.317384,443.927774,0.000765,0.000717,56,0.000199,0,31,0.619048,0.005526
29075,Gentry County,,MO,490,8170,8660,2,2,4,108,140,248,7,0.236733,0.243621,0,0.000025,0.000014,56,0.000095,0,31,1,0.000307
29077,Greene County,,MO,19547,261586,281133,78,59,137,14032,12838,26870,6,0.375922,0.404993,81319.948456,0.023616,0.018198,56,0.001627,0,31,0.267442,0.17109
29079,Grundy County,,MO,615,10936,11551,6,3,9,273,144,417,8,0.212997,0.218475,4796.566139,0.000549,0.000004,56,0.000205,0,31,0.190476,0.004096
29081,Harrison County,,MO,532,9029,9561,1,2,3,45,99,144,7,0.292418,0.304285,0,0.000427,0.00039,56,0.000064,0,31,0.5,0.002778
29083,Henry County,,MO,1492,25077,26569,7,7,14,894,765,1659,6,0.295092,0.307736,12.708277,0.000521,0.000664,56,0.000198,0,31,0.625,0.004025
29085,Hickory County,,MO,627,8566,9193,3,4,7,257,293,550,6,0.294792,0.306933,15.56684,0.000582,0.000588,56,0.000125,0,31,0.833333,0.004472
29087,Holt County,,MO,340,6435,6775,2,2,4,119,143,262,7,0.236733,0.243621,0,0.000025,0.000014,56,0.000095,0,31,1,0.000307
29089,Howard County,,MO,817,10390,11207,2,3,5,362,435,797,7,0.266789,0.276829,1.666667,0.000092,0.000092,56,0.000112,0,31,0.666667,0.000877
29091,Howell County,,MO,2595,42777,45372,10,10,20,950,971,1921,7,0.273833,0.285785,15707.370007,0.000593,0.000254,56,0.000391,0,31,0.265152,0.00529
29093,Iron County,,MO,1023,10915,11938,4,6,10,320,510,830,7,0.247676,0.256712,2.023313,0.000725,0.000067,56,0.000138,0,31,0.619048,0.004997
29095,Jackson County,,MO,45936,716751,762687,120,131,251,30562,36823,67385,6,0.413146,0.449627,162792.183941,0.046763,0.051691,56,0.002036,0,31,0.298411,0.325233
29097,Jasper County,,MO,7881,116584,124465,25,26,51,4574,4588,9162,6,0.344729,0.367992,14107.184346,0.00662,0.00544,56,0.000552,0,31,0.375616,0.048455
29099,Jefferson County,,MO,13742,241179,254921,21,21,42,12854,10211,23065,6,0.328767,0.349197,5208.612076,0.003294,0.002772,56,0.000492,0,31,0.349638,0.023958
29101,Johnson County,,MO,6251,49602,55853,14,17,31,2518,2739,5257,6,0.340445,0.360859,1050.183962,0.004491,0.004546,56,0.000266,0,31,0.445887,0.032343
29103,Knox County,,MO,368,5039,5407,1,1,2,142,48,190,7,0.25,0.257498,0,0.000019,0.000001,56,0.000086,0,31,0,0.000107
29105,Laclede County,,MO,2074,35527,37601,9,8,17,1186,917,2103,6,0.296236,0.30916,202.885556,0.000689,0.000729,56,0.000297,0,31,0.513889,0.00615
29107,Lafayette County,,MO,2383,34331,36714,7,8,15,1437,1492,2929,6,0.301214,0.314348,22.763112,0.000635,0.001051,56,0.000178,0,31,0.569444,0.004769
29109,Lawrence County,,MO,2634,35240,37874,6,6,12,1467,1616,3083,7,0.273627,0.284924,3.72031,0.000225,0.000315,56,0.000223,0,31,0.766667,0.002999
29111,Lewis County,,MO,678,10626,11304,2,2,4,175,252,427,7,0.248396,0.256373,0,0.000031,0.000009,56,0.000106,0,31,1,0.000277
29113,Lincoln County,,MO,2830,49069,51899,8,8,16,3671,1834,5505,6,0.304084,0.317688,146.742422,0.001178,0.0011,56,0.000211,0,31,0.597222,0.008389
29115,Linn County,,MO,923,16024,16947,3,5,8,218,279,497,7,0.26701,0.277518,182.050841,0.000002,0.000092,56,0.000151,0,31,0.2,0.000283
29117,Livingston County,,MO,929,15511,16440,4,4,8,273,255,528,7,0.27019,0.28039,3585.980199,0.000005,0.000122,56,0.000206,0,31,0.2,0.000478
29119,McDonald County,,MO,1915,20017,21932,7,7,14,1167,1243,2410,7,0.281069,0.294282,57.024101,0.000486,0.000741,56,0.000214,0,31,0.642857,0.006099
29121,Macon County,,MO,948,18216,19164,5,4,9,389,386,775,7,0.266838,0.277059,1446.050146,0.000116,0.000092,56,0.00021,0,31,0.3,0.001195
29123,Madison County,,MO,845,12914,13759,4,4,8,346,379,725,7,0.24757,0.256252,0.9,0.000725,0.000049,56,0.00013,0,31,0.7,0.004997
29125,Maries County,,MO,639,8606,9245,4,4,8,266,314,580,7,0.255701,0.264743,38.214526,0.000122,0.000061,56,0.000152,0,31,0.6,0.001431
29127,Marion County,,MO,1840,32451,34291,9,8,17,943,882,1825,6,0.304786,0.31867,9782.227115,0.00102,0.000949,56,0.000318,0,31,0.263889,0.007398
29129,Mercer County,,MO,324,3787,4111,1,0,1,45,0,45,0,0,0,0,0,0,56,0.000109,0,19,0,0.000131
29131,Miller County,,MO,1780,24314,26094,6,7,13,926,1006,1932,7,0.294703,0.307889,231.089633,0.000823,0.000627,56,0.000172,0,31,0.597222,0.006074
29133,Mississippi County,,MO,876,13678,14554,2,3,5,305,450,755,7,0.237994,0.245108,0,0.000006,0.000016,56,0.000108,0,31,1,0.000247
29135,Moniteau County,,MO,933,15221,16154,5,4,9,478,409,887,7,0.249442,0.25829,5.292262,0.000053,0.000055,56,0.000179,0,31,0.55,0.000983
29137,Monroe County,,MO,713,10423,11136,5,5,10,317,328,645,7,0.267034,0.277489,1524.198721,0.000112,0.000101,56,0.000206,0,31,0.45,0.001269
29139,Montgomery County,,MO,941,13146,14087,7,6,13,584,496,1080,7,0.276994,0.28833,101.125874,0.000938,0.000338,56,0.0002,0,31,0.660714,0.006753
29141,Morgan County,,MO,1476,19530,21006,10,8,18,858,766,1624,7,0.29286,0.305834,624.579535,0.001198,0.000464,56,0.000274,0,31,0.5,0.008995
29143,New Madrid County,,MO,1222,19416,20638,6,6,12,597,735,1332,7,0.238835,0.246818,87.202052,0.00003,0.000023,56,0.000213,0,31,0.533333,0.000793
29145,Newton County,,MO,3648,48956,52604,11,10,21,2594,2355,4949,7,0.276256,0.288804,316.689158,0.000768,0.000634,56,0.000299,0,31,0.484848,0.007478
29147,Nodaway County,,MO,1425,20352,21777,5,10,15,266,627,893,6,0.301339,0.314922,11535.909918,0.000443,0.001064,56,0.000229,0,31,0.3,0.003242
29149,Oregon County,,MO,649,9254,9903,2,2,4,206,255,461,8,0.215223,0.221035,0,0.000002,0.000005,56,0.000126,0,31,1,0.000251
29151,Osage County,,MO,626,14632,15258,3,3,6,365,322,687,7,0.24927,0.257716,1.650433,0.000034,0.000052,56,0.000135,0,31,0.583333,0.00065
29153,Ozark County,,MO,608,8931,9539,1,4,5,91,268,359,7,0.273781,0.284769,3.211873,0.000002,0.000217,56,0.000084,0,31,0.666667,0.000148
29155,Pemiscot County,,MO,1303,19354,20657,4,5,9,446,527,973,7,0.252149,0.262003,120.754774,0.000035,0.000023,56,0.000152,0,31,0.45,0.000522
29157,Perry County,,MO,1003,20389,21392,7,5,12,473,459,932,6,0.304403,0.317688,1520.184168,0.000735,0.000653,56,0.000253,0,31,0.380952,0.005248
29159,Pettis County,,MO,3147,43493,46640,9,14,23,1280,1640,2920,6,0.30976,0.325356,1340.863181,0.000633,0.001872,56,0.000288,0,31,0.43956,0.005497
29161,Phelps County,,MO,3369,42616,45985,16,15,31,1517,1474,2991,6,0.334062,0.353748,3347.275451,0.001942,0.002879,56,0.000434,0,31,0.434641,0.014867
29163,Pike County,,MO,1022,18034,19056,6,6,12,563,419,982,6,0.304179,0.317573,194.687813,0.000922,0.00088,56,0.000174,0,31,0.5,0.006519
29165,Platte County,,MO,11292,85232,96524,27,20,47,8524,7732,16256,6,0.356538,0.380033,5315.766959,0.009798,0.007738,56,0.000523,0,31,0.510582,0.067481
29167,Polk County,,MO,2049,24657,26706,8,6,14,1262,1039,2301,6,0.294852,0.307277,52.770673,0.000633,0.00063,56,0.000266,0,31,0.517857,0.005539
29169,Pulaski County,,MO,7029,37045,44074,32,27,59,3026,2551,5577,6,0.340445,0.363384,4970.738589,0.010475,0.008493,56,0.000467,0,31,0.48048,0.072691
29171,Putnam County,,MO,343,5471,5814,1,1,2,40,48,88,8,0.200262,0.204411,0,0,0,56,0.000075,0,104,0,0.00009
29173,Ralls County,,MO,667,10239,10906,1,1,2,270,265,535,7,0.23361,0.239624,0,0.000008,0.000008,56,0.000084,0,31,0,0.000162
29175,Randolph County,,MO,1517,23995,25512,7,6,13,720,656,1376,7,0.293363,0.30615,4157.780561,0.00053,0.000476,56,0.000255,0,31,0.309524,0.004067
29177,Ray County,,MO,1546,21159,22705,6,7,13,1059,990,2049,7,0.292742,0.305433,43.906712,0.000623,0.0006,56,0.000194,0,31,0.571429,0.004742
29179,Reynolds County,,MO,459,6266,6725,0,1,1,0,62,62,7,0.233483,0.239576,0,0,0.00001,56,0.000051,0,105,0,0
29181,Ripley County,,MO,770,13130,13900,1,1,2,174,253,427,7,0.234724,0.241306,0,0.00001,0.000006,56,0.000075,0,31,0,0.000151
29183,St. Charles County,,MO,21171,365982,387153,64,54,118,22166,14720,36886,6,0.375631,0.404333,21911.548502,0.026518,0.024621,56,0.001031,0,31,0.394566,0.183567
29185,St. Clair County,,MO,664,8527,9191,4,5,9,337,304,641,7,0.292536,0.304859,9.19512,0.000609,0.000408,56,0.000129,0,31,0.642857,0.00476
29186,Ste. Genevieve County,,MO,1415,23202,24617,5,4,9,927,804,1731,6,0.303829,0.316868,263.579968,0.000731,0.000677,56,0.000173,0,31,0.7,0.005138
29187,St. Francois County,,MO,3352,56985,60337,12,11,23,2531,1968,4499,6,0.304498,0.318578,5331.43934,0.001191,0.001135,56,0.000374,0,31,0.371795,0.008902
29189,St. Louis County,,MO,77661,1211238,1288899,184,202,386,57646,67392,125038,5,0.436036,0.47772,217358.254454,0.0768,0.083904,56,0.00267,0,31,0.275381,0.523543
29195,Saline County,,MO,1563,23430,24993,6,7,13,483,655,1138,7,0.293452,0.306322,125.264646,0.000546,0.000525,56,0.000199,0,31,0.52381,0.004065
29197,Schuyler County,,MO,271,4446,4717,1,1,2,62,101,163,7,0.25,0.257498,0,0.000019,0.000001,56,0.000086,0,31,0,0.000107
29199,Scotland County,,MO,200,5005,5205,0,0,0,0,0,0,0,0,0,0,0,0,57,0.000051,52,106,0,0
29201,Scott County,,MO,2888,44616,47504,7,7,14,1681,1665,3346,6,0.304626,0.318262,5994.540534,0.000727,0.000657,56,0.000224,0,31,0.446429,0.005161
29203,Shannon County,,MO,485,8057,8542,1,1,2,84,158,242,8,0.214984,0.220461,0,0.000002,0.000005,56,0.000084,0,31,0,0.000148
29205,Shelby County,,MO,445,7647,8092,2,3,5,102,137,239,7,0.266716,0.276686,0.666667,0.000002,0.000089,56,0.00013,0,31,0.666667,0.000215
29207,Stoddard County,,MO,2028,31932,33960,7,8,15,907,1056,1963,6,0.304722,0.318549,2768.380209,0.000727,0.000664,56,0.000245,0,31,0.5,0.005188
29209,Stone County,,MO,2765,27236,30001,10,6,16,1524,1576,3100,7,0.273446,0.284551,113.925754,0.001808,0.000297,56,0.000298,0,31,0.522222,0.01348
29211,Sullivan County,,MO,755,6813,7568,1,4,5,48,218,266,7,0.250388,0.258657,2905,0,0.000005,56,0.000114,0,104,0.083333,0.00009
29213,Taney County,,MO,4062,40174,44236,11,10,21,1654,1735,3389,6,0.304818,0.319795,1331.676095,0.00413,0.001523,56,0.000284,0,31,0.571429,0.030743
29215,Texas County,,MO,1554,19311,20865,6,7,13,575,676,1251,7,0.278134,0.290051,48.289592,0.00025,0.000347,56,0.000212,0,31,0.589286,0.002867
29217,Vernon County,,MO,1307,21133,22440,6,6,12,504,528,1032,6,0.295092,0.307708,246.913951,0.000491,0.000649,56,0.00019,0,31,0.333333,0.0038
29219,Warren County,,MO,2099,27590,29689,6,5,11,2152,1407,3559,6,0.303829,0.316982,24.336315,0.001149,0.000889,56,0.000161,0,31,0.8,0.007935
29221,Washington County,,MO,1264,20465,21729,6,4,10,892,685,1577,6,0.303766,0.316753,262.421844,0.000967,0.000689,56,0.000162,0,31,0.833333,0.006631
29223,Wayne County,,MO,780,10972,11752,4,2,6,278,193,471,7,0.234913,0.241966,1.152632,0.000731,0.000016,56,0.000132,0,31,0.7,0.004977
29225,Webster County,,MO,2239,29478,31717,7,6,13,1528,1408,2936,7,0.273369,0.284379,2.866667,0.000189,0.000243,56,0.000278,0,31,0.666667,0.002807
29227,Worth County,,MO,160,2243,2403,1,1,2,42,45,87,7,0.231579,0.237464,0,0.000009,0.000004,56,0.00007,0,31,0,0.000122
29229,Wright County,,MO,1443,18148,19591,6,7,13,651,842,1493,7,0.273549,0.284838,7.380415,0.000165,0.000248,56,0.00024,0,31,0.714286,0.002218
29510,St. Louis city,,MO,35990,314215,350205,46,54,100,24367,31000,55367,6,0.389746,0.418629,12929.521379,0.0235,0.027493,56,0.00068,0,31,0.517857,0.159287
30001,Beaverhead County,,MT,949,8765,9714,2,4,6,100,210,310,7,0.259239,0.269144,9.192623,0.000071,0.000203,178,0.000114,0,31,0.666667,0.000898
30003,Big Horn County,,MT,875,12338,13213,2,3,5,232,389,621,7,0.259796,0.269583,0.93254,0.000102,0.000116,178,0.000107,0,31,0.666667,0.001033
30005,Blaine County,,MT,523,6876,7399,1,2,3,46,161,207,7,0.259726,0.269296,0,0.000004,0.000114,178,0.000066,0,31,1,0.000106
30007,Broadwater County,,MT,373,4356,4729,1,1,2,64,107,171,7,0.24957,0.257406,0,0.000025,0.000041,178,0.000084,0,31,0,0.000408
30009,Carbon County,,MT,981,10830,11811,1,1,2,325,351,676,7,0.25968,0.269066,0,0.000101,0.000112,178,0.000077,0,31,0,0.000934
30011,Carter County,,MT,74,1347,1421,0,0,0,0,0,0,0,0,0,0,0,0,58,0.000051,53,107,0,0
30013,Cascade County,,MT,7243,89483,96726,26,26,52,2572,2917,5489,6,0.348703,0.371643,28610.793152,0.007159,0.00956,178,0.000657,0,31,0.410282,0.054381
30015,Chouteau County,,MT,457,5242,5699,2,2,4,136,152,288,7,0.258639,0.267591,0,0.000082,0.000061,178,0.000091,0,31,1,0.000664
30017,Custer County,,MT,933,12589,13522,2,1,3,171,116,287,7,0.25968,0.269066,0,0.000102,0.000112,178,0.000107,0,31,1,0.001033
30019,Daniels County,,MT,104,2424,2528,0,0,0,0,0,0,0,0,0,0,0,0,59,0.000051,54,108,0,0
30021,Dawson County,,MT,527,10034,10561,1,1,2,47,43,90,7,0.25968,0.269066,0,0.000101,0.000112,178,0.000077,0,31,0,0.000934
30023,Deer Lodge County,,MT,726,9753,10479,2,1,3,137,181,318,7,0.24957,0.257406,0,0.000121,0.00001,178,0.000091,0,31,1,0.000978
30025,Fallon County,,MT,165,3392,3557,0,0,0,0,0,0,0,0,0,0,0,0,60,0.000051,55,109,0,0
30027,Fergus County,,MT,863,13162,14025,2,3,5,118,223,341,7,0.262118,0.272636,0,0.000171,0.000267,178,0.000099,0,31,1,0.001734
30029,Flathead County,,MT,4878,88525,93403,29,17,46,2815,1903,4718,6,0.337792,0.358396,4901.862828,0.010857,0.006185,178,0.000553,0,31,0.530788,0.078869
30031,Gallatin County,,MT,6709,75855,82564,34,25,59,3655,2652,6307,6,0.344402,0.36677,20430.018288,0.011528,0.008462,178,0.000657,0,31,0.424925,0.084651
30033,Garfield County,,MT,87,1390,1477,0,0,0,0,0,0,0,0,0,0,0,0,61,0.000051,56,110,0,0
30035,Glacier County,,MT,969,13583,14552,4,7,11,267,514,781,7,0.261504,0.272246,2978.296776,0.000176,0.000357,178,0.000159,0,31,0.392857,0.001546
30037,Golden Valley County,,MT,240,999,1239,1,1,2,55,169,224,7,0.25968,0.269066,0,0.000101,0.000112,178,0.000077,0,31,0,0.000934
30039,Granite County,,MT,319,3128,3447,1,1,2,71,59,130,7,0.258455,0.267615,0,0.000096,0.000097,178,0.000068,0,31,0,0.000799
30041,Hill County,,MT,1331,18235,19566,3,7,10,260,555,815,7,0.26252,0.274014,2958.726878,0.000181,0.000493,178,0.000126,0,31,0.738095,0.00158
30043,Jefferson County,,MT,1101,11146,12247,3,3,6,542,508,1050,7,0.256288,0.265242,0,0.00012,0.000146,178,0.000129,0,31,1,0.001388
30045,Judith Basin County,,MT,196,2368,2564,0,0,0,0,0,0,0,0,0,0,0,0,62,0.000051,57,111,0,0
30047,Lake County,,MT,1811,26069,27880,9,3,12,836,535,1371,7,0.260987,0.270805,3.885144,0.00185,0.000245,178,0.000214,0,31,0.644444,0.013497
30049,Lewis and Clark County,,MT,4093,64898,68991,18,12,30,2118,1902,4020,6,0.332532,0.352032,10305.182376,0.004911,0.003024,178,0.000467,0,31,0.526144,0.036922
30051,Liberty County,,MT,118,2295,2413,0,0,0,0,0,0,0,0,0,0,0,0,63,0.000051,58,112,0,0
30053,Lincoln County,,MT,1445,18488,19933,3,3,6,281,371,652,7,0.272702,0.28511,0,0.000217,0.000447,178,0.000118,0,31,1,0.002345
30055,McCone County,,MT,89,1848,1937,0,0,0,0,0,0,0,0,0,0,0,0,64,0.000051,59,113,0,0
30057,Madison County,,MT,573,6633,7206,2,2,4,112,139,251,7,0.25622,0.264955,0,0.000072,0.000096,178,0.000097,0,31,1,0.000898
30059,Meagher County,,MT,111,2402,2513,0,0,0,0,0,0,0,0,0,0,0,0,65,0.000051,60,114,0,0
30061,Mineral County,,MT,450,4380,4830,1,1,2,135,146,281,7,0.258455,0.267615,0,0.000096,0.000097,178,0.000068,0,31,0,0.000799
30063,Missoula County,,MT,8786,102540,111326,32,34,66,4660,4663,9323,6,0.348494,0.372813,31284.164512,0.01171,0.011582,178,0.000708,0,31,0.422436,0.084685
30065,Musselshell County,,MT,408,4472,4880,1,1,2,110,139,249,7,0.25968,0.269066,0,0.000101,0.000112,178,0.000077,0,31,0,0.000934
30067,Park County,,MT,1417,16408,17825,2,2,4,248,461,709,7,0.260472,0.270352,0,0.000171,0.000207,178,0.000099,0,31,1,0.001734
30069,Petroleum County,,MT,0,0,0,0,0,0,0,0,0,0,0,0,0,0,0,66,0.000051,61,115,0,0
30071,Phillips County,,MT,310,4898,5208,0,1,1,0,44,44,7,0.259723,0.269146,0,0,0.000112,178,0.000051,0,116,0,0
30073,Pondera County,,MT,483,7580,8063,1,2,3,50,95,145,7,0.258639,0.267591,0,0.000079,0.000061,178,0.000072,0,31,1,0.000556
30075,Powder River County,,MT,108,1663,1771,0,0,0,0,0,0,0,0,0,0,0,0,67,0.000051,62,117,0,0
30077,Powell County,,MT,499,6018,6517,1,1,2,58,52,110,7,0.249592,0.257463,0,0.000096,0.000041,178,0.000068,0,31,1,0.000799
30079,Prairie County,,MT,107,1355,1462,0,0,0,0,0,0,0,0,0,0,0,0,68,0.000051,63,118,0,0
30081,Ravalli County,,MT,2694,37273,39967,8,9,17,1116,1079,2195,6,0.331016,0.349575,26.099181,0.004707,0.002733,178,0.000155,0,31,0.791209,0.032484
30083,Richland County,,MT,662,11388,12050,1,2,3,48,122,170,7,0.260519,0.270381,73.55895,0.000101,0.000113,178,0.000077,0,31,0,0.000934
30085,Roosevelt County,,MT,735,11544,12279,1,1,2,82,88,170,7,0.25968,0.269066,0,0.000101,0.000112,178,0.000077,0,31,0,0.000934
30087,Rosebud County,,MT,756,10870,11626,2,3,5,175,291,466,7,0.259726,0.269411,0.5,0.000102,0.000114,178,0.000107,0,31,0.666667,0.001033
30089,Sanders County,,MT,830,10107,10937,2,3,5,119,205,324,7,0.258501,0.26796,0,0.000147,0.000202,178,0.000096,0,31,1,0.001546
30091,Sheridan County,,MT,303,4396,4699,0,0,0,0,0,0,0,0,0,0,0,0,69,0.000051,64,119,0,0
30093,Silver Bow County,,MT,2467,35791,38258,9,12,21,803,1031,1834,6,0.332532,0.352032,4060.501364,0.00125,0.003055,178,0.000319,0,31,0.615385,0.009702
30095,Stillwater County,,MT,901,9620,10521,1,1,2,227,293,520,7,0.25968,0.269066,0,0.000101,0.000112,178,0.000077,0,31,0,0.000934
30097,Sweet Grass County,,MT,362,3688,4050,0,1,1,0,50,50,7,0.259723,0.269146,0,0,0.000112,178,0.000051,0,120,0,0
30099,Teton County,,MT,445,7537,7982,1,1,2,139,126,265,7,0.25857,0.267305,0,0.000079,0.000059,178,0.000072,0,31,0,0.000556
30101,Toole County,,MT,523,5399,5922,1,1,2,43,52,95,7,0.258593,0.267362,0,0.000003,0.000059,178,0.00007,0,31,1,0.000107
30103,Treasure County,,MT,0,0,0,0,0,0,0,0,0,0,0,0,0,0,0,70,0.000051,65,121,0,0
30105,Valley County,,MT,546,8483,9029,0,1,1,0,74,74,7,0.259723,0.269146,0,0,0.000112,178,0.000051,0,122,0,0
30107,Wheatland County,,MT,234,2204,2438,0,0,0,0,0,0,0,0,0,0,0,0,71,0.000051,66,123,0,0
30109,Wibaux County,,MT,61,1155,1216,0,0,0,0,0,0,0,0,0,0,0,0,72,0.000051,67,124,0,0
30111,Yellowstone County,,MT,8449,150052,158501,49,45,94,5310,4449,9759,6,0.350725,0.376182,91392.605465,0.013605,0.012221,178,0.001385,0,31,0.257512,0.097995
31001,Adams County,,NE,2159,34317,36476,8,8,16,695,947,1642,6,0.291742,0.304591,12175.276717,0.000588,0.00054,91,0.000398,0,31,0.333333,0.004796
31003,Antelope County,,NE,505,9017,9522,2,3,5,152,191,343,7,0.275626,0.286783,2945,0.000014,0.000167,91,0.000095,0,31,0.666667,0.000309
31005,Arthur County,,NE,0,0,0,0,0,0,0,0,0,0,0,0,0,0,0,73,0.000051,68,125,0,0
31007,Banner County,,NE,91,978,1069,0,0,0,0,0,0,0,0,0,0,0,0,74,0.000051,69,126,0,0
31009,Blaine County,,NE,0,0,0,0,0,0,0,0,0,0,0,0,0,0,0,75,0.000051,70,127,0,0
31011,Boone County,,NE,408,7071,7479,1,3,4,51,139,190,7,0.275653,0.286841,0,0.000005,0.00018,91,0.000078,0,31,1,0.000202
31013,Box Butte County,,NE,984,14760,15744,1,3,4,46,234,280,7,0.275705,0.286703,5888,0.00003,0.000168,91,0.00007,0,31,0.5,0.000208
31015,Boyd County,,NE,145,2810,2955,0,0,0,0,0,0,0,0,0,0,0,0,76,0.000051,71,128,0,0
31017,Brown County,,NE,288,3987,4275,0,0,0,0,0,0,0,0,0,0,0,0,77,0.000051,72,129,0,0
31019,Buffalo County,,NE,3570,47715,51285,13,10,23,1505,1652,3157,6,0.331848,0.350195,11610.517271,0.000601,0.001883,91,0.000455,0,31,0.271429,0.005455
31021,Burt County,,NE,655,9145,9800,3,5,8,259,351,610,6,0.291361,0.303558,0.25,0.000383,0.000533,91,0.000121,0,31,0.85,0.00293
31023,Butler County,,NE,772,12647,13419,4,4,8,353,404,757,6,0.29142,0.303558,21.639526,0.000173,0.000533,91,0.000155,0,31,0.6,0.001663
31025,Cass County,,NE,2259,29721,31980,5,6,11,1708,1419,3127,6,0.294374,0.306996,4.076895,0.0007,0.000701,91,0.00018,0,31,0.766667,0.005377
31027,Cedar County,,NE,617,13129,13746,3,4,7,151,232,383,7,0.275705,0.28707,98.186737,0.000013,0.000167,91,0.000127,0,31,0.35,0.000423
31029,Chase County,,NE,261,5081,5342,0,1,1,0,40,40,7,0.274965,0.285514,0,0,0.000152,91,0.000051,0,130,0,0
31031,Cherry County,,NE,504,7027,7531,1,2,3,49,86,135,7,0.275078,0.285802,60.828633,0.000001,0.000165,91,0.000083,0,31,0.333333,0.000094
31033,Cheyenne County,,NE,867,11781,12648,3,2,5,129,115,244,7,0.275287,0.28606,110.581824,0.000193,0.000168,100,0.000121,0,31,0.5,0.001557
31035,Clay County,,NE,525,7950,8475,2,2,4,175,174,349,7,0.275026,0.285785,0,0.000167,0.000157,91,0.000123,0,31,1,0.001402
31037,Colfax County,,NE,986,15176,16162,2,6,8,150,523,673,6,0.291918,0.304551,1,0.000017,0.000553,91,0.0001,0,31,0.766667,0.000421
31039,Cuming County,,NE,813,12750,13563,4,4,8,199,290,489,6,0.291801,0.304092,6.672713,0.000545,0.000538,91,0.000152,0,31,0.8,0.00418
31041,Custer County,,NE,744,13933,14677,1,4,5,46,237,283,7,0.275261,0.286445,0,0.000025,0.000186,91,0.00008,0,31,1,0.000227
31043,Dakota County,,NE,2397,23863,26260,5,7,12,1217,1348,2565,6,0.292241,0.305091,743.675019,0.000416,0.000562,50,0.000187,0,31,0.357143,0.003362
31045,Dawes County,,NE,884,9008,9892,2,3,5,124,171,295,7,0.277682,0.289309,5215.773659,0.000001,0.000214,91,0.000104,0,31,0.083333,0.000181
31047,Dawson County,,NE,2185,28746,30931,8,8,16,734,869,1603,6,0.330902,0.348829,13475.698244,0.002199,0.00164,91,0.000295,0,31,0.444444,0.015174
31049,Deuel County,,NE,229,2277,2506,1,0,1,51,0,51,0,0,0,0,0.000004,0,91,0.00007,0,21,0,0.000091
31051,Dixon County,,NE,528,7121,7649,2,4,6,112,237,349,7,0.258524,0.267925,125.021066,0.000047,0.000045,50,0.000094,0,31,0.25,0.000533
31053,Dodge County,,NE,2740,41884,44624,10,7,17,1373,1342,2715,6,0.294374,0.307111,50.766239,0.000731,0.000687,91,0.00028,0,31,0.5,0.006122
31055,Douglas County,,NE,32223,554821,587044,119,108,227,23191,23218,46409,5,0.406154,0.440421,153382.68117,0.044261,0.045058,91,0.002192,0,31,0.312044,0.308021
31057,Dundy County,,NE,128,2476,2604,0,0,0,0,0,0,0,0,0,0,0,0,78,0.000051,73,131,0,0
31059,Fillmore County,,NE,492,8751,9243,2,2,4,114,175,289,7,0.275,0.285727,0,0.000167,0.000154,91,0.000117,0,31,1,0.001369
31061,Franklin County,,NE,290,4260,4550,0,1,1,0,83,83,7,0.249228,0.256677,0,0,0.000005,91,0.000051,0,132,0,0
31063,Frontier County,,NE,286,3218,3504,0,1,1,0,58,58,7,0.2277,0.233539,0,0,0.000013,91,0.000051,0,133,0,0
31065,Furnas County,,NE,420,6238,6658,2,1,3,85,42,127,7,0.274974,0.285527,0,0.000003,0.000152,91,0.000092,0,31,0.333333,0.000185
31067,Gage County,,NE,1354,27379,28733,5,6,11,658,665,1323,6,0.291654,0.304132,7296.555371,0.000166,0.000521,91,0.000243,0,31,0.166667,0.00165
31069,Garden County,,NE,188,2388,2576,0,0,0,0,0,0,0,0,0,0,0,0,79,0.000051,74,134,0,0
31071,Garfield County,,NE,174,2462,2636,0,0,0,0,0,0,0,0,0,0,0,0,80,0.000051,75,135,0,0
31073,Gosper County,,NE,217,2160,2377,1,1,2,83,70,153,7,0.248651,0.255942,0,0.000014,0.000018,91,0.000082,0,31,0,0.000219
31075,Grant County,,NE,122,1193,1315,0,0,0,0,0,0,0,0,0,0,0,0,81,0.000051,76,136,0,0
31077,Greeley County,,NE,204,3598,3802,0,0,0,0,0,0,0,0,0,0,0,0,82,0.000051,77,137,0,0
31079,Hall County,,NE,4086,62304,66390,14,14,28,1774,2078,3852,6,0.337792,0.357472,16200.143754,0.001875,0.002976,91,0.000487,0,31,0.333333,0.014377
31081,Hamilton County,,NE,731,11904,12635,4,3,7,375,266,641,7,0.275104,0.286072,5.75,0.000035,0.000169,91,0.000182,0,31,0.55,0.000568
31083,Harlan County,,NE,201,4068,4269,1,0,1,41,0,41,0,0,0,0,0.000001,0,91,0.000068,0,20,0,0.000095
31085,Hayes County,,NE,87,1113,1200,0,0,0,0,0,0,0,0,0,0,0,0,83,0.000051,78,138,0,0
31087,Hitchcock County,,NE,225,3583,3808,1,1,2,74,71,145,8,0.215835,0.221087,0,0.000001,0,91,0.000075,0,139,0,0.00009
31089,Holt County,,NE,677,12516,13193,1,3,4,42,155,197,7,0.275626,0.286783,0,0.000001,0.000167,91,0.000078,0,31,0.833333,0.000094
31091,Hooker County,,NE,58,1107,1165,0,0,0,0,0,0,0,0,0,0,0,0,84,0.000051,79,140,0,0
31093,Howard County,,NE,474,7387,7861,1,1,2,244,143,387,7,0.252522,0.260315,0,0.000025,0.000015,91,0.00008,0,31,0,0.000227
31095,Jefferson County,,NE,519,9580,10099,2,2,4,149,192,341,7,0.275052,0.285785,2,0.000006,0.000154,91,0.000107,0,31,0.5,0.000198
31097,Johnson County,,NE,351,5221,5572,2,3,5,129,167,296,7,0.275104,0.286014,0.666667,0.000167,0.00016,91,0.000115,0,31,0.666667,0.001372
31099,Kearney County,,NE,497,6935,7432,2,2,4,198,167,365,7,0.275052,0.285785,0,0.000017,0.000157,91,0.000106,0,31,0.833333,0.000251
31101,Keith County,,NE,959,9695,10654,1,4,5,79,300,379,6,0.29142,0.30353,2946,0.000006,0.000531,91,0.000093,0,31,0.5,0.000194
31103,Keya Paha County,,NE,72,1158,1230,0,0,0,0,0,0,0,0,0,0,0,0,85,0.000051,80,141,0,0
31105,Kimball County,,NE,422,4292,4714,0,2,2,0,102,102,7,0.249871,0.257693,0,0,0.000017,100,0.000051,0,142,1,0
31107,Knox County,,NE,493,9805,10298,1,2,3,47,114,161,7,0.275574,0.286554,0,0.000012,0.000167,91,0.000073,0,31,1,0.000219
31109,Lancaster County,,NE,15672,293510,309182,84,62,146,10985,8744,19729,6,0.379112,0.408993,149504.807472,0.018472,0.019687,91,0.002175,0,31,0.16271,0.131454
31111,Lincoln County,,NE,2280,40634,42914,12,7,19,825,689,1514,6,0.294733,0.307713,8932.426327,0.001527,0.000708,91,0.00035,0,31,0.326923,0.010885
31113,Logan County,,NE,112,908,1020,0,0,0,0,0,0,0,0,0,0,0,0,86,0.000051,81,143,0,0
31115,Loup County,,NE,50,861,911,0,0,0,0,0,0,0,0,0,0,0,0,87,0.000051,82,144,0,0
31117,McPherson County,,NE,0,0,0,0,0,0,0,0,0,0,0,0,0,0,0,88,0.000051,83,145,0,0
31119,Madison County,,NE,3602,45250,48852,15,19,34,1236,1855,3091,6,0.308805,0.32558,29438.431364,0.001709,0.001484,91,0.000497,0,31,0.175889,0.013079
31121,Merrick County,,NE,608,8458,9066,1,3,4,154,237,391,7,0.275078,0.286014,0,0.000025,0.000168,91,0.00008,0,31,0.833333,0.000227
31123,Morrill County,,NE,452,5418,5870,1,1,2,148,182,330,7,0.249806,0.257437,0,0.00003,0.000015,100,0.00007,0,31,0,0.000208
31125,Nance County,,NE,320,4445,4765,0,1,1,0,62,62,7,0.22614,0.232042,0,0,0.000014,91,0.000051,0,146,0,0
31127,Nemaha County,,NE,671,8821,9492,3,3,6,155,222,377,6,0.291303,0.303214,21.38993,0.000168,0.000524,91,0.000157,0,31,0.666667,0.001505
31129,Nuckolls County,,NE,312,5880,6192,1,1,2,42,42,84,7,0.225869,0.231611,0,0.000004,0.000005,91,0.000093,0,31,0,0.000141
31131,Otoe County,,NE,1034,17580,18614,6,5,11,558,515,1073,6,0.291361,0.303558,68.329639,0.000701,0.000528,91,0.000216,0,31,0.452381,0.005444
31133,Pawnee County,,NE,192,3168,3360,0,1,1,0,49,49,7,0.225859,0.231537,0,0,0.000001,91,0.000051,0,147,0,0
31135,Perkins County,,NE,232,3438,3670,0,0,0,0,0,0,0,0,0,0,0,0,89,0.000051,84,148,0,0
31137,Phelps County,,NE,810,11455,12265,2,6,8,144,334,478,7,0.275235,0.286646,5945.172731,0.000029,0.000176,91,0.000121,0,31,0.333333,0.000376
31139,Pierce County,,NE,529,7980,8509,1,1,2,179,141,320,7,0.235963,0.242901,0,0.000012,0.000014,91,0.000073,0,31,0,0.000219
31141,Platte County,,NE,2205,36457,38662,9,9,18,851,1126,1977,6,0.292124,0.305297,10349.542177,0.001683,0.000555,91,0.00029,0,31,0.327273,0.01238
31143,Polk County,,NE,371,6225,6596,2,2,4,108,102,210,7,0.275026,0.285785,0.866667,0.000009,0.000166,91,0.000115,0,31,0.666667,0.00031
31145,Red Willow County,,NE,883,12739,13622,1,4,5,71,287,358,7,0.275215,0.286334,2905,0,0.000157,91,0.000114,0,139,0.25,0.00009
31147,Richardson County,,NE,579,9913,10492,2,2,4,111,135,246,7,0.274948,0.285613,10.640761,0.000168,0.000154,91,0.000094,0,31,0.333333,0.001354
31149,Rock County,,NE,160,1633,1793,0,0,0,0,0,0,0,0,0,0,0,0,90,0.000051,85,149,0,0
31151,Saline County,,NE,1034,14520,15554,3,3,6,431,494,925,7,0.275078,0.285957,3.5,0.000168,0.000155,91,0.000148,0,31,0.666667,0.001477
31153,Sarpy County,,NE,16092,133233,149325,46,45,91,11756,10324,22080,6,0.375388,0.40291,16492.174989,0.018336,0.018802,91,0.000849,0,31,0.378705,0.131813
31155,Saunders County,,NE,1534,20008,21542,5,5,10,1003,972,1975,6,0.294314,0.306767,0.5,0.000701,0.000681,91,0.000173,0,31,0.9,0.005391
31157,Scotts Bluff County,,NE,2513,40308,42821,11,14,25,927,976,1903,6,0.332951,0.352066,18776.351563,0.001819,0.003622,100,0.000314,0,31,0.37619,0.013141
31159,Seward County,,NE,1333,18168,19501,3,4,7,588,656,1244,7,0.275052,0.286072,2.72619,0.000168,0.000157,91,0.000155,0,31,0.5,0.001476
31161,Sheridan County,,NE,601,6656,7257,1,2,3,56,134,190,8,0.217382,0.223049,1,0.000002,0.000001,91,0.00008,0,31,0,0.000093
31163,Sherman County,,NE,261,4053,4314,0,1,1,0,48,48,7,0.249228,0.256677,0,0,0.000005,91,0.000051,0,150,0,0
31165,Sioux County,,NE,68,942,1010,0,0,0,0,0,0,0,0,0,0,0,0,92,0.000051,86,151,0,0
31167,Stanton County,,NE,298,3737,4035,1,1,2,155,110,265,7,0.235963,0.242901,0,0.000012,0.000014,91,0.000073,0,31,0,0.000219
31169,Thayer County,,NE,405,6639,7044,0,2,2,0,136,136,7,0.275017,0.285744,0,0,0.000153,91,0.000051,0,152,0.5,0
31171,Thomas County,,NE,82,954,1036,0,0,0,0,0,0,0,0,0,0,0,0,93,0.000051,87,153,0,0
31173,Thurston County,,NE,408,7310,7718,2,2,4,124,105,229,7,0.258225,0.267162,0,0.000047,0.000045,50,0.000094,0,31,1,0.000533
31175,Valley County,,NE,255,4669,4924,0,0,0,0,0,0,0,0,0,0,0,0,94,0.000051,88,154,0,0
31177,Washington County,,NE,1477,21547,23024,4,6,10,1011,870,1881,6,0.294374,0.306996,6.874838,0.000537,0.000698,91,0.000139,0,31,0.766667,0.004106
31179,Wayne County,,NE,721,7900,8621,3,3,6,181,265,446,6,0.291771,0.30392,151.343369,0.000014,0.000532,91,0.00012,0,31,0.5,0.000412
31181,Webster County,,NE,226,4413,4639,1,1,2,52,59,111,7,0.225869,0.231611,0,0.000004,0.000005,91,0.000093,0,31,0,0.000141
31183,Wheeler County,,NE,0,0,0,0,0,0,0,0,0,0,0,0,0,0,0,95,0.000051,89,155,0,0
31185,York County,,NE,1062,15898,16960,4,5,9,251,432,683,6,0.29142,0.303673,357.38605,0.000166,0.00052,91,0.000215,0,31,0.266667,0.001569
32001,Churchill County,,NV,3028,24842,27870,10,7,17,1006,1012,2018,6,0.330752,0.348083,314.304595,0.003762,0.003434,178,0.000203,0,31,0.533333,0.029033
32003,Clark County,,NV,83216,1595091,1678307,393,325,718,109022,66178,175200,5,0.459058,0.51044,228355.80751,0.123247,0.111281,178,0.004952,0,31,0.153362,0.854224
32005,Douglas County,,NV,5250,50792,56042,26,13,39,4435,3405,7840,6,0.339133,0.358431,2910.802855,0.012915,0.00808,178,0.000344,0,31,0.806154,0.089488
32007,Elko County,,NV,4706,48019,52725,14,19,33,1511,2087,3598,6,0.338107,0.358701,5962.154735,0.004848,0.006776,178,0.000297,0,31,0.463158,0.035623
32009,Esmeralda County,,NV,93,807,900,0,0,0,0,0,0,0,0,0,0,0,0,96,0.000051,90,156,0,0
32011,Eureka County,,NV,305,1548,1853,0,1,1,0,82,82,7,0.252741,0.260854,0,0,0.00004,178,0.000051,0,157,0,0
32013,Humboldt County,,NV,1640,17557,19197,5,5,10,344,529,873,6,0.330375,0.347802,955.622581,0.001244,0.002526,178,0.00014,0,31,0.566667,0.010091
32015,Lander County,,NV,674,5735,6409,2,3,5,102,226,328,7,0.269313,0.281547,0,0.000077,0.000355,178,0.000088,0,31,1,0.000566
32017,Lincoln County,,NV,279,4032,4311,1,1,2,156,81,237,6,0.31466,0.329121,0,0.000919,0.001017,178,0.000064,0,31,0,0.007229
32019,Lyon County,,NV,4371,39474,43845,27,11,38,4908,2706,7614,6,0.339015,0.358029,443.578657,0.01266,0.006202,178,0.000356,0,31,0.72792,0.088176
32021,Mineral County,,NV,408,5002,5410,1,2,3,99,119,218,7,0.270039,0.281825,0,0.000264,0.000336,178,0.000063,0,31,1,0.002269
32023,Nye County,,NV,3605,33621,37226,11,12,23,2771,1890,4661,6,0.336345,0.355429,69.580693,0.006955,0.005634,178,0.000197,0,31,0.703297,0.051423
32027,Pershing County,,NV,441,4441,4882,1,2,3,46,138,184,7,0.269113,0.28103,0,0.000264,0.000315,178,0.000063,0,31,1,0.002269
32029,Storey County,,NV,989,9176,10165,2,3,5,823,665,1488,7,0.269113,0.281145,0,0.000325,0.000496,178,0.000081,0,31,1,0.00295
32031,Washoe County,,NV,23832,392581,416413,99,90,189,22272,16739,39011,6,0.368061,0.401854,24723.685899,0.036941,0.032023,178,0.001268,0,31,0.388906,0.263919
32033,White Pine County,,NV,771,8578,9349,3,3,6,235,251,486,6,0.315412,0.330441,0,0.001021,0.001362,178,0.000091,0,31,1,0.008123
32510,Carson City,,NV,6229,56330,62559,20,14,34,4533,4035,8568,6,0.339133,0.358546,1055.737162,0.010436,0.007379,178,0.000302,0,31,0.736842,0.073186
33001,Belknap County,,NH,4941,71131,76072,16,13,29,4752,3178,7930,6,0.301276,0.317855,28.481825,0.00522,0.003596,103,0.000188,0,31,0.816993,0.029742
33003,Carroll County,,NH,3311,52828,56139,16,13,29,2493,1816,4309,6,0.300497,0.316902,82.249845,0.004973,0.002982,103,0.0002,0,31,0.792398,0.028989
33005,Cheshire County,,NH,4584,85675,90259,20,18,38,3708,2417,6125,6,0.310124,0.328065,144.916098,0.007558,0.004882,103,0.000229,0,31,0.678333,0.046267
33007,Coos County,,NH,2034,39640,41674,11,9,20,1211,962,2173,7,0.277709,0.291555,4795.494998,0.002723,0.001147,103,0.000171,0,31,0.780303,0.016152
33009,Grafton County,,NH,7411,92913,100324,33,23,56,5002,4297,9299,6,0.332151,0.353019,2121.361813,0.011753,0.007381,103,0.000395,0,31,0.559664,0.07261
33011,Hillsborough County,,NH,29699,465280,494979,69,90,159,22997,22857,45854,6,0.381503,0.415903,7864.69509,0.037169,0.046894,103,0.000715,0,31,0.515094,0.242855
33013,Merrimack County,,NH,11234,162712,173946,27,24,51,10039,7581,17620,6,0.340047,0.361203,713.235673,0.010638,0.009577,103,0.000304,0,31,0.653409,0.066669
33015,Rockingham County,,NH,25459,350706,376165,48,58,106,21747,19858,41605,6,0.359139,0.387012,3084.15664,0.024107,0.02952,103,0.00052,0,31,0.579675,0.157588
33017,Strafford County,,NH,9583,129899,139482,20,19,39,7785,6105,13890,6,0.314082,0.331985,346.254592,0.007127,0.005529,103,0.00025,0,31,0.663043,0.045851
33019,Sullivan County,,NH,2885,47662,50547,9,9,18,1944,1474,3418,6,0.299505,0.315065,3.172637,0.002576,0.00163,103,0.000145,0,31,0.7,0.015993
34001,Atlantic County,,NJ,12594,323166,335760,46,48,94,11768,8915,20683,6,0.349711,0.374966,308.756464,0.027721,0.027448,126,0.000387,0,31,0.783766,0.168234
34003,Bergen County,,NJ,59836,1036771,1096607,91,140,231,45416,53245,98661,6,0.396451,0.436197,2502.29819,0.054756,0.073556,102,0.000782,0,31,0.53817,0.344145
34005,Burlington County,,NJ,29954,524588,554542,84,109,193,28831,22983,51814,6,0.384585,0.421034,2283.821767,0.048784,0.059448,126,0.000771,0,31,0.559734,0.316743
34007,Camden County,,NJ,32480,583540,616020,61,78,139,25500,27332,52832,6,0.372881,0.404936,862.123763,0.037263,0.043826,126,0.00055,0,31,0.670142,0.237074
34009,Cape May County,,NJ,6869,115043,121912,17,23,40,4670,4229,8899,6,0.333563,0.353897,16.993089,0.007656,0.011722,126,0.000165,0,31,0.775385,0.043916
34011,Cumberland County,,NJ,5956,155148,161104,17,14,31,3662,3699,7361,6,0.311755,0.328954,12.506124,0.008956,0.005713,126,0.000163,0,31,0.824675,0.052014
34013,Essex County,,NJ,54819,828350,883169,80,123,203,37585,48522,86107,6,0.391533,0.429465,1585.852439,0.049914,0.066549,102,0.0007,0,31,0.589651,0.313849
34015,Gloucester County,,NJ,14837,301836,316673,25,30,55,15224,11396,26620,6,0.341768,0.364497,65.73132,0.012731,0.013775,126,0.000217,0,31,0.724022,0.072738
34017,Hudson County,,NJ,60821,640262,701083,94,121,215,38763,54882,93645,6,0.393549,0.431319,2289.555433,0.056831,0.065878,102,0.000838,0,31,0.581276,0.359043
34019,Hunterdon County,,NJ,9495,153017,162512,24,23,47,7433,5917,13350,6,0.333793,0.354568,8.073543,0.01327,0.010527,102,0.000195,0,31,0.897701,0.0734
34021,Mercer County,,NJ,24018,399543,423561,58,83,141,18916,18627,37543,6,0.379261,0.411886,375.391245,0.036271,0.048566,102,0.000464,0,31,0.704154,0.219212
34023,Middlesex County,,NJ,66039,895246,961285,109,151,260,52439,58563,111002,6,0.403726,0.44406,4248.277329,0.064572,0.078068,102,0.00098,0,31,0.493348,0.411919
34025,Monmouth County,,NJ,36884,719095,755979,69,122,191,31139,30711,61850,6,0.380254,0.418365,931.993645,0.04324,0.062819,102,0.000609,0,31,0.543929,0.275356
34027,Morris County,,NJ,36422,569564,605986,73,124,197,28507,30771,59278,6,0.389851,0.427806,1659.311027,0.045752,0.065886,102,0.000627,0,31,0.559619,0.286681
34029,Ocean County,,NJ,25756,618434,644190,67,93,160,31586,20362,51948,6,0.367362,0.401159,863.618872,0.036628,0.046327,102,0.000609,0,31,0.556768,0.234766
34031,Passaic County,,NJ,34141,561336,595477,43,85,128,22012,29596,51608,6,0.371261,0.404081,344.745354,0.026797,0.046807,102,0.000352,0,31,0.681122,0.159918
34033,Salem County,,NJ,3769,75765,79534,9,0,9,2477,0,2477,0,0,0,0,0.002841,0,126,0.000115,0,17,0.986111,0.017183
34035,Somerset County,,NJ,28667,345305,373972,61,87,148,24175,23643,47818,6,0.378667,0.41207,440.086114,0.03864,0.050469,102,0.000501,0,31,0.716794,0.236301
34037,Sussex County,,NJ,10083,177001,187084,25,35,60,9264,6825,16089,6,0.340286,0.363372,98.511023,0.014982,0.016882,102,0.000206,0,31,0.764673,0.082412
34039,Union County,,NJ,42716,600297,643013,57,97,154,29954,37459,67413,6,0.379558,0.414222,531.072169,0.035732,0.054026,102,0.000469,0,31,0.651386,0.218029
34041,Warren County,,NJ,8221,122685,130906,21,0,21,7741,0,7741,0,0,0,0,0.009554,0,102,0.000168,0,6,0.940476,0.049214
35001,Bernalillo County,,NM,38515,610689,649204,150,145,295,31927,28912,60839,5,0.415629,0.453719,71550.489358,0.064203,0.062373,100,0.002065,0,31,0.342967,0.445663
35003,Catron County,,NM,313,2763,3076,0,0,0,0,0,0,0,0,0,0,0,0,97,0.000051,91,158,0,0
35005,Chaves County,,NM,3990,60279,64269,20,15,35,1934,1885,3819,6,0.336423,0.356795,152.069439,0.009223,0.00383,100,0.000319,0,31,0.625541,0.06699
35006,Cibola County,,NM,1753,22834,24587,6,6,12,1101,1042,2143,6,0.328953,0.346447,0.34,0.001886,0.001954,100,0.000141,0,31,0.933333,0.014743
35007,Colfax County,,NM,1278,14753,16031,3,7,10,184,427,611,6,0.310655,0.325109,2915.75881,0.000524,0.001569,100,0.000139,0,31,0.303571,0.004022
35009,Curry County,,NM,5425,44818,50243,20,20,40,1813,1932,3745,6,0.347826,0.370713,4239.863859,0.006179,0.008785,100,0.000389,0,31,0.510769,0.046904
35011,De Baca County,,NM,176,2226,2402,0,0,0,0,0,0,0,0,0,0,0,0,98,0.000051,92,159,0,0
35013,Dona Ana County,,NM,12510,181890,194400,44,38,82,8713,7948,16661,6,0.360119,0.386358,3408.899731,0.019401,0.018907,100,0.000645,0,31,0.46131,0.13927
35015,Eddy County,,NM,3070,53137,56207,10,12,22,1082,1320,2402,6,0.337282,0.357415,15.413778,0.003571,0.004675,100,0.00019,0,31,0.801282,0.026605
35017,Grant County,,NM,2638,30360,32998,6,9,15,563,1277,1840,6,0.329438,0.34728,1871.592016,0.003631,0.003014,178,0.000129,0,31,0.6,0.026752
35019,Guadalupe County,,NM,306,4396,4702,1,1,2,42,59,101,6,0.29363,0.305745,0,0.000515,0.00053,100,0.000063,0,31,0,0.003722
35021,Harding County,,NM,52,689,741,0,0,0,0,0,0,0,0,0,0,0,0,99,0.000051,93,160,0,0
35023,Hidalgo County,,NM,454,4972,5426,0,2,2,0,115,115,6,0.328434,0.345181,0,0,0.001323,100,0.000051,0,161,1,0
35025,Lea County,,NM,3676,58064,61740,14,19,33,1070,1796,2866,6,0.342332,0.364859,4428.411969,0.003684,0.005763,100,0.000277,0,31,0.538012,0.027596
35027,Lincoln County,,NM,1656,18571,20227,9,7,16,851,631,1482,6,0.330978,0.349059,4.466789,0.003571,0.002584,100,0.000174,0,31,0.861111,0.026964
35028,Los Alamos County,,NM,1749,22638,24387,7,4,11,682,674,1356,6,0.293719,0.306261,69.357778,0.003019,0.000849,100,0.000155,0,31,0.738095,0.022801
35029,Luna County,,NM,1890,24309,26199,6,6,12,735,758,1493,6,0.33015,0.347796,4.512362,0.003192,0.003033,100,0.000126,0,31,0.904762,0.024242
35031,McKinley County,,NM,9707,85480,95187,11,13,24,5664,8152,13816,6,0.33437,0.353512,124.903404,0.003978,0.004136,100,0.000216,0,31,0.648352,0.030272
35033,Mora County,,NM,338,5036,5374,2,2,4,153,151,304,6,0.29366,0.305917,0,0.000522,0.000536,100,0.000089,0,31,1,0.003866
35035,Otero County,,NM,6086,54607,60693,20,21,41,1856,2159,4015,6,0.34625,0.368486,137.661988,0.010853,0.009301,100,0.000302,0,31,0.678333,0.079923
35037,Quay County,,NM,701,9356,10057,2,2,4,129,118,247,6,0.293778,0.306118,0,0.000587,0.000581,100,0.000079,0,31,1,0.004211
35039,Rio Arriba County,,NM,2774,43162,45936,5,6,11,988,1917,2905,6,0.294076,0.307008,3.140052,0.000788,0.000969,100,0.000162,0,31,0.733333,0.006333
35041,Roosevelt County,,NM,1776,16795,18571,5,6,11,500,756,1256,6,0.295603,0.309332,0.267857,0.001784,0.000993,100,0.000124,0,31,0.904762,0.013935
35043,Sandoval County,,NM,9458,101485,110943,30,19,49,8586,6484,15070,6,0.345673,0.366977,1524.658983,0.014236,0.008597,100,0.000459,0,31,0.566667,0.100187
35045,San Juan County,,NM,11758,135843,147601,27,33,60,9845,8547,18392,6,0.352855,0.377755,1914.269773,0.009619,0.012448,100,0.000444,0,31,0.431933,0.07054
35047,San Miguel County,,NM,1817,27138,28955,5,5,10,626,962,1588,6,0.293868,0.306635,8.13927,0.000761,0.000898,100,0.000153,0,31,0.4,0.006279
35049,Santa Fe County,,NM,9987,134549,144536,44,35,79,6544,6173,12717,6,0.357768,0.383402,4217.808504,0.023614,0.01906,100,0.000619,0,31,0.60594,0.16301
35051,Sierra County,,NM,892,10708,11600,2,2,4,264,257,521,6,0.293689,0.305975,0,0.000671,0.00069,100,0.000077,0,31,1,0.004953
35053,Socorro County,,NM,1235,15901,17136,4,3,7,394,534,928,6,0.293719,0.306147,0,0.000697,0.000722,100,0.000106,0,31,0.85,0.005082
35055,Taos County,,NM,2028,31318,33346,6,3,9,649,627,1276,6,0.293689,0.306089,55.606564,0.002663,0.000731,100,0.00014,0,31,0.6,0.019486
35057,Torrance County,,NM,1355,12593,13948,3,4,7,671,820,1491,6,0.293719,0.306261,0,0.000743,0.000874,100,0.000098,0,31,1,0.006035
35059,Union County,,NM,436,4230,4666,0,1,1,0,48,48,7,0.237085,0.243315,0,0,0.000004,100,0.000051,0,162,0,0
35061,Valencia County,,NM,5242,68504,73746,13,12,25,3302,3535,6837,6,0.339213,0.358414,394.095191,0.003844,0.00553,100,0.000255,0,31,0.625,0.029043
36001,Albany County,,NY,21387,338693,360080,65,72,137,17140,16890,34030,6,0.371118,0.402307,22766.672555,0.02831,0.037432,103,0.000702,0,31,0.494802,0.172718
36003,Allegany County,,NY,2821,55259,58080,10,9,19,1609,1496,3105,6,0.291683,0.306261,1441.729295,0.001369,0.001063,126,0.00021,0,31,0.472727,0.007929
36005,Bronx County,,NY,90584,1265806,1356390,98,157,255,60858,83396,144254,5,0.401993,0.443406,4508.490334,0.056281,0.07427,102,0.000901,0,31,0.447616,0.362701
36007,Broome County,,NY,10069,232919,242988,27,50,77,4177,5341,9518,6,0.357988,0.385308,8007.118057,0.008967,0.022713,126,0.000311,0,31,0.46553,0.049582
36009,Cattaraugus County,,NY,4448,91108,95556,7,8,15,2546,2571,5117,6,0.291596,0.306032,23.035592,0.001369,0.001084,126,0.000142,0,31,0.535714,0.00749
36011,Cayuga County,,NY,4243,93020,97263,9,12,21,2422,2616,5038,6,0.294255,0.309768,32.221193,0.001202,0.001806,126,0.000163,0,31,0.590909,0.007047
36013,Chautauqua County,,NY,5296,149194,154490,8,12,20,1962,2122,4084,6,0.338068,0.358196,331.598972,0.002226,0.005787,126,0.000142,0,31,0.608974,0.012876
36015,Chemung County,,NY,4885,104542,109427,10,12,22,2122,2263,4385,6,0.293363,0.308924,462.068348,0.001986,0.00176,126,0.000177,0,31,0.484848,0.010552
36017,Chenango County,,NY,2752,54921,57673,9,8,17,1569,1479,3048,6,0.279311,0.292614,23.174341,0.002295,0.000731,126,0.00014,0,31,0.622222,0.012307
36019,Clinton County,,NY,2963,91791,94754,7,8,15,1127,926,2053,7,0.273138,0.286499,80.609574,0.001323,0.000677,103,0.000148,0,31,0.527778,0.007503
36021,Columbia County,,NY,3721,72738,76459,14,12,26,2694,2126,4820,6,0.303512,0.3203,2.380793,0.005633,0.003697,102,0.000161,0,31,0.846154,0.030885
36023,Cortland County,,NY,2872,52101,54973,7,7,14,1516,1438,2954,6,0.27915,0.292154,22.150127,0.000761,0.000554,126,0.000125,0,31,0.619048,0.004085
36025,Delaware County,,NY,2791,49037,51828,17,10,27,1770,1411,3181,6,0.301652,0.318004,91.082511,0.006408,0.001993,126,0.000186,0,31,0.646199,0.033806
36027,Dutchess County,,NY,15739,319288,335027,44,59,103,13334,10453,23787,6,0.354665,0.382541,739.634173,0.024849,0.030583,102,0.000376,0,31,0.598771,0.146407
36029,Erie County,,NY,29903,1070813,1100716,117,147,264,17842,22266,40108,5,0.406097,0.445759,36775.908122,0.062115,0.076106,126,0.001214,0,31,0.458657,0.409036
36031,Essex County,,NY,2241,39277,41518,9,6,15,928,999,1927,7,0.271859,0.284083,13.951904,0.000749,0.000496,103,0.000193,0,31,0.513889,0.005068
36033,Franklin County,,NY,2060,50798,52858,6,5,11,945,929,1874,7,0.277815,0.290763,15.054178,0.000683,0.000594,103,0.000134,0,31,0.714286,0.004632
36035,Fulton County,,NY,2549,59420,61969,6,5,11,1486,1370,2856,7,0.271808,0.283853,3.339517,0.000601,0.000511,103,0.000124,0,31,0.766667,0.003719
36037,Genesee County,,NY,3388,76270,79658,6,8,14,2046,2108,4154,6,0.29142,0.305688,3.690909,0.001323,0.001101,126,0.000128,0,31,0.660714,0.0073
36039,Greene County,,NY,2772,50706,53478,18,12,30,2400,1529,3929,6,0.302847,0.319886,49.470969,0.006914,0.003712,102,0.000192,0,31,0.74183,0.036714
36041,Hamilton County,,NY,356,5738,6094,0,0,0,0,0,0,0,0,0,0,0,0,101,0.000051,94,163,0,0
36043,Herkimer County,,NY,3377,71084,74461,6,9,15,1858,1931,3789,7,0.287724,0.302597,41.266239,0.00057,0.001385,126,0.000133,0,31,0.625,0.003709
36045,Jefferson County,,NY,12154,118440,130594,48,46,94,4665,5001,9666,6,0.362411,0.389761,6287.112648,0.022816,0.018832,126,0.000547,0,31,0.471491,0.153246
36047,Kings County,,NY,156966,2327630,2484596,181,240,421,92225,147766,239991,5,0.428382,0.476561,31820.154964,0.08955,0.101728,102,0.001809,0,31,0.319933,0.59279
36049,Lewis County,,NY,1426,28232,29658,3,4,7,577,648,1225,7,0.281805,0.294861,0,0.000318,0.000651,126,0.000081,0,31,1,0.00243
36051,Livingston County,,NY,4238,73074,77312,9,8,17,2794,2773,5567,6,0.291566,0.305917,11.68272,0.00169,0.001068,126,0.000171,0,31,0.652778,0.009653
36053,Madison County,,NY,4559,78307,82866,9,10,19,2996,2821,5817,6,0.291977,0.306864,40.268719,0.001236,0.001506,126,0.000152,0,31,0.544444,0.007428
36055,Monroe County,,NY,31092,866872,897964,112,142,254,18273,23489,41762,6,0.401327,0.441087,42226.562139,0.056742,0.071875,126,0.001171,0,31,0.457651,0.368827
36057,Montgomery County,,NY,3221,63687,66908,8,7,15,1987,1994,3981,7,0.27191,0.284312,7.101232,0.0007,0.000557,103,0.00015,0,31,0.625,0.00448
36059,Nassau County,,NY,76602,1606686,1683288,97,180,277,58228,69910,128138,5,0.407293,0.450924,5973.201797,0.059134,0.085575,102,0.00093,0,31,0.423389,0.387121
36061,New York County,,NY,160893,1494875,1655768,219,215,434,133554,146677,280231,5,0.424872,0.470323,38509.897817,0.099123,0.096477,102,0.002217,0,31,0.323332,0.6545
36063,Niagara County,,NY,9137,255981,265118,11,18,29,5529,5532,11061,6,0.338462,0.358953,1198.961354,0.005638,0.009092,126,0.000179,0,31,0.570175,0.039304
36065,Oneida County,,NY,9210,259607,268817,31,35,66,4794,5333,10127,6,0.348829,0.372612,4218.690149,0.014461,0.017572,126,0.00036,0,31,0.560366,0.094653
36067,Onondaga County,,NY,21242,520808,542050,79,91,170,13004,14622,27626,6,0.382558,0.416753,25705.107713,0.038996,0.047168,126,0.000858,0,31,0.497844,0.257504
36069,Ontario County,,NY,6789,121668,128457,12,9,21,4750,3990,8740,6,0.291859,0.306491,96.768215,0.003223,0.001369,126,0.000199,0,31,0.507576,0.018814
36071,Orange County,,NY,20997,405085,426082,60,98,158,20068,14629,34697,6,0.370503,0.405366,1810.164166,0.034867,0.048224,102,0.000515,0,31,0.527106,0.212682
36073,Orleans County,,NY,2378,46804,49182,4,4,8,1393,1514,2907,6,0.291245,0.304884,0,0.001306,0.001039,126,0.000087,0,31,1,0.006978
36075,Oswego County,,NY,6160,134173,140333,9,11,20,4019,3677,7696,6,0.308411,0.324644,37.315935,0.001527,0.002669,126,0.00014,0,31,0.663636,0.008645
36077,Otsego County,,NY,3537,65412,68949,13,12,25,1806,1703,3509,6,0.29748,0.314256,172.997354,0.003769,0.001679,126,0.000182,0,31,0.542857,0.019877
36079,Putnam County,,NY,7691,112927,120618,12,18,30,6450,5474,11924,6,0.336189,0.356491,0.276786,0.007061,0.009967,102,0.000114,0,31,0.892105,0.036204
36081,Queens County,,NY,155271,2244718,2399989,145,221,366,93308,146552,239860,5,0.419048,0.466552,19385.673752,0.076694,0.096958,102,0.001412,0,31,0.350026,0.505929
36083,Rensselaer County,,NY,10847,175001,185848,24,24,48,8031,7738,15769,6,0.342857,0.36475,1974.104778,0.009313,0.010385,103,0.000279,0,31,0.620968,0.051425
36085,Richmond County,,NY,24666,491630,516296,35,78,113,21857,20881,42738,6,0.372451,0.404316,409.151975,0.023401,0.040365,102,0.000303,0,31,0.621714,0.140521
36087,Rockland County,,NY,16739,336271,353010,36,57,93,10772,12989,23761,6,0.361329,0.389526,226.668246,0.021823,0.031818,102,0.000283,0,31,0.753133,0.123894
36089,St. Lawrence County,,NY,4304,113706,118010,10,13,23,1289,1518,2807,6,0.294613,0.310572,466.62807,0.002637,0.002117,126,0.000171,0,31,0.510989,0.017016
36091,Saratoga County,,NY,15192,247288,262480,55,50,105,13423,10598,24021,6,0.357503,0.385721,14158.589211,0.022931,0.023157,103,0.000622,0,31,0.434783,0.142301
36093,Schenectady County,,NY,10064,161104,171168,24,23,47,7390,6783,14173,6,0.330225,0.351475,1359.626073,0.009387,0.009582,103,0.000287,0,31,0.581609,0.052904
36095,Schoharie County,,NY,1576,29417,30993,7,8,15,863,958,1821,7,0.271961,0.284542,30.523308,0.001854,0.000652,103,0.000126,0,31,0.611111,0.009671
36097,Schuyler County,,NY,1334,22073,23407,6,5,11,902,763,1665,7,0.26101,0.271477,4.74851,0.000211,0.00016,126,0.000139,0,31,0.533333,0.001547
36099,Seneca County,,NY,2091,36772,38863,8,8,16,1258,1201,2459,6,0.291771,0.306233,130.385053,0.001172,0.001471,126,0.000166,0,31,0.638889,0.006829
36101,Steuben County,,NY,5654,111209,116863,12,15,27,2547,2802,5349,6,0.330752,0.350092,1759.383959,0.001611,0.003601,126,0.000236,0,31,0.390476,0.009005
36103,Suffolk County,,NY,61837,1750361,1812198,128,204,332,53754,53127,106881,5,0.400221,0.447463,13224.625125,0.06834,0.087819,102,0.001296,0,31,0.345227,0.458336
36105,Sullivan County,,NY,4279,77448,81727,16,18,34,3536,2330,5866,6,0.31466,0.333322,48.604847,0.007928,0.007284,102,0.000165,0,31,0.794737,0.042623
36107,Tioga County,,NY,3530,59443,62973,5,7,12,2007,2037,4044,6,0.279311,0.29247,20.985868,0.000356,0.00054,126,0.000109,0,31,0.619048,0.001742
36109,Tompkins County,,NY,7897,87983,95880,28,35,63,3332,3925,7257,6,0.350006,0.375212,10604.224122,0.014011,0.017669,126,0.00033,0,31,0.6,0.086576
36111,Ulster County,,NY,8593,184474,193067,28,26,54,6585,5056,11641,6,0.343628,0.365674,311.564491,0.013929,0.012619,102,0.000261,0,31,0.711174,0.080582
36113,Warren County,,NY,4849,74723,79572,16,6,22,3548,2800,6348,7,0.271834,0.284025,86.198481,0.005455,0.000595,103,0.000223,0,31,0.545833,0.029638
36115,Washington County,,NY,3504,61817,65321,8,7,15,2623,2433,5056,7,0.271987,0.284484,63.766211,0.001331,0.000569,103,0.000177,0,31,0.571429,0.007797
36117,Wayne County,,NY,5733,109169,114902,8,9,17,3855,3750,7605,6,0.291771,0.306348,13.011576,0.00168,0.001381,126,0.00015,0,31,0.652778,0.009489
36119,Westchester County,,NY,57315,1034104,1091419,93,158,251,39647,50448,90095,6,0.391427,0.433701,4154.99383,0.055136,0.076005,102,0.000827,0,31,0.456405,0.347074
36121,Wyoming County,,NY,2287,42863,45150,6,6,12,1595,1595,3190,6,0.291391,0.305401,1.771429,0.001257,0.001029,126,0.000131,0,31,0.833333,0.007067
36123,Yates County,,NY,1199,23769,24968,6,5,11,795,696,1491,7,0.286673,0.300244,59.315914,0.000662,0.00052,126,0.00014,0,31,0.619048,0.003952
37001,Alamance County,,NC,8063,165127,173190,16,19,35,4684,4635,9319,6,0.335219,0.355435,348.56225,0.00365,0.00574,104,0.000272,0,31,0.55,0.028728
37003,Alexander County,,NC,2307,39737,42044,6,5,11,1729,1402,3131,7,0.243033,0.25243,0.48631,0.000895,0.000152,104,0.000148,0,31,0.966667,0.0076
37005,Alleghany County,,NC,508,11705,12213,2,2,4,112,105,217,7,0.23518,0.242221,0,0.000018,0.000013,104,0.000097,0,31,1,0.000311
37007,Anson County,,NC,1316,27483,28799,5,6,11,658,776,1434,6,0.301432,0.315846,3.066977,0.000824,0.0011,104,0.000128,0,31,0.633333,0.007137
37009,Ashe County,,NC,976,26470,27446,3,4,7,373,332,705,7,0.235867,0.243598,17.841078,0.000042,0.00004,104,0.000131,0,31,0.5,0.000612
37011,Avery County,,NC,1321,18039,19360,6,5,11,507,450,957,7,0.269763,0.281084,2479.496951,0.001622,0.000301,104,0.000173,0,31,0.380952,0.012555
37013,Beaufort County,,NC,2857,54693,57550,7,7,14,1442,1449,2891,7,0.301214,0.315976,6755.904371,0.000945,0.001069,104,0.000181,0,31,0.339286,0.007633
37015,Bertie County,,NC,1256,22637,23893,5,4,9,537,588,1125,7,0.253868,0.263017,265.875047,0.000095,0.000057,104,0.000159,0,31,0.3,0.000912
37017,Bladen County,,NC,3210,45536,48746,11,12,23,2120,2014,4134,6,0.311755,0.328357,30.27668,0.001739,0.003421,104,0.000219,0,31,0.631868,0.013849
37019,Brunswick County,,NC,5067,79419,84486,30,12,42,3968,2243,6211,6,0.31381,0.330705,97.186136,0.010523,0.004266,104,0.000392,0,31,0.46129,0.068222
37021,Buncombe County,,NC,13859,239408,253267,73,57,130,9029,7765,16794,6,0.368154,0.396998,47405.059833,0.030558,0.024795,104,0.001369,0,31,0.384673,0.230818
37023,Burke County,,NC,4877,98865,103742,15,13,28,3030,2810,5840,6,0.307595,0.324024,903.842893,0.002329,0.002834,104,0.000325,0,31,0.508333,0.019534
37025,Cabarrus County,,NC,13351,190664,204015,36,29,65,10697,8935,19632,6,0.337008,0.36056,1233.827655,0.016318,0.010215,104,0.000508,0,31,0.537374,0.116532
37027,Caldwell County,,NC,4572,94437,99009,10,12,22,2762,2720,5482,6,0.307595,0.32391,407.587091,0.001565,0.002883,104,0.000223,0,31,0.711538,0.013279
37029,Camden County,,NC,826,10484,11310,6,3,9,844,375,1219,7,0.234194,0.241335,32.373393,0.001277,0.000031,47,0.000203,0,31,0.733333,0.009819
37031,Carteret County,,NC,4620,66111,70731,15,7,22,2602,1653,4255,7,0.306847,0.322346,21.632456,0.005402,0.00221,104,0.00024,0,31,0.771429,0.039303
37033,Caswell County,,NC,2042,30212,32254,8,8,16,1458,1482,2940,7,0.301432,0.316406,1055.389927,0.000995,0.001733,104,0.000175,0,31,0.569444,0.00809
37035,Catawba County,,NC,11779,187989,199768,19,31,50,7052,7594,14646,6,0.320459,0.342045,2230.722973,0.003581,0.006976,104,0.000365,0,31,0.399194,0.028566
37037,Chatham County,,NC,6918,76270,83188,17,14,31,5631,4422,10053,6,0.311722,0.32853,109.386367,0.006795,0.004026,104,0.000271,0,31,0.69281,0.049948
37039,Cherokee County,,NC,1386,24565,25951,7,5,12,422,306,728,8,0.214872,0.221861,9253.221933,0.001823,0.000089,12,0.000405,0,31,0.160714,0.01397
37041,Chowan County,,NC,944,16336,17280,4,5,9,372,315,687,7,0.300995,0.315373,1307.749979,0.000017,0.000888,47,0.000189,0,31,0.333333,0.00055
37043,Clay County,,NC,572,8927,9499,2,2,4,155,198,353,9,0.176901,0.180826,20.124274,0.000001,0.000015,12,0.000226,0,31,0,0.000301
37045,Cleveland County,,NC,6077,117045,123122,13,15,28,3939,3856,7795,6,0.307953,0.32477,72.114711,0.00231,0.003294,104,0.000256,0,31,0.669118,0.019471
37047,Columbus County,,NC,2441,53031,55472,7,8,15,987,1369,2356,6,0.311321,0.327238,1.901853,0.001825,0.002954,104,0.000159,0,31,0.875,0.014851
37049,Craven County,,NC,12032,103133,115165,41,38,79,5174,5183,10357,6,0.356976,0.382272,11148.039854,0.01991,0.015899,104,0.000567,0,31,0.43098,0.137231
37051,Cumberland County,,NC,46650,314608,361258,181,185,366,26086,29622,55708,6,0.420078,0.463246,48536.085115,0.073617,0.073579,104,0.002133,0,31,0.276855,0.508484
37053,Currituck County,,NC,1455,19293,20748,7,6,13,1686,798,2484,6,0.290691,0.304913,1056.054415,0.001367,0.001429,47,0.000215,0,31,0.761905,0.010609
37055,Dare County,,NC,2532,34625,37157,13,8,21,913,831,1744,6,0.305716,0.321493,88.927802,0.004666,0.002174,47,0.000252,0,31,0.621795,0.034299
37057,Davidson County,,NC,10749,201788,212537,19,23,42,8224,7389,15613,6,0.316443,0.335566,468.008268,0.002922,0.005194,104,0.000345,0,31,0.456667,0.025121
37059,Davie County,,NC,2409,40146,42555,7,7,14,1784,1355,3139,6,0.301934,0.316621,45.527032,0.001511,0.001725,104,0.000154,0,31,0.880952,0.012583
37061,Duplin County,,NC,3061,53734,56795,10,14,24,1655,2024,3679,7,0.311221,0.328074,78.659991,0.002329,0.00321,104,0.000186,0,31,0.642857,0.016191
37063,Durham County,,NC,24358,241621,265979,100,87,187,16207,18007,34214,6,0.389746,0.423204,16835.206813,0.0507,0.045804,104,0.001194,0,31,0.497025,0.340521
37065,Edgecombe County,,NC,4870,65724,70594,7,10,17,3162,3793,6955,6,0.310455,0.327003,526.235986,0.001536,0.002859,104,0.000156,0,31,0.611111,0.011032
37067,Forsyth County,,NC,21002,334079,355081,79,68,147,14370,14609,28979,6,0.37783,0.408752,20827.36241,0.035653,0.03076,104,0.001057,0,31,0.41842,0.249389
37069,Franklin County,,NC,4646,61810,66456,10,10,20,4199,3042,7241,6,0.306912,0.322532,40.604131,0.001297,0.002234,104,0.000211,0,31,0.545455,0.010383
37071,Gaston County,,NC,12799,218353,231152,25,28,53,7787,8954,16741,6,0.316685,0.336857,419.952452,0.006253,0.007048,104,0.00044,0,31,0.517137,0.049519
37073,Gates County,,NC,643,10442,11085,4,3,7,276,201,477,7,0.235542,0.243223,2676.04363,0.000336,0.000076,47,0.000123,0,31,0.5,0.003062
37075,Graham County,,NC,398,8290,8688,1,2,3,48,82,130,8,0.190927,0.195303,6.973485,0.000001,0.000017,104,0.000119,0,31,0,0.000206
37077,Granville County,,NC,3432,52015,55447,8,9,17,2580,2144,4724,7,0.30137,0.316406,92.924961,0.001305,0.001951,104,0.000183,0,31,0.518182,0.010381
37079,Greene County,,NC,1862,25444,27306,6,5,11,1659,1304,2963,7,0.259796,0.269721,0.852531,0.00037,0.000193,104,0.000136,0,31,0.766667,0.00311
37081,Guilford County,,NC,30153,466211,496364,134,113,247,21389,22329,43718,6,0.400441,0.436421,65182.82879,0.054404,0.049173,104,0.00177,0,31,0.332351,0.374067
37083,Halifax County,,NC,2911,59503,62414,8,9,17,1328,1473,2801,7,0.301495,0.316607,6804.968439,0.000897,0.001799,104,0.000189,0,31,0.455556,0.007097
37085,Harnett County,,NC,10005,115624,125629,21,17,38,7768,5962,13730,6,0.311956,0.329247,176.759795,0.00563,0.004017,104,0.000343,0,31,0.503623,0.043481
37087,Haywood County,,NC,2901,59713,62614,9,5,14,1157,981,2138,7,0.269213,0.280114,915.763819,0.004454,0.000337,104,0.000274,0,31,0.566667,0.034044
37089,Henderson County,,NC,5526,90714,96240,21,15,36,3147,2533,5680,6,0.314797,0.333345,1931.479214,0.008687,0.005465,104,0.000424,0,31,0.488142,0.067768
37091,Hertford County,,NC,1473,22257,23730,3,5,8,528,636,1164,7,0.300995,0.315344,680.851238,0.000008,0.000872,104,0.000135,0,31,0.3,0.000317
37093,Hoke County,,NC,4636,37662,42298,10,9,19,3432,2463,5895,6,0.323205,0.339107,114.036561,0.002089,0.00315,104,0.000165,0,31,0.527473,0.015003
37095,Hyde County,,NC,412,5026,5438,0,3,3,0,170,170,7,0.2538,0.262726,0,0,0.000064,104,0.000051,0,164,0.333333,0
37097,Iredell County,,NC,8822,148773,157595,29,23,52,5867,5063,10930,6,0.30851,0.326596,2027.085148,0.009326,0.004162,104,0.000465,0,31,0.451613,0.067807
37099,Jackson County,,NC,2325,30146,32471,7,8,15,979,874,1853,6,0.307009,0.322532,5456.504031,0.00109,0.002058,104,0.000331,0,31,0.5,0.009334
37101,Johnston County,,NC,9483,145390,154873,22,17,39,8376,5877,14253,6,0.314422,0.331876,548.364176,0.004218,0.004219,104,0.000384,0,31,0.480237,0.032158
37103,Jones County,,NC,1020,13022,14042,4,4,8,532,587,1119,7,0.296387,0.309903,0.69575,0.000814,0.000677,104,0.000093,0,31,0.833333,0.004898
37105,Lee County,,NC,3820,41412,45232,7,7,14,1764,2524,4288,7,0.308051,0.323551,0,0.002561,0.002431,104,0.000147,0,31,1,0.019866
37107,Lenoir County,,NC,3319,59545,62864,9,13,22,1651,2113,3764,7,0.311221,0.327959,340.934842,0.002079,0.003341,104,0.000178,0,31,0.692308,0.014704
37109,Lincoln County,,NC,2958,38764,41722,6,6,12,2218,2096,4314,6,0.30162,0.316047,0.587302,0.001,0.001042,104,0.000134,0,31,0.857143,0.008714
37111,McDowell County,,NC,2033,42111,44144,6,6,12,947,1017,1964,7,0.270366,0.281793,300.60151,0.000348,0.000316,104,0.000172,0,31,0.52381,0.003514
37113,Macon County,,NC,1872,32498,34370,8,4,12,588,351,939,7,0.269888,0.281182,3804.088655,0.003672,0.000492,104,0.000263,0,31,0.458333,0.027752
37115,Madison County,,NC,1297,19800,21097,2,1,3,680,663,1343,7,0.269113,0.279426,0,0.000207,0.000252,104,0.000118,0,31,1,0.002322
37117,Martin County,,NC,1313,26315,27628,5,6,11,581,773,1354,7,0.301026,0.315516,410.843784,0.000099,0.000889,104,0.000152,0,31,0.5,0.001059
37119,Mecklenburg County,,NC,58533,783944,842477,289,226,515,55899,48812,104711,5,0.430924,0.476326,219839.222361,0.10314,0.08944,104,0.003687,0,31,0.213802,0.707716
37121,Mitchell County,,NC,863,16539,17402,3,5,8,317,422,739,7,0.269388,0.280516,4.818347,0.000007,0.000289,104,0.000156,0,31,0.6,0.00043
37123,Montgomery County,,NC,1692,30416,32108,7,6,13,1034,937,1971,6,0.301934,0.316506,5.821669,0.001277,0.001395,104,0.000152,0,31,0.690476,0.010495
37125,Moore County,,NC,4636,82093,86729,17,16,33,2370,2112,4482,6,0.311789,0.328874,186.605901,0.004926,0.003947,104,0.000283,0,31,0.546784,0.037445
37127,Nash County,,NC,7583,101297,108880,16,16,32,5388,5122,10510,6,0.312695,0.329821,138.87559,0.003992,0.004069,104,0.00027,0,31,0.55848,0.029881
37129,New Hanover County,,NC,14029,170292,184321,65,54,119,9291,8375,17666,6,0.355708,0.383075,4668.95093,0.026421,0.022213,104,0.00088,0,31,0.41318,0.183222
37131,Northampton County,,NC,1391,21894,23285,2,5,7,550,752,1302,7,0.300901,0.315201,44.127208,0.000022,0.000853,104,0.000091,0,31,0.45,0.000254
37133,Onslow County,,NC,34214,147212,181426,114,171,285,12777,18427,31204,6,0.420443,0.461662,23926.645783,0.057652,0.076133,178,0.001327,0,31,0.362983,0.39604
37135,Orange County,,NC,12999,91516,104515,35,28,63,6512,8683,15195,6,0.357591,0.381732,1647.963564,0.020774,0.015209,104,0.000419,0,31,0.650987,0.139186
37137,Pamlico County,,NC,830,12841,13671,2,2,4,256,302,558,7,0.263234,0.272849,0,0.00014,0.000172,104,0.000085,0,31,1,0.001352
37139,Pasquotank County,,NC,2763,34156,36919,12,9,21,1377,1113,2490,6,0.305684,0.321551,7595.55152,0.002115,0.001934,47,0.000373,0,31,0.423077,0.016898
37141,Pender County,,NC,3048,38276,41324,6,8,14,2171,1825,3996,7,0.309892,0.325698,3.125232,0.001627,0.002255,104,0.000142,0,31,0.839286,0.011523
37143,Perquimans County,,NC,888,11343,12231,4,3,7,414,458,872,7,0.234269,0.241478,200.546052,0.000245,0.000028,47,0.000189,0,31,0.583333,0.002427
37145,Person County,,NC,1841,37428,39269,7,8,15,1281,1091,2372,7,0.301464,0.316406,1833.529277,0.001321,0.001901,104,0.000161,0,31,0.642857,0.010339
37147,Pitt County,,NC,9211,129148,138359,34,30,64,5512,5176,10688,6,0.339768,0.361938,15196.328182,0.006788,0.007965,104,0.000584,0,31,0.301974,0.048528
37149,Polk County,,NC,1380,21611,22991,5,5,10,704,688,1392,7,0.282738,0.294981,0,0.000643,0.000806,104,0.000146,0,31,1,0.006328
37151,Randolph County,,NC,7122,124788,131910,13,15,28,4905,4734,9639,6,0.307334,0.323795,148.161777,0.003648,0.003119,104,0.000233,0,31,0.573529,0.028197
37153,Richmond County,,NC,2458,49246,51704,9,12,21,899,1191,2090,6,0.307334,0.32345,567.564644,0.001877,0.002657,104,0.000184,0,31,0.483516,0.014999
37155,Robeson County,,NC,4570,113993,118563,11,18,29,2131,2743,4874,6,0.312258,0.329878,231.37264,0.003011,0.00378,104,0.000203,0,31,0.522876,0.023063
37157,Rockingham County,,NC,4260,92280,96540,9,11,20,2378,2662,5040,6,0.302563,0.318073,1155.276508,0.000974,0.001702,104,0.000193,0,31,0.5,0.008848
37159,Rowan County,,NC,7270,122236,129506,14,14,28,4097,4520,8617,6,0.307464,0.32391,32.350455,0.003112,0.003384,104,0.000251,0,31,0.7125,0.025158
37161,Rutherford County,,NC,2763,65053,67816,11,11,22,1571,1419,2990,6,0.302217,0.317711,160.098662,0.001543,0.001747,104,0.000249,0,31,0.613636,0.013681
37163,Sampson County,,NC,2568,51385,53953,11,9,20,1672,1525,3197,7,0.308378,0.323867,19.29409,0.002516,0.001831,104,0.0002,0,31,0.736364,0.019583
37165,Scotland County,,NC,2291,38137,40428,7,11,18,1162,1361,2523,6,0.311621,0.328013,418.819791,0.001464,0.00294,104,0.00014,0,31,0.609091,0.011001
37167,Stanly County,,NC,2993,59770,62763,7,7,14,1697,1561,3258,6,0.301589,0.316104,5.188165,0.000956,0.001136,104,0.000164,0,31,0.619048,0.008574
37169,Stokes County,,NC,3493,56191,59684,7,8,15,2641,2469,5110,7,0.286985,0.300221,3285.790121,0.000738,0.000786,104,0.000178,0,31,0.535714,0.006137
37171,Surry County,,NC,3569,67333,70902,9,9,18,2064,2208,4272,6,0.3025,0.317671,4776.202694,0.000769,0.001642,104,0.000229,0,31,0.544444,0.00693
37173,Swain County,,NC,1004,16856,17860,4,2,6,351,409,760,7,0.234951,0.241796,2499.459444,0.000225,0.000046,104,0.000204,0,31,0.5,0.002584
37175,Transylvania County,,NC,1886,31391,33277,3,3,6,503,629,1132,7,0.269163,0.27977,0,0.000267,0.000333,104,0.00013,0,31,1,0.00277
37177,Tyrrell County,,NC,240,4206,4446,2,0,2,108,0,108,0,0,0,0,0.000001,0,104,0.000081,0,7,0,0.000181
37179,Union County,,NC,8130,142823,150953,24,18,42,8281,4791,13072,6,0.316133,0.335118,541.714857,0.010027,0.005043,104,0.000367,0,31,0.562678,0.071686
37181,Vance County,,NC,3250,46796,50046,6,6,12,1520,2069,3589,7,0.301214,0.315775,8.830154,0.001567,0.001708,104,0.00014,0,31,0.766667,0.012011
37183,Wake County,,NC,50410,704778,755188,262,218,480,48960,40873,89833,6,0.429649,0.474575,176463.810359,0.098356,0.089417,104,0.003282,0,31,0.237633,0.663035
37185,Warren County,,NC,993,13881,14874,4,6,10,479,624,1103,7,0.300839,0.315172,2.059524,0.000786,0.001272,104,0.000119,0,31,0.833333,0.006068
37187,Washington County,,NC,753,14155,14908,2,5,7,160,315,475,7,0.253846,0.263103,2949.006973,0.000016,0.000065,104,0.000094,0,31,0.35,0.000265
37189,Watauga County,,NC,3509,35336,38845,13,12,25,1245,1572,2817,6,0.307627,0.323967,7535.180952,0.003234,0.002947,104,0.000287,0,31,0.49359,0.025645
37191,Wayne County,,NC,8969,107148,116117,23,26,49,3595,4155,7750,6,0.346168,0.368124,3063.823873,0.007908,0.009227,104,0.000353,0,31,0.481609,0.058405
37193,Wilkes County,,NC,2886,72394,75280,12,13,25,1438,1639,3077,6,0.307367,0.323582,8395.849007,0.001561,0.002141,104,0.000289,0,31,0.505495,0.013324
37195,Wilson County,,NC,4296,72478,76774,11,13,24,2316,2675,4991,6,0.313607,0.330785,369.781467,0.002379,0.004181,104,0.000207,0,31,0.733333,0.017903
37197,Yadkin County,,NC,2267,41233,43500,7,8,15,1454,1585,3039,7,0.286815,0.299992,7.800376,0.000383,0.000882,104,0.000172,0,31,0.75,0.003797
37199,Yancey County,,NC,839,18414,19253,3,2,5,336,289,625,7,0.269188,0.279713,243.385266,0.00021,0.000252,104,0.000122,0,31,0.833333,0.002185
38001,Adams County,,ND,160,2752,2912,0,0,0,0,0,0,0,0,0,0,0,0,105,0.000051,95,165,0,0
38003,Barnes County,,ND,730,13090,13820,2,2,4,173,311,484,7,0.260052,0.269391,0,0.000056,0.000039,50,0.000119,0,31,1,0.000566
38005,Benson County,,ND,417,7657,8074,1,2,3,110,186,296,7,0.260052,0.269391,0,0.000001,0.000039,50,0.000076,0,31,1,0.000096
38007,Billings County,,ND,95,1000,1095,0,0,0,0,0,0,0,0,0,0,0,0,106,0.000051,96,166,0,0
38009,Bottineau County,,ND,477,8218,8695,1,1,2,64,109,173,7,0.255409,0.263882,0,0.000051,0.000037,50,0.000078,0,31,0,0.00038
38011,Bowman County,,ND,238,3992,4230,0,0,0,0,0,0,0,0,0,0,0,0,107,0.000051,97,167,0,0
38013,Burke County,,ND,175,2928,3103,0,0,0,0,0,0,0,0,0,0,0,0,108,0.000051,98,168,0,0
38015,Burleigh County,,ND,5000,84137,89137,17,15,32,3064,2675,5739,6,0.335025,0.355108,26906.099458,0.001114,0.002248,50,0.000695,0,31,0.169048,0.008789
38017,Cass County,,ND,10373,145454,155827,46,36,82,7284,6257,13541,6,0.351319,0.375826,94199.199608,0.004676,0.006747,50,0.001606,0,31,0.137632,0.03652
38019,Cavalier County,,ND,278,6009,6287,0,1,1,0,55,55,7,0.255654,0.264494,0,0,0.000032,50,0.000051,0,169,0,0
38021,Dickey County,,ND,439,6415,6854,0,1,1,0,47,47,7,0.260048,0.269241,0,0,0.000039,50,0.000051,0,170,0,0
38023,Divide County,,ND,88,2645,2733,0,0,0,0,0,0,0,0,0,0,0,0,109,0.000051,99,171,0,0
38025,Dunn County,,ND,186,3951,4137,0,0,0,0,0,0,0,0,0,0,0,0,110,0.000051,100,172,0,0
38027,Eddy County,,ND,174,2879,3053,0,1,1,0,40,40,7,0.260048,0.269241,0,0,0.000039,50,0.000051,0,173,0,0
38029,Emmons County,,ND,243,4644,4887,0,1,1,0,87,87,7,0.251015,0.259039,0,0,0.000009,50,0.000051,0,174,0,0
38031,Foster County,,ND,255,4204,4459,0,0,0,0,0,0,0,0,0,0,0,0,111,0.000051,101,175,0,0
38033,Golden Valley County,,ND,122,2116,2238,0,0,0,0,0,0,0,0,0,0,0,0,112,0.000051,102,176,0,0
38035,Grand Forks County,,ND,7095,69103,76198,23,27,50,2299,2935,5234,6,0.343344,0.366288,38863.50459,0.003858,0.006115,50,0.000705,0,31,0.222538,0.029026
38037,Grant County,,ND,153,3306,3459,0,0,0,0,0,0,0,0,0,0,0,0,113,0.000051,103,177,0,0
38039,Griggs County,,ND,182,3177,3359,0,0,0,0,0,0,0,0,0,0,0,0,114,0.000051,104,178,0,0
38041,Hettinger County,,ND,120,3321,3441,0,1,1,0,42,42,8,0.208843,0.213837,0,0,0.000001,50,0.000051,0,179,0,0
38043,Kidder County,,ND,147,3110,3257,1,0,1,49,0,49,0,0,0,0,0.000019,0,50,0.00009,0,3,0,0.00019
38045,LaMoure County,,ND,243,5470,5713,1,1,2,44,44,88,7,0.260029,0.269219,0,0.000001,0.000039,50,0.000081,0,31,1,0.0001
38047,Logan County,,ND,158,2509,2667,0,0,0,0,0,0,0,0,0,0,0,0,115,0.000051,105,180,0,0
38049,McHenry County,,ND,398,6761,7159,1,1,2,151,145,296,7,0.255409,0.263882,0,0.000051,0.000037,50,0.000078,0,31,0,0.00038
38051,McIntosh County,,ND,158,3937,4095,0,1,1,0,43,43,7,0.251015,0.259039,0,0,0.000009,50,0.000051,0,181,0,0
38053,McKenzie County,,ND,333,5322,5655,0,1,1,0,49,49,8,0.209415,0.2146,0,0,0,50,0.000051,0,182,0,0
38055,McLean County,,ND,641,11025,11666,2,2,4,216,278,494,7,0.256582,0.265529,0,0.00007,0.000046,50,0.000118,0,31,1,0.000571
38057,Mercer County,,ND,535,10928,11463,1,2,3,102,166,268,7,0.250994,0.259128,0,0.000019,0.000011,50,0.00009,0,31,1,0.00019
38059,Morton County,,ND,2250,29385,31635,5,3,8,1282,1345,2627,7,0.260168,0.269793,35.237869,0.000176,0.000049,50,0.000216,0,31,0.666667,0.001486
38061,Mountrail County,,ND,517,7911,8428,1,2,3,81,159,240,7,0.256582,0.265529,0,0.000051,0.000046,50,0.000078,0,31,1,0.00038
38063,Nelson County,,ND,259,4052,4311,1,1,2,48,48,96,7,0.255611,0.264413,0,0.00005,0.000032,50,0.000073,0,31,0,0.000358
38065,Oliver County,,ND,123,2384,2507,0,0,0,0,0,0,0,0,0,0,0,0,116,0.000051,106,183,0,0
38067,Pembina County,,ND,591,10284,10875,2,3,5,110,205,315,7,0.263736,0.273767,0,0.000051,0.000071,50,0.000113,0,31,1,0.000459
38069,Pierce County,,ND,321,5362,5683,0,1,1,0,40,40,7,0.255452,0.263963,0,0,0.000037,50,0.000051,0,184,0,0
38071,Ramsey County,,ND,891,13704,14595,2,4,6,208,357,565,7,0.26388,0.274226,2955.643308,0.000056,0.00008,50,0.000121,0,31,0.583333,0.000556
38073,Ransom County,,ND,352,6543,6895,2,1,3,121,134,255,7,0.260005,0.269162,0,0.000056,0.000039,50,0.000114,0,31,1,0.00056
38075,Renville County,,ND,231,3138,3369,1,1,2,107,81,188,7,0.255409,0.263882,0,0.000051,0.000037,50,0.000078,0,31,0,0.00038
38077,Richland County,,ND,1327,19820,21147,4,3,7,437,551,988,7,0.260122,0.269678,1.97619,0.000068,0.000052,50,0.000192,0,31,0.666667,0.000871
38079,Rolette County,,ND,740,14291,15031,3,4,7,152,343,495,7,0.26477,0.275391,0,0.000158,0.000116,50,0.000138,0,31,1,0.001204
38081,Sargent County,,ND,312,5319,5631,1,3,4,50,162,212,7,0.260052,0.269506,0,0.000056,0.00004,50,0.000089,0,31,0.666667,0.000466
38083,Sheridan County,,ND,111,1920,2031,0,0,0,0,0,0,0,0,0,0,0,0,117,0.000051,107,185,0,0
38085,Sioux County,,ND,300,3461,3761,1,1,2,72,79,151,7,0.250972,0.258956,0,0.000019,0.000009,50,0.00009,0,31,0,0.00019
38087,Slope County,,ND,44,646,690,0,0,0,0,0,0,0,0,0,0,0,0,118,0.000051,108,186,0,0
38089,Stark County,,ND,1430,26280,27710,6,4,10,335,398,733,7,0.26388,0.274151,2976.395635,0.000126,0.000085,50,0.000291,0,31,0.547619,0.001313
38091,Steele County,,ND,162,2926,3088,0,1,1,0,41,41,7,0.260048,0.269241,0,0,0.000039,50,0.000051,0,187,0,0
38093,Stutsman County,,ND,1332,24373,25705,3,5,8,239,515,754,7,0.263904,0.274398,2958.643308,0.000075,0.00008,50,0.000178,0,31,0.45,0.000753
38095,Towner County,,ND,171,3421,3592,0,0,0,0,0,0,0,0,0,0,0,0,119,0.000051,109,188,0,0
38097,Traill County,,ND,653,9114,9767,2,2,4,192,284,476,7,0.263712,0.273595,0,0.000106,0.00007,50,0.000111,0,31,1,0.000824
38099,Walsh County,,ND,782,14203,14985,3,3,6,234,342,576,7,0.263736,0.273767,31.323321,0.000107,0.000071,50,0.000143,0,31,0.833333,0.000919
38101,Ward County,,ND,6408,66675,73083,22,22,44,1872,2087,3959,6,0.342979,0.364882,39885.174993,0.004455,0.006238,50,0.000713,0,31,0.287356,0.032722
38103,Wells County,,ND,279,5800,6079,0,0,0,0,0,0,0,0,0,0,0,0,120,0.000051,110,189,0,0
38105,Williams County,,ND,1191,23328,24519,4,5,9,188,334,522,7,0.264794,0.275563,2969.368085,0.000053,0.000117,50,0.000216,0,31,0.428571,0.000676
39001,Adams County,,OH,1827,36634,38461,9,7,16,1480,1168,2648,6,0.297024,0.310675,30.810469,0.001212,0.000996,121,0.000189,0,31,0.622222,0.008285
39003,Allen County,,OH,5571,132140,137711,14,18,32,2609,3113,5722,6,0.310588,0.328524,746.051867,0.002446,0.003255,121,0.000236,0,31,0.461988,0.01559
39005,Ashland County,,OH,3481,65243,68724,10,11,21,2536,2111,4647,6,0.305781,0.321711,110.523539,0.002135,0.001999,121,0.000169,0,31,0.628788,0.013333
39007,Ashtabula County,,OH,5192,122784,127976,13,11,24,3449,2553,6002,6,0.307855,0.324753,57.808006,0.003462,0.002688,121,0.000177,0,31,0.74359,0.020549
39009,Athens County,,OH,4225,57940,62165,16,11,27,1988,1706,3694,6,0.305749,0.321752,1189.491308,0.002594,0.001697,121,0.000408,0,31,0.352941,0.017672
39011,Auglaize County,,OH,3024,57451,60475,9,12,21,1858,1977,3835,6,0.307921,0.324403,126.141671,0.00127,0.001891,121,0.000186,0,31,0.583333,0.009176
39013,Belmont County,,OH,3233,84091,87324,8,8,16,1631,1669,3300,6,0.303734,0.319077,1540.407382,0.000975,0.000857,121,0.00023,0,31,0.305556,0.007097
39015,Brown County,,OH,3456,51089,54545,8,8,16,2932,2550,5482,6,0.296963,0.310732,2906.990055,0.001055,0.001158,121,0.000186,0,31,0.694444,0.007178
39017,Butler County,,OH,24755,389369,414124,48,60,108,19266,17852,37118,6,0.375679,0.405062,15673.304412,0.021731,0.0264,121,0.000677,0,31,0.435611,0.152996
39019,Carroll County,,OH,2368,39205,41573,6,7,13,1846,1617,3463,6,0.303893,0.319043,530.804683,0.000552,0.0012,121,0.000153,0,31,0.714286,0.00368
39021,Champaign County,,OH,3660,55768,59428,10,11,21,2821,2614,5435,6,0.307953,0.323892,27.204669,0.001588,0.002051,121,0.000209,0,31,0.636364,0.011751
39023,Clark County,,OH,8113,162466,170579,12,15,27,4423,4961,9384,6,0.311789,0.329695,90.075185,0.003015,0.003606,121,0.000216,0,31,0.619048,0.020093
39025,Clermont County,,OH,16052,243407,259459,24,29,53,13130,11365,24495,6,0.35724,0.381428,2206.490059,0.011074,0.013187,121,0.000379,0,31,0.613191,0.075724
39027,Clinton County,,OH,3609,54852,58461,11,11,22,2823,2432,5255,6,0.308248,0.324294,55.382795,0.002403,0.002239,121,0.000197,0,31,0.712121,0.016327
39029,Columbiana County,,OH,5210,129521,134731,13,12,25,3175,3066,6241,6,0.307921,0.324983,124.656397,0.003217,0.002689,121,0.000196,0,31,0.647436,0.019718
39031,Coshocton County,,OH,2222,50149,52371,10,9,19,1564,1392,2956,6,0.303639,0.319048,73.738582,0.001354,0.000975,121,0.000203,0,31,0.611111,0.009339
39033,Crawford County,,OH,3212,61283,64495,8,9,17,1759,2107,3866,6,0.303543,0.318876,8.972619,0.001006,0.001043,121,0.000193,0,31,0.541667,0.007726
39035,Cuyahoga County,,OH,65097,1555455,1620552,164,187,351,36257,54760,91017,5,0.421786,0.464193,47020.838515,0.078563,0.086645,121,0.001818,0,31,0.354167,0.525373
39037,Darke County,,OH,2802,68352,71154,9,10,19,1701,1618,3319,6,0.308215,0.324208,204.433574,0.000659,0.001832,121,0.000188,0,31,0.518182,0.005244
39039,Defiance County,,OH,2796,52132,54928,8,10,18,1374,1577,2951,6,0.305042,0.321292,262.9683,0.000552,0.001177,121,0.000174,0,31,0.511111,0.003473
39041,Delaware County,,OH,15737,193421,209158,61,42,103,20741,11070,31811,6,0.364229,0.390484,8873.612068,0.024957,0.020471,121,0.00083,0,31,0.420172,0.172852
39043,Erie County,,OH,5104,99218,104322,10,11,21,2903,3044,5947,6,0.312998,0.330997,120.272049,0.003477,0.003381,121,0.000151,0,31,0.666667,0.021378
39045,Fairfield County,,OH,11679,174888,186567,23,16,39,12116,8096,20212,6,0.334524,0.354373,1503.852478,0.006111,0.004004,121,0.000433,0,31,0.345,0.040669
39047,Fayette County,,OH,2013,33358,35371,9,10,19,1283,1241,2524,6,0.3062,0.321757,40.912714,0.001876,0.001426,121,0.000193,0,31,0.509091,0.01286
39049,Franklin County,,OH,79521,1210852,1290373,256,256,512,58985,68610,127595,5,0.435187,0.483247,356114.677771,0.090103,0.092223,121,0.003359,0,31,0.205127,0.603919
39051,Fulton County,,OH,3003,54152,57155,7,7,14,1990,1963,3953,7,0.279607,0.29179,7.487744,0.000445,0.000301,121,0.000137,0,31,0.589286,0.002817
39053,Gallia County,,OH,1844,36019,37863,6,7,13,914,922,1836,6,0.303607,0.318761,195.88112,0.000809,0.0008,121,0.000203,0,31,0.5,0.005857
39055,Geauga County,,OH,5809,112439,118248,9,9,18,5079,3666,8745,6,0.341607,0.361473,42.707826,0.002345,0.003973,121,0.00013,0,31,0.845455,0.013805
39057,Greene County,,OH,15735,170802,186537,39,41,80,10393,10678,21071,6,0.370125,0.396912,5373.651068,0.018468,0.019143,121,0.000526,0,31,0.49102,0.130674
39059,Guernsey County,,OH,2159,50703,52862,10,10,20,1179,1148,2327,6,0.305684,0.321522,2964.729578,0.002016,0.001598,121,0.000235,0,31,0.44697,0.013229
39061,Hamilton County,,OH,54434,935691,990125,123,143,266,28882,45135,74017,5,0.415689,0.453421,59478.851766,0.057423,0.070933,121,0.001557,0,31,0.381929,0.390379
39063,Hancock County,,OH,4984,88391,93375,11,16,27,2498,2766,5264,6,0.310489,0.328042,597.025344,0.001914,0.003854,121,0.000205,0,31,0.433333,0.01236
39065,Hardin County,,OH,2185,35282,37467,8,8,16,1226,1232,2458,6,0.303639,0.318905,11.975395,0.000878,0.000826,121,0.000178,0,31,0.535714,0.006371
39067,Harrison County,,OH,1032,17767,18799,6,4,10,702,556,1258,7,0.235733,0.243713,3.674688,0.000546,0.000049,121,0.000151,0,31,0.633333,0.003578
39069,Henry County,,OH,1836,36499,38335,7,7,14,1165,1144,2309,7,0.279338,0.291504,37.677448,0.000419,0.000272,121,0.000143,0,31,0.666667,0.002542
39071,Highland County,,OH,2733,40132,42865,13,12,25,2145,1988,4133,6,0.308051,0.324151,105.320547,0.002402,0.002076,121,0.00025,0,31,0.615385,0.016563
39073,Hocking County,,OH,2049,32069,34118,8,7,15,1596,1548,3144,6,0.303448,0.318475,492.392256,0.000864,0.000847,121,0.000237,0,31,0.642857,0.006705
39075,Holmes County,,OH,1833,42360,44193,6,7,13,1057,1182,2239,6,0.303543,0.318647,2.80202,0.000218,0.000952,121,0.000146,0,31,0.738095,0.002029
39077,Huron County,,OH,4240,80366,84606,12,13,25,2691,2702,5393,6,0.306265,0.322676,21.976552,0.00214,0.00211,121,0.000198,0,31,0.604396,0.013395
39079,Jackson County,,OH,1964,37617,39581,7,7,14,1085,1053,2138,6,0.30348,0.318532,489.441119,0.000805,0.000803,121,0.000207,0,31,0.5,0.006014
39081,Jefferson County,,OH,3153,77659,80812,11,11,22,1509,1598,3107,6,0.307921,0.324868,1436.245409,0.002322,0.002565,121,0.000245,0,31,0.467949,0.015683
39083,Knox County,,OH,3628,67104,70732,10,9,19,2522,1987,4509,6,0.303543,0.318876,115.379027,0.001758,0.001081,121,0.000204,0,31,0.507576,0.012358
39085,Lake County,,OH,12703,281458,294161,19,27,46,8493,8918,17411,6,0.359673,0.383844,310.935702,0.008496,0.013885,121,0.000236,0,31,0.703202,0.057217
39087,Lawrence County,,OH,2924,66640,69564,7,9,16,1887,1680,3567,6,0.304562,0.320219,1017.44053,0.000821,0.000821,121,0.000218,0,31,0.430556,0.00599
39089,Licking County,,OH,9074,167550,176624,15,16,31,7323,5844,13167,6,0.312023,0.329649,139.561506,0.003224,0.003453,121,0.000297,0,31,0.411905,0.021453
39091,Logan County,,OH,3113,52218,55331,11,12,23,2005,1974,3979,6,0.3131,0.330349,94.21662,0.001469,0.002306,121,0.000219,0,31,0.545455,0.011
39093,Lorain County,,OH,13402,340789,354191,26,42,68,11366,8741,20107,6,0.368061,0.395059,1619.729554,0.011529,0.020185,121,0.000315,0,31,0.535437,0.076685
39095,Lucas County,,OH,23855,513824,537679,61,78,139,13734,16812,30546,6,0.386839,0.418928,21989.341713,0.023562,0.036154,121,0.000732,0,31,0.414461,0.160885
39097,Madison County,,OH,3270,40094,43364,8,7,15,2563,2185,4748,6,0.303448,0.318475,6.803968,0.001037,0.001019,121,0.00019,0,31,0.571429,0.008027
39099,Mahoning County,,OH,11323,288131,299454,18,30,48,6461,7507,13968,6,0.356057,0.380062,1124.934357,0.005958,0.014124,121,0.000239,0,31,0.592473,0.03882
39101,Marion County,,OH,3341,73167,76508,9,8,17,1903,1855,3758,6,0.30348,0.318647,9.45,0.001004,0.001013,121,0.000216,0,31,0.569444,0.007852
39103,Medina County,,OH,10925,194543,205468,16,21,37,10201,7279,17480,6,0.351787,0.374948,342.23249,0.005348,0.009125,121,0.00021,0,31,0.638462,0.033079
39105,Meigs County,,OH,1036,22549,23585,5,5,10,527,540,1067,6,0.303512,0.31836,450.040618,0.000783,0.000786,121,0.000195,0,31,0.466667,0.00575
39107,Mercer County,,OH,2126,50308,52434,8,10,18,987,1278,2265,6,0.307562,0.32364,930.031476,0.001256,0.001678,121,0.000167,0,31,0.577778,0.008908
39109,Miami County,,OH,6840,122476,129316,16,13,29,4787,4214,9001,6,0.308378,0.324753,72.708534,0.002684,0.00218,121,0.000261,0,31,0.554167,0.017889
39111,Monroe County,,OH,868,16803,17671,6,5,11,462,445,907,6,0.303639,0.318561,9039.846998,0.001116,0.000759,121,0.000212,0,31,0.266667,0.007451
39113,Montgomery County,,OH,34782,635864,670646,106,101,207,22032,25579,47611,6,0.401216,0.435841,32193.026763,0.04703,0.049176,121,0.001356,0,31,0.395528,0.330662
39115,Morgan County,,OH,1152,20823,21975,6,6,12,707,758,1465,6,0.30348,0.318417,2.889123,0.000812,0.000813,121,0.000183,0,31,0.714286,0.006016
39117,Morrow County,,OH,2533,32433,34966,7,6,13,2218,1785,4003,6,0.303448,0.31836,1.554762,0.001011,0.001005,121,0.000169,0,31,0.761905,0.007678
39119,Muskingum County,,OH,3961,95975,99936,8,11,19,2284,2569,4853,6,0.303734,0.31945,14.191032,0.000865,0.001114,121,0.000219,0,31,0.527273,0.006654
39121,Noble County,,OH,467,9735,10202,3,3,6,334,257,591,7,0.234477,0.241882,1.866667,0.000027,0.000033,121,0.000135,0,31,0.5,0.000517
39123,Ottawa County,,OH,2805,50550,53355,9,8,17,1978,1680,3658,6,0.305877,0.321511,7.099266,0.002337,0.001702,121,0.000149,0,31,0.777778,0.014889
39125,Paulding County,,OH,1340,22736,24076,5,5,10,652,755,1407,7,0.275156,0.286835,44.626107,0.000258,0.000186,121,0.000125,0,31,0.6,0.00182
39127,Perry County,,OH,1766,30635,32401,7,7,14,1542,1390,2932,6,0.303448,0.318475,2.706818,0.00086,0.000863,121,0.000204,0,31,0.761905,0.006525
39129,Pickaway County,,OH,4053,53347,57400,8,8,16,3098,2890,5988,6,0.303512,0.318704,8.752016,0.000869,0.000869,121,0.000213,0,31,0.553571,0.006674
39131,Pike County,,OH,2365,42164,44529,7,7,14,1775,1550,3325,6,0.303543,0.318618,28.847474,0.000823,0.000805,121,0.000191,0,31,0.571429,0.006139
39133,Portage County,,OH,11380,171287,182667,15,19,34,8573,7962,16535,6,0.347368,0.370024,268.181961,0.004997,0.007131,121,0.000195,0,31,0.678571,0.031206
39135,Preble County,,OH,2609,47457,50066,6,7,13,1734,1669,3403,6,0.306039,0.321534,3.610954,0.000914,0.001516,121,0.000131,0,31,0.785714,0.006832
39137,Putnam County,,OH,1629,45004,46633,7,9,16,910,1033,1943,6,0.304084,0.319726,100.771966,0.000139,0.001035,121,0.000154,0,31,0.527778,0.001331
39139,Richland County,,OH,6605,139614,146219,15,16,31,3399,3978,7377,6,0.309331,0.326412,75.197688,0.002958,0.003183,121,0.00026,0,31,0.54902,0.018978
39141,Ross County,,OH,3662,71016,74678,12,12,24,2338,2286,4624,6,0.305588,0.321476,935.468999,0.001286,0.001465,121,0.000301,0,31,0.410256,0.009887
39143,Sandusky County,,OH,3567,72107,75674,8,10,18,2017,2229,4246,6,0.306815,0.323261,4.927495,0.001218,0.0025,121,0.000152,0,31,0.744444,0.008007
39145,Scioto County,,OH,3336,66810,70146,7,9,16,1417,1871,3288,6,0.305523,0.321212,142.536218,0.000804,0.001318,121,0.000209,0,31,0.416667,0.006054
39147,Seneca County,,OH,3299,66965,70264,10,8,18,1687,1951,3638,6,0.303925,0.319324,11.702479,0.001245,0.001045,121,0.000185,0,31,0.644444,0.008309
39149,Shelby County,,OH,2920,56625,59545,9,8,17,1660,1708,3368,6,0.305459,0.320816,24.523492,0.001293,0.001216,121,0.000176,0,31,0.763889,0.009246
39151,Stark County,,OH,16557,452989,469546,37,44,81,10144,10838,20982,6,0.366574,0.393492,9005.014268,0.01554,0.018552,121,0.000505,0,31,0.430588,0.110851
39153,Summit County,,OH,29572,633221,662793,66,87,153,20653,22060,42713,6,0.391375,0.424799,15351.515984,0.031612,0.041167,121,0.000782,0,31,0.418029,0.216108
39155,Trumbull County,,OH,10382,259035,269417,14,23,37,5628,6422,12050,6,0.344443,0.366322,382.899316,0.003266,0.010986,121,0.000195,0,31,0.612319,0.020254
39157,Tuscarawas County,,OH,4131,109661,113792,12,10,22,2583,2525,5108,6,0.305781,0.321597,1029.61503,0.002063,0.00184,121,0.000241,0,31,0.522727,0.013681
39159,Union County,,OH,3000,39883,42883,7,7,14,2460,2005,4465,6,0.303448,0.318475,4.316667,0.00099,0.000999,121,0.000175,0,31,0.666667,0.007484
39161,Van Wert County,,OH,1513,35242,36755,7,8,15,757,847,1604,6,0.304722,0.320615,197.819164,0.00029,0.000964,121,0.000163,0,31,0.446429,0.002237
39163,Vinton County,,OH,679,10786,11465,5,4,9,471,399,870,7,0.235504,0.243139,1.5,0.000801,0.000046,121,0.000169,0,31,0.75,0.005838
39165,Warren County,,OH,14530,189852,204382,41,29,70,16512,10094,26606,6,0.362185,0.38808,3817.338755,0.018727,0.011783,121,0.000575,0,31,0.519027,0.128649
39167,Washington County,,OH,3401,67337,70738,9,10,19,1721,1790,3511,6,0.303797,0.319421,4226.280372,0.000811,0.000863,121,0.000333,0,31,0.345455,0.006303
39169,Wayne County,,OH,6616,135429,142045,12,12,24,4035,3841,7876,6,0.305813,0.321884,112.627368,0.002344,0.002007,121,0.000195,0,31,0.634615,0.014694
39171,Williams County,,OH,2343,46510,48853,9,10,19,1145,1151,2296,6,0.30517,0.321493,235.514543,0.000566,0.001156,121,0.000192,0,31,0.433333,0.003745
39173,Wood County,,OH,10313,132306,142619,21,23,44,7145,6896,14041,6,0.345632,0.368308,4043.185259,0.005815,0.007105,121,0.000296,0,31,0.428775,0.037217
39175,Wyandot County,,OH,1491,26058,27549,6,6,12,963,996,1959,6,0.30348,0.318417,3.859957,0.000826,0.000794,121,0.000152,0,31,0.666667,0.005951
40001,Adair County,,OK,1407,22680,24087,5,6,11,806,872,1678,6,0.293096,0.306038,3.990119,0.000655,0.00074,123,0.000162,0,31,0.766667,0.005801
40003,Alfalfa County,,OK,386,5475,5861,1,2,3,78,174,252,7,0.253802,0.262252,2945,0.000027,0.00004,123,0.00008,0,31,0.5,0.000404
40005,Atoka County,,OK,834,12990,13824,4,3,7,344,247,591,6,0.290255,0.303558,788.417129,0.000485,0.000443,152,0.000155,0,31,0.416667,0.003684
40007,Beaver County,,OK,514,5425,5939,1,1,2,110,89,199,7,0.234667,0.24126,0,0.000009,0.000012,56,0.000085,0,31,0,0.000181
40009,Beckham County,,OK,1592,19095,20687,4,4,8,469,564,1033,6,0.290255,0.303673,6331.212124,0.000458,0.000423,123,0.000201,0,31,0.416667,0.003458
40011,Blaine County,,OK,884,11792,12676,4,7,11,269,437,706,6,0.290429,0.304333,187.024077,0.000537,0.000507,123,0.000123,0,31,0.595238,0.00402
40013,Bryan County,,OK,2534,32390,34924,15,11,26,1587,1346,2933,6,0.320884,0.338912,5085.182396,0.003364,0.003414,152,0.000332,0,31,0.379167,0.024827
40015,Caddo County,,OK,2004,29574,31578,7,8,15,1085,1189,2274,6,0.293008,0.307386,11.903501,0.000896,0.000821,123,0.000159,0,31,0.611111,0.006461
40017,Canadian County,,OK,8170,99079,107249,18,21,39,7039,5685,12724,6,0.342412,0.36502,2335.321645,0.004299,0.006175,123,0.00036,0,31,0.450216,0.031765
40019,Carter County,,OK,2966,46937,49903,16,17,33,1531,1663,3194,6,0.321417,0.340433,5843.468522,0.003375,0.003345,123,0.000371,0,31,0.368421,0.024669
40021,Cherokee County,,OK,2987,37556,40543,13,11,24,1617,1622,3239,6,0.298735,0.313631,59.023473,0.001099,0.0012,123,0.000296,0,31,0.521978,0.009311
40023,Choctaw County,,OK,898,14222,15120,4,5,9,376,381,757,6,0.290603,0.30439,187.657208,0.000075,0.000491,152,0.000138,0,31,0.5,0.000952
40025,Cimarron County,,OK,261,3110,3371,0,0,0,0,0,0,0,0,0,0,0,0,122,0.000051,111,190,0,0
40027,Cleveland County,,OK,20737,220173,240910,53,51,104,17345,15171,32516,6,0.365467,0.393716,13435.338018,0.017334,0.019817,123,0.000893,0,31,0.340825,0.128507
40029,Coal County,,OK,413,5123,5536,2,2,4,116,132,248,7,0.241919,0.249481,0.833333,0.000019,0.000024,152,0.000117,0,31,0,0.000378
40031,Comanche County,,OK,14506,109110,123616,52,60,112,6004,6605,12609,6,0.378076,0.407857,12650.733748,0.021967,0.025676,123,0.000696,0,31,0.455443,0.153439
40033,Cotton County,,OK,421,6144,6565,2,3,5,194,192,386,7,0.281014,0.293412,0,0.000414,0.000376,123,0.000071,0,31,0.833333,0.002698
40035,Craig County,,OK,1175,16082,17257,5,5,10,668,638,1306,6,0.292388,0.304919,1.546491,0.000498,0.00041,123,0.000146,0,31,0.8,0.00349
40037,Creek County,,OK,6492,74240,80732,14,14,28,4579,4691,9270,6,0.298121,0.313114,45.153148,0.001225,0.001055,123,0.000287,0,31,0.528571,0.009139
40039,Custer County,,OK,2184,24575,26759,7,12,19,659,1217,1876,6,0.301026,0.316167,3261.30026,0.000519,0.001224,123,0.000221,0,31,0.397436,0.004141
40041,Delaware County,,OK,2636,33079,35715,14,12,26,1976,1627,3603,6,0.293808,0.307782,148.997751,0.001234,0.00084,123,0.000341,0,31,0.461538,0.010807
40043,Dewey County,,OK,390,5329,5719,2,1,3,93,42,135,7,0.229602,0.235734,1.5,0.000017,0.000004,123,0.000121,0,31,0,0.000258
40045,Ellis County,,OK,313,3991,4304,1,1,2,100,85,185,7,0.229602,0.235734,0,0.000007,0.000004,123,0.000106,0,31,0,0.000124
40047,Garfield County,,OK,4988,62070,67058,23,16,39,1936,1683,3619,6,0.339888,0.360761,18853.970293,0.004803,0.003319,123,0.000552,0,31,0.301538,0.035541
40049,Garvin County,,OK,2187,29987,32174,8,7,15,1123,1054,2177,6,0.290429,0.304362,7.890019,0.000704,0.000629,123,0.000212,0,31,0.678571,0.005587
40051,Grady County,,OK,3841,49953,53794,11,8,19,2976,2365,5341,6,0.292978,0.307329,27.50165,0.001428,0.000818,123,0.00024,0,31,0.590909,0.010029
40053,Grant County,,OK,455,5118,5573,2,2,4,169,214,383,7,0.255791,0.264709,0,0.000049,0.00007,123,0.0001,0,31,1,0.000728
40055,Greer County,,OK,441,4943,5384,1,1,2,109,108,217,7,0.256356,0.264683,0,0.000048,0.000034,123,0.000071,0,31,0,0.000343
40057,Harmon County,,OK,269,2878,3147,0,1,1,0,72,72,7,0.256399,0.264764,0,0,0.000034,123,0.000051,0,191,0,0
40059,Harper County,,OK,301,4430,4731,0,1,1,0,57,57,7,0.229644,0.235825,0,0,0.000004,123,0.000051,0,192,0,0
40061,Haskell County,,OK,596,11983,12579,4,3,7,292,227,519,7,0.258363,0.268187,4.793871,0.000041,0.000076,123,0.000121,0,31,0.55,0.000732
40063,Hughes County,,OK,1016,12007,13023,4,6,10,361,489,850,6,0.290313,0.304017,2.113095,0.000475,0.000486,123,0.000128,0,31,0.666667,0.003681
40065,Jackson County,,OK,3789,28338,32127,15,14,29,1045,1128,2173,6,0.344688,0.365926,10458.854402,0.00411,0.005799,123,0.000336,0,31,0.379085,0.029788
40067,Jefferson County,,OK,464,6077,6541,2,3,5,178,192,370,7,0.271808,0.283745,4.544714,0.00006,0.000222,123,0.000087,0,31,0.5,0.000584
40069,Johnston County,,OK,841,9651,10492,3,5,8,327,404,731,7,0.243563,0.252219,1.6125,0.000067,0.000094,123,0.000119,0,31,0.6,0.000806
40071,Kay County,,OK,3974,51615,55589,14,13,27,1587,2224,3811,6,0.32688,0.346396,3577.196855,0.003657,0.002638,123,0.000311,0,31,0.466667,0.02663
40073,Kingfisher County,,OK,858,15354,16212,5,4,9,531,439,970,6,0.290313,0.303759,0.827381,0.000558,0.000511,123,0.000138,0,31,0.85,0.004261
40075,Kiowa County,,OK,777,9792,10569,5,5,10,330,284,614,6,0.293008,0.307013,765.486453,0.000715,0.000639,123,0.000153,0,31,0.633333,0.005085
40077,Latimer County,,OK,940,11629,12569,4,5,9,392,441,833,6,0.297907,0.311679,384.001226,0.000466,0.000792,123,0.000124,0,31,0.65,0.003565
40079,Le Flore County,,OK,2886,44000,46886,9,11,20,1387,1553,2940,6,0.298735,0.313717,3526.736361,0.000986,0.001073,123,0.000227,0,31,0.371212,0.007073
40081,Lincoln County,,OK,3126,35635,38761,9,9,18,1949,1951,3900,6,0.297938,0.312196,2.67619,0.001228,0.001035,123,0.000194,0,31,0.805556,0.008468
40083,Logan County,,OK,4183,46794,50977,11,13,24,3143,2667,5810,6,0.321274,0.339715,273.555749,0.002484,0.003311,123,0.000235,0,31,0.587912,0.018107
40085,Love County,,OK,669,8555,9224,3,2,5,343,324,667,7,0.243379,0.251358,1.0816,0.000491,0.000052,123,0.000108,0,31,0.666667,0.004074
40087,McClain County,,OK,2242,23277,25519,5,6,11,1753,1568,3321,6,0.290255,0.303903,1,0.000675,0.000636,123,0.000145,0,31,0.8,0.004992
40089,McCurtain County,,OK,1772,32040,33812,5,8,13,288,591,879,6,0.318526,0.335486,6360.122592,0.001344,0.001406,152,0.000159,0,31,0.357143,0.009592
40091,McIntosh County,,OK,1542,18117,19659,8,8,16,824,816,1640,6,0.297938,0.312081,452.152215,0.00111,0.000959,123,0.000181,0,31,0.633333,0.008003
40093,Major County,,OK,630,8213,8843,2,1,3,142,150,292,7,0.253691,0.261908,0,0.000032,0.00004,123,0.000095,0,31,1,0.00053
40095,Marshall County,,OK,1030,12471,13501,7,6,13,560,507,1067,6,0.314524,0.331147,900.694005,0.001628,0.001409,123,0.000168,0,31,0.732143,0.011667
40097,Mayes County,,OK,2789,39856,42645,8,9,17,1785,1595,3380,6,0.298397,0.312913,22.545336,0.000526,0.001074,123,0.000208,0,31,0.7,0.004164
40099,Murray County,,OK,831,11208,12039,6,5,11,514,391,905,6,0.290371,0.304017,132.758247,0.000661,0.000612,123,0.000166,0,31,0.766667,0.005098
40101,Muskogee County,,OK,4366,70342,74708,15,15,30,2616,2538,5154,6,0.318911,0.336949,2353.649847,0.0021,0.001915,123,0.000324,0,31,0.475,0.015411
40103,Noble County,,OK,995,11945,12940,4,5,9,436,568,1004,6,0.2904,0.304046,0.860714,0.00056,0.000526,123,0.000126,0,31,0.85,0.004113
40105,Nowata County,,OK,765,10887,11652,4,4,8,623,393,1016,6,0.292477,0.30489,1.5332,0.000516,0.000433,123,0.000114,0,31,0.833333,0.003522
40107,Okfuskee County,,OK,821,10813,11634,6,6,12,463,442,905,6,0.290313,0.304017,7.059763,0.00093,0.000471,123,0.000149,0,31,0.666667,0.006551
40109,Oklahoma County,,OK,49270,666031,715301,151,155,306,35370,38402,73772,5,0.408611,0.449093,169670.203771,0.050291,0.054273,123,0.0024,0,31,0.241485,0.361865
40111,Okmulgee County,,OK,2745,35710,38455,7,11,18,1469,1581,3050,6,0.29803,0.312598,19.706021,0.000938,0.000906,123,0.00017,0,31,0.575758,0.006627
40113,Osage County,,OK,4889,50945,55834,9,10,19,3595,3545,7140,6,0.29803,0.312483,13.447851,0.001062,0.001066,123,0.000193,0,31,0.755556,0.007609
40115,Ottawa County,,OK,2337,31088,33425,7,8,15,908,1211,2119,6,0.29895,0.313596,424.216609,0.00061,0.00104,123,0.000205,0,31,0.472222,0.005359
40117,Pawnee County,,OK,1607,16553,18160,4,6,10,956,1041,1997,6,0.297846,0.311679,0,0.00053,0.000845,123,0.000109,0,31,1,0.003278
40119,Payne County,,OK,6327,58826,65153,19,24,43,2943,3317,6260,6,0.347368,0.370885,1516.618203,0.002531,0.007609,123,0.000366,0,31,0.44302,0.019118
40121,Pittsburg County,,OK,2840,42352,45192,10,12,22,922,1084,2006,6,0.298183,0.312999,497.705853,0.001127,0.001029,123,0.000221,0,31,0.379121,0.008156
40123,Pontotoc County,,OK,2347,33884,36231,13,12,25,1167,1159,2326,6,0.318946,0.336662,6012.998291,0.002416,0.001871,123,0.000322,0,31,0.417582,0.018288
40125,Pottawatomie County,,OK,4663,62686,67349,15,11,26,3163,2799,5962,6,0.29806,0.312655,173.435509,0.002993,0.001047,123,0.000294,0,31,0.491667,0.021474
40127,Pushmataha County,,OK,741,10039,10780,4,4,8,235,238,473,7,0.243604,0.251966,119.577328,0.00047,0.000043,152,0.000125,0,31,0.6,0.003509
40129,Roger Mills County,,OK,288,3183,3471,1,1,2,102,73,175,7,0.224977,0.231063,0,0.000003,0.000004,123,0.000093,0,31,0,0.000122
40131,Rogers County,,OK,6228,84125,90353,19,17,36,6010,4130,10140,6,0.319016,0.338068,1040.963644,0.004193,0.002878,123,0.000358,0,31,0.420949,0.030179
40133,Seminole County,,OK,1836,22866,24702,8,8,16,1000,1224,2224,6,0.297938,0.312081,21.13865,0.001102,0.000981,123,0.000194,0,31,0.678571,0.007923
40135,Sequoyah County,,OK,2317,38432,40749,8,7,15,1327,1229,2556,6,0.298183,0.312397,21.061206,0.001004,0.000865,123,0.000196,0,31,0.607143,0.007147
40137,Stephens County,,OK,2648,44165,46813,11,11,22,1140,1193,2333,6,0.328618,0.348508,2194.215678,0.002923,0.003908,123,0.000229,0,31,0.521978,0.021468
40139,Texas County,,OK,2084,19550,21634,4,5,9,307,454,761,6,0.300559,0.3158,3018.823393,0.000104,0.000956,56,0.000149,0,31,0.366667,0.001261
40141,Tillman County,,OK,682,8077,8759,3,4,7,197,237,434,7,0.281041,0.293584,12.523798,0.000462,0.000387,123,0.000092,0,31,0.666667,0.003041
40143,Tulsa County,,OK,43809,580773,624582,119,136,255,27588,33335,60923,5,0.412676,0.44969,99891.797522,0.043116,0.054449,123,0.001885,0,31,0.29607,0.308239
40145,Wagoner County,,OK,6007,59409,65416,12,10,22,5395,4128,9523,6,0.297999,0.312425,107.560256,0.001967,0.001008,123,0.000239,0,31,0.631868,0.013975
40147,Washington County,,OK,4660,51024,55684,14,17,31,2637,2862,5499,6,0.32821,0.34876,1119.888145,0.004256,0.003847,123,0.000267,0,31,0.471053,0.031518
40149,Washita County,,OK,1003,10688,11691,4,3,7,431,401,832,7,0.231468,0.238362,1.866667,0.000467,0.000014,123,0.000148,0,31,0.75,0.003504
40151,Woods County,,OK,596,8567,9163,1,3,4,65,161,226,6,0.290371,0.303759,210.028203,0,0.000459,123,0.000085,0,31,0.583333,0.000093
40153,Woodward County,,OK,1365,19389,20754,5,5,10,306,373,679,6,0.297999,0.311823,13067.311575,0.000452,0.000811,123,0.000324,0,31,0.190476,0.003474
41001,Baker County,,OR,1292,16287,17579,3,5,8,211,354,565,7,0.267379,0.280048,0.762933,0.000183,0.000492,178,0.000108,0,31,0.75,0.001824
41003,Benton County,,OR,8930,82997,91927,27,24,51,4659,5992,10651,6,0.341286,0.362804,111.195117,0.009706,0.008949,178,0.000412,0,31,0.721839,0.072239
41005,Clackamas County,,OR,33952,396041,429993,73,70,143,31054,28678,59732,6,0.364824,0.3955,5098.599808,0.030457,0.026635,178,0.000936,0,31,0.508319,0.21588
41007,Clatsop County,,OR,2855,34350,37205,15,15,30,1439,1404,2843,6,0.310323,0.327594,31.834636,0.0045,0.003477,178,0.000244,0,31,0.712418,0.034163
41009,Columbia County,,OR,3262,49223,52485,10,11,21,2853,1929,4782,6,0.329438,0.347394,14.913138,0.003003,0.00362,178,0.000179,0,31,0.916667,0.024324
41011,Coos County,,OR,3909,60143,64052,26,17,43,2364,2001,4365,6,0.331469,0.350815,176.212181,0.008705,0.004873,178,0.000405,0,31,0.738916,0.06721
41013,Crook County,,OR,1775,19643,21418,8,6,14,1202,854,2056,6,0.287525,0.301131,0.47619,0.00159,0.001344,178,0.000168,0,31,0.910714,0.013544
41015,Curry County,,OR,1791,22365,24156,11,7,18,799,694,1493,7,0.260565,0.272298,10.925182,0.003622,0.000907,178,0.000212,0,31,0.772727,0.027503
41017,Deschutes County,,OR,9653,135469,145122,59,44,103,9473,6362,15835,6,0.343872,0.368388,16765.679219,0.018245,0.014133,178,0.000878,0,31,0.465526,0.133214
41019,Douglas County,,OR,5507,105914,111421,37,22,59,4046,3144,7190,6,0.336345,0.3573,330.820968,0.014786,0.007408,178,0.000502,0,31,0.710526,0.108676
41021,Gilliam County,,OR,200,1967,2167,0,0,0,0,0,0,0,0,0,0,0,0,124,0.000051,112,193,0,0
41023,Grant County,,OR,602,7498,8100,1,2,3,42,92,134,7,0.256243,0.265894,0,0.000117,0.000188,178,0.000068,0,31,1,0.00121
41025,Harney County,,OR,699,7395,8094,1,2,3,66,109,175,7,0.256243,0.265894,0,0.000117,0.000188,178,0.000068,0,31,1,0.00121
41027,Hood River County,,OR,1602,22934,24536,6,6,12,638,791,1429,6,0.289128,0.302703,2.694378,0.001325,0.001193,178,0.00014,0,31,0.785714,0.010707
41029,Jackson County,,OR,10305,196884,207189,63,46,109,9609,6610,16219,6,0.344484,0.369421,2366.954931,0.022242,0.017735,178,0.000803,0,31,0.570556,0.160323
41031,Jefferson County,,OR,1212,17001,18213,7,6,13,557,513,1070,6,0.287525,0.301131,33.31724,0.002464,0.001097,178,0.000149,0,31,0.861111,0.018844
41033,Josephine County,,OR,4471,76907,81378,36,18,54,3944,2557,6501,6,0.340206,0.360595,497.715577,0.015869,0.007095,178,0.000457,0,31,0.738265,0.112495
41035,Klamath County,,OR,4509,63884,68393,30,22,52,2495,2372,4867,6,0.340087,0.36091,1635.526265,0.012646,0.007621,178,0.000436,0,31,0.711174,0.092402
41037,Lake County,,OR,681,7320,8001,3,3,6,174,177,351,7,0.25665,0.266674,0,0.00039,0.000439,178,0.000097,0,31,1,0.003805
41039,Lane County,,OR,18837,335292,354129,80,72,152,14463,13230,27693,6,0.351531,0.380768,5291.990524,0.027791,0.025455,178,0.001031,0,31,0.468914,0.199566
41041,Lincoln County,,OR,3904,42713,46617,23,19,42,2301,2234,4535,6,0.337674,0.358069,98.759554,0.008775,0.006776,178,0.000356,0,31,0.795,0.067478
41043,Linn County,,OR,7067,108033,115100,28,20,48,6563,4929,11492,6,0.331167,0.351211,101.328999,0.009309,0.005088,178,0.000433,0,31,0.722988,0.071312
41045,Malheur County,,OR,2313,27673,29986,8,7,15,918,1142,2060,6,0.329513,0.347308,417.735389,0.001017,0.001641,178,0.000199,0,31,0.511111,0.009041
41047,Marion County,,OR,19323,295234,314557,61,51,112,15318,14917,30235,6,0.350809,0.378174,2063.409522,0.0203,0.019178,178,0.000827,0,31,0.519114,0.148966
41049,Morrow County,,OR,1175,10835,12010,1,2,3,422,564,986,7,0.255679,0.264929,0,0.000057,0.000166,178,0.000066,0,31,1,0.00041
41051,Multnomah County,,OR,61268,689256,750524,155,139,294,48425,53080,101505,5,0.40283,0.441936,45952.744512,0.063567,0.05569,178,0.001964,0,31,0.331133,0.437894
41053,Polk County,,OR,6336,64770,71106,19,15,34,5536,4670,10206,6,0.332418,0.351877,41.333793,0.005473,0.005498,178,0.000314,0,31,0.866667,0.042436
41055,Sherman County,,OR,170,1932,2102,0,1,1,0,43,43,7,0.224619,0.23102,0,0,0.000012,178,0.000051,0,194,0,0
41057,Tillamook County,,OR,1819,24980,26799,9,10,19,936,848,1784,6,0.289387,0.303679,11.577619,0.002737,0.001938,178,0.000167,0,31,0.931818,0.022077
41059,Umatilla County,,OR,5176,72549,77725,24,27,51,2928,3051,5979,6,0.33858,0.360319,11914.547155,0.004534,0.006855,178,0.000476,0,31,0.46371,0.036118
41061,Union County,,OR,1897,26204,28101,9,7,16,695,658,1353,6,0.289358,0.303937,851.532586,0.001577,0.001227,178,0.00021,0,31,0.6,0.013034
41063,Wallowa County,,OR,569,7639,8208,2,2,4,92,146,238,7,0.252984,0.261524,0,0.000067,0.00005,178,0.000091,0,31,1,0.000614
41065,Wasco County,,OR,1781,23894,25675,9,8,17,825,820,1645,6,0.289589,0.303822,2911.568153,0.001446,0.001772,178,0.000218,0,31,0.577778,0.012232
41067,Washington County,,OR,42174,489433,531607,114,109,223,35483,35633,71116,5,0.391375,0.427169,17492.901205,0.047077,0.045278,178,0.001434,0,31,0.381095,0.329509
41069,Wheeler County,,OR,152,1411,1563,0,0,0,0,0,0,0,0,0,0,0,0,125,0.000051,113,195,0,0
41071,Yamhill County,,OR,5926,83961,89887,22,21,43,4635,4094,8729,6,0.340925,0.36176,122.004742,0.008595,0.009033,178,0.000342,0,31,0.82,0.065191
42001,Adams County,,PA,6123,133629,139752,17,12,29,5881,3754,9635,6,0.303893,0.321241,19.046364,0.006091,0.003958,126,0.000233,0,31,0.798246,0.042772
42003,Allegheny County,,PA,54631,1492518,1547149,203,211,414,35871,44868,80739,5,0.423447,0.468429,187261.700701,0.087935,0.089728,126,0.002418,0,31,0.305369,0.590664
42005,Armstrong County,,PA,3540,93594,97134,6,6,12,2469,2443,4912,6,0.297663,0.312093,3.22619,0.000931,0.000879,126,0.000159,0,31,0.7,0.006424
42007,Beaver County,,PA,7440,210132,217572,14,15,29,4396,4053,8449,6,0.318212,0.33657,317.028603,0.004019,0.0043,126,0.000214,0,31,0.513072,0.025686
42009,Bedford County,,PA,1994,63887,65881,8,8,16,987,947,1934,6,0.298336,0.313447,727.838818,0.000857,0.000962,126,0.000192,0,31,0.402778,0.00636
42011,Berks County,,PA,16690,470750,487440,57,61,118,15138,11296,26434,6,0.364916,0.394043,2495.183384,0.027644,0.031784,126,0.000517,0,31,0.595886,0.166943
42013,Blair County,,PA,4523,146907,151430,9,12,21,1901,2156,4057,6,0.299135,0.315507,77.618517,0.001259,0.002395,126,0.000185,0,31,0.621795,0.008878
42015,Bradford County,,PA,3067,74008,77075,10,11,21,1233,1462,2695,6,0.266887,0.279832,500.368882,0.000422,0.000401,126,0.000225,0,31,0.327273,0.002836
42017,Bucks County,,PA,40185,790887,831072,102,126,228,34593,33436,68029,6,0.389485,0.427916,9287.039002,0.057509,0.063367,126,0.000917,0,31,0.488171,0.366885
42019,Butler County,,PA,9182,212982,222164,15,16,31,6287,5132,11419,6,0.335956,0.356439,684.108774,0.0024,0.004329,126,0.000279,0,31,0.418421,0.015614
42021,Cambria County,,PA,5649,173766,179415,14,14,28,2421,2767,5188,6,0.304786,0.322584,89.813702,0.002508,0.003114,126,0.000239,0,31,0.5125,0.017668
42023,Cameron County,,PA,328,6964,7292,0,1,1,0,75,75,7,0.229463,0.235828,0,0,0.000006,126,0.000051,0,196,0,0
42025,Carbon County,,PA,3585,73704,77289,13,9,22,3168,2285,5453,7,0.290458,0.305961,1.814785,0.005597,0.002759,126,0.000144,0,31,0.884615,0.031881
42027,Centre County,,PA,8483,131997,140480,31,35,66,3578,3879,7457,6,0.346003,0.370558,11127.252861,0.010422,0.013483,126,0.000423,0,31,0.475034,0.068368
42029,Chester County,,PA,29602,545956,575558,104,95,199,28510,22938,51448,6,0.380055,0.414853,4524.022827,0.056432,0.051308,126,0.000988,0,31,0.547581,0.362483
42031,Clarion County,,PA,1914,44844,46758,6,6,12,872,845,1717,6,0.297663,0.312093,1331.872563,0.000797,0.000774,126,0.000209,0,31,0.566667,0.005689
42033,Clearfield County,,PA,3703,92884,96587,9,8,17,1854,1877,3731,6,0.298152,0.313212,39.228712,0.001175,0.000897,126,0.000209,0,31,0.466667,0.008597
42035,Clinton County,,PA,1859,41317,43176,2,2,4,870,805,1675,7,0.257378,0.267063,0,0.000137,0.00012,126,0.000079,0,31,1,0.000997
42037,Columbia County,,PA,3205,77502,80707,11,11,22,1820,1733,3553,7,0.290429,0.306276,1759.729302,0.002521,0.00207,126,0.000207,0,31,0.666667,0.016375
42039,Crawford County,,PA,4314,103629,107943,10,7,17,2214,1965,4179,6,0.297724,0.312322,7.240715,0.001163,0.000894,126,0.000192,0,31,0.611111,0.007884
42041,Cumberland County,,PA,15752,268154,283906,52,47,99,11766,10468,22234,6,0.354579,0.380596,9919.629412,0.020998,0.019569,126,0.000625,0,31,0.455315,0.13834
42043,Dauphin County,,PA,16981,316711,333692,50,48,98,11083,12041,23124,6,0.362004,0.389073,11315.067369,0.022199,0.022676,126,0.000573,0,31,0.535359,0.144056
42045,Delaware County,,PA,32863,638262,671125,78,81,159,25586,27485,53071,6,0.376996,0.409366,2193.023749,0.044107,0.046455,126,0.000735,0,31,0.653975,0.282606
42047,Elk County,,PA,1326,43050,44376,5,4,9,405,434,839,6,0.297693,0.31192,2907.22619,0.000762,0.00075,126,0.000173,0,31,0.45,0.005425
42049,Erie County,,PA,10499,321485,331984,25,40,65,3468,4769,8237,6,0.361644,0.388378,4539.374734,0.011152,0.019823,126,0.000359,0,31,0.522199,0.07495
42051,Fayette County,,PA,5296,170033,175329,7,6,13,2717,2820,5537,6,0.299042,0.313596,29.685278,0.00119,0.000889,126,0.000161,0,31,0.571429,0.008566
42053,Forest County,,PA,355,5454,5809,4,2,6,202,109,311,7,0.229475,0.23611,0.47619,0.000761,0.000015,126,0.000134,0,31,0.75,0.005319
42055,Franklin County,,PA,5617,161031,166648,15,12,27,3356,2608,5964,6,0.299104,0.315352,1335.384574,0.002885,0.00193,126,0.000261,0,31,0.492647,0.020563
42057,Fulton County,,PA,619,17352,17971,4,4,8,416,355,771,7,0.238522,0.247449,2.448771,0.000068,0.000084,126,0.000126,0,31,0.583333,0.001006
42059,Greene County,,PA,1767,41740,43507,4,5,9,834,964,1798,6,0.29895,0.313309,3.17092,0.000808,0.000884,126,0.000122,0,31,0.85,0.005505
42061,Huntingdon County,,PA,1729,48915,50644,8,8,16,863,883,1746,7,0.264843,0.276541,173.906386,0.00057,0.000501,126,0.000176,0,31,0.527778,0.004771
42063,Indiana County,,PA,4046,97899,101945,7,9,16,1968,1954,3922,6,0.299474,0.31522,15.519726,0.000924,0.001576,126,0.000178,0,31,0.477778,0.006613
42065,Jefferson County,,PA,2207,53699,55906,6,6,12,1291,1214,2505,6,0.297663,0.312093,7.166667,0.000781,0.000764,126,0.000188,0,31,0.6,0.005626
42067,Juniata County,,PA,953,28818,29771,5,5,10,618,481,1099,7,0.268541,0.279491,109.230454,0.000362,0.000372,126,0.000143,0,31,0.75,0.002909
42069,Lackawanna County,,PA,7616,241727,249343,28,26,54,4460,4241,8701,6,0.342776,0.365484,3912.890323,0.01083,0.010915,126,0.000299,0,31,0.621622,0.062516
42071,Lancaster County,,PA,18087,595848,613935,81,69,150,13538,11347,24885,6,0.360701,0.390048,17054.830144,0.037988,0.02961,126,0.000833,0,31,0.459407,0.24409
42073,Lawrence County,,PA,3611,108114,111725,5,7,12,1658,1906,3564,6,0.297724,0.312322,0.733333,0.000943,0.000876,126,0.000109,0,31,0.761905,0.00601
42075,Lebanon County,,PA,5746,148071,153817,15,13,28,4544,3458,8002,7,0.290807,0.307183,61.428134,0.005773,0.003295,126,0.000194,0,31,0.75,0.0355
42077,Lehigh County,,PA,19407,378924,398331,65,62,127,17486,14079,31565,6,0.365099,0.394421,2026.582088,0.035014,0.032148,126,0.00057,0,31,0.628649,0.216937
42079,Luzerne County,,PA,10607,358508,369115,47,44,91,7400,6304,13704,6,0.349627,0.374581,13364.609765,0.019171,0.018352,126,0.000497,0,31,0.526593,0.116602
42081,Lycoming County,,PA,5182,138540,143722,21,18,39,2270,2538,4808,6,0.300621,0.31832,8756.866895,0.004104,0.003121,126,0.000388,0,31,0.417749,0.028052
42083,McKean County,,PA,1961,50746,52707,7,8,15,621,719,1340,6,0.297999,0.312925,1353.800848,0.000936,0.000871,126,0.000193,0,31,0.303571,0.006328
42085,Mercer County,,PA,4936,137458,142394,11,11,22,2741,2494,5235,6,0.300964,0.316913,21.766686,0.001373,0.001734,126,0.000197,0,31,0.583333,0.008393
42087,Mifflin County,,PA,1731,55180,56911,6,9,15,655,961,1616,7,0.270971,0.283761,255.195791,0.000551,0.00097,126,0.000153,0,31,0.625,0.004379
42089,Monroe County,,PA,9932,162060,171992,41,40,81,12260,6432,18692,6,0.339411,0.363298,256.031693,0.018914,0.017871,126,0.00034,0,31,0.687057,0.105544
42091,Montgomery County,,PA,51514,872150,923664,132,135,267,46373,44488,90861,6,0.391322,0.430699,16135.987389,0.068135,0.068543,126,0.001267,0,31,0.456704,0.439675
42093,Montour County,,PA,1398,18022,19420,4,3,7,691,597,1288,8,0.225343,0.232907,0.335281,0.000212,0.000043,126,0.000112,0,31,0.9,0.001823
42095,Northampton County,,PA,15786,320558,336344,49,45,94,15079,11280,26359,6,0.350725,0.376808,690.576011,0.023632,0.022064,126,0.000426,0,31,0.67592,0.141348
42097,Northumberland County,,PA,4362,104731,109093,13,13,26,2748,2877,5625,7,0.283815,0.299602,2145.185726,0.001783,0.002186,126,0.000259,0,31,0.654167,0.013202
42099,Perry County,,PA,2469,54966,57435,9,6,15,1893,1731,3624,7,0.269113,0.280599,155.142413,0.000822,0.000606,126,0.000192,0,31,0.652778,0.006933
42101,Philadelphia County,,PA,78941,1445263,1524204,162,164,326,51209,70972,122181,6,0.406097,0.448295,24189.45604,0.080244,0.080513,126,0.001628,0,31,0.424518,0.526862
42103,Pike County,,PA,3738,54233,57971,29,16,45,4884,1884,6768,6,0.307367,0.325086,22.673971,0.012886,0.005782,102,0.00023,0,31,0.789315,0.065925
42105,Potter County,,PA,1344,20837,22181,5,3,8,513,429,942,7,0.231358,0.239278,13.177969,0.000787,0.000026,126,0.000131,0,31,0.35,0.005533
42107,Schuylkill County,,PA,5275,169790,175065,17,19,36,3302,3310,6612,6,0.300715,0.31852,41.281441,0.003976,0.005207,126,0.000223,0,31,0.763158,0.026766
42109,Snyder County,,PA,1974,40634,42608,8,6,14,1104,1084,2188,7,0.23145,0.240004,16.994124,0.000493,0.00007,126,0.000205,0,31,0.535714,0.004434
42111,Somerset County,,PA,2761,89111,91872,7,8,15,1260,1248,2508,6,0.298091,0.312988,67.411603,0.000935,0.00092,126,0.000193,0,31,0.428571,0.006755
42113,Sullivan County,,PA,486,6213,6699,2,2,4,147,207,354,7,0.23206,0.240061,0,0.000029,0.000037,126,0.000086,0,31,1,0.000467
42115,Susquehanna County,,PA,2347,49726,52073,6,6,12,1189,1243,2432,6,0.266544,0.278455,18.400143,0.00045,0.000405,126,0.000134,0,31,0.633333,0.002882
42117,Tioga County,,PA,2203,46851,49054,7,6,13,879,828,1707,7,0.266153,0.278108,306.268204,0.000841,0.000387,126,0.000166,0,31,0.357143,0.006041
42119,Union County,,PA,2447,41389,43836,8,5,13,1491,1227,2718,7,0.257515,0.267752,105.571022,0.000913,0.00016,126,0.000192,0,31,0.571429,0.00665
42121,Venango County,,PA,2578,65071,67649,8,7,15,1251,1157,2408,6,0.297693,0.312265,1578.329118,0.000975,0.000872,126,0.000224,0,31,0.607143,0.00658
42123,Warren County,,PA,2032,49058,51090,6,7,13,753,833,1586,6,0.297816,0.312494,20.577255,0.000976,0.000868,126,0.000137,0,31,0.482143,0.006253
42125,Washington County,,PA,8649,231067,239716,13,16,29,6657,5102,11759,6,0.339451,0.360606,780.676391,0.002643,0.004748,126,0.000257,0,31,0.397661,0.01741
42127,Wayne County,,PA,2973,52762,55735,22,9,31,2377,1397,3774,7,0.290226,0.305731,289.411296,0.009389,0.001857,126,0.000199,0,31,0.713333,0.048797
42129,Westmoreland County,,PA,14233,420933,435166,31,34,65,10760,9303,20063,6,0.351744,0.376056,4612.330005,0.013692,0.015653,126,0.000438,0,31,0.488372,0.095678
42131,Wyoming County,,PA,1711,30754,32465,4,4,8,1282,1062,2344,7,0.260192,0.270217,0.665404,0.000248,0.000255,126,0.000106,0,31,0.916667,0.001901
42133,York County,,PA,16336,465068,481404,56,50,106,15224,10593,25817,6,0.348118,0.37426,5659.490745,0.023593,0.021053,126,0.000638,0,31,0.472344,0.155105
44001,Bristol County,,RI,3376,56632,60008,5,5,10,1831,2044,3875,6,0.299166,0.314061,0.126923,0.00221,0.001539,103,0.000085,0,31,0.933333,0.012659
44003,Kent County,,RI,11739,200575,212314,21,24,45,8326,8525,16851,6,0.338304,0.359378,110.753452,0.011911,0.013544,103,0.000203,0,31,0.75504,0.071838
44005,Newport County,,RI,9205,94781,103986,32,30,62,4110,4878,8988,6,0.349458,0.372624,374.325349,0.015874,0.017537,103,0.000331,0,31,0.595238,0.103796
44007,Providence County,,RI,29919,669913,699832,77,86,163,22964,23309,46273,6,0.377143,0.410273,2770.717866,0.045342,0.049399,103,0.000739,0,31,0.609462,0.294937
44009,Washington County,,RI,8069,143568,151637,21,0,21,6061,0,6061,0,0,0,0,0.009862,0,103,0.000203,0,5,0.82619,0.05913
45001,Abbeville County,,SC,1484,28562,30046,4,3,7,900,903,1803,7,0.282216,0.293845,329.032949,0.000382,0.000452,104,0.000135,0,31,0.666667,0.0036
45003,Aiken County,,SC,8302,169598,177900,33,23,56,5109,4614,9723,6,0.342009,0.363384,6491.11335,0.011957,0.008054,104,0.000533,0,31,0.466967,0.086686
45005,Allendale County,,SC,634,10447,11081,2,4,6,141,330,471,7,0.263545,0.274031,4.043185,0.000012,0.000274,104,0.000088,0,31,0.416667,0.000224
45007,Anderson County,,SC,9618,200181,209799,20,20,40,6898,6037,12935,6,0.316374,0.335577,1262.113606,0.005817,0.005583,104,0.000393,0,31,0.571667,0.046464
45009,Bamberg County,,SC,1125,16307,17432,2,5,7,265,646,911,7,0.284678,0.29722,0,0.000039,0.000684,104,0.000082,0,31,0.9,0.000497
45011,Barnwell County,,SC,1142,22020,23162,4,6,10,569,610,1179,7,0.284734,0.297449,601.740127,0.000108,0.000683,104,0.000118,0,31,0.633333,0.001379
45013,Beaufort County,,SC,13865,140220,154085,91,58,149,8460,6331,14791,6,0.373409,0.402784,12979.185416,0.048148,0.033294,178,0.001061,0,31,0.54113,0.322862
45015,Berkeley County,,SC,19212,162857,182069,57,48,105,12091,12953,25044,6,0.358563,0.386025,3217.264693,0.02901,0.02149,104,0.000741,0,31,0.509046,0.207987
45017,Calhoun County,,SC,1013,16983,17996,3,3,6,823,637,1460,7,0.284539,0.296732,0,0.000565,0.000584,104,0.000095,0,31,1,0.004436
45019,Charleston County,,SC,28271,325791,354062,131,104,235,21312,20010,41322,6,0.399835,0.435009,23907.823755,0.062398,0.050927,104,0.001593,0,31,0.421769,0.427175
45021,Cherokee County,,SC,2946,60732,63678,7,7,14,1709,1869,3578,6,0.30184,0.316563,21.784298,0.000556,0.001517,104,0.000168,0,31,0.803571,0.005649
45023,Chester County,,SC,2225,39544,41769,5,8,13,1162,1549,2711,6,0.304307,0.319685,102.471567,0.000838,0.002096,104,0.000135,0,31,0.607143,0.007402
45025,Chesterfield County,,SC,2363,48121,50484,7,10,17,1188,1289,2477,6,0.301902,0.317137,282.910113,0.000895,0.001485,104,0.000154,0,31,0.555556,0.007689
45027,Clarendon County,,SC,2148,36874,39022,7,7,14,1092,1196,2288,7,0.285433,0.298442,16.553926,0.001207,0.000734,104,0.000146,0,31,0.75,0.009767
45029,Colleton County,,SC,2141,41328,43469,7,8,15,1229,1187,2416,7,0.291361,0.305329,53.862599,0.001352,0.001794,104,0.000157,0,31,0.803571,0.011669
45031,Darlington County,,SC,4014,77809,81823,10,13,23,2160,2517,4677,6,0.309661,0.326343,626.355984,0.001684,0.003254,104,0.000197,0,31,0.57619,0.0141
45033,Dillon County,,SC,1561,34222,35783,5,7,12,654,826,1480,7,0.285349,0.298729,54.943251,0.00031,0.00079,104,0.000123,0,31,0.571429,0.003277
45035,Dorchester County,,SC,8724,90494,99218,17,15,32,7106,5601,12707,6,0.319753,0.338883,130.405684,0.006688,0.006538,104,0.000289,0,31,0.764069,0.05346
45037,Edgefield County,,SC,1259,18578,19837,6,6,12,887,932,1819,7,0.274299,0.286206,10.583478,0.000588,0.000606,104,0.000156,0,31,0.7,0.004945
45039,Fairfield County,,SC,1690,26666,28356,4,6,10,819,964,1783,7,0.284957,0.297822,5.031038,0.000572,0.000697,104,0.000111,0,31,0.633333,0.004436
45041,Florence County,,SC,7118,136481,143599,22,28,50,4503,4528,9031,6,0.319824,0.340473,2607.391325,0.004697,0.006862,104,0.000377,0,31,0.449507,0.038247
45043,Georgetown County,,SC,3854,67150,71004,9,9,18,2005,2018,4023,6,0.308477,0.324604,51.379785,0.002447,0.003139,104,0.000184,0,31,0.866667,0.020982
45045,Greenville County,,SC,25805,433585,459390,107,84,191,18037,17805,35842,6,0.392804,0.425712,35224.017427,0.047536,0.037981,104,0.001473,0,31,0.405697,0.337581
45047,Greenwood County,,SC,3600,72748,76348,12,15,27,1835,2118,3953,6,0.305974,0.322446,2936.150069,0.001411,0.002674,104,0.000299,0,31,0.514286,0.012376
45049,Hampton County,,SC,979,21641,22620,4,5,9,404,389,793,7,0.284873,0.297788,2427.486496,0.000298,0.000785,178,0.000123,0,31,0.4,0.003078
45051,Horry County,,SC,13579,216476,230055,103,56,159,10083,6569,16652,6,0.358032,0.385698,15896.304876,0.041015,0.024455,104,0.001268,0,31,0.360967,0.276161
45053,Jasper County,,SC,832,8440,9272,3,4,7,485,561,1046,7,0.286165,0.298327,30.672498,0.000626,0.000735,178,0.000099,0,31,0.666667,0.005152
45055,Kershaw County,,SC,3358,63511,66869,12,12,24,2386,1849,4235,6,0.306394,0.322503,128.439203,0.00201,0.002924,104,0.000226,0,31,0.637363,0.01662
45057,Lancaster County,,SC,3132,67989,71121,8,9,17,1987,1987,3974,6,0.304116,0.319599,14.220729,0.001493,0.001969,104,0.000175,0,31,0.652778,0.013195
45059,Laurens County,,SC,3695,70022,73717,6,9,15,2428,2493,4921,7,0.287895,0.301891,2.75167,0.000496,0.001434,104,0.000155,0,31,0.861111,0.004615
45061,Lee County,,SC,1589,22579,24168,6,6,12,1136,1178,2314,7,0.285321,0.298127,0.755061,0.000624,0.000712,104,0.000133,0,31,0.833333,0.004569
45063,Lexington County,,SC,17572,264076,281648,59,45,104,14501,12379,26880,6,0.35724,0.38393,12634.627033,0.020782,0.017606,104,0.000908,0,31,0.388154,0.154603
45065,McCormick County,,SC,553,9808,10361,2,2,4,122,198,320,7,0.234326,0.241409,4.351502,0.000138,0.000015,104,0.000084,0,31,0.333333,0.001144
45067,Marion County,,SC,1747,36275,38022,4,5,9,759,906,1665,6,0.303893,0.318739,12.959523,0.000292,0.001602,104,0.000109,0,31,0.866667,0.003102
45069,Marlboro County,,SC,1576,31428,33004,6,8,14,626,888,1514,7,0.285265,0.298798,15.046444,0.000148,0.000799,104,0.000127,0,31,0.464286,0.001317
45071,Newberry County,,SC,1856,38952,40808,10,8,18,1012,1062,2074,7,0.287354,0.300996,35.316832,0.001026,0.001036,104,0.000222,0,31,0.588889,0.009095
45073,Oconee County,,SC,3468,75890,79358,8,6,14,1614,1559,3173,7,0.291128,0.304727,9.000052,0.002371,0.001418,104,0.000172,0,31,0.958333,0.019855
45075,Orangeburg County,,SC,4778,92949,97727,19,18,37,2402,2893,5295,6,0.314252,0.331967,3939.226112,0.005048,0.004101,104,0.000319,0,31,0.47619,0.035956
45077,Pickens County,,SC,7579,107253,114832,12,14,26,4572,4922,9494,6,0.315549,0.332662,76.360972,0.001918,0.004943,104,0.000251,0,31,0.770833,0.01788
45079,Richland County,,SC,28341,321118,349459,116,105,221,21567,20467,42034,6,0.396234,0.431543,53926.179542,0.044905,0.046682,104,0.001536,0,31,0.34132,0.316376
45081,Saluda County,,SC,850,14746,15596,6,6,12,479,589,1068,7,0.284762,0.297507,9.608871,0.000633,0.000666,104,0.000162,0,31,0.8,0.005361
45083,Spartanburg County,,SC,11364,269430,280794,33,29,62,7405,6899,14304,6,0.342493,0.364847,2923.745104,0.009258,0.007904,104,0.00057,0,31,0.453453,0.071847
45085,Sumter County,,SC,8450,108493,116943,31,34,65,3189,3984,7173,6,0.353113,0.377904,3208.821335,0.012177,0.015128,104,0.000467,0,31,0.495732,0.092031
45087,Union County,,SC,1174,32737,33911,5,6,11,494,719,1213,7,0.282518,0.294649,4.659985,0.000417,0.000612,104,0.000141,0,31,0.633333,0.00399
45089,Williamsburg County,,SC,1956,35308,37264,5,6,11,691,1170,1861,7,0.285602,0.298844,2.800587,0.000676,0.001018,104,0.000129,0,31,0.833333,0.005884
45091,York County,,SC,10573,191702,202275,45,31,76,8810,5998,14808,6,0.321346,0.343584,2115.879279,0.014884,0.008745,104,0.000675,0,31,0.403529,0.112141
46003,Aurora County,,SD,188,3877,4065,1,1,2,51,49,100,8,0.211816,0.2171,0,0.000001,0.000001,50,0.000091,0,31,0,0.000116
46005,Beadle County,,SD,1276,19406,20682,1,5,6,46,401,447,7,0.268814,0.279977,0,0.000079,0.000141,50,0.00008,0,31,0.75,0.000716
46007,Bennett County,,SD,253,3197,3450,0,0,0,0,0,0,0,0,0,0,0,0,127,0.000051,114,197,0,0
46009,Bon Homme County,,SD,390,7263,7653,1,2,3,70,147,217,7,0.265157,0.274806,0,0.000001,0.000077,50,0.000084,0,31,1,0.000108
46011,Brookings County,,SD,2605,28814,31419,8,9,17,556,989,1545,6,0.308805,0.323841,8172.453337,0.00009,0.000795,50,0.000373,0,31,0.25,0.001444
46013,Brown County,,SD,2413,41281,43694,10,11,21,716,912,1628,6,0.30976,0.325505,25847.300211,0.000178,0.000837,50,0.000515,0,31,0.164835,0.002058
46015,Brule County,,SD,401,5325,5726,1,1,2,58,43,101,1,1,1,0,0,0,140,0.000338,115,198,0,0.00009
46017,Buffalo County,,SD,128,1911,2039,0,0,0,0,0,0,0,0,0,0,0,0,128,0.000051,116,199,0,0
46019,Butte County,,SD,878,10126,11004,4,3,7,451,335,786,7,0.262473,0.272045,2.374631,0.00014,0.000068,100,0.00017,0,31,0.916667,0.000967
46021,Campbell County,,SD,127,2415,2542,0,0,0,0,0,0,0,0,0,0,0,0,129,0.000051,117,200,0,0
46023,Charles Mix County,,SD,512,10086,10598,1,2,3,49,120,169,7,0.265157,0.274834,0,0.000079,0.000077,50,0.00008,0,31,1,0.000716
46025,Clark County,,SD,232,4298,4530,1,1,2,53,65,118,8,0.212794,0.218633,0,0.000001,0.000002,50,0.000102,0,31,0,0.000127
46027,Clay County,,SD,1576,11877,13453,6,6,12,433,611,1044,7,0.269763,0.281366,107.764619,0.000235,0.000181,50,0.000237,0,31,0.5,0.002037
46029,Codington County,,SD,1966,30948,32914,11,9,20,869,818,1687,7,0.27029,0.283018,19324.136202,0.000191,0.000178,50,0.000549,0,31,0.189394,0.002175
46031,Corson County,,SD,290,4062,4352,0,0,0,0,0,0,0,0,0,0,0,0,130,0.000051,118,201,0,0
46033,Custer County,,SD,733,7640,8373,2,2,4,249,242,491,7,0.261881,0.271201,0,0.000097,0.000062,100,0.000131,0,31,1,0.000669
46035,Davison County,,SD,1684,21352,23036,7,7,14,487,619,1106,7,0.268715,0.280005,11794.385015,0.000178,0.000139,50,0.000335,0,31,0.166667,0.001762
46037,Day County,,SD,492,6970,7462,0,3,3,0,195,195,7,0.236718,0.243919,0,0,0.000003,50,0.000051,0,202,0.5,0
46039,Deuel County,,SD,416,5978,6394,2,2,4,127,102,229,7,0.236578,0.243457,0,0.000008,0.000002,50,0.000138,0,31,1,0.000243
46041,Dewey County,,SD,397,6477,6874,2,1,3,107,49,156,1,1,1,2947,0.000096,0,100,0.000426,0,25,0,0.000663
46043,Douglas County,,SD,198,4078,4276,0,0,0,0,0,0,0,0,0,0,0,0,131,0.000051,119,203,0,0
46045,Edmunds County,,SD,314,4708,5022,1,1,2,109,101,210,7,0.236521,0.24317,0,0.000007,0.000001,50,0.00009,0,31,0,0.000124
46047,Fall River County,,SD,585,7417,8002,2,2,4,163,176,339,7,0.261881,0.271201,0,0.000097,0.000062,100,0.000131,0,31,1,0.000669
46049,Faulk County,,SD,130,2747,2877,0,0,0,0,0,0,0,0,0,0,0,0,132,0.000051,120,204,0,0
46051,Grant County,,SD,533,9649,10182,1,3,4,56,181,237,7,0.265254,0.27515,2943,0.000001,0.000077,50,0.000102,0,31,0.666667,0.000127
46053,Gregory County,,SD,281,5522,5803,0,0,0,0,0,0,0,0,0,0,0,0,133,0.000051,121,205,0,0
46055,Haakon County,,SD,191,2728,2919,0,1,1,0,46,46,7,0.2619,0.271108,0,0,0.000061,100,0.000051,0,206,0,0
46057,Hamlin County,,SD,384,5880,6264,2,1,3,132,103,235,8,0.212794,0.218633,0,0.000008,0.000002,50,0.000138,0,31,1,0.000243
46059,Hand County,,SD,284,4335,4619,0,0,0,0,0,0,0,0,0,0,0,0,134,0.000051,122,207,0,0
46061,Hanson County,,SD,298,4010,4308,1,2,3,65,148,213,7,0.265157,0.274834,0,0.000001,0.000077,50,0.000091,0,31,1,0.000116
46063,Harding County,,SD,77,1623,1700,0,0,0,0,0,0,0,0,0,0,0,0,135,0.000051,123,208,0,0
46065,Hughes County,,SD,1445,19721,21166,4,4,8,430,553,983,7,0.268665,0.279546,5848,0.000182,0.000139,50,0.000229,0,31,0.5,0.001503
46067,Hutchinson County,,SD,458,8911,9369,3,2,5,169,160,329,7,0.265157,0.274834,2,0.000081,0.000077,50,0.000155,0,31,0.666667,0.00093
46069,Hyde County,,SD,92,1770,1862,0,0,0,0,0,0,0,0,0,0,0,0,136,0.000051,124,209,0,0
46071,Jackson County,,SD,179,2892,3071,0,0,0,0,0,0,0,0,0,0,0,0,137,0.000051,125,210,0,0
46073,Jerauld County,,SD,177,2531,2708,0,0,0,0,0,0,0,0,0,0,0,0,138,0.000051,126,211,0,0
46075,Jones County,,SD,102,1320,1422,0,0,0,0,0,0,0,0,0,0,0,0,139,0.000051,127,212,0,0
46077,Kingsbury County,,SD,363,6231,6594,1,2,3,66,111,177,7,0.265157,0.274834,0,0.000007,0.000077,50,0.000086,0,31,1,0.000115
46079,Lake County,,SD,860,12559,13419,2,2,4,244,289,533,7,0.265157,0.274834,1.666667,0.000079,0.000077,50,0.000102,0,31,0.5,0.000804
46081,Lawrence County,,SD,2248,23586,25834,7,5,12,926,833,1759,7,0.269438,0.280648,380.7153,0.000225,0.000146,100,0.000274,0,31,0.47619,0.001885
46083,Lincoln County,,SD,3623,34879,38502,9,8,17,3796,2287,6083,6,0.333486,0.352181,2280.059216,0.000094,0.001899,50,0.000366,0,31,0.263636,0.001596
46085,Lyman County,,SD,282,4332,4614,1,1,2,43,58,101,1,1,1,0,0,0,140,0.000338,115,198,0,0.00009
46087,McCook County,,SD,402,6449,6851,1,1,2,174,133,307,7,0.26506,0.27449,0,0.000079,0.000076,50,0.00008,0,31,0,0.000716
46089,McPherson County,,SD,143,2860,3003,1,1,2,57,41,98,7,0.236521,0.24317,0,0.000007,0.000001,50,0.00009,0,31,0,0.000124
46091,Marshall County,,SD,327,5219,5546,0,2,2,0,116,116,7,0.236621,0.243517,0,0,0.000001,50,0.000051,0,213,0,0
46093,Meade County,,SD,5025,32077,37102,7,10,17,1927,2523,4450,6,0.339094,0.358655,1574.001245,0.000599,0.003625,100,0.000234,0,31,0.469697,0.004334
46095,Mellette County,,SD,143,1993,2136,0,0,0,0,0,0,0,0,0,0,0,0,141,0.000051,128,214,0,0
46097,Miner County,,SD,223,2486,2709,0,2,2,0,84,84,7,0.265127,0.27474,0,0,0.000076,50,0.000051,0,215,1,0
46099,Minnehaha County,,SD,13123,182658,195781,50,45,95,8074,7965,16039,6,0.360611,0.386507,151109.723979,0.009178,0.009536,50,0.001574,0,31,0.143797,0.06811
46101,Moody County,,SD,563,7006,7569,2,2,4,199,216,415,7,0.265157,0.274834,0,0.000085,0.000077,50,0.000116,0,31,1,0.000831
46103,Pennington County,,SD,8904,96936,105840,32,34,66,4563,4278,8841,6,0.354709,0.379287,81755.454449,0.007432,0.011678,100,0.000989,0,31,0.245732,0.054784
46105,Perkins County,,SD,237,3853,4090,0,0,0,0,0,0,0,0,0,0,0,0,142,0.000051,129,216,0,0
46107,Potter County,,SD,147,3208,3355,0,0,0,0,0,0,0,0,0,0,0,0,143,0.000051,130,217,0,0
46109,Roberts County,,SD,526,10516,11042,3,2,5,194,100,294,7,0.26523,0.274978,336.234014,0.000001,0.000077,50,0.000116,0,31,0.3,0.000266
46111,Sanborn County,,SD,146,2891,3037,1,0,1,52,0,52,0,0,0,0,0.000001,0,50,0.000091,0,26,0,0.000116
46113,Shannon County,,SD,608,11206,11814,2,1,3,222,159,381,7,0.261858,0.271029,654.317885,0.000096,0.000061,100,0.000109,0,31,0,0.000662
46115,Spink County,,SD,434,7389,7823,1,1,2,68,106,174,7,0.236521,0.24317,0,0.000007,0.000001,50,0.00009,0,31,0,0.000124
46117,Stanley County,,SD,409,3235,3644,1,1,2,192,192,384,8,0.211785,0.216957,0,0.000001,0.000002,50,0.000099,0,31,0,0.000108
46119,Sully County,,SD,117,1624,1741,0,0,0,0,0,0,0,0,0,0,0,0,144,0.000051,131,218,0,0
46121,Todd County,,SD,510,7796,8306,1,2,3,50,91,141,7,0.262354,0.271793,2945,0.000096,0.000061,91,0.000075,0,31,0,0.000572
46123,Tripp County,,SD,383,6914,7297,0,0,0,0,0,0,0,0,0,0,0,0,145,0.000051,132,219,0,0
46125,Turner County,,SD,655,9142,9797,2,3,5,327,357,684,7,0.265109,0.274834,0.5,0.000094,0.000077,50,0.000119,0,31,0.666667,0.000835
46127,Union County,,SD,1337,14557,15894,6,5,11,871,559,1430,7,0.266446,0.276992,46.115894,0.000145,0.000123,50,0.000225,0,31,0.5,0.001586
46129,Walworth County,,SD,512,6477,6989,0,1,1,0,45,45,7,0.236564,0.243259,0,0,0.000001,50,0.000051,0,220,0,0
46135,Yankton County,,SD,1466,24273,25739,5,5,10,445,482,927,7,0.265424,0.275598,3160.194086,0.000094,0.000079,50,0.000199,0,31,0.3,0.001239
46137,Ziebach County,,SD,156,1158,1314,1,1,2,49,55,104,1,1,1,0,0,0.000001,100,0.000413,0,25,0,0.000097
47001,Anderson County,,TN,5655,84667,90322,9,10,19,3084,3413,6497,7,0.301432,0.315895,284.081522,0.000924,0.001265,146,0.000329,0,31,0.411111,0.008277
47003,Bedford County,,TN,2426,43626,46052,9,9,18,1792,1426,3218,7,0.299474,0.313031,1556.270269,0.000912,0.000998,146,0.000245,0,31,0.597222,0.007963
47005,Benton County,,TN,1126,17829,18955,4,5,9,420,426,846,7,0.299474,0.312503,298.310563,0.000607,0.0006,54,0.000136,0,31,0.35,0.004584
47007,Bledsoe County,,TN,673,11253,11926,4,4,8,378,391,769,7,0.274117,0.285268,5.533284,0.000228,0.000252,146,0.000159,0,31,0.666667,0.002224
47009,Blount County,,TN,6531,126667,133198,22,11,33,4396,3514,7910,7,0.301871,0.316544,1148.334627,0.005946,0.001245,146,0.00054,0,31,0.378788,0.0466
47011,Bradley County,,TN,5910,99002,104912,13,15,28,2925,3112,6037,6,0.316305,0.333396,3840.037844,0.00184,0.002656,146,0.000361,0,31,0.352941,0.015368
47013,Campbell County,,TN,1743,38565,40308,5,5,10,884,821,1705,7,0.281914,0.293891,68.309522,0.000322,0.000396,146,0.000205,0,31,0.3,0.00332
47015,Cannon County,,TN,1135,16783,17918,5,5,10,864,772,1636,7,0.299351,0.312343,86.379535,0.000717,0.000729,146,0.000173,0,31,0.85,0.005683
47017,Carroll County,,TN,2143,35384,37527,7,8,15,1230,1340,2570,6,0.309035,0.324145,60.999359,0.000725,0.001243,54,0.000207,0,31,0.625,0.005378
47019,Carter County,,TN,3474,58543,62017,7,7,14,2077,2089,4166,7,0.282271,0.294654,869.754211,0.000351,0.00044,146,0.000254,0,31,0.428571,0.003881
47021,Cheatham County,,TN,3647,45969,49616,9,9,18,2670,2572,5242,7,0.301746,0.315717,6.937275,0.001152,0.001276,146,0.000207,0,31,0.847222,0.009949
47023,Chester County,,TN,1540,18378,19918,4,7,11,731,905,1636,6,0.305363,0.319226,1.166667,0.000695,0.000665,54,0.000147,0,31,0.714286,0.004928
47025,Claiborne County,,TN,1496,32723,34219,9,7,16,1042,846,1888,7,0.282079,0.294408,6638.782725,0.000326,0.000392,146,0.000283,0,31,0.236111,0.00368
47027,Clay County,,TN,499,8618,9117,2,3,5,152,200,352,7,0.237449,0.244917,3.027381,0.000011,0.000031,146,0.000102,0,31,0.333333,0.000244
47029,Cocke County,,TN,1546,37642,39188,5,5,10,787,905,1692,7,0.281641,0.293432,0.65,0.00033,0.00042,146,0.000193,0,31,0.85,0.003534
47031,Coffee County,,TN,3559,54652,58211,10,10,20,2112,1966,4078,7,0.301777,0.31624,4155.322251,0.000757,0.001253,146,0.000292,0,31,0.431818,0.006522
47033,Crockett County,,TN,1341,17936,19277,6,6,12,827,811,1638,7,0.277258,0.289811,50.435933,0.000715,0.000357,54,0.000198,0,31,0.619048,0.005263
47035,Cumberland County,,TN,2704,57317,60021,13,12,25,1098,1071,2169,7,0.30162,0.316469,5130.475522,0.002553,0.001272,146,0.000392,0,31,0.302198,0.01857
47037,Davidson County,,TN,54192,621849,676041,178,169,347,35603,43449,79052,6,0.426682,0.466345,221734.751178,0.070049,0.070398,146,0.002823,0,31,0.2693,0.494692
47039,Decatur County,,TN,736,12507,13243,5,2,7,391,295,686,7,0.250734,0.259134,2051.125059,0.000044,0.000027,54,0.000184,0,31,0.3,0.000811
47041,DeKalb County,,TN,1141,20024,21165,8,8,16,845,729,1574,7,0.299443,0.312859,857.358625,0.000753,0.000782,146,0.000268,0,31,0.607143,0.006396
47043,Dickson County,,TN,2977,48320,51297,11,11,22,2192,1776,3968,7,0.301777,0.316004,77.224952,0.00116,0.001296,146,0.000271,0,31,0.618182,0.010281
47045,Dyer County,,TN,2253,41582,43835,11,9,20,1273,1082,2355,6,0.309364,0.324679,5108.692159,0.000758,0.001238,54,0.000327,0,31,0.363636,0.005929
47047,Fayette County,,TN,4076,54517,58593,5,7,12,4225,2726,6951,6,0.305395,0.319284,6.335611,0.000704,0.000731,54,0.000175,0,31,0.52381,0.00546
47049,Fentress County,,TN,751,17705,18456,3,3,6,242,290,532,7,0.237332,0.244859,3.15873,0.000032,0.00005,146,0.000139,0,31,0.666667,0.000659
47051,Franklin County,,TN,2195,40907,43102,9,9,18,1140,1172,2312,7,0.301683,0.315953,4950.487793,0.001207,0.001244,146,0.000244,0,31,0.541667,0.009758
47053,Gibson County,,TN,3222,55764,58986,9,9,18,1874,1922,3796,6,0.309133,0.324403,115.388548,0.000738,0.001245,54,0.000266,0,31,0.533333,0.005643
47055,Giles County,,TN,2016,36648,38664,7,8,15,1118,1191,2309,7,0.300995,0.314799,51.353857,0.000902,0.001042,146,0.000187,0,31,0.553571,0.007109
47057,Grainger County,,TN,1480,21419,22899,6,7,13,1050,1110,2160,7,0.281805,0.293977,2952.484199,0.000326,0.000402,146,0.000233,0,31,0.547619,0.003507
47059,Greene County,,TN,2915,73485,76400,10,9,19,1546,1488,3034,7,0.282216,0.294798,1206.379655,0.001242,0.000437,146,0.000327,0,31,0.511111,0.010837
47061,Grundy County,,TN,535,14840,15375,3,4,7,211,281,492,8,0.232097,0.239195,10.286905,0.000023,0.000024,146,0.000125,0,31,0.333333,0.000448
47063,Hamblen County,,TN,3825,63889,67714,11,12,23,2081,2428,4509,7,0.301432,0.31597,2129.399324,0.000376,0.00109,146,0.000385,0,31,0.455128,0.004767
47065,Hamilton County,,TN,18920,351387,370307,74,63,137,10636,12097,22733,6,0.377094,0.407036,64073.696507,0.027524,0.025495,146,0.001357,0,31,0.310478,0.200945
47067,Hancock County,,TN,295,5264,5559,1,3,4,96,161,257,8,0.231912,0.23875,0,0.000003,0.000009,146,0.000079,0,31,0.833333,0.000126
47069,Hardeman County,,TN,1559,26903,28462,6,5,11,841,883,1724,6,0.308805,0.323427,40.25123,0.000706,0.001221,54,0.000175,0,31,0.5,0.005194
47071,Hardin County,,TN,1552,27990,29542,8,6,14,736,667,1403,6,0.305427,0.319198,1285.640587,0.001287,0.000649,54,0.000239,0,31,0.416667,0.009444
47073,Hawkins County,,TN,3400,56920,60320,10,8,18,2227,2335,4562,7,0.282161,0.294597,1369.717936,0.000365,0.000441,146,0.000328,0,31,0.466667,0.004244
47075,Haywood County,,TN,1269,22113,23382,6,6,12,751,777,1528,6,0.305331,0.319054,44.007678,0.000709,0.000668,54,0.000187,0,31,0.666667,0.005299
47077,Henderson County,,TN,1546,26489,28035,7,7,14,1018,880,1898,6,0.305395,0.319284,992.20647,0.000715,0.00066,54,0.000263,0,31,0.595238,0.00535
47079,Henry County,,TN,1935,33834,35769,6,7,13,665,784,1449,6,0.309035,0.32403,175.264619,0.001271,0.00123,54,0.00018,0,31,0.547619,0.009057
47081,Hickman County,,TN,1679,21810,23489,6,8,14,1083,1099,2182,7,0.299351,0.312687,573.038779,0.000778,0.000991,146,0.000174,0,31,0.607143,0.006631
47083,Houston County,,TN,558,9255,9813,5,4,9,381,327,708,7,0.276019,0.28717,43.145562,0.000807,0.000238,146,0.000155,0,31,0.6,0.006212
47085,Humphreys County,,TN,1080,18644,19724,5,5,10,471,478,949,7,0.299351,0.312343,45.287045,0.000607,0.000606,146,0.00016,0,31,0.55,0.00475
47087,Jackson County,,TN,841,13582,14423,4,4,8,476,436,912,7,0.237313,0.244917,424.996622,0.00061,0.000033,146,0.000152,0,31,0.55,0.004705
47089,Jefferson County,,TN,4136,49847,53983,9,8,17,3178,2726,5904,7,0.281778,0.294063,103.241764,0.001177,0.000468,146,0.000307,0,31,0.513889,0.010061
47091,Johnson County,,TN,677,15799,16476,3,3,6,291,238,529,7,0.241799,0.250448,44.964431,0.000028,0.000052,104,0.00013,0,31,0.333333,0.000536
47093,Knox County,,TN,25616,415464,441080,107,86,193,18596,16953,35549,6,0.391744,0.424615,125466.921092,0.046131,0.036655,146,0.0019,0,31,0.370674,0.33183
47095,Lake County,,TN,385,6070,6455,2,2,4,175,223,398,7,0.236444,0.243293,0,0.00002,0.000012,54,0.000112,0,31,1,0.000296
47097,Lauderdale County,,TN,1562,25597,27159,7,6,13,784,910,1694,6,0.305427,0.319198,97.740544,0.001294,0.000664,54,0.000208,0,31,0.666667,0.009422
47099,Lawrence County,,TN,1838,43480,45318,6,7,13,870,910,1780,7,0.299814,0.313175,3510.935251,0.000624,0.000745,146,0.000209,0,31,0.380952,0.004896
47101,Lewis County,,TN,630,10637,11267,4,2,6,272,202,474,7,0.236945,0.243981,854.626773,0.000031,0.000026,146,0.00014,0,31,0.333333,0.000628
47103,Lincoln County,,TN,1587,33687,35274,6,10,16,848,1005,1853,7,0.301026,0.315086,689.383176,0.000892,0.00104,146,0.000165,0,31,0.555556,0.006914
47105,Loudon County,,TN,3025,46634,49659,6,6,12,2072,1858,3930,7,0.281723,0.293719,1.316667,0.000339,0.00045,146,0.000227,0,31,0.833333,0.003865
47107,McMinn County,,TN,2747,53280,56027,8,9,17,1707,1596,3303,7,0.282765,0.295842,461.355548,0.000551,0.000687,146,0.000262,0,31,0.569444,0.005399
47109,McNairy County,,TN,1455,25326,26781,6,6,12,921,780,1701,6,0.305427,0.319198,9.259553,0.00071,0.000659,54,0.000202,0,31,0.666667,0.005242
47111,Macon County,,TN,1123,22927,24050,6,7,13,672,649,1321,7,0.299629,0.312945,3403.697888,0.000651,0.000677,146,0.000176,0,31,0.5,0.005347
47113,Madison County,,TN,6575,96123,102698,20,21,41,3690,3735,7425,6,0.334562,0.355538,8411.867884,0.00256,0.00339,54,0.000568,0,31,0.257246,0.019283
47115,Marion County,,TN,1349,29889,31238,4,5,9,800,650,1450,7,0.274117,0.285412,440.789538,0.000217,0.000238,146,0.000159,0,31,0.4,0.002113
47117,Marshall County,,TN,1852,31178,33030,7,8,15,1062,1097,2159,6,0.308969,0.324059,53.519247,0.000894,0.001599,146,0.000183,0,31,0.714286,0.007687
47119,Maury County,,TN,4733,82735,87468,14,12,26,3838,2607,6445,6,0.31029,0.326349,5030.975451,0.002488,0.001981,146,0.000338,0,31,0.442857,0.018494
47121,Meigs County,,TN,903,10440,11343,3,4,7,613,579,1192,7,0.274066,0.285211,3.852914,0.000238,0.00025,146,0.000114,0,31,0.75,0.00212
47123,Monroe County,,TN,2146,40845,42991,7,6,13,1455,1221,2676,7,0.28186,0.293977,11.089296,0.00056,0.000455,146,0.000236,0,31,0.785714,0.005657
47125,Montgomery County,,TN,18490,139248,157738,63,63,126,10826,10193,21019,6,0.380852,0.411071,20915.421777,0.026678,0.025158,146,0.000914,0,31,0.448908,0.188631
47127,Moore County,,TN,426,5512,5938,4,3,7,241,263,504,8,0.231967,0.238707,0,0.000037,0.000024,146,0.000136,0,31,0.916667,0.000654
47129,Morgan County,,TN,1296,22097,23393,6,5,11,838,778,1616,7,0.281832,0.293776,225.374735,0.000333,0.000415,146,0.000237,0,31,0.466667,0.003566
47131,Obion County,,TN,2133,35369,37502,7,8,15,1074,1045,2119,6,0.309199,0.324403,9131.01461,0.000687,0.001207,54,0.000282,0,31,0.410714,0.005123
47133,Overton County,,TN,1327,24047,25374,5,6,11,708,757,1465,7,0.299505,0.312744,3992.200358,0.000027,0.00063,146,0.000213,0,31,0.333333,0.000867
47135,Perry County,,TN,460,7691,8151,0,2,2,0,87,87,8,0.200843,0.205626,0,0,0.000001,146,0.000051,0,221,0,0
47137,Pickett County,,TN,246,4352,4598,0,1,1,0,41,41,8,0.230537,0.236454,0,0,0,146,0.000051,0,222,0,0
47139,Polk County,,TN,1185,15145,16330,4,4,8,735,737,1472,7,0.240716,0.248668,64.230216,0.000241,0.000054,146,0.000163,0,31,0.4,0.002358
47141,Putnam County,,TN,4504,60935,65439,17,13,30,2453,2113,4566,6,0.310821,0.327353,13190.341984,0.003119,0.001995,146,0.000467,0,31,0.362745,0.023761
47143,Rhea County,,TN,1530,29838,31368,5,6,11,813,795,1608,7,0.28271,0.295383,22.228635,0.000251,0.000649,146,0.00018,0,31,0.633333,0.002482
47145,Roane County,,TN,3003,50740,53743,10,10,20,1852,1839,3691,7,0.282793,0.296015,59.415992,0.000358,0.000703,146,0.000347,0,31,0.481818,0.004458
47147,Robertson County,,TN,4965,70236,75201,11,11,22,4019,3409,7428,6,0.310887,0.32686,211.956435,0.001368,0.001896,146,0.000241,0,31,0.606061,0.011147
47149,Rutherford County,,TN,15920,213179,229099,48,40,88,14245,10130,24375,6,0.367874,0.394588,20384.027211,0.016051,0.01422,146,0.000913,0,31,0.321104,0.118167
47151,Scott County,,TN,800,20844,21644,4,4,8,273,329,602,7,0.281696,0.293403,1161.256246,0.000309,0.000386,146,0.000203,0,31,0.333333,0.003129
47153,Sequatchie County,,TN,670,10860,11530,3,3,6,437,362,799,7,0.273936,0.284809,1.583333,0.000215,0.000231,146,0.00013,0,31,0.666667,0.001971
47155,Sevier County,,TN,5655,74309,79964,10,8,18,2745,2812,5557,7,0.301746,0.31613,211.018028,0.001967,0.001303,146,0.000306,0,31,0.484848,0.016511
47157,Shelby County,,TN,49475,1012356,1061831,206,217,423,31732,38507,70239,5,0.439069,0.482449,335283.77906,0.073881,0.079435,54,0.003162,0,31,0.222243,0.517318
47159,Smith County,,TN,1281,19098,20379,9,8,17,932,806,1738,7,0.299474,0.312917,613.089454,0.00079,0.000835,146,0.000252,0,31,0.611111,0.006906
47161,Stewart County,,TN,997,12600,13597,3,3,6,465,439,904,7,0.280417,0.29163,9.224127,0.000403,0.00036,146,0.000104,0,31,0.666667,0.002796
47163,Sullivan County,,TN,8995,171877,180872,17,18,35,5450,5568,11018,7,0.303543,0.319941,35268.691156,0.00145,0.001679,146,0.000614,0,31,0.269048,0.013452
47165,Sumner County,,TN,10037,138926,148963,22,21,43,7511,6411,13922,6,0.339888,0.361346,3369.511958,0.00663,0.004121,146,0.000437,0,31,0.42029,0.049369
47167,Tipton County,,TN,3665,50913,54578,6,7,13,2800,2336,5136,6,0.308969,0.323915,219.727366,0.001813,0.001284,54,0.000183,0,31,0.5,0.013171
47169,Trousdale County,,TN,423,6578,7001,4,5,9,308,285,593,7,0.299289,0.312228,0,0.000644,0.000672,146,0.000121,0,31,1,0.005102
47171,Unicoi County,,TN,1134,19102,20236,3,4,7,548,682,1230,7,0.240756,0.249277,0,0.000035,0.000048,146,0.000141,0,31,1,0.000612
47173,Union County,,TN,1181,17403,18584,4,4,8,966,848,1814,7,0.281696,0.293403,3.925433,0.00032,0.000394,146,0.00016,0,31,0.666667,0.003214
47175,Van Buren County,,TN,415,5330,5745,2,2,4,143,148,291,8,0.212296,0.217689,0,0.000002,0.000006,146,0.000131,0,31,1,0.000257
47177,Warren County,,TN,1559,38670,40229,8,7,15,877,791,1668,7,0.269338,0.280244,5906.672108,0.000722,0.000177,146,0.000293,0,31,0.444444,0.005974
47179,Washington County,,TN,8201,111540,119741,17,15,32,4827,4702,9529,6,0.316305,0.3349,15718.25143,0.002742,0.003369,146,0.000502,0,31,0.326316,0.022508
47181,Wayne County,,TN,799,14789,15588,2,3,5,230,337,567,7,0.237799,0.24555,2.743819,0.000023,0.000021,146,0.000091,0,31,0.333333,0.000288
47183,Weakley County,,TN,2112,32425,34537,7,10,17,881,1114,1995,6,0.309298,0.324805,5338.44739,0.000724,0.001244,54,0.000226,0,31,0.5,0.005346
47185,White County,,TN,1164,22214,23378,6,5,11,512,619,1131,7,0.237429,0.245347,359.249982,0.000035,0.000059,146,0.000261,0,31,0.366667,0.001081
47187,Williamson County,,TN,12612,142116,154728,52,37,89,10649,8152,18801,6,0.373457,0.400184,7486.412421,0.028551,0.018671,146,0.000761,0,31,0.580189,0.204531
47189,Wilson County,,TN,7322,101948,109270,16,18,34,6135,4736,10871,6,0.319331,0.338717,860.915857,0.003255,0.002818,146,0.000359,0,31,0.460526,0.025484
48001,Anderson County,,TX,3255,44482,47737,12,15,27,1533,1702,3235,6,0.326696,0.346424,52.536084,0.004235,0.005321,152,0.000236,0,31,0.65,0.032783
48003,Andrews County,,TX,1148,14205,15353,2,3,5,252,377,629,7,0.261952,0.272272,0.441667,0.000198,0.000163,152,0.00008,0,31,0.666667,0.001441
48005,Angelina County,,TX,4986,84786,89772,21,22,43,2640,2839,5479,6,0.33181,0.35198,1517.487158,0.004719,0.005937,152,0.000412,0,31,0.450593,0.037094
48007,Aransas County,,TX,1957,20241,22198,7,5,12,1118,772,1890,6,0.326476,0.343796,0,0.00372,0.00284,152,0.000136,0,31,0.952381,0.027222
48009,Archer County,,TX,968,10654,11622,2,1,3,617,498,1115,7,0.271351,0.282568,0,0.000204,0.00017,152,0.000085,0,31,1,0.001445
48011,Armstrong County,,TX,220,2089,2309,1,2,3,48,105,153,7,0.260776,0.270751,0,0.000093,0.000155,152,0.000069,0,31,1,0.00086
48013,Atascosa County,,TX,3575,45683,49258,8,6,14,2600,2401,5001,6,0.328061,0.346149,54.958168,0.002882,0.003463,152,0.000191,0,31,0.625,0.0212
48015,Austin County,,TX,1956,28399,30355,6,7,13,1435,1115,2550,6,0.32131,0.33859,3.2,0.001334,0.001532,152,0.000152,0,31,0.690476,0.010604
48017,Bailey County,,TX,601,7195,7796,4,3,7,220,182,402,7,0.266569,0.277687,3.265107,0.000238,0.000198,152,0.000134,0,31,0.583333,0.001939
48019,Bandera County,,TX,1622,17706,19328,5,5,10,1146,915,2061,6,0.325378,0.342568,5.821591,0.002706,0.001931,152,0.000133,0,31,0.766667,0.020242
48021,Bastrop County,,TX,5881,65416,71297,15,13,28,5932,3912,9844,6,0.330451,0.349937,108.737242,0.006759,0.005554,152,0.000254,0,31,0.731618,0.050345
48023,Baylor County,,TX,289,3804,4093,0,1,1,0,47,47,7,0.271394,0.282643,0,0,0.00017,152,0.000051,0,223,0,0
48025,Bee County,,TX,1866,24681,26547,8,10,18,871,954,1825,6,0.326549,0.34468,1116.138321,0.002189,0.002524,152,0.000177,0,31,0.490909,0.016399
48027,Bell County,,TX,45110,267602,312712,144,147,291,25508,26198,51706,5,0.408841,0.448634,23492.141551,0.060145,0.061682,152,0.001795,0,31,0.32977,0.423748
48029,Bexar County,,TX,80501,1577205,1657706,300,278,578,71407,65007,136414,5,0.44732,0.496258,184986.961486,0.09995,0.095908,152,0.004002,0,31,0.18908,0.699687
48031,Blanco County,,TX,790,9431,10221,5,6,11,460,399,859,6,0.313607,0.329138,0.686111,0.001663,0.001773,152,0.000132,0,31,0.738095,0.012543
48033,Borden County,,TX,78,897,975,0,0,0,0,0,0,0,0,0,0,0,0,147,0.000051,133,224,0,0
48035,Bosque County,,TX,1663,18251,19914,7,6,13,985,815,1800,6,0.312057,0.327772,10.896142,0.002961,0.001158,152,0.000174,0,31,0.767857,0.022148
48037,Bowie County,,TX,6540,92322,98862,22,19,41,3744,3813,7557,6,0.331924,0.352806,8151.528768,0.006601,0.006164,152,0.000475,0,31,0.38587,0.050487
48039,Brazoria County,,TX,18936,276004,294940,40,41,81,17255,13188,30443,6,0.351404,0.376762,1599.065014,0.015365,0.012959,152,0.000568,0,31,0.441931,0.112431
48041,Brazos County,,TX,13517,127864,141381,44,40,84,7756,8567,16323,6,0.351489,0.376791,2132.79542,0.012542,0.014145,152,0.000724,0,31,0.446003,0.095346
48043,Brewster County,,TX,1041,8422,9463,4,6,10,306,327,633,6,0.310455,0.326119,3080.338416,0.001367,0.001411,152,0.000108,0,31,0.533333,0.009822
48045,Briscoe County,,TX,143,1954,2097,0,0,0,0,0,0,0,0,0,0,0,0,148,0.000051,134,225,0,0
48047,Brooks County,,TX,528,7945,8473,1,4,5,108,303,411,7,0.280201,0.292933,0,0.000034,0.000603,152,0.000066,0,31,1,0.000288
48049,Brown County,,TX,2588,36826,39414,15,15,30,1165,1104,2269,6,0.326733,0.345305,12215.626899,0.004906,0.004523,152,0.000416,0,31,0.473684,0.035933
48051,Burleson County,,TX,1235,17621,18856,5,4,9,776,607,1383,6,0.321203,0.338074,0.7,0.001182,0.001164,152,0.000133,0,31,0.7,0.008981
48053,Burnet County,,TX,3485,40549,44034,11,11,22,2294,1860,4154,6,0.339649,0.359539,198.658893,0.005083,0.004783,152,0.000212,0,31,0.653846,0.037692
48055,Caldwell County,,TX,3859,37607,41466,9,10,19,3152,2762,5914,6,0.329214,0.347871,5.247833,0.003011,0.004037,152,0.000187,0,31,0.877778,0.023221
48057,Calhoun County,,TX,1628,21707,23335,4,8,12,513,782,1295,6,0.326659,0.344427,450.504178,0.001298,0.002955,152,0.000114,0,31,0.642857,0.009719
48059,Callahan County,,TX,1185,13182,14367,2,2,4,581,519,1100,7,0.265861,0.27651,0,0.00016,0.000144,152,0.000091,0,31,1,0.001277
48061,Cameron County,,TX,15171,359494,374665,50,44,94,9795,9104,18899,6,0.369889,0.397383,2121.870906,0.023334,0.022061,152,0.000696,0,31,0.492402,0.172354
48063,Camp County,,TX,1211,13078,14289,6,9,15,542,791,1333,6,0.315927,0.331996,106.79353,0.001015,0.001199,152,0.000173,0,31,0.611111,0.007675
48065,Carson County,,TX,776,6926,7702,4,4,8,348,463,811,7,0.260846,0.271153,0,0.000204,0.00016,152,0.000127,0,31,1,0.001599
48067,Cass County,,TX,2427,34086,36513,10,11,21,1184,1430,2614,6,0.326476,0.345707,553.65577,0.003071,0.003107,152,0.000228,0,31,0.627273,0.022799
48069,Castro County,,TX,758,8209,8967,3,6,9,150,352,502,7,0.266667,0.278416,6.136086,0.000183,0.000321,152,0.000113,0,31,0.733333,0.00148
48071,Chambers County,,TX,4544,47501,52045,8,8,16,3715,3140,6855,6,0.32281,0.339916,2.260753,0.001641,0.001921,152,0.000163,0,31,0.811111,0.013549
48073,Cherokee County,,TX,2943,47694,50637,12,9,21,1841,1693,3534,6,0.325963,0.344731,3.137617,0.004418,0.003094,152,0.000222,0,31,0.840909,0.03285
48075,Childress County,,TX,526,6258,6784,0,0,0,0,0,0,0,0,0,0,0,0,149,0.000051,135,226,0,0
48077,Clay County,,TX,968,11757,12725,2,3,5,559,596,1155,7,0.271427,0.28297,0.75,0.000223,0.000192,152,0.000081,0,31,0.666667,0.00158
48079,Cochran County,,TX,307,3674,3981,1,2,3,63,129,192,7,0.266324,0.277153,0,0.000001,0.000147,152,0.000099,0,31,1,0.000108
48081,Coke County,,TX,369,3755,4124,2,1,3,116,123,239,7,0.261928,0.271726,0,0.000132,0.000114,152,0.000089,0,31,1,0.001032
48083,Coleman County,,TX,701,8748,9449,3,3,6,211,246,457,6,0.313269,0.328472,0,0.000318,0.001057,152,0.000104,0,31,0.916667,0.002424
48085,Collin County,,TX,60355,611516,671871,183,160,343,70930,49696,120626,5,0.424313,0.463149,37303.701375,0.078387,0.068824,152,0.002313,0,31,0.313581,0.537778
48087,Collingsworth County,,TX,292,3005,3297,0,0,0,0,0,0,0,0,0,0,0,0,150,0.000051,136,227,0,0
48089,Colorado County,,TX,1168,21448,22616,7,7,14,842,643,1485,6,0.322273,0.339675,7.895752,0.002123,0.002117,152,0.000151,0,31,0.589286,0.016159
48091,Comal County,,TX,7595,90828,98423,26,19,45,7298,4903,12201,6,0.343344,0.365048,313.113513,0.00877,0.00764,152,0.000446,0,31,0.632308,0.068704
48093,Comanche County,,TX,952,14292,15244,5,4,9,391,411,802,6,0.31209,0.3276,6.898388,0.001813,0.000963,152,0.000148,0,31,0.85,0.013379
48095,Concho County,,TX,332,2651,2983,1,0,1,71,0,71,0,0,0,0,0.00013,0,152,0.000066,0,13,0,0.000925
48097,Cooke County,,TX,3074,40480,43554,9,7,16,1844,1758,3602,6,0.318596,0.335336,1380.180633,0.002887,0.002977,152,0.000213,0,31,0.625,0.021867
48099,Coryell County,,TX,12964,53910,66874,30,31,61,6808,7060,13868,6,0.357591,0.382696,660.128478,0.014462,0.015076,152,0.000405,0,31,0.645646,0.103845
48101,Cottle County,,TX,132,1852,1984,0,0,0,0,0,0,0,0,0,0,0,0,151,0.000051,137,228,0,0
48103,Crane County,,TX,369,4255,4624,1,2,3,53,128,181,7,0.261881,0.271985,0,0.000084,0.000161,152,0.000064,0,31,1,0.000643
48105,Crockett County,,TX,300,4180,4480,1,0,1,73,0,73,0,0,0,0,0.00013,0,152,0.000066,0,14,0,0.000925
48107,Crosby County,,TX,758,7663,8421,1,1,2,245,335,580,7,0.266275,0.276923,0,0.000161,0.000145,152,0.00007,0,31,0,0.001234
48109,Culberson County,,TX,384,2952,3336,1,2,3,42,99,141,6,0.288639,0.301808,3.85775,0.000003,0.000493,100,0.000076,0,31,0.666667,0.000112
48111,Dallam County,,TX,792,7268,8060,2,2,4,93,138,231,7,0.260776,0.270751,0,0.000088,0.000155,152,0.000095,0,31,1,0.000641
48113,Dallas County,,TX,187530,2291329,2478859,325,346,671,119580,170506,290086,5,0.461172,0.514669,329985.623335,0.105494,0.108007,152,0.0045,0,31,0.153435,0.726956
48115,Dawson County,,TX,1079,13177,14256,4,3,7,324,389,713,7,0.266544,0.277756,3.946078,0.000314,0.000245,152,0.000131,0,31,0.666667,0.002316
48117,Deaf Smith County,,TX,1567,19651,21218,5,5,10,480,630,1110,7,0.266642,0.278243,18.953556,0.000216,0.000303,152,0.000145,0,31,0.5,0.001921
48119,Delta County,,TX,518,4968,5486,4,3,7,295,281,576,7,0.246645,0.255283,0,0.000992,0.000089,152,0.000116,0,31,1,0.007138
48121,Denton County,,TX,50895,484471,535366,149,134,283,56414,40580,96994,5,0.411099,0.448605,35688.896151,0.060179,0.053122,152,0.001999,0,31,0.298399,0.414394
48123,DeWitt County,,TX,1103,20297,21400,6,5,11,640,516,1156,6,0.326329,0.343624,1038.799018,0.002096,0.002603,152,0.000164,0,31,0.666667,0.015769
48125,Dickens County,,TX,177,2204,2381,1,0,1,40,0,40,0,0,0,0,0.000161,0,152,0.00007,0,10,0,0.001234
48127,Dimmit County,,TX,745,10126,10871,2,3,5,166,217,383,6,0.309199,0.323709,0,0.000799,0.000864,152,0.000095,0,31,1,0.006042
48129,Donley County,,TX,312,3542,3854,1,2,3,59,97,156,7,0.260776,0.270751,0,0.000093,0.000155,152,0.000069,0,31,1,0.00086
48131,Duval County,,TX,1042,14954,15996,3,4,7,358,594,952,6,0.309628,0.324426,0,0.001275,0.001122,152,0.000089,0,31,1,0.009391
48133,Eastland County,,TX,1368,17633,19001,8,8,16,614,587,1201,6,0.313472,0.32939,378.369839,0.00109,0.00113,152,0.00024,0,31,0.464286,0.008831
48135,Ector County,,TX,8194,133415,141609,28,33,61,4176,4919,9095,6,0.349753,0.374615,22387.466583,0.008753,0.010204,152,0.000529,0,31,0.335586,0.064854
48137,Edwards County,,TX,318,4319,4637,1,1,2,40,42,82,7,0.257401,0.266066,0,0.000062,0.000049,152,0.000066,0,31,0,0.000441
48139,Ellis County,,TX,9618,128054,137672,18,20,38,9765,6549,16314,6,0.343506,0.365335,150.415117,0.007425,0.008311,152,0.000314,0,31,0.656126,0.055227
48141,El Paso County,,TX,39179,781730,820909,127,140,267,21077,27218,48295,5,0.404739,0.443842,45258.33593,0.050939,0.055743,100,0.001631,0,31,0.310559,0.35491
48143,Erath County,,TX,2734,30753,33487,16,14,30,1409,1261,2670,6,0.326329,0.345879,3436.474732,0.003883,0.003628,152,0.00041,0,31,0.464052,0.029479
48145,Falls County,,TX,1234,16183,17417,6,4,10,672,752,1424,6,0.317446,0.333207,8.043666,0.002505,0.001496,152,0.000143,0,31,0.761905,0.018664
48147,Fannin County,,TX,2178,30020,32198,8,8,16,1825,1363,3188,6,0.318701,0.335623,7.331016,0.003896,0.003049,152,0.000159,0,31,0.902778,0.028982
48149,Fayette County,,TX,1348,24587,25935,7,7,14,720,620,1340,6,0.322273,0.339675,6.231452,0.001826,0.001842,152,0.000168,0,31,0.571429,0.013589
48151,Fisher County,,TX,372,4067,4439,2,2,4,94,108,202,7,0.265812,0.276395,0.333333,0.000159,0.000143,152,0.000084,0,31,0.666667,0.001203
48153,Floyd County,,TX,520,7811,8331,2,2,4,213,230,443,7,0.2663,0.277096,0,0.0002,0.000162,152,0.000087,0,31,1,0.001459
48155,Foard County,,TX,153,1564,1717,0,0,0,0,0,0,0,0,0,0,0,0,153,0.000051,138,229,0,0
48157,Fort Bend County,,TX,33422,449186,482608,86,69,155,45109,27116,72225,5,0.37729,0.408224,6305.888366,0.041102,0.030305,152,0.001048,0,31,0.419394,0.275461
48159,Franklin County,,TX,1087,11348,12435,7,5,12,640,499,1139,7,0.261716,0.272215,16.539083,0.002384,0.000208,152,0.000167,0,31,0.714286,0.017868
48161,Freestone County,,TX,1469,17778,19247,7,9,16,755,722,1477,6,0.325963,0.344731,32.480114,0.00285,0.003035,152,0.000155,0,31,0.680556,0.020896
48163,Frio County,,TX,1067,14295,15362,3,3,6,328,436,764,6,0.309166,0.323651,0.833333,0.000821,0.00087,152,0.000107,0,31,0.583333,0.006242
48165,Gaines County,,TX,996,14824,15820,6,5,11,351,374,725,7,0.266691,0.278301,70.67619,0.000297,0.000266,152,0.000173,0,31,0.5,0.002506
48167,Galveston County,,TX,20838,283923,304761,47,41,88,18079,14331,32410,6,0.354103,0.379827,1308.245016,0.01907,0.017357,152,0.000669,0,31,0.532428,0.13922
48169,Garza County,,TX,344,3863,4207,1,1,2,100,101,201,7,0.266275,0.276923,0,0.000161,0.000145,152,0.00007,0,31,0,0.001234
48171,Gillespie County,,TX,1367,24361,25728,10,4,14,875,442,1317,6,0.313539,0.328794,2.590837,0.004616,0.0016,152,0.000206,0,31,0.766667,0.034427
48173,Glasscock County,,TX,172,2606,2778,1,0,1,47,0,47,0,0,0,0,0.000114,0,152,0.000067,0,23,0,0.000799
48175,Goliad County,,TX,903,10670,11573,3,2,5,581,440,1021,7,0.248651,0.25703,0.4,0.000093,0.000062,152,0.000092,0,31,0.5,0.000853
48177,Gonzales County,,TX,1224,19350,20574,6,9,15,552,699,1251,6,0.326476,0.344312,7.168842,0.002629,0.002881,152,0.000144,0,31,0.777778,0.019339
48179,Gray County,,TX,1895,21978,23873,4,6,10,352,682,1034,6,0.3131,0.329465,101.150643,0.000195,0.001187,152,0.000135,0,31,0.8,0.001599
48181,Grayson County,,TX,7234,115835,123069,17,19,36,5066,4312,9378,6,0.345303,0.367746,510.08869,0.006752,0.008253,152,0.000319,0,31,0.554762,0.050416
48183,Gregg County,,TX,9916,130159,140075,29,32,61,6424,6660,13084,6,0.345426,0.369353,2329.873372,0.008022,0.009193,152,0.000505,0,31,0.440336,0.060689
48185,Grimes County,,TX,1879,23318,25197,8,7,15,1558,1134,2692,6,0.32131,0.33859,2.392419,0.001508,0.001542,152,0.000189,0,31,0.75,0.012768
48187,Guadalupe County,,TX,8420,100944,109364,27,19,46,7200,5458,12658,6,0.347452,0.369817,283.915977,0.010804,0.00944,152,0.000422,0,31,0.648276,0.080549
48189,Hale County,,TX,2998,37140,40138,9,12,21,1202,1591,2793,6,0.331242,0.351045,1934.487507,0.002087,0.004701,152,0.000243,0,31,0.544872,0.01551
48191,Hall County,,TX,311,3407,3718,0,0,0,0,0,0,0,0,0,0,0,0,154,0.000051,139,230,0,0
48193,Hamilton County,,TX,480,6736,7216,3,1,4,182,78,260,7,0.24606,0.253985,0.212121,0.000999,0.000032,152,0.000099,0,31,0.666667,0.007597
48195,Hansford County,,TX,520,5679,6199,0,1,1,0,51,51,8,0.20505,0.209824,0,0,0,152,0.000051,0,232,0,0
48197,Hardeman County,,TX,396,4485,4881,1,2,3,121,118,239,7,0.271402,0.282798,0,0.000009,0.000172,152,0.00009,0,31,1,0.00011
48199,Hardin County,,TX,3942,52964,56906,13,10,23,2874,2634,5508,6,0.321452,0.339164,28.454395,0.002685,0.001705,152,0.00024,0,31,0.660256,0.020974
48201,Harris County,,TX,196589,3665384,3861973,431,435,866,148222,177180,325402,5,0.472887,0.533615,507291.596675,0.12274,0.121856,152,0.005893,0,31,0.117157,0.854754
48203,Harrison County,,TX,4751,62447,67198,12,15,27,2625,2921,5546,6,0.32688,0.346711,635.843081,0.003223,0.004781,152,0.000245,0,31,0.628571,0.024815
48205,Hartley County,,TX,297,3393,3690,0,1,1,0,42,42,7,0.257787,0.267076,0,0,0.000053,152,0.000051,0,233,0,0
48207,Haskell County,,TX,544,5961,6505,2,1,3,99,89,188,7,0.265788,0.276223,2904,0.000151,0.000135,152,0.000108,0,31,0,0.001193
48209,Hays County,,TX,11005,95359,106364,33,28,61,10980,8241,19221,6,0.34477,0.367975,360.539975,0.011069,0.009775,152,0.000519,0,31,0.622103,0.085247
48211,Hemphill County,,TX,296,3547,3843,0,0,0,0,0,0,0,0,0,0,0,0,155,0.000051,140,234,0,0
48213,Henderson County,,TX,5400,71812,77212,17,15,32,6014,3466,9480,6,0.326696,0.346424,12.095531,0.005186,0.005092,152,0.0003,0,31,0.698529,0.040169
48215,Hidalgo County,,TX,22241,610789,633030,107,76,183,17262,13338,30600,6,0.377388,0.409395,39229.131644,0.037133,0.028101,152,0.00158,0,31,0.261863,0.26357
48217,Hill County,,TX,2626,32615,35241,11,7,18,2140,1420,3560,6,0.318456,0.335107,10.638656,0.004121,0.002066,152,0.000221,0,31,0.763636,0.030854
48219,Hockley County,,TX,1962,23679,25641,4,3,7,860,973,1833,7,0.266349,0.277325,2946,0.000165,0.000147,152,0.000172,0,31,0.416667,0.001538
48221,Hood County,,TX,3745,44463,48208,10,10,20,2971,2110,5081,6,0.339967,0.360526,138.117067,0.003922,0.004636,152,0.000234,0,31,0.727273,0.02979
48223,Hopkins County,,TX,2312,32661,34973,11,11,22,1413,1253,2666,6,0.318701,0.335968,876.249373,0.00245,0.002691,152,0.000267,0,31,0.530303,0.018937
48225,Houston County,,TX,1336,20788,22124,7,6,13,656,625,1281,6,0.321274,0.338418,6.075622,0.002235,0.001473,152,0.000157,0,31,0.761905,0.017264
48227,Howard County,,TX,2315,30320,32635,9,13,22,686,1025,1711,6,0.332075,0.35175,6481.570017,0.001387,0.00465,152,0.000245,0,31,0.571429,0.010194
48229,Hudspeth County,,TX,418,3237,3655,1,2,3,80,192,272,6,0.28821,0.301033,2945,0.00046,0.000421,100,0.000061,0,31,0.5,0.003001
48231,Hunt County,,TX,6991,79353,86344,18,19,37,5359,4840,10199,6,0.32688,0.347171,1330.708392,0.004285,0.005194,152,0.000352,0,31,0.571053,0.033164
48233,Hutchinson County,,TX,2021,25268,27289,6,8,14,614,853,1467,6,0.322559,0.340628,359.22428,0.000354,0.001662,152,0.000178,0,31,0.535714,0.002951
48235,Irion County,,TX,359,1933,2292,1,1,2,91,97,188,7,0.261928,0.271726,0,0.00013,0.000114,152,0.000066,0,31,0,0.000925
48237,Jack County,,TX,662,7814,8476,5,5,10,322,309,631,6,0.311956,0.327485,1.517647,0.000957,0.001003,152,0.00016,0,31,0.7,0.007604
48239,Jackson County,,TX,1016,15318,16334,5,4,9,453,484,937,6,0.321274,0.338189,0.866667,0.001131,0.001088,152,0.000121,0,31,0.8,0.008413
48241,Jasper County,,TX,2698,37723,40421,9,8,17,1493,1480,2973,6,0.321381,0.33882,437.743406,0.001339,0.001202,152,0.0002,0,31,0.555556,0.010484
48243,Jeff Davis County,,TX,227,2145,2372,1,0,1,42,0,42,0,0,0,0,0.000012,0,152,0.000066,0,12,0,0.00017
48245,Jefferson County,,TX,13951,255854,269805,34,39,73,7530,9750,17280,6,0.351021,0.376045,5724.528588,0.010762,0.013388,152,0.000538,0,31,0.503659,0.081667
48247,Jim Hogg County,,TX,422,5351,5773,1,2,3,44,86,130,7,0.28012,0.292531,0,0.000099,0.000538,152,0.000061,0,31,1,0.000706
48249,Jim Wells County,,TX,2529,39958,42487,10,11,21,1772,1668,3440,6,0.329252,0.34829,3115.879579,0.003139,0.004166,152,0.000193,0,31,0.628788,0.023614
48251,Johnson County,,TX,11630,148340,159970,27,22,49,10891,8030,18921,6,0.341205,0.363275,636.453448,0.010077,0.007945,152,0.000482,0,31,0.524138,0.074147
48253,Jones County,,TX,1566,15522,17088,1,3,4,555,707,1262,6,0.313201,0.328357,0,0.000151,0.001018,152,0.000065,0,31,0.666667,0.001105
48255,Karnes County,,TX,780,12976,13756,3,3,6,218,262,480,6,0.309232,0.323766,0.892857,0.000829,0.000861,152,0.000104,0,31,0.666667,0.00636
48257,Kaufman County,,TX,7805,81199,89004,12,14,26,9184,5724,14908,6,0.326659,0.346252,3.484781,0.004796,0.005085,152,0.000219,0,31,0.835165,0.035871
48259,Kendall County,,TX,2042,26783,28825,8,8,16,1599,1178,2777,6,0.326365,0.344025,35.393418,0.003528,0.002731,152,0.000207,0,31,0.694444,0.025941
48261,Kenedy County,,TX,0,0,0,0,0,0,0,0,0,0,0,0,0,0,0,156,0.000051,141,235,0,0
48263,Kent County,,TX,105,915,1020,0,0,0,0,0,0,0,0,0,0,0,0,157,0.000051,142,236,0,0
48265,Kerr County,,TX,3421,44942,48363,14,11,25,1660,1456,3116,6,0.330038,0.349191,103.066353,0.005092,0.004983,152,0.000309,0,31,0.591667,0.038859
48267,Kimble County,,TX,338,4417,4755,0,0,0,0,0,0,0,0,0,0,0,0,158,0.000051,143,237,0,0
48269,King County,,TX,0,0,0,0,0,0,0,0,0,0,0,0,0,0,0,159,0.000051,144,238,0,0
48271,Kinney County,,TX,315,3207,3522,0,1,1,0,49,49,7,0.257444,0.266146,0,0,0.000049,152,0.000051,0,239,0,0
48273,Kleberg County,,TX,2974,30041,33015,13,10,23,1379,1540,2919,6,0.340645,0.360652,278.381635,0.004716,0.005413,152,0.000221,0,31,0.621324,0.035248
48275,Knox County,,TX,305,4012,4317,0,1,1,0,53,53,8,0.210035,0.215183,0,0,0.000001,152,0.000051,0,240,0,0
48277,Lamar County,,TX,3006,51482,54488,14,14,28,1659,1470,3129,6,0.326439,0.345994,2758.874728,0.004046,0.004262,152,0.000297,0,31,0.485714,0.030929
48279,Lamb County,,TX,1294,14910,16204,5,5,10,541,599,1140,7,0.266642,0.278243,11.891667,0.000205,0.000268,152,0.00019,0,31,0.466667,0.001783
48281,Lampasas County,,TX,1831,17391,19222,6,6,12,1130,836,1966,6,0.307953,0.322871,1696.903064,0.00244,0.001656,152,0.000129,0,31,0.666667,0.01823
48283,La Salle County,,TX,426,5632,6058,1,3,4,43,157,200,6,0.309265,0.323823,0.75,0.000099,0.00092,152,0.000061,0,31,0.666667,0.000706
48285,Lavaca County,,TX,1043,19720,20763,7,6,13,643,538,1181,6,0.322309,0.339618,9.82628,0.001924,0.001816,152,0.000169,0,31,0.642857,0.014564
48287,Lee County,,TX,1195,15823,17018,5,8,13,512,625,1137,6,0.322309,0.339847,3.954174,0.001989,0.002224,152,0.000127,0,31,0.678571,0.015053
48289,Leon County,,TX,1224,16126,17350,6,7,13,585,513,1098,6,0.32131,0.33859,3.9921,0.001387,0.00153,152,0.000145,0,31,0.547619,0.011392
48291,Liberty County,,TX,6817,69380,76197,14,16,30,5120,5034,10154,6,0.331583,0.350947,73.614966,0.003354,0.005541,152,0.000254,0,31,0.709559,0.027062
48293,Limestone County,,TX,1500,20511,22011,7,7,14,798,715,1513,6,0.318491,0.335164,17.189784,0.002088,0.001975,152,0.000171,0,31,0.652778,0.015471
48295,Lipscomb County,,TX,318,3028,3346,1,1,2,44,46,90,8,0.205009,0.209724,0,0,0,152,0.000142,0,231,0,0.000093
48297,Live Oak County,,TX,921,9666,10587,2,4,6,196,371,567,6,0.309595,0.324369,0,0.000256,0.001141,152,0.000078,0,31,1,0.00202
48299,Llano County,,TX,1183,13660,14843,4,4,8,672,470,1142,6,0.303575,0.317396,1247.221936,0.001753,0.00104,152,0.000107,0,31,0.6,0.013329
48301,Loving County,,TX,0,0,0,0,0,0,0,0,0,0,0,0,0,0,0,160,0.000051,145,241,0,0
48303,Lubbock County,,TX,16985,245141,262126,68,62,130,11867,11127,22994,6,0.362864,0.392585,73410.228667,0.017583,0.019471,152,0.001382,0,31,0.274912,0.132515
48305,Lynn County,,TX,676,6430,7106,1,2,3,183,359,542,7,0.2663,0.277096,0,0.000161,0.000148,152,0.00007,0,31,1,0.001234
48307,McCulloch County,,TX,677,8334,9011,1,1,2,52,52,104,7,0.261952,0.271784,2.072727,0.000037,0.000114,152,0.000074,0,31,0.5,0.000394
48309,McLennan County,,TX,12357,216996,229353,47,37,84,7785,7956,15741,6,0.351616,0.376561,1474.6008,0.013474,0.012846,152,0.000774,0,31,0.442177,0.102767
48311,McMullen County,,TX,55,807,862,0,0,0,0,0,0,0,0,0,0,0,0,161,0.000051,146,242,0,0
48313,Madison County,,TX,974,10523,11497,6,6,12,474,493,967,6,0.321274,0.338418,1,0.00138,0.001515,152,0.000152,0,31,0.866667,0.011438
48315,Marion County,,TX,796,8071,8867,4,4,8,418,408,826,7,0.256877,0.26645,0,0.001033,0.000152,152,0.000107,0,31,0.95,0.007351
48317,Martin County,,TX,435,4158,4593,1,2,3,76,209,285,7,0.261504,0.271337,0,0.000114,0.0001,152,0.000067,0,31,1,0.000799
48319,Mason County,,TX,242,3512,3754,0,0,0,0,0,0,0,0,0,0,0,0,162,0.000051,147,243,0,0
48321,Matagorda County,,TX,2490,39283,41773,8,8,16,1200,1274,2474,6,0.326476,0.344198,12.535879,0.002296,0.003081,152,0.000166,0,31,0.791667,0.017629
48323,Maverick County,,TX,3016,56509,59525,11,12,23,1329,1586,2915,6,0.334023,0.354081,132.921556,0.005297,0.005364,152,0.000202,0,31,0.615385,0.03881
48325,Medina County,,TX,2865,39042,41907,7,6,13,2117,1722,3839,6,0.326292,0.343681,66.224291,0.002577,0.002615,152,0.000191,0,31,0.607143,0.019075
48327,Menard County,,TX,242,2259,2501,0,0,0,0,0,0,0,0,0,0,0,0,163,0.000051,148,244,0,0
48329,Midland County,,TX,8599,126040,134639,40,39,79,5649,5451,11100,6,0.353974,0.379919,27281.372403,0.010716,0.013822,152,0.000741,0,31,0.35119,0.082468
48331,Milam County,,TX,1815,24994,26809,9,8,17,975,1045,2020,6,0.323313,0.341001,19.146225,0.003445,0.002753,152,0.000185,0,31,0.590909,0.025695
48333,Mills County,,TX,324,4586,4910,1,1,2,40,90,130,7,0.24629,0.253776,0,0.000037,0.00004,152,0.000074,0,31,0,0.000394
48335,Mitchell County,,TX,620,6824,7444,1,3,4,43,156,199,7,0.249377,0.257606,0.492857,0.000038,0.000024,152,0.000067,0,31,0.666667,0.000184
48337,Montague County,,TX,1358,18521,19879,7,7,14,805,678,1483,6,0.320742,0.337483,458.416551,0.002431,0.002467,152,0.000162,0,31,0.690476,0.017936
48339,Montgomery County,,TX,24719,320720,345439,92,58,150,29918,17578,47496,6,0.36956,0.398508,8761.860638,0.03952,0.022182,152,0.001257,0,31,0.409174,0.277946
48341,Moore County,,TX,1847,21336,23183,5,5,10,468,607,1075,7,0.261104,0.271584,201.264441,0.000662,0.00016,152,0.000143,0,31,0.533333,0.004597
48343,Morris County,,TX,1261,15454,16715,7,7,14,789,709,1498,6,0.318631,0.335336,13.168758,0.001084,0.001915,152,0.000178,0,31,0.660714,0.008231
48345,Motley County,,TX,91,1207,1298,0,0,0,0,0,0,0,0,0,0,0,0,164,0.000051,149,245,0,0
48347,Nacogdoches County,,TX,4237,54697,58934,20,18,38,2345,2442,4787,6,0.328991,0.348858,1259.680334,0.005448,0.006196,152,0.000363,0,31,0.551383,0.042777
48349,Navarro County,,TX,2956,44338,47294,11,11,22,1765,1716,3481,6,0.326072,0.345133,22.575759,0.004024,0.0042,152,0.000221,0,31,0.736364,0.030512
48351,Newton County,,TX,902,9730,10632,3,3,6,443,475,918,7,0.259889,0.269506,0,0.000152,0.000117,152,0.000095,0,31,1,0.001194
48353,Nolan County,,TX,1307,15995,17302,5,5,10,430,438,868,6,0.318072,0.334045,780.311822,0.001001,0.001269,152,0.000167,0,31,0.5,0.00775
48355,Nueces County,,TX,23266,331144,354410,77,78,155,13700,16089,29789,6,0.376166,0.408362,16227.766831,0.02807,0.028468,152,0.001099,0,31,0.33634,0.205181
48357,Ochiltree County,,TX,753,9405,10158,2,2,4,97,89,186,7,0.257853,0.267328,5811,0,0.000053,152,0.000214,0,231,0,0.000178
48359,Oldham County,,TX,259,2168,2427,2,2,4,126,116,242,7,0.260776,0.270751,0,0.00018,0.000155,152,0.000089,0,31,1,0.001368
48361,Orange County,,TX,5338,92483,97821,10,16,26,3156,3316,6472,6,0.325123,0.344645,828.118639,0.002128,0.003792,152,0.000213,0,31,0.554167,0.015828
48363,Palo Pinto County,,TX,2056,26883,28939,9,9,18,1247,1193,2440,6,0.318596,0.335566,240.809947,0.001942,0.002001,152,0.000232,0,31,0.544444,0.014907
48365,Panola County,,TX,1678,24350,26028,7,9,16,664,931,1595,6,0.324978,0.34352,22.164434,0.002182,0.002322,152,0.000154,0,31,0.75,0.015888
48367,Parker County,,TX,8626,101975,110601,20,16,36,8137,5945,14082,6,0.338304,0.359389,421.207103,0.007698,0.006298,152,0.000361,0,31,0.614625,0.057482
48369,Parmer County,,TX,1053,10539,11592,3,6,9,283,488,771,7,0.266887,0.278777,6.063931,0.000168,0.000355,152,0.00011,0,31,0.7,0.001461
48371,Pecos County,,TX,1244,13984,15228,3,3,6,192,332,524,7,0.265545,0.276673,0,0.000659,0.000275,152,0.00009,0,31,1,0.004443
48373,Polk County,,TX,5730,54143,59873,23,25,48,2981,2466,5447,6,0.348452,0.37135,1430.278866,0.011217,0.009299,152,0.000372,0,31,0.506629,0.083157
48375,Potter County,,TX,12620,122211,134831,38,35,73,9188,9001,18189,6,0.351787,0.377313,37368.937798,0.012413,0.0113,152,0.00074,0,31,0.359911,0.090681
48377,Presidio County,,TX,1031,10095,11126,3,4,7,199,456,655,7,0.261952,0.272387,32.375179,0.000556,0.000174,152,0.000089,0,31,0.8,0.003814
48379,Rains County,,TX,770,8706,9476,6,5,11,688,422,1110,6,0.315789,0.331307,0.309524,0.001872,0.000994,152,0.000147,0,31,0.933333,0.013811
48381,Randall County,,TX,11008,97798,108806,28,29,57,8106,7795,15901,6,0.347202,0.371476,29460.555111,0.00638,0.010556,152,0.000688,0,31,0.336134,0.047713
48383,Reagan County,,TX,308,3534,3842,0,0,0,0,0,0,0,0,0,0,0,0,165,0.000051,150,246,0,0
48385,Real County,,TX,281,3045,3326,1,1,2,49,44,93,7,0.246164,0.253483,0,0.000022,0.000032,152,0.000076,0,31,0,0.00033
48387,Red River County,,TX,968,13651,14619,3,3,6,402,458,860,6,0.315927,0.33125,0.457515,0.000978,0.000959,152,0.000101,0,31,0.833333,0.007024
48389,Reeves County,,TX,1150,12538,13688,4,5,9,255,507,762,6,0.310389,0.32589,228.33957,0.000201,0.001407,152,0.000124,0,31,0.633333,0.001661
48391,Refugio County,,TX,630,8177,8807,3,4,7,181,286,467,7,0.273807,0.285707,0,0.000372,0.000361,152,0.000089,0,31,1,0.002822
48393,Roberts County,,TX,132,850,982,0,0,0,0,0,0,0,0,0,0,0,0,166,0.000051,151,247,0,0
48395,Robertson County,,TX,1482,16576,18058,3,5,8,620,835,1455,6,0.324614,0.342487,1.61757,0.002014,0.002127,152,0.000089,0,31,0.85,0.014371
48397,Rockwall County,,TX,4651,47337,51988,10,9,19,6147,2977,9124,6,0.326476,0.345391,7.077536,0.005366,0.004722,152,0.00018,0,31,0.9,0.039627
48399,Runnels County,,TX,1028,11955,12983,2,3,5,249,350,599,6,0.268417,0.27962,11.297675,0.000281,0.000249,152,0.000081,0,31,0.666667,0.002031
48401,Rusk County,,TX,3215,42407,45622,11,10,21,2009,2047,4056,6,0.325999,0.344904,7.94115,0.003525,0.003129,152,0.000219,0,31,0.772727,0.026729
48403,Sabine County,,TX,794,10230,11024,5,5,10,330,247,577,6,0.321274,0.338303,257.99397,0.001159,0.001117,152,0.000133,0,31,0.666667,0.008666
48405,San Augustine County,,TX,569,8370,8939,4,4,8,225,274,499,7,0.24957,0.258203,1,0.001074,0.000103,152,0.000123,0,31,0.8,0.008059
48407,San Jacinto County,,TX,1852,18513,20365,6,5,11,1823,1223,3046,6,0.322595,0.339228,0,0.001611,0.001508,152,0.000135,0,31,0.966667,0.013561
48409,San Patricio County,,TX,7705,69696,77401,19,23,42,4198,4261,8459,6,0.350555,0.373496,1550.821705,0.008054,0.010803,152,0.000311,0,31,0.536667,0.059775
48411,San Saba County,,TX,448,5420,5868,2,1,3,85,47,132,7,0.246331,0.253862,3.835714,0.000022,0.00004,152,0.000092,0,31,0,0.000433
48413,Schleicher County,,TX,315,3120,3435,1,0,1,46,0,46,0,0,0,0,0.00013,0,152,0.000066,0,11,0,0.000925
48415,Scurry County,,TX,1203,15369,16572,8,5,13,414,315,729,6,0.273343,0.285658,255.807941,0.000567,0.000413,152,0.000205,0,31,0.5,0.004365
48417,Shackelford County,,TX,316,3570,3886,1,1,2,51,68,119,7,0.265788,0.276223,0,0.000151,0.000135,152,0.000065,0,31,0,0.001105
48419,Shelby County,,TX,1248,23859,25107,6,6,12,645,551,1196,6,0.32131,0.338476,263.442597,0.001137,0.001134,152,0.000162,0,31,0.5,0.008738
48421,Sherman County,,TX,258,2542,2800,0,0,0,0,0,0,0,0,0,0,0,0,167,0.000051,152,248,0,0
48423,Smith County,,TX,12013,189724,201737,53,42,95,9208,7907,17115,6,0.353974,0.380091,3818.990193,0.016627,0.013832,152,0.00083,0,31,0.408835,0.124958
48425,Somervell County,,TX,665,7366,8031,5,3,8,431,260,691,6,0.311889,0.327141,0.25,0.00185,0.000997,152,0.000138,0,31,0.85,0.013788
48427,Starr County,,TX,2887,58676,61563,10,9,19,1479,1755,3234,6,0.344566,0.365593,410.628194,0.005726,0.005592,152,0.000179,0,31,0.836364,0.04034
48429,Stephens County,,TX,873,9315,10188,3,4,7,175,253,428,7,0.265983,0.277027,3.09176,0.001005,0.00018,152,0.000103,0,31,0.65,0.007592
48431,Sterling County,,TX,128,1258,1386,0,0,0,0,0,0,0,0,0,0,0,0,168,0.000051,153,249,0,0
48433,Stonewall County,,TX,157,1509,1666,0,0,0,0,0,0,0,0,0,0,0,0,169,0.000051,154,250,0,0
48435,Sutton County,,TX,371,4758,5129,1,1,2,62,60,122,7,0.261928,0.271726,0,0.00013,0.000114,152,0.000066,0,31,0,0.000925
48437,Swisher County,,TX,835,7663,8498,4,4,8,286,395,681,7,0.266618,0.278071,0,0.00038,0.000318,152,0.000125,0,31,1,0.002827
48439,Tarrant County,,TX,110220,1594791,1705011,341,318,659,100133,94541,194674,5,0.453042,0.505521,245624.185581,0.106834,0.102372,152,0.004745,0,31,0.148115,0.744209
48441,Taylor County,,TX,12453,129658,142111,49,57,106,6085,7136,13221,6,0.361959,0.390915,42832.081908,0.016302,0.01827,152,0.000975,0,31,0.349868,0.120502
48443,Terrell County,,TX,84,959,1043,0,0,0,0,0,0,0,0,0,0,0,0,170,0.000051,155,251,0,0
48445,Terry County,,TX,1119,11836,12955,2,3,5,233,504,737,7,0.266373,0.277383,1.5,0.000163,0.000149,152,0.000099,0,31,0.666667,0.001353
48447,Throckmorton County,,TX,168,1769,1937,0,0,0,0,0,0,0,0,0,0,0,0,171,0.000051,156,252,0,0
48449,Titus County,,TX,1816,24665,26481,6,6,12,847,806,1653,6,0.315927,0.331652,139.36813,0.000992,0.001425,152,0.00017,0,31,0.52381,0.007487
48451,Tom Green County,,TX,10072,108836,118908,36,42,78,4115,5004,9119,6,0.354839,0.381325,35705.538429,0.013787,0.015723,152,0.000772,0,31,0.363265,0.100389
48453,Travis County,,TX,83725,838460,922185,221,219,440,62148,72649,134797,5,0.435578,0.480005,86114.970867,0.08524,0.08543,152,0.002876,0,31,0.251424,0.582042
48455,Trinity County,,TX,1187,12716,13903,6,6,12,757,712,1469,6,0.322631,0.3394,1.810978,0.001376,0.001538,152,0.000147,0,31,0.866667,0.011565
48457,Tyler County,,TX,1303,17652,18955,7,7,14,806,748,1554,6,0.322703,0.339629,4.312954,0.001298,0.001284,152,0.000155,0,31,0.785714,0.009968
48459,Upshur County,,TX,2873,33530,36403,13,9,22,2074,1798,3872,6,0.32476,0.343176,367.305887,0.004077,0.002195,152,0.00025,0,31,0.615385,0.031075
48461,Upton County,,TX,390,3470,3860,0,2,2,0,95,95,7,0.261924,0.272064,0,0,0.000161,152,0.000051,0,253,1,0
48463,Uvalde County,,TX,2107,28096,30203,10,9,19,803,958,1761,6,0.326512,0.34437,5997.651904,0.00392,0.002705,152,0.000264,0,31,0.487179,0.029098
48465,Val Verde County,,TX,4247,46675,50922,14,17,31,1412,1526,2938,6,0.346581,0.368853,8976.530749,0.005891,0.007534,152,0.000315,0,31,0.521645,0.042612
48467,Van Zandt County,,TX,4238,44989,49227,12,12,24,2948,2947,5895,6,0.326109,0.345305,29.28509,0.004073,0.004259,152,0.000235,0,31,0.818182,0.031058
48469,Victoria County,,TX,5895,89555,95450,23,25,48,3293,3920,7213,6,0.330865,0.351819,4342.469184,0.005428,0.0058,152,0.000427,0,31,0.433048,0.041939
48471,Walker County,,TX,4395,43831,48226,19,19,38,2803,2966,5769,6,0.331658,0.351406,191.870127,0.00584,0.005941,152,0.000346,0,31,0.592105,0.045034
48473,Waller County,,TX,2422,25377,27799,8,7,15,1912,1673,3585,6,0.32131,0.33859,16.184244,0.002491,0.001825,152,0.000183,0,31,0.75,0.019691
48475,Ward County,,TX,1005,10972,11977,2,3,5,199,373,572,7,0.261905,0.272157,0,0.000096,0.000162,152,0.000085,0,31,1,0.000751
48477,Washington County,,TX,1892,31592,33484,10,9,19,1132,1032,2164,6,0.322344,0.34002,17.905906,0.002327,0.002216,152,0.000232,0,31,0.566667,0.018785
48479,Webb County,,TX,7866,226139,234005,22,27,49,3872,4746,8618,6,0.356319,0.380831,7176.242734,0.010625,0.011988,152,0.000338,0,31,0.513547,0.075419
48481,Wharton County,,TX,2433,45359,47792,8,10,18,1269,1526,2795,6,0.327543,0.346241,47.065939,0.002258,0.003288,152,0.000168,0,31,0.6,0.017657
48483,Wheeler County,,TX,459,5244,5703,0,0,0,0,0,0,0,0,0,0,0,0,172,0.000051,157,254,0,0
48485,Wichita County,,TX,14058,126099,140157,56,75,131,6070,8512,14582,6,0.372355,0.404339,35330.436411,0.020607,0.024531,152,0.000962,0,31,0.302017,0.150663
48487,Wilbarger County,,TX,1200,14167,15367,4,3,7,295,434,729,6,0.314354,0.329832,3062.944821,0.000255,0.001052,152,0.00014,0,31,0.45,0.001892
48489,Willacy County,,TX,1310,19467,20777,4,4,8,520,745,1265,6,0.326109,0.34336,0,0.002312,0.002338,152,0.000104,0,31,1,0.017245
48491,Williamson County,,TX,28810,276947,305757,83,58,141,31989,21699,53688,6,0.370503,0.400052,5603.015322,0.035627,0.026276,152,0.001129,0,31,0.426724,0.252857
48493,Wilson County,,TX,2456,33874,36330,7,6,13,2234,1526,3760,6,0.325415,0.34274,54.07663,0.002209,0.002031,152,0.000182,0,31,0.642857,0.016833
48495,Winkler County,,TX,664,7314,7978,1,2,3,108,219,327,7,0.261881,0.271985,0,0.000084,0.000161,152,0.000064,0,31,1,0.000643
48497,Wise County,,TX,4324,50799,55123,9,11,20,3588,2774,6362,6,0.320955,0.338286,41.659379,0.002608,0.003321,152,0.000196,0,31,0.606061,0.019621
48499,Wood County,,TX,2411,33151,35562,15,13,28,2360,1461,3821,6,0.326146,0.345478,502.64476,0.00412,0.004271,152,0.000301,0,31,0.614286,0.031819
48501,Yoakum County,,TX,614,7967,8581,2,3,5,105,190,295,7,0.266446,0.277526,0,0.00005,0.000178,152,0.000092,0,31,1,0.000448
48503,Young County,,TX,1182,17455,18637,8,4,12,606,307,913,6,0.320601,0.336909,247.28302,0.002456,0.001931,152,0.000188,0,31,0.589286,0.018403
48505,Zapata County,,TX,573,11813,12386,3,3,6,264,223,487,7,0.274195,0.285794,0,0.001151,0.000442,152,0.00009,0,31,1,0.008434
48507,Zavala County,,TX,833,11159,11992,3,3,6,234,309,543,6,0.309199,0.323709,1,0.000821,0.000864,152,0.000115,0,31,0.833333,0.006367
49001,Beaver County,,UT,504,6557,7061,3,2,5,153,163,316,7,0.253868,0.262094,0,0.000708,0.000151,178,0.0001,0,31,1,0.004815
49003,Box Elder County,,UT,3238,50972,54210,6,8,14,1917,2172,4089,6,0.316892,0.333224,5848,0.001359,0.002272,178,0.000165,0,31,0.75,0.008686
49005,Cache County,,UT,8513,98312,106825,26,28,54,4506,5067,9573,6,0.342332,0.364658,4939.917175,0.007939,0.009023,178,0.000434,0,31,0.394958,0.058014
49007,Carbon County,,UT,1646,21534,23180,5,7,12,750,765,1515,6,0.298735,0.313395,3.377927,0.001206,0.001312,178,0.000108,0,31,0.696429,0.007337
49009,Daggett County,,UT,98,846,944,0,0,0,0,0,0,0,0,0,0,0,0,173,0.000051,158,255,0,0
49011,Davis County,,UT,23447,284402,307849,55,50,105,19461,16956,36417,6,0.358253,0.386312,4619.716165,0.021928,0.021143,178,0.000734,0,31,0.464038,0.155868
49013,Duchesne County,,UT,1310,16476,17786,4,4,8,614,650,1264,6,0.29806,0.312018,0,0.001129,0.000977,178,0.000093,0,31,1,0.006801
49015,Emery County,,UT,853,11574,12427,3,4,7,307,438,745,6,0.297816,0.311771,0,0.001015,0.000895,178,0.000081,0,31,0.916667,0.005813
49017,Garfield County,,UT,445,4843,5288,1,2,3,40,129,169,7,0.253891,0.262152,0,0.000393,0.000151,178,0.00006,0,31,1,0.002118
49019,Grand County,,UT,793,8697,9490,1,3,4,79,172,251,6,0.298366,0.31246,0,0.000611,0.000899,178,0.000059,0,31,1,0.003542
49021,Iron County,,UT,3811,33276,37087,15,14,29,2134,2260,4394,6,0.331393,0.350385,2318.658838,0.00605,0.003509,178,0.000303,0,31,0.51634,0.042775
49023,Juab County,,UT,670,8901,9571,3,3,6,448,447,895,6,0.297785,0.311599,0,0.001014,0.000796,178,0.000086,0,31,1,0.005833
49025,Kane County,,UT,601,5953,6554,4,4,8,211,244,455,6,0.31507,0.330154,0.277778,0.000824,0.001283,178,0.000113,0,31,0.9,0.005721
49027,Millard County,,UT,851,12962,13813,4,5,9,400,502,902,6,0.297846,0.311943,0,0.001101,0.000944,178,0.000109,0,31,1,0.006933
49029,Morgan County,,UT,620,8648,9268,3,3,6,336,385,721,6,0.295964,0.309866,0,0.000891,0.000806,178,0.000085,0,31,1,0.005892
49031,Piute County,,UT,114,1309,1423,0,0,0,0,0,0,0,0,0,0,0,0,174,0.000051,159,256,0,0
49033,Rich County,,UT,149,2045,2194,1,0,1,42,0,42,0,0,0,0,0.000074,0,178,0.000064,0,28,0,0.000585
49035,Salt Lake County,,UT,59709,1007622,1067331,146,196,342,36504,49206,85710,5,0.419714,0.463763,95610.155662,0.060729,0.074044,178,0.001851,0,31,0.282516,0.422233
49037,San Juan County,,UT,1327,8852,10179,4,7,11,554,749,1303,6,0.299042,0.313797,5.65276,0.001132,0.001087,100,0.0001,0,31,0.547619,0.006715
49039,Sanpete County,,UT,1651,22128,23779,8,8,16,1097,1073,2170,6,0.297968,0.312517,5.689332,0.001373,0.001141,178,0.000177,0,31,0.736111,0.009184
49041,Sevier County,,UT,1409,20038,21447,6,7,13,548,864,1412,6,0.316823,0.332995,22.652864,0.001118,0.002029,178,0.000147,0,31,0.839286,0.007254
49043,Summit County,,UT,3467,32615,36082,11,12,23,2007,1811,3818,6,0.340685,0.360468,97.947653,0.00725,0.00649,178,0.000179,0,31,0.862637,0.050313
49045,Tooele County,,UT,4285,49895,54180,11,9,20,3806,2550,6356,6,0.336618,0.355515,9.504493,0.003892,0.004498,178,0.000197,0,31,0.780303,0.027973
49047,Uintah County,,UT,1928,26108,28036,6,10,16,711,958,1669,6,0.317516,0.334343,20.454582,0.001367,0.002364,178,0.000127,0,31,0.609091,0.008742
49049,Utah County,,UT,30465,398325,428790,93,118,211,20170,23270,43440,5,0.39222,0.429419,33497.898708,0.034282,0.04761,178,0.001233,0,31,0.351819,0.244837
49051,Wasatch County,,UT,1445,17287,18732,7,5,12,1145,815,1960,6,0.297877,0.312001,0.225,0.003542,0.00101,178,0.000139,0,31,0.964286,0.024885
49053,Washington County,,UT,7475,95787,103262,38,22,60,8132,4870,13002,6,0.340166,0.360985,6046.504903,0.012197,0.008179,178,0.000605,0,31,0.38478,0.087609
49055,Wayne County,,UT,318,2589,2907,0,0,0,0,0,0,0,0,0,0,0,0,175,0.000051,160,257,0,0
49057,Weber County,,UT,16483,221449,237932,37,31,68,11530,11725,23255,6,0.346995,0.370047,2531.72455,0.014941,0.012738,178,0.000519,0,31,0.481098,0.107283
50001,Addison County,,VT,2434,41647,44081,3,8,11,1070,1252,2322,6,0.29932,0.314778,23.798353,0.000219,0.001021,103,0.000097,0,31,0.553571,0.001566
50003,Bennington County,,VT,2436,42725,45161,6,8,14,803,953,1756,7,0.273215,0.286671,15.448856,0.000224,0.000841,103,0.000141,0,31,0.472222,0.00219
50005,Caledonia County,,VT,1815,34086,35901,8,8,16,859,897,1756,7,0.265399,0.276763,683.533503,0.000309,0.000344,103,0.000227,0,31,0.553571,0.00292
50007,Chittenden County,,VT,11730,182704,194434,49,53,102,6240,6791,13031,6,0.360521,0.388258,36044.022575,0.021018,0.024582,103,0.000665,0,31,0.478423,0.133105
50009,Essex County,,VT,536,7399,7935,2,3,5,236,272,508,8,0.21792,0.224997,2.593055,0.000012,0.000027,103,0.000091,0,31,0.333333,0.000354
50011,Franklin County,,VT,2207,47186,49393,5,3,8,1377,1027,2404,7,0.26506,0.275385,4.45,0.00022,0.000184,103,0.000166,0,31,0.4,0.001692
50013,Grand Isle County,,VT,714,8376,9090,2,2,4,547,375,922,7,0.265036,0.275213,0,0.000204,0.000175,103,0.000108,0,31,1,0.001288
50015,Lamoille County,,VT,1922,26617,28539,6,5,11,1002,947,1949,7,0.265133,0.275787,141.988873,0.001024,0.000194,103,0.000194,0,31,0.6,0.006713
50017,Orange County,,VT,2312,34876,37188,8,6,14,1581,1322,2903,7,0.265399,0.276533,36.289578,0.001121,0.000342,103,0.000167,0,31,0.75,0.007821
50019,Orleans County,,VT,1183,30816,31999,6,4,10,607,431,1038,7,0.265109,0.275615,372.361757,0.000247,0.000199,103,0.000175,0,31,0.666667,0.002079
50021,Rutland County,,VT,3249,73455,76704,11,9,20,1328,1199,2527,7,0.270366,0.283128,265.828666,0.001907,0.000485,103,0.000198,0,31,0.403846,0.012025
50023,Washington County,,VT,4137,66455,70592,10,12,22,1900,2150,4050,6,0.300062,0.316271,460.6005,0.001702,0.001468,103,0.000237,0,31,0.5,0.011113
50025,Windham County,,VT,3212,50874,54086,15,10,25,1473,1346,2819,6,0.300155,0.31603,427.643529,0.005341,0.002008,103,0.000198,0,31,0.558824,0.032368
50027,Windsor County,,VT,4603,68128,72731,16,15,31,2570,2474,5044,6,0.331356,0.350981,2734.922237,0.004752,0.003295,103,0.000252,0,31,0.452381,0.029739
51001,Accomack County,,VA,1737,38011,39748,6,5,11,490,569,1059,6,0.290865,0.3052,28.320672,0.001184,0.000963,126,0.000168,0,31,0.366667,0.009348
51003,Albemarle County,,VA,10889,109013,119902,43,34,77,6343,6496,12839,6,0.36223,0.387816,25140.212349,0.018455,0.015451,47,0.000789,0,31,0.464539,0.133039
51005,Alleghany County,,VA,931,20051,20982,4,3,7,275,261,536,8,0.218362,0.225016,8809.408439,0.000005,0.000002,104,0.000338,0,31,0,0.000406
51007,Amelia County,,VA,1050,14556,15606,6,7,13,746,656,1402,7,0.276861,0.289965,24.789445,0.000767,0.001003,47,0.000194,0,31,0.642857,0.007282
51009,Amherst County,,VA,1910,34088,35998,7,5,12,1277,1219,2496,7,0.241056,0.250342,53.987169,0.000078,0.000038,104,0.000231,0,31,0.452381,0.001167
51011,Appomattox County,,VA,926,16497,17423,5,6,11,437,573,1010,7,0.241036,0.250526,184.805239,0.000064,0.000031,104,0.000175,0,31,0.433333,0.00075
51013,Arlington County,,VA,43579,204337,247916,123,95,218,29222,36476,65698,5,0.389276,0.42325,7037.418981,0.071366,0.053552,47,0.001285,0,31,0.550331,0.471459
51015,Augusta County,,VA,4332,95963,100295,12,9,21,2925,2302,5227,6,0.307269,0.323927,12310.119761,0.00189,0.001109,47,0.000428,0,31,0.307692,0.015079
51017,Bath County,,VA,347,6074,6421,0,1,1,0,58,58,9,0.179277,0.182949,0,0,0,104,0.000051,0,258,0,0
51019,Bedford County,,VA,5573,82998,88571,16,14,30,4382,3468,7850,6,0.307464,0.324943,13282.079534,0.002449,0.002092,104,0.000431,0,31,0.393382,0.019643
51021,Bland County,,VA,319,7099,7418,3,2,5,180,113,293,7,0.23361,0.240798,60.520804,0.000009,0.000001,146,0.00014,0,31,0.333333,0.000317
51023,Botetourt County,,VA,2602,38987,41589,7,8,15,1906,1625,3531,7,0.276256,0.289369,12378.863711,0.000174,0.000571,104,0.000286,0,31,0.660714,0.001733
51025,Brunswick County,,VA,1059,18478,19537,5,4,9,447,429,876,7,0.271073,0.282923,2574.018613,0.000443,0.000373,47,0.000158,0,31,0.433333,0.004258
51027,Buchanan County,,VA,1175,23700,24875,5,4,9,351,636,987,8,0.22195,0.228643,685.527092,0.000003,0.000001,146,0.00019,0,31,0.3,0.00051
51029,Buckingham County,,VA,797,14359,15156,5,5,10,349,352,701,7,0.266178,0.276409,23.260058,0.00046,0.000198,47,0.000192,0,31,0.466667,0.004678
51031,Campbell County,,VA,4882,63572,68454,7,10,17,2980,3206,6186,7,0.303005,0.319184,2022.867764,0.000376,0.001669,104,0.000216,0,31,0.422222,0.003886
51033,Caroline County,,VA,2072,27474,29546,10,9,19,1924,1294,3218,6,0.307921,0.32492,18.901487,0.002546,0.002332,47,0.000201,0,31,0.766667,0.02048
51035,Carroll County,,VA,1467,35825,37292,7,7,14,726,657,1383,7,0.254714,0.264819,2516.761493,0.000022,0.00005,104,0.000267,0,31,0.303571,0.000834
51036,Charles City County,,VA,638,9722,10360,6,4,10,458,346,804,7,0.276229,0.288485,0.214286,0.000841,0.000704,47,0.000168,0,31,0.933333,0.008025
51037,Charlotte County,,VA,720,14303,15023,3,4,7,178,259,437,8,0.214904,0.221994,10.515555,0.000012,0.000007,47,0.000122,0,31,0.25,0.000332
51041,Chesterfield County,,VA,23361,326926,350287,102,79,181,21176,16609,37785,6,0.371166,0.403139,64275.641862,0.044676,0.030547,47,0.0015,0,31,0.356248,0.303292
51043,Clarke County,,VA,1241,14059,15300,6,6,12,981,775,1756,6,0.306879,0.322836,0.414286,0.00182,0.00151,47,0.000153,0,31,0.839286,0.014372
51045,Craig County,,VA,269,5876,6145,2,1,3,109,57,166,7,0.240577,0.248804,0,0.000078,0.000049,104,0.000099,0,31,1,0.00072
51047,Culpeper County,,VA,2800,41428,44228,10,9,19,2994,1511,4505,6,0.306879,0.323324,1110.157705,0.002074,0.002387,47,0.000238,0,31,0.611111,0.017157
51049,Cumberland County,,VA,709,9839,10548,6,4,10,457,344,801,7,0.27087,0.28255,20.431291,0.000764,0.000381,47,0.000198,0,31,0.6,0.007294
51051,Dickenson County,,VA,576,14876,15452,2,4,6,207,322,529,8,0.220685,0.227128,7.950794,0,0.000001,146,0.000121,0,31,0.75,0.00021
51053,Dinwiddie County,,VA,1867,26262,28129,9,9,18,1518,1298,2816,7,0.277709,0.29132,38.915802,0.000837,0.001052,47,0.000226,0,31,0.554545,0.00801
51057,Essex County,,VA,690,11597,12287,5,2,7,349,112,461,7,0.275182,0.28682,1076.722716,0.000364,0.000469,47,0.000178,0,31,0.3,0.00379
51059,Fairfax County,,VA,126116,1146303,1272419,293,301,594,92674,112107,204781,5,0.442009,0.49468,196947.689,0.112213,0.112277,47,0.003519,0,31,0.206994,0.764159
51061,Fauquier County,,VA,5424,64924,70348,16,16,32,4719,3256,7975,6,0.307269,0.324673,1188.672697,0.004932,0.003073,47,0.000308,0,31,0.457895,0.037747
51063,Floyd County,,VA,931,16458,17389,6,5,11,585,501,1086,7,0.254157,0.263729,133.713028,0.000157,0.000107,104,0.000202,0,31,0.619048,0.001466
51065,Fluvanna County,,VA,1726,21767,23493,8,6,14,1495,836,2331,7,0.2756,0.2881,190.176777,0.002152,0.000638,47,0.000199,0,31,0.571429,0.015009
51067,Franklin County,,VA,2730,57234,59964,7,10,17,1808,1590,3398,7,0.254692,0.265497,266.750644,0.000192,0.000139,104,0.000217,0,31,0.477778,0.001764
51069,Frederick County,,VA,5977,84450,90427,17,12,29,5172,3414,8586,6,0.307888,0.324925,6229.992257,0.003648,0.002785,47,0.00039,0,31,0.411765,0.030077
51071,Giles County,,VA,877,18934,19811,4,3,7,438,339,777,7,0.253868,0.262897,131.010407,0.000086,0.000042,104,0.000181,0,31,0.45,0.000734
51073,Gloucester County,,VA,2526,40658,43184,9,6,15,1650,1144,2794,7,0.281641,0.293983,1931.780887,0.002167,0.000738,47,0.000233,0,31,0.583333,0.016936
51075,Goochland County,,VA,1540,21660,23200,5,5,10,1470,897,2367,7,0.276809,0.289621,0.215909,0.000797,0.001034,47,0.000144,0,31,0.95,0.007475
51077,Grayson County,,VA,918,20225,21143,2,4,6,214,389,603,8,0.205201,0.211201,2955.166659,0.000001,0.000001,104,0.000123,0,31,0.333333,0.000216
51079,Greene County,,VA,1289,15007,16296,5,6,11,938,731,1669,7,0.266178,0.276553,3.359524,0.000182,0.000231,47,0.000171,0,31,0.7,0.001988
51081,Greensville County,,VA,776,13222,13998,3,5,8,218,319,537,8,0.23408,0.242483,5866.303501,0.000009,0.000025,47,0.000184,0,31,0.1,0.000426
51083,Halifax County,,VA,1499,39992,41491,6,6,12,433,489,922,7,0.265983,0.277305,538.109379,0.000042,0.000198,47,0.000177,0,31,0.190476,0.000779
51085,Hanover County,,VA,7075,104966,112041,15,16,31,6151,4624,10775,6,0.315755,0.335417,699.288591,0.003407,0.004503,47,0.000384,0,31,0.467836,0.028418
51087,Henrico County,,VA,28923,322067,350990,116,86,202,23989,22607,46596,6,0.379558,0.412936,81921.888189,0.053434,0.038701,47,0.001727,0,31,0.397128,0.362248
51089,Henry County,,VA,3061,68959,72020,7,11,18,1448,1811,3259,6,0.302942,0.318607,5505.919124,0.000433,0.001675,104,0.000202,0,31,0.309091,0.003868
51091,Highland County,,VA,124,2697,2821,0,0,0,0,0,0,0,0,0,0,0,0,176,0.000051,161,259,0,0
51093,Isle of Wight County,,VA,2411,35546,37957,11,8,19,2263,1373,3636,6,0.293689,0.308523,858.396407,0.002029,0.001687,47,0.000241,0,31,0.609091,0.015467
51095,James City County,,VA,5737,68098,73835,25,18,43,4108,2673,6781,6,0.313776,0.333488,961.322076,0.009266,0.005501,47,0.000421,0,31,0.522487,0.066825
51097,King and Queen County,,VA,533,6561,7094,2,3,5,140,194,334,7,0.275208,0.286992,0.333333,0.000327,0.00045,47,0.000098,0,31,0.666667,0.003165
51099,King George County,,VA,2420,19895,22315,11,12,23,1529,1190,2719,6,0.33387,0.352301,585.690324,0.004194,0.004637,47,0.000198,0,31,0.593407,0.030179
51101,King William County,,VA,1013,16470,17483,6,5,11,852,613,1465,7,0.276019,0.288634,11.831764,0.000667,0.000851,47,0.00018,0,31,0.666667,0.006824
51103,Lancaster County,,VA,671,14009,14680,4,2,6,222,159,381,7,0.280336,0.291871,1068.643982,0.00125,0.000347,47,0.000197,0,31,0.45,0.009644
51105,Lee County,,VA,769,21319,22088,4,4,8,276,284,560,8,0.233272,0.240977,53.925307,0.000006,0.000015,146,0.000163,0,31,0.4,0.000439
51107,Loudoun County,,VA,22023,234595,256618,106,71,177,32609,15207,47816,6,0.375874,0.407013,11535.944855,0.058558,0.038201,47,0.001253,0,31,0.520727,0.397123
51109,Louisa County,,VA,1738,27204,28942,13,10,23,1740,1005,2745,7,0.277975,0.291785,82.158447,0.002501,0.001353,47,0.000289,0,31,0.56044,0.020738
51111,Lunenburg County,,VA,615,11961,12576,3,5,8,228,290,518,7,0.276177,0.28895,20.361774,0.000012,0.000816,47,0.000136,0,31,0.4,0.000382
51113,Madison County,,VA,916,13164,14080,6,4,10,547,426,973,7,0.266153,0.276266,31.86489,0.0007,0.000187,47,0.000165,0,31,0.633333,0.005948
51115,Mathews County,,VA,558,9646,10204,2,3,5,196,212,408,7,0.280309,0.291957,2.988683,0.000357,0.000362,47,0.000096,0,31,0.666667,0.00259
51117,Mecklenburg County,,VA,1714,32477,34191,6,7,13,593,675,1268,7,0.272907,0.285787,5523.284122,0.000441,0.000559,47,0.00019,0,31,0.238095,0.004292
51119,Middlesex County,,VA,669,10586,11255,4,2,6,355,151,506,8,0.219867,0.225824,5.886036,0.000581,0.000028,47,0.000144,0,31,0.3,0.005905
51121,Montgomery County,,VA,7555,70745,78300,23,27,50,3033,3556,6589,6,0.340047,0.362609,44049.117915,0.004878,0.009346,104,0.000596,0,31,0.369892,0.038037
51125,Nelson County,,VA,962,15418,16380,5,4,9,523,420,943,7,0.266373,0.27657,643.228481,0.001102,0.00017,47,0.000175,0,31,0.566667,0.008085
51127,New Kent County,,VA,1143,16252,17395,9,7,16,1331,697,2028,7,0.276861,0.289965,12.222266,0.00129,0.001102,47,0.000231,0,31,0.666667,0.011339
51131,Northampton County,,VA,725,13462,14187,2,2,4,272,252,524,7,0.280417,0.292439,0.530202,0.000623,0.000381,126,0.000091,0,31,0.833333,0.005001
51133,Northumberland County,,VA,738,12920,13658,4,3,7,291,231,522,7,0.275313,0.287193,1982.141235,0.000933,0.000451,47,0.000206,0,31,0.35,0.006842
51135,Nottoway County,,VA,970,15644,16614,5,5,10,395,415,810,7,0.272446,0.284611,782.229983,0.000281,0.000553,47,0.000169,0,31,0.566667,0.003091
51137,Orange County,,VA,2361,31849,34210,11,10,21,2000,1298,3298,6,0.283013,0.297446,229.608529,0.001908,0.001138,47,0.00026,0,31,0.515152,0.015259
51139,Page County,,VA,982,28796,29778,5,5,10,546,414,960,7,0.236155,0.244522,6.439572,0.000978,0.00007,47,0.000186,0,31,0.7,0.007171
51141,Patrick County,,VA,821,17344,18165,5,4,9,377,386,763,7,0.232991,0.240657,34.365217,0.000035,0.000016,104,0.000158,0,31,0.35,0.000661
51143,Pittsylvania County,,VA,3909,80952,84861,9,10,19,2331,2335,4666,7,0.287297,0.301025,1190.922066,0.000501,0.000498,104,0.000214,0,31,0.327273,0.004212
51145,Powhatan County,,VA,1508,22755,24263,6,5,11,1683,856,2539,7,0.276782,0.289564,7.472765,0.000798,0.000998,47,0.000185,0,31,0.733333,0.007515
51147,Prince Edward County,,VA,1241,15182,16423,7,6,13,601,471,1072,7,0.272471,0.284783,1279.124862,0.00027,0.000563,47,0.000245,0,31,0.321429,0.00331
51149,Prince George County,,VA,5432,33941,39373,16,19,35,2956,2925,5881,6,0.325123,0.346229,3417.265254,0.004285,0.006008,47,0.000291,0,31,0.495671,0.031823
51153,Prince William County,,VA,46265,359391,405656,136,134,270,46786,36269,83055,5,0.393709,0.432903,28983.623199,0.068323,0.062546,47,0.001558,0,31,0.380133,0.465216
51155,Pulaski County,,VA,1945,37781,39726,7,6,13,1193,1048,2241,7,0.254402,0.264073,178.516613,0.000116,0.000092,104,0.000293,0,31,0.5,0.001438
51157,Rappahannock County,,VA,656,7935,8591,4,3,7,303,256,559,7,0.235332,0.243042,0.568687,0.00099,0.000075,47,0.000125,0,31,0.833333,0.00721
51159,Richmond County,,VA,545,8654,9199,2,3,5,193,213,406,8,0.216943,0.223252,2.36369,0.000007,0.000031,47,0.000133,0,31,0.333333,0.000384
51161,Roanoke County,,VA,9400,115848,125248,25,17,42,6769,6222,12991,6,0.316754,0.336857,27220.598299,0.005985,0.004379,104,0.000647,0,31,0.328333,0.04651
51163,Rockbridge County,,VA,1370,28064,29434,3,3,6,347,362,709,7,0.240956,0.249911,8754.498902,0.000009,0.000065,47,0.000233,0,31,0,0.000402
51165,Rockingham County,,VA,5514,92645,98159,11,10,21,2950,2910,5860,6,0.308117,0.325379,10321.596782,0.001336,0.001941,47,0.00041,0,31,0.295455,0.011229
51167,Russell County,,VA,1312,28964,30276,6,6,12,734,776,1510,8,0.234269,0.242368,843.352741,0.000018,0.000013,146,0.000247,0,31,0.47619,0.000745
51169,Scott County,,VA,1001,24169,25170,4,5,9,604,647,1251,7,0.240856,0.24961,59.656002,0.000018,0.000038,146,0.000179,0,31,0.65,0.000572
51171,Shenandoah County,,VA,2234,42468,44702,10,7,17,1667,988,2655,6,0.306977,0.323123,466.258413,0.002296,0.001015,47,0.000257,0,31,0.554545,0.018787
51173,Smyth County,,VA,1537,39385,40922,4,3,7,590,530,1120,8,0.233948,0.24157,513.818217,0.000018,0.000013,146,0.000187,0,31,0.333333,0.00054
51175,Southampton County,,VA,1177,19172,20349,10,7,17,758,606,1364,7,0.281805,0.294695,7105.644133,0.001627,0.000689,47,0.000247,0,31,0.5,0.013408
51177,Spotsylvania County,,VA,10024,116531,126555,38,28,66,10640,6147,16787,6,0.343181,0.365421,2379.138151,0.015454,0.011736,47,0.000538,0,31,0.529036,0.111003
51179,Stafford County,,VA,13853,112757,126610,51,40,91,14209,8947,23156,6,0.355621,0.380797,5345.161942,0.026067,0.019564,47,0.000678,0,31,0.542045,0.187942
51181,Surry County,,VA,542,7073,7615,3,4,7,216,235,451,7,0.280607,0.292577,86.11355,0.000368,0.000433,47,0.000113,0,31,0.333333,0.002689
51183,Sussex County,,VA,818,9684,10502,5,6,11,278,380,658,7,0.271987,0.284238,453.204768,0.000068,0.000439,47,0.000171,0,31,0.357143,0.000969
51185,Tazewell County,,VA,2056,41332,43388,5,6,11,1056,859,1915,7,0.256333,0.266576,920.790311,0.000012,0.000041,146,0.000212,0,31,0.261905,0.000524
51187,Warren County,,VA,2700,36190,38890,12,10,22,2201,1496,3697,6,0.307334,0.323904,1639.565454,0.002024,0.002146,47,0.000301,0,31,0.5,0.016977
51191,Washington County,,VA,3225,55620,58845,9,8,17,1843,1828,3671,7,0.282903,0.295509,8901.469552,0.000043,0.000416,146,0.000388,0,31,0.322222,0.001225
51193,Westmoreland County,,VA,1213,17404,18617,8,6,14,686,533,1219,7,0.263354,0.273678,2881.480448,0.002493,0.000388,47,0.000171,0,31,0.455556,0.018128
51195,Wise County,,VA,1712,39347,41059,7,9,16,763,933,1696,7,0.241096,0.250551,8572.188521,0.000018,0.000038,146,0.000315,0,31,0.333333,0.000829
51197,Wythe County,,VA,1404,27757,29161,6,6,12,647,584,1231,7,0.254893,0.264745,8746.853546,0.000078,0.000042,146,0.000282,0,31,0.266667,0.000929
51199,York County,,VA,9248,59963,69211,26,26,52,5421,5107,10528,6,0.342776,0.365123,2446.850118,0.012267,0.011507,47,0.000411,0,31,0.502841,0.09226
51510,Alexandria city,,VA,33685,130000,163685,87,66,153,22176,27951,50127,6,0.385401,0.415932,3330.975611,0.053082,0.040548,47,0.000928,0,31,0.63136,0.354944
51515,Bedford city,,VA,353,3777,4130,1,1,2,74,120,194,7,0.23518,0.242517,0,0.000017,0.00002,104,0.000077,0,31,0,0.000268
51520,Bristol city,,VA,1634,15262,16896,3,2,5,1262,1087,2349,8,0.233197,0.240268,0,0.000017,0.000012,146,0.000156,0,31,1,0.000445
51530,Buena Vista city,,VA,377,5055,5432,1,1,2,147,149,296,8,0.194183,0.198752,0,0.000001,0,47,0.000117,0,31,0,0.000097
51540,Charlottesville city,,VA,5217,22397,27614,10,14,24,2134,3104,5238,6,0.311722,0.330171,1115.967101,0.002312,0.004611,47,0.000248,0,31,0.416667,0.017896
51550,Chesapeake city,,VA,22994,221977,244971,66,57,123,19272,16322,35594,6,0.368715,0.397578,15598.629843,0.033037,0.026853,47,0.000871,0,31,0.507595,0.228305
51570,Colonial Heights city,,VA,2088,18600,20688,7,7,14,1400,1465,2865,7,0.277576,0.290832,0,0.000825,0.001046,47,0.000177,0,31,1,0.007757
51580,Covington city,,VA,366,6058,6424,1,1,2,126,120,246,9,0.179237,0.18284,0,0,0,104,0.000146,0,31,0,0.000099
51590,Danville city,,VA,2729,37917,40646,5,5,10,1584,1677,3261,7,0.286786,0.299613,42.726554,0.000048,0.000465,104,0.000143,0,31,0.666667,0.000711
51595,Emporia city,,VA,279,3603,3882,1,1,2,66,58,124,9,0.189692,0.193975,0,0,0,47,0.000082,0,31,0,0.000097
51600,Fairfax city,,VA,3044,17568,20612,5,8,13,1900,2118,4018,6,0.309068,0.325362,0,0.002535,0.004465,47,0.000109,0,31,0.892857,0.020139
51610,Falls Church city,,VA,1996,9395,11391,5,6,11,952,1327,2279,6,0.307921,0.32411,0,0.003101,0.003779,47,0.000102,0,31,1,0.02252
51620,Franklin city,,VA,617,7465,8082,2,3,5,305,279,584,7,0.235466,0.242924,0,0.000029,0.000089,47,0.000105,0,31,1,0.000712
51630,Fredericksburg city,,VA,3699,13501,17200,7,8,15,2129,2591,4720,6,0.307562,0.324329,16.665861,0.001769,0.002346,47,0.000156,0,31,0.803571,0.013553
51640,Galax city,,VA,143,1891,2034,1,0,1,43,0,43,0,0,0,0,0,0,104,0.000077,0,1,0,0.000093
51650,Hampton city,,VA,18761,141026,159787,50,47,97,11768,12383,24151,6,0.366945,0.394967,4986.74279,0.025834,0.026329,47,0.00065,0,31,0.640144,0.178294
51660,Harrisonburg city,,VA,3256,15421,18677,5,5,10,1457,1820,3277,6,0.306944,0.322951,497.139201,0.000961,0.001113,47,0.000199,0,31,0.733333,0.007158
51670,Hopewell city,,VA,2755,22491,25246,7,7,14,1653,1814,3467,7,0.277576,0.290832,0,0.000825,0.001046,47,0.000177,0,31,1,0.007757
51678,Lexington city,,VA,279,2336,2615,0,1,1,0,43,43,8,0.194223,0.198856,0,0,0,47,0.000051,0,260,0,0
51680,Lynchburg city,,VA,5320,50728,56048,8,13,21,2670,3168,5838,6,0.31449,0.333965,3823.114795,0.000574,0.003931,104,0.000226,0,31,0.516484,0.005314
51683,Manassas city,,VA,4227,24079,28306,8,10,18,3019,3029,6048,6,0.307042,0.323582,3.367584,0.002616,0.002439,47,0.000155,0,31,0.685897,0.021004
51685,Manassas Park city,,VA,1858,9618,11476,6,6,12,1296,1281,2577,6,0.30675,0.32275,0,0.002139,0.002251,47,0.000127,0,31,0.928571,0.01696
51690,Martinsville city,,VA,868,10698,11566,1,2,3,404,410,814,7,0.286391,0.29858,0,0.000014,0.000453,104,0.000066,0,31,1,0.000131
51700,Newport News city,,VA,26762,184747,211509,86,82,168,17222,17939,35161,6,0.389224,0.422159,35110.510673,0.041145,0.042466,47,0.00116,0,31,0.468588,0.281509
51710,Norfolk city,,VA,34784,213035,247819,86,98,184,20445,24397,44842,6,0.389381,0.424156,12828.517057,0.044926,0.049901,47,0.001025,0,31,0.465142,0.306437
51720,Norton city,,VA,392,3852,4244,1,1,2,198,189,387,8,0.194273,0.198892,0,0,0,146,0.00008,0,31,0,0.000108
51730,Petersburg city,,VA,3611,32082,35693,9,8,17,2032,2318,4350,7,0.277629,0.291062,447.847967,0.001436,0.001042,47,0.000211,0,31,0.708333,0.012058
51735,Poquoson city,,VA,1200,13802,15002,3,3,6,616,543,1159,7,0.281368,0.293122,0,0.000663,0.000654,47,0.000088,0,31,1,0.004713
51740,Portsmouth city,,VA,12048,98934,110982,19,23,42,7428,8307,15735,6,0.342898,0.364451,1395.570433,0.008198,0.010168,47,0.000312,0,31,0.546296,0.056447
51750,Radford city,,VA,1833,10563,12396,4,5,9,626,882,1508,7,0.254046,0.263499,3.572973,0.000114,0.000109,104,0.000195,0,31,0.7,0.00112
51760,Richmond city,,VA,22902,161365,184267,59,54,113,14933,18547,33480,6,0.36097,0.388625,23068.090446,0.021258,0.0215,47,0.000977,0,31,0.370647,0.149156
51770,Roanoke city,,VA,9183,85606,94789,13,18,31,5445,6559,12004,6,0.317031,0.337431,5483.161764,0.00201,0.005017,104,0.000345,0,31,0.407143,0.015572
51775,Salem city,,VA,2434,20823,23257,6,6,12,1452,1682,3134,7,0.25438,0.264263,0,0.000178,0.00013,104,0.000193,0,31,1,0.001636
51790,Staunton city,,VA,1381,15026,16407,3,3,6,742,716,1458,7,0.235695,0.243458,0,0.000027,0.000028,47,0.000179,0,31,1,0.000533
51800,Suffolk city,,VA,6205,75211,81416,20,12,32,6651,3688,10339,6,0.307595,0.324122,6689.235377,0.007112,0.002846,47,0.000347,0,31,0.54329,0.051036
51810,Virginia Beach city,,VA,53405,468275,521680,200,170,370,39798,38423,78221,5,0.408956,0.451188,63943.190993,0.087087,0.074552,47,0.002342,0,31,0.309097,0.586331
51820,Waynesboro city,,VA,1673,16739,18412,6,4,10,1051,909,1960,7,0.266202,0.276323,185.453817,0.000192,0.000179,47,0.000249,0,31,0.6,0.002081
51830,Williamsburg city,,VA,872,4127,4999,2,3,5,241,426,667,7,0.280553,0.292301,0,0.000396,0.000517,47,0.000083,0,31,1,0.002988
51840,Winchester city,,VA,3001,16712,19713,9,9,18,1667,2068,3735,6,0.307432,0.323892,1269.621133,0.001837,0.00158,47,0.000253,0,31,0.633333,0.015024
53001,Adams County,,WA,1373,18759,20132,4,6,10,530,745,1275,6,0.309364,0.32504,0,0.001206,0.001446,178,0.000104,0,31,1,0.008769
53003,Asotin County,,WA,2237,22041,24278,9,9,18,1300,1288,2588,6,0.310356,0.32706,2235.127079,0.002021,0.001854,178,0.000184,0,31,0.627273,0.014688
53005,Benton County,,WA,11374,166081,177455,51,33,84,8962,7815,16777,6,0.343019,0.366093,3037.712689,0.015537,0.011807,178,0.000725,0,31,0.441649,0.112907
53007,Chelan County,,WA,5541,71903,77444,13,17,30,3778,3850,7628,6,0.340007,0.360193,103.036982,0.003998,0.006606,178,0.000203,0,31,0.841912,0.028952
53009,Clallam County,,WA,4058,71815,75873,22,16,38,2545,1957,4502,6,0.339808,0.359791,158.361605,0.01056,0.006228,178,0.000289,0,31,0.733333,0.073861
53011,Clark County,,WA,23330,405508,428838,87,91,178,23467,17308,40775,6,0.363864,0.397234,8436.334222,0.032452,0.030106,178,0.001143,0,31,0.389011,0.231762
53013,Columbia County,,WA,461,5241,5702,1,1,2,136,161,297,7,0.240218,0.247667,0,0.000035,0.00005,178,0.000069,0,31,0,0.000464
53015,Cowlitz County,,WA,5669,99938,105607,22,24,46,3769,3488,7257,6,0.337557,0.358724,5567.820718,0.007684,0.008462,178,0.000339,0,31,0.715385,0.057242
53017,Douglas County,,WA,3529,34175,37704,9,10,19,2716,2493,5209,6,0.31337,0.32993,0.634198,0.002453,0.002371,178,0.000156,0,31,0.944444,0.017295
53019,Ferry County,,WA,663,7715,8378,3,2,5,289,249,538,7,0.270668,0.282625,0,0.001136,0.00028,178,0.0001,0,31,1,0.008129
53021,Franklin County,,WA,4403,52300,56703,15,11,26,4707,3056,7763,6,0.337204,0.356474,180.760073,0.005888,0.004279,178,0.000239,0,31,0.761905,0.04233
53023,Garfield County,,WA,76,1058,1134,0,0,0,0,0,0,0,0,0,0,0,0,177,0.000051,162,261,0,0
53025,Grant County,,WA,4653,75143,79796,20,22,42,2717,2762,5479,6,0.33854,0.359544,685.942696,0.005229,0.005785,178,0.000318,0,31,0.581667,0.039086
53027,Grays Harbor County,,WA,4262,69588,73850,13,17,30,2500,2642,5142,6,0.332189,0.351871,21.675092,0.003133,0.005111,178,0.000214,0,31,0.823529,0.023175
53029,Island County,,WA,10184,78062,88246,28,32,60,6472,5556,12028,6,0.357283,0.381807,245.942439,0.014272,0.016457,178,0.000374,0,31,0.644538,0.103898
53031,Jefferson County,,WA,2075,29329,31404,6,7,13,1160,939,2099,6,0.313201,0.329385,0,0.002352,0.00247,178,0.000117,0,31,1,0.016511
53033,King County,,WA,130650,1998396,2129046,284,300,584,96883,116903,213786,5,0.446151,0.497653,163762.247573,0.10335,0.10616,178,0.003507,0,31,0.202235,0.705202
53035,Kitsap County,,WA,23075,261006,284081,76,75,151,16153,15211,31364,5,0.370834,0.402761,4296.611061,0.034607,0.032759,178,0.000903,0,31,0.447741,0.243352
53037,Kittitas County,,WA,3042,31938,34980,13,12,25,2226,1805,4031,6,0.313675,0.330647,1.611874,0.003075,0.003008,178,0.000212,0,31,0.851648,0.022831
53039,Klickitat County,,WA,1609,19968,21577,7,7,14,753,645,1398,6,0.288381,0.302416,7.221124,0.001236,0.001061,178,0.000171,0,31,0.678571,0.009923
53041,Lewis County,,WA,4608,73927,78535,17,15,32,3390,2849,6239,6,0.331962,0.351326,79.711899,0.006962,0.004676,178,0.000255,0,31,0.789474,0.050613
53043,Lincoln County,,WA,780,11164,11944,3,3,6,418,417,835,7,0.270896,0.283032,0.142857,0.00117,0.000323,178,0.000086,0,31,0.833333,0.008326
53045,Mason County,,WA,4177,54908,59085,11,10,21,3759,2793,6552,6,0.335567,0.354488,13.537142,0.004924,0.004638,178,0.000172,0,31,0.916667,0.034834
53047,Okanogan County,,WA,2667,39124,41791,10,12,22,1165,1442,2607,6,0.313438,0.330274,17.772938,0.003731,0.002613,178,0.000162,0,31,0.813187,0.026284
53049,Pacific County,,WA,1381,20094,21475,11,8,19,983,628,1611,6,0.312897,0.329167,422.895451,0.002919,0.002035,178,0.000192,0,31,0.754545,0.021277
53051,Pend Oreille County,,WA,1416,15614,17030,5,4,9,886,848,1734,7,0.270719,0.282969,0.72619,0.001601,0.000454,178,0.000145,0,31,0.833333,0.01116
53053,Pierce County,,WA,58958,786092,845050,170,173,343,48817,44847,93664,5,0.416284,0.458167,39539.150011,0.064596,0.064701,178,0.002072,0,31,0.286538,0.450069
53055,San Juan County,,WA,1108,15678,16786,5,4,9,472,353,825,6,0.309265,0.324581,0,0.00264,0.001464,178,0.000109,0,31,1,0.018273
53057,Skagit County,,WA,7285,122598,129883,28,20,48,6658,4411,11069,6,0.340725,0.361358,233.529224,0.011781,0.009069,178,0.000393,0,31,0.696774,0.08722
53059,Skamania County,,WA,622,8785,9407,4,3,7,431,321,752,6,0.287952,0.301251,0.478352,0.000727,0.000803,178,0.000114,0,31,0.916667,0.006042
53061,Snohomish County,,WA,51380,700803,752183,105,136,241,41148,42020,83168,5,0.403389,0.44142,17467.248723,0.042644,0.054797,178,0.001303,0,31,0.345093,0.300665
53063,Spokane County,,WA,24626,467917,492543,99,97,196,18892,17630,36522,6,0.371023,0.405424,33667.216054,0.03161,0.029813,178,0.001495,0,31,0.309382,0.226789
53065,Stevens County,,WA,2808,36694,39502,9,7,16,1546,1507,3053,6,0.309925,0.32593,179.781524,0.002251,0.00167,178,0.000216,0,31,0.560606,0.016284
53067,Thurston County,,WA,17712,240338,258050,63,51,114,14982,12202,27184,6,0.350302,0.376647,1565.000133,0.023879,0.020274,178,0.000778,0,31,0.473442,0.170481
53069,Wahkiakum County,,WA,354,3611,3965,1,2,3,67,144,211,7,0.252412,0.26078,0,0.00007,0.000088,178,0.000063,0,31,1,0.00057
53071,Walla Walla County,,WA,3663,53862,57525,16,14,30,2129,2001,4130,6,0.316133,0.334154,5892.057922,0.006033,0.004196,178,0.0003,0,31,0.748366,0.04478
53073,Whatcom County,,WA,11583,178740,190323,45,33,78,7984,7381,15365,6,0.348201,0.372635,836.145928,0.019533,0.013522,178,0.000571,0,31,0.586436,0.139299
53075,Whitman County,,WA,4486,32407,36893,16,20,36,2122,2511,4633,6,0.340805,0.361685,206.287164,0.003496,0.007441,178,0.000275,0,31,0.709957,0.026766
53077,Yakima County,,WA,10350,236604,246954,43,45,88,6009,6982,12991,6,0.343384,0.367872,1121.898285,0.013495,0.014885,178,0.000591,0,31,0.516401,0.099611
54001,Barbour County,,WV,791,15979,16770,4,3,7,385,340,725,7,0.230806,0.237915,1.5,0.000007,0.000007,126,0.000193,0,31,0.666667,0.000455
54003,Berkeley County,,WV,4703,94695,99398,23,12,35,5893,2199,8092,6,0.302626,0.318922,4025.621252,0.006127,0.00196,47,0.000435,0,31,0.416667,0.045155
54005,Boone County,,WV,1444,28953,30397,4,6,10,767,858,1625,7,0.249335,0.259684,10.436042,0.000069,0.000055,121,0.000172,0,31,0.666667,0.000799
54007,Braxton County,,WV,740,14201,14941,3,5,8,190,258,448,7,0.247887,0.257813,5982.700259,0.000055,0.000033,121,0.000187,0,31,0.25,0.000581
54009,Brooke County,,WV,1576,34013,35589,5,5,10,773,776,1549,6,0.297816,0.312196,1.616667,0.000821,0.000787,121,0.000133,0,31,0.8,0.005677
54011,Cabell County,,WV,6433,101156,107589,15,17,32,3110,3615,6725,6,0.320671,0.340949,9761.166517,0.000887,0.003338,121,0.000499,0,31,0.271053,0.007306
54013,Calhoun County,,WV,346,7265,7611,0,2,2,0,116,116,7,0.233803,0.240893,0,0,0.000008,121,0.000051,0,262,0,0
54015,Clay County,,WV,512,9400,9912,2,2,4,130,188,318,7,0.24776,0.257124,0,0.000055,0.000033,121,0.000107,0,31,1,0.000482
54017,Doddridge County,,WV,381,6137,6518,1,2,3,135,172,307,7,0.230898,0.237932,14.978658,0.000006,0.000007,126,0.000086,0,31,0,0.000154
54019,Fayette County,,WV,2463,48228,50691,5,5,10,1182,1133,2315,7,0.249377,0.259655,198.159042,0.000097,0.000048,121,0.000253,0,31,0.6,0.000944
54021,Gilmer County,,WV,412,5625,6037,1,1,2,49,71,120,8,0.198659,0.203572,0,0,0,121,0.000082,0,31,0,0.000098
54023,Grant County,,WV,627,13691,14318,3,3,6,239,206,445,8,0.196681,0.20242,2995.14612,0.000001,0,47,0.000144,0,31,0,0.000284
54025,Greenbrier County,,WV,1534,35160,36694,8,4,12,553,380,933,7,0.238875,0.246992,7521.435679,0.00007,0.000008,121,0.000421,0,31,0.25,0.001141
54027,Hampshire County,,WV,1210,23552,24762,6,6,12,721,511,1232,7,0.238267,0.247214,3143.063434,0.000054,0.000114,47,0.000212,0,31,0.333333,0.001394
54029,Hancock County,,WV,1608,35098,36706,6,6,12,787,882,1669,6,0.297755,0.312265,2.524542,0.000865,0.000833,121,0.000142,0,31,0.7,0.006058
54031,Hardy County,,WV,686,14259,14945,2,3,5,201,244,445,7,0.236251,0.244281,449.366191,0.000001,0.000011,47,0.000122,0,31,0,0.000206
54033,Harrison County,,WV,3497,78480,81977,10,10,20,1475,1501,2976,6,0.299907,0.315479,26486.133961,0.000824,0.000773,126,0.000414,0,31,0.288889,0.006177
54035,Jackson County,,WV,1456,31843,33299,6,6,12,774,662,1436,7,0.247993,0.258186,23.596699,0.000091,0.000054,121,0.000283,0,31,0.5,0.001083
54037,Jefferson County,,WV,3515,49591,53106,13,7,20,3370,1962,5332,6,0.30828,0.324661,12.441732,0.004656,0.002495,47,0.000253,0,31,0.705128,0.033718
54039,Kanawha County,,WV,9895,227656,237551,26,29,55,4969,5303,10272,6,0.329252,0.352726,72325.213943,0.003898,0.006673,121,0.000828,0,31,0.208403,0.032221
54041,Lewis County,,WV,772,19338,20110,3,2,5,385,329,714,7,0.230751,0.237628,8.633333,0.000007,0.000007,126,0.000159,0,31,0.333333,0.000352
54043,Lincoln County,,WV,1106,21216,22322,6,4,10,668,704,1372,7,0.249099,0.258966,18.200307,0.000084,0.000041,121,0.000229,0,31,0.566667,0.001021
54045,Logan County,,WV,1424,32961,34385,5,5,10,500,692,1192,7,0.249356,0.259546,700.738147,0.000817,0.000047,121,0.000152,0,31,0.452381,0.005818
54047,McDowell County,,WV,1246,19055,20301,2,3,5,195,611,806,7,0.233591,0.240872,25.794831,0.000008,0,146,0.00009,0,31,0.5,0.000205
54049,Marion County,,WV,2797,63107,65904,7,7,14,1199,1231,2430,6,0.299876,0.315048,4930.073599,0.000083,0.000779,126,0.000314,0,31,0.339286,0.001153
54051,Marshall County,,WV,1571,36970,38541,3,4,7,804,710,1514,6,0.303575,0.318331,1949.255654,0.00002,0.000765,121,0.000147,0,31,0.5,0.00044
54053,Mason County,,WV,1177,28003,29180,7,6,13,715,676,1391,7,0.249249,0.259569,536.525667,0.000858,0.000054,121,0.000261,0,31,0.571429,0.006164
54055,Mercer County,,WV,2934,62985,65919,7,12,19,1106,1131,2237,6,0.304307,0.320242,12963.724139,0.000014,0.000982,146,0.000278,0,31,0.174242,0.000744
54057,Mineral County,,WV,1443,30293,31736,4,7,11,669,893,1562,7,0.243767,0.254085,8130.664057,0.000041,0.000131,47,0.000167,0,31,0.285714,0.000647
54059,Mingo County,,WV,1311,25430,26741,5,6,11,510,631,1141,7,0.248545,0.259138,5904.932493,0.000764,0.000042,121,0.000157,0,31,0.142857,0.005554
54061,Monongalia County,,WV,5187,74967,80154,17,18,35,2202,2126,4328,6,0.318596,0.338877,28436.656802,0.001664,0.002561,126,0.000529,0,31,0.192982,0.012584
54063,Monroe County,,WV,528,12951,13479,3,3,6,255,251,506,7,0.233534,0.240838,47.201809,0.000008,0.000001,121,0.000179,0,31,0.333333,0.000314
54065,Morgan County,,WV,841,15821,16662,4,4,8,417,406,823,7,0.238659,0.24738,379.315086,0.001432,0.00013,47,0.000117,0,31,0.566667,0.010033
54067,Nicholas County,,WV,1212,26914,28126,6,6,12,425,517,942,7,0.250518,0.261451,5898.01968,0.00007,0.000048,121,0.000296,0,31,0.357143,0.000939
54069,Ohio County,,WV,2904,52531,55435,7,8,15,1188,1546,2734,6,0.307042,0.323605,1935.271659,0.001582,0.001539,121,0.000188,0,31,0.517857,0.01083
54071,Pendleton County,,WV,569,9062,9631,1,2,3,49,89,138,7,0.236059,0.243707,372.041823,0,0.000011,47,0.000092,0,31,0,0.000096
54073,Pleasants County,,WV,508,8574,9082,3,3,6,187,295,482,7,0.233911,0.241308,6.779762,0.000014,0.000014,121,0.000189,0,31,0.666667,0.000413
54075,Pocahontas County,,WV,397,9396,9793,1,1,2,46,43,89,8,0.192867,0.197081,12.618304,0,0.000001,126,0.000085,0,31,0,0.000103
54077,Preston County,,WV,1176,32624,33800,4,3,7,563,501,1064,7,0.241879,0.250653,1568.114925,0.000033,0.000032,126,0.000193,0,31,0.166667,0.000634
54079,Putnam County,,WV,3759,51456,55215,8,5,13,2876,2085,4961,7,0.249142,0.259196,12.158418,0.000105,0.000048,121,0.000308,0,31,0.553571,0.001354
54081,Raleigh County,,WV,3721,78292,82013,10,13,23,1380,1513,2893,6,0.313133,0.331003,25174.740569,0.000881,0.001652,121,0.000339,0,31,0.258242,0.00748
54083,Randolph County,,WV,1365,31288,32653,5,6,11,385,507,892,7,0.24194,0.251216,7378.894504,0.000028,0.000021,126,0.000243,0,31,0.266667,0.000661
54085,Ritchie County,,WV,531,12549,13080,3,2,5,233,201,434,7,0.233741,0.240746,25.120384,0.000007,0.000007,121,0.000176,0,31,0.333333,0.00035
54087,Roane County,,WV,700,14446,15146,3,2,5,287,285,572,7,0.24776,0.257124,101.285837,0.000056,0.000033,121,0.000136,0,31,0.333333,0.00058
54089,Summers County,,WV,540,10450,10990,2,4,6,147,256,403,7,0.239249,0.247508,322.565909,0.000022,0.000008,121,0.000093,0,31,0.666667,0.000273
54091,Taylor County,,WV,694,14500,15194,3,4,7,300,424,724,7,0.241819,0.250711,26.189814,0.000034,0.000021,126,0.000149,0,31,0.666667,0.000483
54093,Tucker County,,WV,407,7895,8302,1,2,3,83,125,208,8,0.195004,0.200023,1.116667,0,0,126,0.000085,0,31,0,0.000103
54095,Tyler County,,WV,476,9813,10289,1,1,2,141,158,299,8,0.190651,0.194747,0,0,0,121,0.000102,0,31,0,0.000099
54097,Upshur County,,WV,1044,22044,23088,4,5,9,433,389,822,7,0.230971,0.238506,10.954978,0.000007,0.000008,126,0.000242,0,31,0.5,0.000453
54099,Wayne County,,WV,2166,39846,42012,5,6,11,1211,1354,2565,7,0.243563,0.253061,63.665671,0.000047,0.000036,121,0.000191,0,31,0.333333,0.000769
54101,Webster County,,WV,342,8666,9008,1,1,2,73,87,160,8,0.200345,0.205681,0,0,0.000001,121,0.000093,0,31,0,0.000107
54103,Wetzel County,,WV,977,18944,19921,4,4,8,295,380,675,7,0.235542,0.243484,5872.900662,0.000019,0.00001,121,0.000243,0,31,0,0.000455
54105,Wirt County,,WV,573,7177,7750,1,1,2,320,350,670,7,0.233722,0.240574,0,0.000007,0.000007,121,0.000086,0,31,0,0.000162
54107,Wood County,,WV,4598,96959,101557,11,11,22,1885,1993,3878,6,0.304978,0.321086,18398.468818,0.000887,0.000827,121,0.000459,0,31,0.234848,0.006759
54109,Wyoming County,,WV,947,22747,23694,3,5,8,255,463,718,7,0.239644,0.248312,1990.567392,0.000022,0.000021,121,0.000115,0,31,0.3,0.000413
55001,Adams County,,WI,1935,25670,27605,15,10,25,1593,1227,2820,6,0.297236,0.310985,144.20064,0.003175,0.001055,179,0.000263,0,31,0.547619,0.021391
55003,Ashland County,,WI,1183,20799,21982,2,3,5,223,295,518,7,0.236155,0.243161,7.729033,0.000001,0.00001,50,0.000138,0,31,0.333333,0.000195
55005,Barron County,,WI,2925,58252,61177,14,13,27,1607,1553,3160,6,0.308772,0.324529,4331.84115,0.001592,0.001516,50,0.000372,0,31,0.545833,0.01181
55007,Bayfield County,,WI,947,15611,16558,3,2,5,315,312,627,7,0.235848,0.242455,589.958259,0.000012,0.00001,50,0.000158,0,31,0.166667,0.000403
55009,Brown County,,WI,13078,290168,303246,40,37,77,8480,8693,17173,6,0.351234,0.375752,26136.691126,0.008892,0.008483,179,0.00076,0,31,0.321138,0.064047
55011,Buffalo County,,WI,1072,19471,20543,7,5,12,674,565,1239,7,0.255791,0.265552,44.990322,0.000101,0.000094,50,0.000196,0,31,0.428571,0.001489
55013,Burnett County,,WI,1066,20580,21646,10,4,14,923,395,1318,6,0.306265,0.319846,745.517649,0.001534,0.000682,50,0.000231,0,31,0.733333,0.010861
55015,Calumet County,,WI,5388,65886,71274,11,10,21,4899,3983,8882,6,0.327433,0.345644,27.562668,0.00144,0.002142,179,0.000204,0,31,0.901515,0.010764
55017,Chippewa County,,WI,3819,70986,74805,14,13,27,2677,2469,5146,6,0.333525,0.353294,3785.219581,0.002353,0.002667,50,0.00031,0,31,0.466667,0.016676
55019,Clark County,,WI,2060,41360,43420,7,8,15,1035,1218,2253,7,0.25622,0.266918,22.813464,0.000146,0.000152,179,0.000171,0,31,0.5,0.001687
55021,Columbia County,,WI,4418,66656,71074,15,12,27,3628,2941,6569,6,0.297419,0.31153,97.530561,0.002544,0.001333,179,0.000271,0,31,0.5625,0.017826
55023,Crawford County,,WI,1304,21289,22593,7,6,13,666,704,1370,6,0.287667,0.300356,2368.322731,0.000444,0.00048,179,0.000222,0,31,0.452381,0.004003
55025,Dane County,,WI,28863,521369,550232,140,118,258,23614,21065,44679,5,0.402606,0.438309,87188.589224,0.052442,0.046884,179,0.001957,0,31,0.297343,0.350194
55027,Dodge County,,WI,6352,104582,110934,12,15,27,4870,4310,9180,6,0.297663,0.312305,24.185682,0.00141,0.001551,179,0.000233,0,31,0.625,0.010885
55029,Door County,,WI,1671,36366,38037,8,6,14,855,684,1539,6,0.327285,0.344955,825.561741,0.002558,0.002022,179,0.000162,0,31,0.75,0.016554
55031,Douglas County,,WI,2431,49753,52184,9,7,16,1454,1053,2507,6,0.308444,0.323267,8577.001844,0.001187,0.001441,50,0.000307,0,31,0.366667,0.008558
55033,Dunn County,,WI,3181,44065,47246,14,12,26,2018,1787,3805,6,0.308772,0.324415,2607.608978,0.002092,0.001729,50,0.000302,0,31,0.5375,0.014564
55035,Eau Claire County,,WI,7262,98921,106183,30,26,56,4509,4815,9324,6,0.342776,0.365393,21308.659057,0.005134,0.004807,50,0.000614,0,31,0.301136,0.038078
55037,Florence County,,WI,402,5813,6215,1,1,2,98,121,219,8,0.20731,0.212378,0,0.000001,0,179,0.000082,0,31,0,0.000103
55039,Fond du Lac County,,WI,5707,121033,126740,16,19,35,3543,3653,7196,6,0.339173,0.360095,511.376927,0.002557,0.003676,179,0.000287,0,31,0.605263,0.018576
55041,Forest County,,WI,507,10580,11087,4,1,5,190,61,251,7,0.229257,0.235326,0.25,0.000548,0.000021,179,0.000139,0,31,0.583333,0.003762
55043,Grant County,,WI,3021,60036,63057,10,11,21,1377,1723,3100,6,0.29803,0.312276,125.980104,0.001029,0.001073,179,0.000269,0,31,0.390909,0.007931
55045,Green County,,WI,2367,43609,45976,4,6,10,1473,1367,2840,6,0.297663,0.311157,21.805223,0.000461,0.001053,179,0.000118,0,31,0.566667,0.003759
55047,Green Lake County,,WI,1637,24095,25732,8,7,15,981,896,1877,6,0.287382,0.30004,6.392673,0.001025,0.000551,179,0.000184,0,31,0.785714,0.007726
55049,Iowa County,,WI,1580,26587,28167,5,5,10,1050,1053,2103,6,0.287212,0.299495,1.333333,0.000422,0.00048,179,0.000163,0,31,0.8,0.003733
55051,Iron County,,WI,427,7296,7723,1,1,2,117,102,219,8,0.198822,0.203061,0,0,0.000009,179,0.000122,0,31,0,0.000153
55053,Jackson County,,WI,1162,22086,23248,5,5,10,594,557,1151,7,0.255701,0.26542,5.332043,0.000088,0.000093,50,0.000158,0,31,0.6,0.001259
55055,Jefferson County,,WI,6325,96040,102365,10,11,21,4678,4172,8850,6,0.327396,0.345673,62.544647,0.002433,0.00235,179,0.000169,0,31,0.8,0.016814
55057,Juneau County,,WI,1949,30446,32395,11,10,21,1296,1148,2444,6,0.297358,0.311214,99.350483,0.002163,0.001089,179,0.000233,0,31,0.606061,0.01537
55059,Kenosha County,,WI,10775,182435,193210,14,19,33,8486,6425,14911,6,0.346995,0.368446,60.914987,0.00702,0.009397,179,0.000185,0,31,0.689474,0.046871
55061,Kewaunee County,,WI,1142,22082,23224,3,3,6,589,697,1286,7,0.260005,0.269452,0.2,0.000116,0.000106,179,0.000104,0,31,0.833333,0.00108
55063,La Crosse County,,WI,6472,123487,129959,27,25,52,3557,3685,7242,6,0.342736,0.365192,9684.118472,0.003532,0.004674,179,0.000535,0,31,0.326613,0.027575
55065,Lafayette County,,WI,1054,18742,19796,4,4,8,597,658,1255,6,0.287212,0.29938,1.791667,0.000409,0.000449,179,0.00013,0,31,0.666667,0.003419
55067,Langlade County,,WI,1214,24166,25380,5,6,11,440,454,894,6,0.28781,0.300591,7.355687,0.000593,0.000561,179,0.000151,0,31,0.660714,0.004204
55069,Lincoln County,,WI,1702,38343,40045,4,6,10,785,802,1587,6,0.297054,0.310267,4.636512,0.000966,0.000977,179,0.000122,0,31,0.833333,0.006888
55071,Manitowoc County,,WI,3822,99751,103573,10,14,24,1729,2167,3896,6,0.338738,0.358947,827.10458,0.001379,0.003537,179,0.000209,0,31,0.697802,0.010302
55073,Marathon County,,WI,6996,155932,162928,26,31,57,3814,4408,8222,6,0.343181,0.366483,14780.144953,0.004546,0.004925,179,0.000473,0,31,0.363636,0.03381
55075,Marinette County,,WI,2895,51340,54235,7,8,15,1566,1543,3109,6,0.297236,0.310813,3041.628585,0.000861,0.001088,179,0.000192,0,31,0.597222,0.006289
55077,Marquette County,,WI,1224,15796,17020,8,6,14,769,629,1398,6,0.287354,0.299868,5.927593,0.001021,0.000544,179,0.000188,0,31,0.767857,0.007811
55078,Menominee County,,WI,285,4930,5215,1,1,2,81,139,220,7,0.227052,0.233028,0,0.000006,0.000008,179,0.000076,0,31,0,0.000168
55079,Milwaukee County,,WI,51939,1041083,1093022,132,151,283,32469,43425,75894,5,0.41462,0.453082,84933.083629,0.056744,0.064052,179,0.001698,0,31,0.319767,0.381903
55081,Monroe County,,WI,2845,48020,50865,9,6,15,1265,1105,2370,6,0.297024,0.310267,759.086328,0.002293,0.000953,179,0.000201,0,31,0.638889,0.015998
55083,Oconto County,,WI,2372,41557,43929,8,7,15,2138,1630,3768,6,0.293571,0.306749,11.0664,0.000767,0.000667,179,0.000184,0,31,0.638889,0.005803
55085,Oneida County,,WI,2626,44958,47584,17,10,27,1645,987,2632,6,0.297419,0.311329,3250.684262,0.002578,0.001155,179,0.00041,0,31,0.496732,0.018674
55087,Outagamie County,,WI,13151,199401,212552,33,27,60,10197,9747,19944,6,0.342817,0.365507,2926.54406,0.006808,0.004709,179,0.000572,0,31,0.385714,0.048612
55089,Ozaukee County,,WI,6641,106788,113429,14,13,27,5052,4244,9296,6,0.341727,0.362437,119.995276,0.00499,0.004204,179,0.000214,0,31,0.825,0.033717
55091,Pepin County,,WI,455,7725,8180,3,4,7,204,242,446,7,0.255476,0.264801,1.398179,0.000026,0.000074,50,0.000128,0,31,0.75,0.000544
55093,Pierce County,,WI,2850,44566,47416,12,10,22,2300,1709,4009,6,0.306782,0.321424,1587.962835,0.001597,0.00137,50,0.000265,0,31,0.681818,0.011525
55095,Polk County,,WI,2524,48547,51071,11,11,22,2160,1592,3752,6,0.306685,0.321367,9.44829,0.001563,0.001429,50,0.000263,0,31,0.763636,0.011171
55097,Portage County,,WI,4268,78496,82764,15,18,33,2015,2429,4444,6,0.332837,0.352657,781.475277,0.001458,0.003132,179,0.000284,0,31,0.542105,0.011547
55099,Price County,,WI,1005,18398,19403,3,5,8,218,257,475,7,0.255882,0.265782,2474.836125,0.000042,0.000102,179,0.00012,0,31,0.35,0.000596
55101,Racine County,,WI,10850,226009,236859,19,26,45,7919,7049,14968,6,0.350767,0.373984,205.870775,0.005711,0.008881,179,0.000263,0,31,0.529885,0.037708
55103,Richland County,,WI,1278,21457,22735,7,6,13,844,703,1547,6,0.287326,0.299782,6.086771,0.000466,0.000483,179,0.000206,0,31,0.714286,0.004225
55105,Rock County,,WI,8357,177491,185848,24,24,48,5084,4808,9892,6,0.349543,0.373485,1479.495871,0.005671,0.006209,179,0.000349,0,31,0.399287,0.037649
55107,Rusk County,,WI,991,17121,18112,4,3,7,291,318,609,7,0.255409,0.264514,59.620234,0.000074,0.000075,50,0.000146,0,31,0.75,0.001035
55109,St. Croix County,,WI,4896,79900,84796,16,16,32,5675,3165,8840,6,0.33341,0.353524,1170.237743,0.002608,0.003126,50,0.000319,0,31,0.549708,0.018749
55111,Sauk County,,WI,3972,67361,71333,17,13,30,2799,2399,5198,6,0.32758,0.346189,690.071101,0.003763,0.002271,179,0.000311,0,31,0.461988,0.024783
55113,Sawyer County,,WI,1114,19272,20386,4,4,8,306,236,542,7,0.236098,0.243316,1934.508027,0.000753,0.000014,50,0.000144,0,31,0.433333,0.005368
55115,Shawano County,,WI,2217,44115,46332,11,9,20,1571,1398,2969,6,0.293719,0.307266,5861.054263,0.000985,0.000705,179,0.000273,0,31,0.618182,0.007556
55117,Sheboygan County,,WI,5382,139861,145243,16,17,33,2861,3155,6016,6,0.342534,0.363918,257.024795,0.003755,0.005296,179,0.000263,0,31,0.733918,0.027595
55119,Taylor County,,WI,1114,21668,22782,3,5,8,309,515,824,7,0.255836,0.265667,2.654762,0.000043,0.000101,179,0.000102,0,31,0.75,0.000618
55121,Trempealeau County,,WI,1762,31382,33144,6,7,13,1053,1053,2106,7,0.255859,0.265954,10.018075,0.000117,0.000131,50,0.000187,0,31,0.5,0.001511
55123,Vernon County,,WI,1604,28077,29681,6,7,13,883,1029,1912,6,0.287439,0.300126,7.032744,0.00045,0.000537,179,0.000192,0,31,0.666667,0.004081
55125,Vilas County,,WI,1484,23673,25157,8,4,12,889,456,1345,6,0.297024,0.309952,50.957086,0.002335,0.000932,179,0.000175,0,31,0.75,0.016409
55127,Walworth County,,WI,6717,106564,113281,15,15,30,5732,4173,9905,6,0.338777,0.359091,44.207713,0.005556,0.004816,179,0.000194,0,31,0.75,0.035681
55129,Washburn County,,WI,1125,16252,17377,5,5,10,451,475,926,7,0.255566,0.265088,53.384656,0.000056,0.000084,50,0.000209,0,31,0.433333,0.000974
55131,Washington County,,WI,8807,149649,158456,18,18,36,7561,6403,13964,6,0.342574,0.36409,229.646123,0.00525,0.005373,179,0.000273,0,31,0.694737,0.036585
55133,Waukesha County,,WI,27282,451828,479110,58,67,125,23662,21118,44780,6,0.375145,0.405785,10393.921064,0.025647,0.026172,179,0.000731,0,31,0.383017,0.172866
55135,Waupaca County,,WI,2978,59252,62230,10,11,21,1946,1898,3844,6,0.297389,0.311444,13.057772,0.000994,0.001177,179,0.000212,0,31,0.795455,0.007533
55137,Waushara County,,WI,1419,23749,25168,10,9,19,1025,791,1816,6,0.293393,0.306721,19.523783,0.000713,0.000659,179,0.000218,0,31,0.577778,0.005653
55139,Winnebago County,,WI,11456,178959,190415,32,28,60,8071,8360,16431,6,0.343222,0.366156,2924.77377,0.006008,0.005472,179,0.000554,0,31,0.401681,0.042405
55141,Wood County,,WI,4308,90602,94910,9,17,26,1944,2447,4391,6,0.310256,0.32686,337.02826,0.001287,0.001981,179,0.000188,0,31,0.571895,0.009632
56001,Albany County,,WY,4376,29670,34046,18,16,34,1654,1596,3250,6,0.330865,0.350011,5949.74624,0.002424,0.003647,100,0.000426,0,31,0.329004,0.018296
56003,Big Horn County,,WY,880,11474,12354,1,3,4,144,298,442,7,0.249142,0.257311,2945,0.000002,0.000022,100,0.00008,0,31,0.5,0.000125
56005,Campbell County,,WY,3470,42522,45992,13,13,26,1019,1329,2348,6,0.331091,0.349925,10273.736275,0.000358,0.00145,100,0.000425,0,31,0.266667,0.003613
56007,Carbon County,,WY,1693,16598,18291,5,5,10,369,556,925,7,0.258455,0.268292,0,0.0002,0.000225,100,0.000141,0,31,1,0.002133
56009,Converse County,,WY,1522,14609,16131,3,2,5,451,607,1058,7,0.252874,0.261333,2.809914,0.000141,0.000066,100,0.000114,0,31,0.666667,0.001511
56011,Crook County,,WY,526,6072,6598,1,2,3,143,170,313,7,0.249377,0.257251,0,0.000012,0.000005,100,0.000078,0,31,1,0.000142
56013,Fremont County,,WY,2624,39520,42144,8,10,18,566,760,1326,6,0.3297,0.347756,2389.890124,0.00192,0.001408,100,0.000192,0,31,0.462121,0.014413
56015,Goshen County,,WY,1027,12845,13872,3,4,7,221,368,589,7,0.257835,0.267247,21.213374,0.000409,0.000139,100,0.000095,0,31,0.7,0.003143
56017,Hot Springs County,,WY,459,5034,5493,0,2,2,0,91,91,7,0.252302,0.260664,0,0,0.000079,100,0.000051,0,263,1,0
56019,Johnson County,,WY,666,7875,8541,3,2,5,249,171,420,7,0.252215,0.260495,0,0.000068,0.000065,100,0.000137,0,31,1,0.000822
56021,Laramie County,,WY,8007,95340,103347,31,34,65,3676,2993,6669,6,0.34625,0.369376,16580.387053,0.012415,0.010371,100,0.000542,0,31,0.425803,0.088397
56023,Lincoln County,,WY,1336,17198,18534,7,7,14,605,446,1051,6,0.296478,0.311301,353.409268,0.000858,0.000693,178,0.000161,0,31,0.388889,0.005916
56025,Natrona County,,WY,4919,75465,80384,26,22,48,2631,2015,4646,6,0.337204,0.358064,20115.957835,0.0076,0.005279,100,0.000571,0,31,0.382056,0.053611
56027,Niobrara County,,WY,231,2556,2787,0,0,0,0,0,0,0,0,0,0,0,0,180,0.000051,163,264,0,0
56029,Park County,,WY,2342,30225,32567,7,6,13,565,595,1160,7,0.261316,0.27216,5997.370975,0.000273,0.0002,100,0.000205,0,31,0.5,0.00296
56031,Platte County,,WY,770,9604,10374,4,2,6,230,164,394,7,0.25731,0.266203,0,0.00016,0.000123,100,0.000129,0,31,0.75,0.001746
56033,Sheridan County,,WY,2260,30310,32570,9,7,16,755,695,1450,6,0.330038,0.347899,1264.390419,0.000287,0.001464,100,0.000297,0,31,0.511111,0.003246
56035,Sublette County,,WY,616,7145,7761,1,2,3,74,131,205,7,0.25,0.258069,0,0.000029,0.000031,100,0.000067,0,31,1,0.000287
56037,Sweetwater County,,WY,3578,44670,48248,13,15,28,1046,1348,2394,6,0.332913,0.352399,7387.916789,0.002877,0.003548,100,0.000281,0,31,0.375,0.022181
56039,Teton County,,WY,2803,20193,22996,7,6,13,425,656,1081,6,0.330789,0.348904,3629.282435,0.003317,0.002138,178,0.000147,0,31,0.433333,0.02352
56041,Uinta County,,WY,1996,22495,24491,5,10,15,449,831,1280,6,0.330188,0.348617,45.5485,0.001144,0.00243,178,0.000117,0,31,0.588889,0.007069
56043,Washakie County,,WY,709,9578,10287,1,2,3,56,107,163,7,0.25228,0.260639,5.639401,0,0.000065,100,0.000073,0,31,0.666667,0.000091
56045,Weston County,,WY,505,7361,7866,1,2,3,120,116,236,7,0.262118,0.271689,0,0.000012,0.000064,100,0.000078,0,31,1,0.000142
2198,Prince Of Wales Oute,,AK,499,4821,5320,2,2,4,94,118,212,7,0.249313,0.257001,0,0.000374,0.000015,178,0.000088,0,31,1,0.00295
2230,Skagway Hoonah Ango,,AK,542,3353,3895,1,1,2,48,120,168,7,0.24927,0.256771,0,0.000022,0.000012,178,0.00009,0,31,0,0.000195
2275,Wrangell Petersburg,,AK,648,6812,7460,0,1,1,0,101,101,7,0.249313,0.256855,0,0,0.000012,178,0.000051,0,265,0,0
